"SUMLEV","STATE","COUNTY","STNAME","CTYNAME","YEAR","AGE","TOT_POP","TOT_MALE","TOT_FEMALE"
050,36,001,"New York","Albany County",1,0,2901,1478,1423
050,36,001,"New York","Albany County",1,1,2973,1503,1470
050,36,001,"New York","Albany County",1,2,3056,1548,1508
050,36,001,"New York","Albany County",1,3,3136,1623,1513
050,36,001,"New York","Albany County",1,4,3266,1682,1584
050,36,001,"New York","Albany County",1,5,3327,1709,1618
050,36,001,"New York","Albany County",1,6,3265,1711,1554
050,36,001,"New York","Albany County",1,7,3318,1711,1607
050,36,001,"New York","Albany County",1,8,3224,1652,1572
050,36,001,"New York","Albany County",1,9,3220,1685,1535
050,36,001,"New York","Albany County",1,10,3299,1667,1632
050,36,001,"New York","Albany County",1,11,3243,1648,1595
050,36,001,"New York","Albany County",1,12,3286,1707,1579
050,36,001,"New York","Albany County",1,13,3247,1692,1555
050,36,001,"New York","Albany County",1,14,3281,1683,1598
050,36,001,"New York","Albany County",1,15,3280,1631,1649
050,36,001,"New York","Albany County",1,16,3428,1705,1723
050,36,001,"New York","Albany County",1,17,3537,1731,1806
050,36,001,"New York","Albany County",1,18,5402,2618,2784
050,36,001,"New York","Albany County",1,19,6752,3223,3529
050,36,001,"New York","Albany County",1,20,7688,3846,3842
050,36,001,"New York","Albany County",1,21,7626,3600,4026
050,36,001,"New York","Albany County",1,22,6085,3084,3001
050,36,001,"New York","Albany County",1,23,5756,2763,2993
050,36,001,"New York","Albany County",1,24,4881,2386,2495
050,36,001,"New York","Albany County",1,25,4644,2321,2323
050,36,001,"New York","Albany County",1,26,4434,2243,2191
050,36,001,"New York","Albany County",1,27,4231,2112,2119
050,36,001,"New York","Albany County",1,28,4258,2147,2111
050,36,001,"New York","Albany County",1,29,4220,2083,2137
050,36,001,"New York","Albany County",1,30,3946,1908,2038
050,36,001,"New York","Albany County",1,31,3898,1943,1955
050,36,001,"New York","Albany County",1,32,4017,1991,2026
050,36,001,"New York","Albany County",1,33,3987,2035,1952
050,36,001,"New York","Albany County",1,34,4001,2070,1931
050,36,001,"New York","Albany County",1,35,4131,2070,2061
050,36,001,"New York","Albany County",1,36,4011,2028,1983
050,36,001,"New York","Albany County",1,37,4008,2009,1999
050,36,001,"New York","Albany County",1,38,3878,1930,1948
050,36,001,"New York","Albany County",1,39,3850,1825,2025
050,36,001,"New York","Albany County",1,40,3906,1960,1946
050,36,001,"New York","Albany County",1,41,3609,1829,1780
050,36,001,"New York","Albany County",1,42,3486,1753,1733
050,36,001,"New York","Albany County",1,43,3366,1665,1701
050,36,001,"New York","Albany County",1,44,3322,1614,1708
050,36,001,"New York","Albany County",1,45,3370,1681,1689
050,36,001,"New York","Albany County",1,46,3161,1536,1625
050,36,001,"New York","Albany County",1,47,3278,1565,1713
050,36,001,"New York","Albany County",1,48,3593,1812,1781
050,36,001,"New York","Albany County",1,49,3915,1961,1954
050,36,001,"New York","Albany County",1,50,3828,1923,1905
050,36,001,"New York","Albany County",1,51,3790,1875,1915
050,36,001,"New York","Albany County",1,52,3728,1835,1893
050,36,001,"New York","Albany County",1,53,3900,1929,1971
050,36,001,"New York","Albany County",1,54,4011,1945,2066
050,36,001,"New York","Albany County",1,55,4225,2049,2176
050,36,001,"New York","Albany County",1,56,4298,2082,2216
050,36,001,"New York","Albany County",1,57,4291,2099,2192
050,36,001,"New York","Albany County",1,58,4295,2126,2169
050,36,001,"New York","Albany County",1,59,4290,2100,2190
050,36,001,"New York","Albany County",1,60,4206,2051,2155
050,36,001,"New York","Albany County",1,61,4165,2008,2157
050,36,001,"New York","Albany County",1,62,4157,2032,2125
050,36,001,"New York","Albany County",1,63,3997,1976,2021
050,36,001,"New York","Albany County",1,64,3942,1922,2020
050,36,001,"New York","Albany County",1,65,3822,1822,2000
050,36,001,"New York","Albany County",1,66,3656,1727,1929
050,36,001,"New York","Albany County",1,67,3557,1682,1875
050,36,001,"New York","Albany County",1,68,3473,1651,1822
050,36,001,"New York","Albany County",1,69,3258,1543,1715
050,36,001,"New York","Albany County",1,70,3186,1452,1734
050,36,001,"New York","Albany County",1,71,3186,1466,1720
050,36,001,"New York","Albany County",1,72,3125,1446,1679
050,36,001,"New York","Albany County",1,73,3040,1420,1620
050,36,001,"New York","Albany County",1,74,2052,922,1130
050,36,001,"New York","Albany County",1,75,2029,914,1115
050,36,001,"New York","Albany County",1,76,1960,859,1101
050,36,001,"New York","Albany County",1,77,2034,893,1141
050,36,001,"New York","Albany County",1,78,1664,689,975
050,36,001,"New York","Albany County",1,79,1519,641,878
050,36,001,"New York","Albany County",1,80,1390,596,794
050,36,001,"New York","Albany County",1,81,1257,501,756
050,36,001,"New York","Albany County",1,82,1210,481,729
050,36,001,"New York","Albany County",1,83,1115,455,660
050,36,001,"New York","Albany County",1,84,1024,386,638
050,36,001,"New York","Albany County",1,85,7174,2269,4905
050,36,001,"New York","Albany County",2,0,2953,1503,1450
050,36,001,"New York","Albany County",2,1,2952,1494,1458
050,36,001,"New York","Albany County",2,2,3038,1539,1499
050,36,001,"New York","Albany County",2,3,3100,1596,1504
050,36,001,"New York","Albany County",2,4,3238,1670,1568
050,36,001,"New York","Albany County",2,5,3309,1704,1605
050,36,001,"New York","Albany County",2,6,3287,1720,1567
050,36,001,"New York","Albany County",2,7,3305,1715,1590
050,36,001,"New York","Albany County",2,8,3230,1657,1573
050,36,001,"New York","Albany County",2,9,3217,1673,1544
050,36,001,"New York","Albany County",2,10,3272,1664,1608
050,36,001,"New York","Albany County",2,11,3243,1647,1596
050,36,001,"New York","Albany County",2,12,3282,1696,1586
050,36,001,"New York","Albany County",2,13,3251,1693,1558
050,36,001,"New York","Albany County",2,14,3264,1677,1587
050,36,001,"New York","Albany County",2,15,3272,1638,1634
050,36,001,"New York","Albany County",2,16,3394,1690,1704
050,36,001,"New York","Albany County",2,17,3525,1726,1799
050,36,001,"New York","Albany County",2,18,5313,2574,2739
050,36,001,"New York","Albany County",2,19,6659,3166,3493
050,36,001,"New York","Albany County",2,20,7643,3824,3819
050,36,001,"New York","Albany County",2,21,7567,3574,3993
050,36,001,"New York","Albany County",2,22,6089,3086,3003
050,36,001,"New York","Albany County",2,23,5721,2751,2970
050,36,001,"New York","Albany County",2,24,4848,2364,2484
050,36,001,"New York","Albany County",2,25,4643,2313,2330
050,36,001,"New York","Albany County",2,26,4414,2239,2175
050,36,001,"New York","Albany County",2,27,4207,2103,2104
050,36,001,"New York","Albany County",2,28,4239,2137,2102
050,36,001,"New York","Albany County",2,29,4211,2083,2128
050,36,001,"New York","Albany County",2,30,4026,1959,2067
050,36,001,"New York","Albany County",2,31,3904,1931,1973
050,36,001,"New York","Albany County",2,32,3975,1976,1999
050,36,001,"New York","Albany County",2,33,3982,2020,1962
050,36,001,"New York","Albany County",2,34,3987,2055,1932
050,36,001,"New York","Albany County",2,35,4110,2079,2031
050,36,001,"New York","Albany County",2,36,4011,2021,1990
050,36,001,"New York","Albany County",2,37,4006,2012,1994
050,36,001,"New York","Albany County",2,38,3912,1944,1968
050,36,001,"New York","Albany County",2,39,3838,1840,1998
050,36,001,"New York","Albany County",2,40,3913,1946,1967
050,36,001,"New York","Albany County",2,41,3671,1851,1820
050,36,001,"New York","Albany County",2,42,3500,1765,1735
050,36,001,"New York","Albany County",2,43,3415,1699,1716
050,36,001,"New York","Albany County",2,44,3301,1615,1686
050,36,001,"New York","Albany County",2,45,3368,1670,1698
050,36,001,"New York","Albany County",2,46,3181,1550,1631
050,36,001,"New York","Albany County",2,47,3239,1554,1685
050,36,001,"New York","Albany County",2,48,3512,1748,1764
050,36,001,"New York","Albany County",2,49,3841,1921,1920
050,36,001,"New York","Albany County",2,50,3842,1926,1916
050,36,001,"New York","Albany County",2,51,3775,1871,1904
050,36,001,"New York","Albany County",2,52,3734,1846,1888
050,36,001,"New York","Albany County",2,53,3842,1896,1946
050,36,001,"New York","Albany County",2,54,3978,1945,2033
050,36,001,"New York","Albany County",2,55,4156,2012,2144
050,36,001,"New York","Albany County",2,56,4281,2075,2206
050,36,001,"New York","Albany County",2,57,4283,2086,2197
050,36,001,"New York","Albany County",2,58,4268,2102,2166
050,36,001,"New York","Albany County",2,59,4291,2109,2182
050,36,001,"New York","Albany County",2,60,4201,2050,2151
050,36,001,"New York","Albany County",2,61,4145,2002,2143
050,36,001,"New York","Albany County",2,62,4118,2000,2118
050,36,001,"New York","Albany County",2,63,4045,1998,2047
050,36,001,"New York","Albany County",2,64,3897,1902,1995
050,36,001,"New York","Albany County",2,65,3819,1829,1990
050,36,001,"New York","Albany County",2,66,3682,1747,1935
050,36,001,"New York","Albany County",2,67,3548,1672,1876
050,36,001,"New York","Albany County",2,68,3442,1635,1807
050,36,001,"New York","Albany County",2,69,3304,1565,1739
050,36,001,"New York","Albany County",2,70,3177,1461,1716
050,36,001,"New York","Albany County",2,71,3167,1452,1715
050,36,001,"New York","Albany County",2,72,3073,1419,1654
050,36,001,"New York","Albany County",2,73,3186,1485,1701
050,36,001,"New York","Albany County",2,74,2139,968,1171
050,36,001,"New York","Albany County",2,75,2025,912,1113
050,36,001,"New York","Albany County",2,76,1929,850,1079
050,36,001,"New York","Albany County",2,77,2040,889,1151
050,36,001,"New York","Albany County",2,78,1696,711,985
050,36,001,"New York","Albany County",2,79,1526,635,891
050,36,001,"New York","Albany County",2,80,1407,598,809
050,36,001,"New York","Albany County",2,81,1255,512,743
050,36,001,"New York","Albany County",2,82,1210,481,729
050,36,001,"New York","Albany County",2,83,1111,446,665
050,36,001,"New York","Albany County",2,84,1012,387,625
050,36,001,"New York","Albany County",2,85,7036,2243,4793
050,36,001,"New York","Albany County",3,0,2787,1385,1402
050,36,001,"New York","Albany County",3,1,2932,1508,1424
050,36,001,"New York","Albany County",3,2,2925,1467,1458
050,36,001,"New York","Albany County",3,3,3053,1556,1497
050,36,001,"New York","Albany County",3,4,3150,1620,1530
050,36,001,"New York","Albany County",3,5,3195,1640,1555
050,36,001,"New York","Albany County",3,6,3294,1705,1589
050,36,001,"New York","Albany County",3,7,3283,1715,1568
050,36,001,"New York","Albany County",3,8,3293,1683,1610
050,36,001,"New York","Albany County",3,9,3184,1624,1560
050,36,001,"New York","Albany County",3,10,3184,1660,1524
050,36,001,"New York","Albany County",3,11,3272,1648,1624
050,36,001,"New York","Albany County",3,12,3192,1607,1585
050,36,001,"New York","Albany County",3,13,3289,1706,1583
050,36,001,"New York","Albany County",3,14,3242,1705,1537
050,36,001,"New York","Albany County",3,15,3271,1670,1601
050,36,001,"New York","Albany County",3,16,3299,1631,1668
050,36,001,"New York","Albany County",3,17,3470,1712,1758
050,36,001,"New York","Albany County",3,18,5737,2786,2951
050,36,001,"New York","Albany County",3,19,7252,3415,3837
050,36,001,"New York","Albany County",3,20,8086,4003,4083
050,36,001,"New York","Albany County",3,21,7919,3727,4192
050,36,001,"New York","Albany County",3,22,6225,3147,3078
050,36,001,"New York","Albany County",3,23,5740,2757,2983
050,36,001,"New York","Albany County",3,24,4835,2344,2491
050,36,001,"New York","Albany County",3,25,4639,2280,2359
050,36,001,"New York","Albany County",3,26,4399,2226,2173
050,36,001,"New York","Albany County",3,27,4269,2153,2116
050,36,001,"New York","Albany County",3,28,4266,2165,2101
050,36,001,"New York","Albany County",3,29,4233,2153,2080
050,36,001,"New York","Albany County",3,30,4230,2097,2133
050,36,001,"New York","Albany County",3,31,4151,2020,2131
050,36,001,"New York","Albany County",3,32,3965,1949,2016
050,36,001,"New York","Albany County",3,33,3959,1987,1972
050,36,001,"New York","Albany County",3,34,4007,2036,1971
050,36,001,"New York","Albany County",3,35,3999,2037,1962
050,36,001,"New York","Albany County",3,36,4131,2094,2037
050,36,001,"New York","Albany County",3,37,4009,2021,1988
050,36,001,"New York","Albany County",3,38,3966,2021,1945
050,36,001,"New York","Albany County",3,39,3935,1948,1987
050,36,001,"New York","Albany County",3,40,3858,1865,1993
050,36,001,"New York","Albany County",3,41,3884,1904,1980
050,36,001,"New York","Albany County",3,42,3671,1843,1828
050,36,001,"New York","Albany County",3,43,3498,1766,1732
050,36,001,"New York","Albany County",3,44,3406,1699,1707
050,36,001,"New York","Albany County",3,45,3308,1620,1688
050,36,001,"New York","Albany County",3,46,3349,1639,1710
050,36,001,"New York","Albany County",3,47,3206,1572,1634
050,36,001,"New York","Albany County",3,48,3257,1569,1688
050,36,001,"New York","Albany County",3,49,3535,1747,1788
050,36,001,"New York","Albany County",3,50,3821,1926,1895
050,36,001,"New York","Albany County",3,51,3865,1942,1923
050,36,001,"New York","Albany County",3,52,3726,1850,1876
050,36,001,"New York","Albany County",3,53,3673,1800,1873
050,36,001,"New York","Albany County",3,54,3835,1908,1927
050,36,001,"New York","Albany County",3,55,3930,1909,2021
050,36,001,"New York","Albany County",3,56,4103,1967,2136
050,36,001,"New York","Albany County",3,57,4201,2019,2182
050,36,001,"New York","Albany County",3,58,4147,2016,2131
050,36,001,"New York","Albany County",3,59,4204,2081,2123
050,36,001,"New York","Albany County",3,60,4214,2065,2149
050,36,001,"New York","Albany County",3,61,4063,1955,2108
050,36,001,"New York","Albany County",3,62,4059,1934,2125
050,36,001,"New York","Albany County",3,63,4029,1958,2071
050,36,001,"New York","Albany County",3,64,3959,1937,2022
050,36,001,"New York","Albany County",3,65,3848,1868,1980
050,36,001,"New York","Albany County",3,66,3719,1787,1932
050,36,001,"New York","Albany County",3,67,3614,1705,1909
050,36,001,"New York","Albany County",3,68,3455,1614,1841
050,36,001,"New York","Albany County",3,69,3382,1601,1781
050,36,001,"New York","Albany County",3,70,3202,1503,1699
050,36,001,"New York","Albany County",3,71,3112,1434,1678
050,36,001,"New York","Albany County",3,72,3078,1406,1672
050,36,001,"New York","Albany County",3,73,2992,1380,1612
050,36,001,"New York","Albany County",3,74,3088,1422,1666
050,36,001,"New York","Albany County",3,75,2084,946,1138
050,36,001,"New York","Albany County",3,76,1953,885,1068
050,36,001,"New York","Albany County",3,77,1917,823,1094
050,36,001,"New York","Albany County",3,78,1950,838,1112
050,36,001,"New York","Albany County",3,79,1636,677,959
050,36,001,"New York","Albany County",3,80,1478,609,869
050,36,001,"New York","Albany County",3,81,1315,537,778
050,36,001,"New York","Albany County",3,82,1203,492,711
050,36,001,"New York","Albany County",3,83,1118,437,681
050,36,001,"New York","Albany County",3,84,998,391,607
050,36,001,"New York","Albany County",3,85,6968,2203,4765
050,36,001,"New York","Albany County",4,0,2853,1448,1405
050,36,001,"New York","Albany County",4,1,2780,1365,1415
050,36,001,"New York","Albany County",4,2,2934,1505,1429
050,36,001,"New York","Albany County",4,3,2952,1485,1467
050,36,001,"New York","Albany County",4,4,3039,1565,1474
050,36,001,"New York","Albany County",4,5,3140,1622,1518
050,36,001,"New York","Albany County",4,6,3164,1653,1511
050,36,001,"New York","Albany County",4,7,3266,1677,1589
050,36,001,"New York","Albany County",4,8,3263,1695,1568
050,36,001,"New York","Albany County",4,9,3286,1681,1605
050,36,001,"New York","Albany County",4,10,3147,1590,1557
050,36,001,"New York","Albany County",4,11,3198,1664,1534
050,36,001,"New York","Albany County",4,12,3271,1642,1629
050,36,001,"New York","Albany County",4,13,3191,1589,1602
050,36,001,"New York","Albany County",4,14,3308,1714,1594
050,36,001,"New York","Albany County",4,15,3271,1718,1553
050,36,001,"New York","Albany County",4,16,3289,1677,1612
050,36,001,"New York","Albany County",4,17,3375,1661,1714
050,36,001,"New York","Albany County",4,18,5708,2795,2913
050,36,001,"New York","Albany County",4,19,7322,3459,3863
050,36,001,"New York","Albany County",4,20,8053,3991,4062
050,36,001,"New York","Albany County",4,21,7955,3715,4240
050,36,001,"New York","Albany County",4,22,6346,3194,3152
050,36,001,"New York","Albany County",4,23,5637,2698,2939
050,36,001,"New York","Albany County",4,24,4745,2334,2411
050,36,001,"New York","Albany County",4,25,4617,2237,2380
050,36,001,"New York","Albany County",4,26,4240,2129,2111
050,36,001,"New York","Albany County",4,27,4178,2132,2046
050,36,001,"New York","Albany County",4,28,4279,2172,2107
050,36,001,"New York","Albany County",4,29,4152,2135,2017
050,36,001,"New York","Albany County",4,30,4134,2086,2048
050,36,001,"New York","Albany County",4,31,4215,2074,2141
050,36,001,"New York","Albany County",4,32,4067,1970,2097
050,36,001,"New York","Albany County",4,33,3960,1947,2013
050,36,001,"New York","Albany County",4,34,3989,1982,2007
050,36,001,"New York","Albany County",4,35,3988,2002,1986
050,36,001,"New York","Albany County",4,36,4036,2038,1998
050,36,001,"New York","Albany County",4,37,4113,2085,2028
050,36,001,"New York","Albany County",4,38,3981,2007,1974
050,36,001,"New York","Albany County",4,39,3957,2012,1945
050,36,001,"New York","Albany County",4,40,3956,1967,1989
050,36,001,"New York","Albany County",4,41,3827,1840,1987
050,36,001,"New York","Albany County",4,42,3899,1924,1975
050,36,001,"New York","Albany County",4,43,3610,1796,1814
050,36,001,"New York","Albany County",4,44,3506,1782,1724
050,36,001,"New York","Albany County",4,45,3391,1676,1715
050,36,001,"New York","Albany County",4,46,3227,1561,1666
050,36,001,"New York","Albany County",4,47,3307,1605,1702
050,36,001,"New York","Albany County",4,48,3206,1558,1648
050,36,001,"New York","Albany County",4,49,3264,1558,1706
050,36,001,"New York","Albany County",4,50,3501,1752,1749
050,36,001,"New York","Albany County",4,51,3781,1892,1889
050,36,001,"New York","Albany County",4,52,3845,1949,1896
050,36,001,"New York","Albany County",4,53,3675,1806,1869
050,36,001,"New York","Albany County",4,54,3668,1798,1870
050,36,001,"New York","Albany County",4,55,3795,1868,1927
050,36,001,"New York","Albany County",4,56,3887,1903,1984
050,36,001,"New York","Albany County",4,57,4054,1937,2117
050,36,001,"New York","Albany County",4,58,4128,1977,2151
050,36,001,"New York","Albany County",4,59,4067,1978,2089
050,36,001,"New York","Albany County",4,60,4180,2059,2121
050,36,001,"New York","Albany County",4,61,4128,2016,2112
050,36,001,"New York","Albany County",4,62,4009,1905,2104
050,36,001,"New York","Albany County",4,63,3963,1893,2070
050,36,001,"New York","Albany County",4,64,3964,1908,2056
050,36,001,"New York","Albany County",4,65,3868,1883,1985
050,36,001,"New York","Albany County",4,66,3778,1820,1958
050,36,001,"New York","Albany County",4,67,3626,1727,1899
050,36,001,"New York","Albany County",4,68,3527,1662,1865
050,36,001,"New York","Albany County",4,69,3400,1588,1812
050,36,001,"New York","Albany County",4,70,3262,1540,1722
050,36,001,"New York","Albany County",4,71,3146,1464,1682
050,36,001,"New York","Albany County",4,72,3070,1404,1666
050,36,001,"New York","Albany County",4,73,3018,1374,1644
050,36,001,"New York","Albany County",4,74,2925,1338,1587
050,36,001,"New York","Albany County",4,75,3051,1412,1639
050,36,001,"New York","Albany County",4,76,2022,928,1094
050,36,001,"New York","Albany County",4,77,1908,842,1066
050,36,001,"New York","Albany County",4,78,1839,780,1059
050,36,001,"New York","Albany County",4,79,1890,816,1074
050,36,001,"New York","Albany County",4,80,1581,657,924
050,36,001,"New York","Albany County",4,81,1400,562,838
050,36,001,"New York","Albany County",4,82,1276,527,749
050,36,001,"New York","Albany County",4,83,1151,463,688
050,36,001,"New York","Albany County",4,84,1021,388,633
050,36,001,"New York","Albany County",4,85,6925,2197,4728
050,36,001,"New York","Albany County",5,0,2847,1447,1400
050,36,001,"New York","Albany County",5,1,2856,1437,1419
050,36,001,"New York","Albany County",5,2,2793,1389,1404
050,36,001,"New York","Albany County",5,3,2927,1510,1417
050,36,001,"New York","Albany County",5,4,2980,1504,1476
050,36,001,"New York","Albany County",5,5,3042,1569,1473
050,36,001,"New York","Albany County",5,6,3184,1656,1528
050,36,001,"New York","Albany County",5,7,3165,1640,1525
050,36,001,"New York","Albany County",5,8,3255,1675,1580
050,36,001,"New York","Albany County",5,9,3283,1692,1591
050,36,001,"New York","Albany County",5,10,3305,1692,1613
050,36,001,"New York","Albany County",5,11,3151,1596,1555
050,36,001,"New York","Albany County",5,12,3211,1677,1534
050,36,001,"New York","Albany County",5,13,3303,1646,1657
050,36,001,"New York","Albany County",5,14,3229,1604,1625
050,36,001,"New York","Albany County",5,15,3312,1732,1580
050,36,001,"New York","Albany County",5,16,3296,1732,1564
050,36,001,"New York","Albany County",5,17,3397,1714,1683
050,36,001,"New York","Albany County",5,18,5651,2774,2877
050,36,001,"New York","Albany County",5,19,7376,3498,3878
050,36,001,"New York","Albany County",5,20,8100,3992,4108
050,36,001,"New York","Albany County",5,21,7841,3644,4197
050,36,001,"New York","Albany County",5,22,6263,3166,3097
050,36,001,"New York","Albany County",5,23,5834,2791,3043
050,36,001,"New York","Albany County",5,24,4660,2245,2415
050,36,001,"New York","Albany County",5,25,4489,2206,2283
050,36,001,"New York","Albany County",5,26,4282,2119,2163
050,36,001,"New York","Albany County",5,27,4039,2010,2029
050,36,001,"New York","Albany County",5,28,4172,2104,2068
050,36,001,"New York","Albany County",5,29,4278,2172,2106
050,36,001,"New York","Albany County",5,30,4157,2152,2005
050,36,001,"New York","Albany County",5,31,4172,2101,2071
050,36,001,"New York","Albany County",5,32,4210,2078,2132
050,36,001,"New York","Albany County",5,33,4056,1969,2087
050,36,001,"New York","Albany County",5,34,4025,1979,2046
050,36,001,"New York","Albany County",5,35,4016,1992,2024
050,36,001,"New York","Albany County",5,36,4031,2023,2008
050,36,001,"New York","Albany County",5,37,4051,2037,2014
050,36,001,"New York","Albany County",5,38,4085,2081,2004
050,36,001,"New York","Albany County",5,39,3960,2015,1945
050,36,001,"New York","Albany County",5,40,3976,2005,1971
050,36,001,"New York","Albany County",5,41,3919,1938,1981
050,36,001,"New York","Albany County",5,42,3855,1874,1981
050,36,001,"New York","Albany County",5,43,3908,1935,1973
050,36,001,"New York","Albany County",5,44,3577,1795,1782
050,36,001,"New York","Albany County",5,45,3538,1803,1735
050,36,001,"New York","Albany County",5,46,3355,1648,1707
050,36,001,"New York","Albany County",5,47,3228,1564,1664
050,36,001,"New York","Albany County",5,48,3351,1635,1716
050,36,001,"New York","Albany County",5,49,3221,1551,1670
050,36,001,"New York","Albany County",5,50,3228,1544,1684
050,36,001,"New York","Albany County",5,51,3474,1738,1736
050,36,001,"New York","Albany County",5,52,3759,1890,1869
050,36,001,"New York","Albany County",5,53,3802,1911,1891
050,36,001,"New York","Albany County",5,54,3642,1792,1850
050,36,001,"New York","Albany County",5,55,3644,1768,1876
050,36,001,"New York","Albany County",5,56,3747,1847,1900
050,36,001,"New York","Albany County",5,57,3861,1893,1968
050,36,001,"New York","Albany County",5,58,3997,1909,2088
050,36,001,"New York","Albany County",5,59,4077,1949,2128
050,36,001,"New York","Albany County",5,60,4038,1961,2077
050,36,001,"New York","Albany County",5,61,4105,2014,2091
050,36,001,"New York","Albany County",5,62,4067,1970,2097
050,36,001,"New York","Albany County",5,63,3868,1836,2032
050,36,001,"New York","Albany County",5,64,3862,1830,2032
050,36,001,"New York","Albany County",5,65,3912,1871,2041
050,36,001,"New York","Albany County",5,66,3800,1829,1971
050,36,001,"New York","Albany County",5,67,3675,1753,1922
050,36,001,"New York","Albany County",5,68,3566,1685,1881
050,36,001,"New York","Albany County",5,69,3478,1624,1854
050,36,001,"New York","Albany County",5,70,3286,1529,1757
050,36,001,"New York","Albany County",5,71,3198,1496,1702
050,36,001,"New York","Albany County",5,72,3089,1428,1661
050,36,001,"New York","Albany County",5,73,3010,1383,1627
050,36,001,"New York","Albany County",5,74,2928,1341,1587
050,36,001,"New York","Albany County",5,75,2867,1310,1557
050,36,001,"New York","Albany County",5,76,2944,1361,1583
050,36,001,"New York","Albany County",5,77,1998,904,1094
050,36,001,"New York","Albany County",5,78,1843,808,1035
050,36,001,"New York","Albany County",5,79,1794,762,1032
050,36,001,"New York","Albany County",5,80,1840,801,1039
050,36,001,"New York","Albany County",5,81,1486,595,891
050,36,001,"New York","Albany County",5,82,1356,550,806
050,36,001,"New York","Albany County",5,83,1199,488,711
050,36,001,"New York","Albany County",5,84,1053,409,644
050,36,001,"New York","Albany County",5,85,6954,2191,4763
050,36,003,"New York","Allegany County",1,0,451,231,220
050,36,003,"New York","Allegany County",1,1,470,238,232
050,36,003,"New York","Allegany County",1,2,482,229,253
050,36,003,"New York","Allegany County",1,3,492,259,233
050,36,003,"New York","Allegany County",1,4,514,265,249
050,36,003,"New York","Allegany County",1,5,522,287,235
050,36,003,"New York","Allegany County",1,6,485,275,210
050,36,003,"New York","Allegany County",1,7,506,271,235
050,36,003,"New York","Allegany County",1,8,481,256,225
050,36,003,"New York","Allegany County",1,9,542,285,257
050,36,003,"New York","Allegany County",1,10,534,258,276
050,36,003,"New York","Allegany County",1,11,560,262,298
050,36,003,"New York","Allegany County",1,12,534,271,263
050,36,003,"New York","Allegany County",1,13,554,282,272
050,36,003,"New York","Allegany County",1,14,560,292,268
050,36,003,"New York","Allegany County",1,15,569,302,267
050,36,003,"New York","Allegany County",1,16,586,328,258
050,36,003,"New York","Allegany County",1,17,607,334,273
050,36,003,"New York","Allegany County",1,18,1156,636,520
050,36,003,"New York","Allegany County",1,19,1551,858,693
050,36,003,"New York","Allegany County",1,20,1375,735,640
050,36,003,"New York","Allegany County",1,21,1033,544,489
050,36,003,"New York","Allegany County",1,22,719,405,314
050,36,003,"New York","Allegany County",1,23,515,267,248
050,36,003,"New York","Allegany County",1,24,472,237,235
050,36,003,"New York","Allegany County",1,25,446,247,199
050,36,003,"New York","Allegany County",1,26,459,247,212
050,36,003,"New York","Allegany County",1,27,487,251,236
050,36,003,"New York","Allegany County",1,28,441,221,220
050,36,003,"New York","Allegany County",1,29,408,200,208
050,36,003,"New York","Allegany County",1,30,415,198,217
050,36,003,"New York","Allegany County",1,31,477,247,230
050,36,003,"New York","Allegany County",1,32,514,278,236
050,36,003,"New York","Allegany County",1,33,500,253,247
050,36,003,"New York","Allegany County",1,34,507,263,244
050,36,003,"New York","Allegany County",1,35,496,253,243
050,36,003,"New York","Allegany County",1,36,479,221,258
050,36,003,"New York","Allegany County",1,37,499,236,263
050,36,003,"New York","Allegany County",1,38,474,245,229
050,36,003,"New York","Allegany County",1,39,478,253,225
050,36,003,"New York","Allegany County",1,40,495,252,243
050,36,003,"New York","Allegany County",1,41,488,235,253
050,36,003,"New York","Allegany County",1,42,463,229,234
050,36,003,"New York","Allegany County",1,43,453,235,218
050,36,003,"New York","Allegany County",1,44,488,261,227
050,36,003,"New York","Allegany County",1,45,468,230,238
050,36,003,"New York","Allegany County",1,46,441,217,224
050,36,003,"New York","Allegany County",1,47,453,223,230
050,36,003,"New York","Allegany County",1,48,506,262,244
050,36,003,"New York","Allegany County",1,49,553,284,269
050,36,003,"New York","Allegany County",1,50,542,284,258
050,36,003,"New York","Allegany County",1,51,537,274,263
050,36,003,"New York","Allegany County",1,52,512,248,264
050,36,003,"New York","Allegany County",1,53,537,260,277
050,36,003,"New York","Allegany County",1,54,557,277,280
050,36,003,"New York","Allegany County",1,55,574,287,287
050,36,003,"New York","Allegany County",1,56,606,304,302
050,36,003,"New York","Allegany County",1,57,663,345,318
050,36,003,"New York","Allegany County",1,58,670,343,327
050,36,003,"New York","Allegany County",1,59,668,336,332
050,36,003,"New York","Allegany County",1,60,661,335,326
050,36,003,"New York","Allegany County",1,61,700,378,322
050,36,003,"New York","Allegany County",1,62,689,352,337
050,36,003,"New York","Allegany County",1,63,651,331,320
050,36,003,"New York","Allegany County",1,64,644,329,315
050,36,003,"New York","Allegany County",1,65,674,354,320
050,36,003,"New York","Allegany County",1,66,629,324,305
050,36,003,"New York","Allegany County",1,67,600,296,304
050,36,003,"New York","Allegany County",1,68,550,267,283
050,36,003,"New York","Allegany County",1,69,530,267,263
050,36,003,"New York","Allegany County",1,70,554,280,274
050,36,003,"New York","Allegany County",1,71,522,264,258
050,36,003,"New York","Allegany County",1,72,522,264,258
050,36,003,"New York","Allegany County",1,73,497,252,245
050,36,003,"New York","Allegany County",1,74,361,194,167
050,36,003,"New York","Allegany County",1,75,320,164,156
050,36,003,"New York","Allegany County",1,76,359,186,173
050,36,003,"New York","Allegany County",1,77,349,171,178
050,36,003,"New York","Allegany County",1,78,275,130,145
050,36,003,"New York","Allegany County",1,79,255,113,142
050,36,003,"New York","Allegany County",1,80,237,106,131
050,36,003,"New York","Allegany County",1,81,214,99,115
050,36,003,"New York","Allegany County",1,82,229,107,122
050,36,003,"New York","Allegany County",1,83,189,86,103
050,36,003,"New York","Allegany County",1,84,167,77,90
050,36,003,"New York","Allegany County",1,85,1048,386,662
050,36,003,"New York","Allegany County",2,0,468,230,238
050,36,003,"New York","Allegany County",2,1,466,236,230
050,36,003,"New York","Allegany County",2,2,482,233,249
050,36,003,"New York","Allegany County",2,3,488,251,237
050,36,003,"New York","Allegany County",2,4,512,266,246
050,36,003,"New York","Allegany County",2,5,518,280,238
050,36,003,"New York","Allegany County",2,6,494,279,215
050,36,003,"New York","Allegany County",2,7,496,269,227
050,36,003,"New York","Allegany County",2,8,487,257,230
050,36,003,"New York","Allegany County",2,9,526,277,249
050,36,003,"New York","Allegany County",2,10,532,261,271
050,36,003,"New York","Allegany County",2,11,551,259,292
050,36,003,"New York","Allegany County",2,12,542,270,272
050,36,003,"New York","Allegany County",2,13,550,281,269
050,36,003,"New York","Allegany County",2,14,557,288,269
050,36,003,"New York","Allegany County",2,15,564,300,264
050,36,003,"New York","Allegany County",2,16,584,322,262
050,36,003,"New York","Allegany County",2,17,606,335,271
050,36,003,"New York","Allegany County",2,18,1313,726,587
050,36,003,"New York","Allegany County",2,19,1846,1027,819
050,36,003,"New York","Allegany County",2,20,1620,870,750
050,36,003,"New York","Allegany County",2,21,1177,618,559
050,36,003,"New York","Allegany County",2,22,796,444,352
050,36,003,"New York","Allegany County",2,23,528,279,249
050,36,003,"New York","Allegany County",2,24,480,246,234
050,36,003,"New York","Allegany County",2,25,456,246,210
050,36,003,"New York","Allegany County",2,26,461,250,211
050,36,003,"New York","Allegany County",2,27,479,249,230
050,36,003,"New York","Allegany County",2,28,453,228,225
050,36,003,"New York","Allegany County",2,29,419,208,211
050,36,003,"New York","Allegany County",2,30,416,201,215
050,36,003,"New York","Allegany County",2,31,464,237,227
050,36,003,"New York","Allegany County",2,32,505,270,235
050,36,003,"New York","Allegany County",2,33,506,259,247
050,36,003,"New York","Allegany County",2,34,504,262,242
050,36,003,"New York","Allegany County",2,35,503,258,245
050,36,003,"New York","Allegany County",2,36,478,226,252
050,36,003,"New York","Allegany County",2,37,492,231,261
050,36,003,"New York","Allegany County",2,38,481,243,238
050,36,003,"New York","Allegany County",2,39,477,251,226
050,36,003,"New York","Allegany County",2,40,496,256,240
050,36,003,"New York","Allegany County",2,41,482,234,248
050,36,003,"New York","Allegany County",2,42,465,230,235
050,36,003,"New York","Allegany County",2,43,459,234,225
050,36,003,"New York","Allegany County",2,44,474,253,221
050,36,003,"New York","Allegany County",2,45,478,240,238
050,36,003,"New York","Allegany County",2,46,446,219,227
050,36,003,"New York","Allegany County",2,47,448,220,228
050,36,003,"New York","Allegany County",2,48,490,252,238
050,36,003,"New York","Allegany County",2,49,546,281,265
050,36,003,"New York","Allegany County",2,50,548,285,263
050,36,003,"New York","Allegany County",2,51,535,275,260
050,36,003,"New York","Allegany County",2,52,514,252,262
050,36,003,"New York","Allegany County",2,53,527,253,274
050,36,003,"New York","Allegany County",2,54,548,271,277
050,36,003,"New York","Allegany County",2,55,569,284,285
050,36,003,"New York","Allegany County",2,56,601,301,300
050,36,003,"New York","Allegany County",2,57,648,334,314
050,36,003,"New York","Allegany County",2,58,665,343,322
050,36,003,"New York","Allegany County",2,59,669,337,332
050,36,003,"New York","Allegany County",2,60,662,336,326
050,36,003,"New York","Allegany County",2,61,690,367,323
050,36,003,"New York","Allegany County",2,62,689,357,332
050,36,003,"New York","Allegany County",2,63,665,337,328
050,36,003,"New York","Allegany County",2,64,635,322,313
050,36,003,"New York","Allegany County",2,65,666,349,317
050,36,003,"New York","Allegany County",2,66,639,332,307
050,36,003,"New York","Allegany County",2,67,603,301,302
050,36,003,"New York","Allegany County",2,68,552,270,282
050,36,003,"New York","Allegany County",2,69,537,271,266
050,36,003,"New York","Allegany County",2,70,546,274,272
050,36,003,"New York","Allegany County",2,71,527,268,259
050,36,003,"New York","Allegany County",2,72,507,255,252
050,36,003,"New York","Allegany County",2,73,524,268,256
050,36,003,"New York","Allegany County",2,74,365,192,173
050,36,003,"New York","Allegany County",2,75,324,167,157
050,36,003,"New York","Allegany County",2,76,342,177,165
050,36,003,"New York","Allegany County",2,77,361,180,181
050,36,003,"New York","Allegany County",2,78,282,135,147
050,36,003,"New York","Allegany County",2,79,254,114,140
050,36,003,"New York","Allegany County",2,80,237,105,132
050,36,003,"New York","Allegany County",2,81,213,99,114
050,36,003,"New York","Allegany County",2,82,227,107,120
050,36,003,"New York","Allegany County",2,83,188,86,102
050,36,003,"New York","Allegany County",2,84,169,76,93
050,36,003,"New York","Allegany County",2,85,1039,389,650
050,36,003,"New York","Allegany County",3,0,448,239,209
050,36,003,"New York","Allegany County",3,1,488,237,251
050,36,003,"New York","Allegany County",3,2,462,239,223
050,36,003,"New York","Allegany County",3,3,483,235,248
050,36,003,"New York","Allegany County",3,4,489,251,238
050,36,003,"New York","Allegany County",3,5,506,258,248
050,36,003,"New York","Allegany County",3,6,508,279,229
050,36,003,"New York","Allegany County",3,7,494,276,218
050,36,003,"New York","Allegany County",3,8,502,266,236
050,36,003,"New York","Allegany County",3,9,494,261,233
050,36,003,"New York","Allegany County",3,10,519,271,248
050,36,003,"New York","Allegany County",3,11,523,257,266
050,36,003,"New York","Allegany County",3,12,547,260,287
050,36,003,"New York","Allegany County",3,13,546,265,281
050,36,003,"New York","Allegany County",3,14,543,277,266
050,36,003,"New York","Allegany County",3,15,553,284,269
050,36,003,"New York","Allegany County",3,16,581,304,277
050,36,003,"New York","Allegany County",3,17,590,320,270
050,36,003,"New York","Allegany County",3,18,1305,728,577
050,36,003,"New York","Allegany County",3,19,1786,1006,780
050,36,003,"New York","Allegany County",3,20,1567,853,714
050,36,003,"New York","Allegany County",3,21,1116,583,533
050,36,003,"New York","Allegany County",3,22,806,440,366
050,36,003,"New York","Allegany County",3,23,531,291,240
050,36,003,"New York","Allegany County",3,24,464,249,215
050,36,003,"New York","Allegany County",3,25,460,240,220
050,36,003,"New York","Allegany County",3,26,450,238,212
050,36,003,"New York","Allegany County",3,27,437,232,205
050,36,003,"New York","Allegany County",3,28,467,239,228
050,36,003,"New York","Allegany County",3,29,441,232,209
050,36,003,"New York","Allegany County",3,30,433,213,220
050,36,003,"New York","Allegany County",3,31,423,211,212
050,36,003,"New York","Allegany County",3,32,469,241,228
050,36,003,"New York","Allegany County",3,33,494,258,236
050,36,003,"New York","Allegany County",3,34,501,257,244
050,36,003,"New York","Allegany County",3,35,507,266,241
050,36,003,"New York","Allegany County",3,36,501,258,243
050,36,003,"New York","Allegany County",3,37,491,237,254
050,36,003,"New York","Allegany County",3,38,497,235,262
050,36,003,"New York","Allegany County",3,39,487,248,239
050,36,003,"New York","Allegany County",3,40,498,268,230
050,36,003,"New York","Allegany County",3,41,492,252,240
050,36,003,"New York","Allegany County",3,42,490,238,252
050,36,003,"New York","Allegany County",3,43,479,234,245
050,36,003,"New York","Allegany County",3,44,448,229,219
050,36,003,"New York","Allegany County",3,45,464,244,220
050,36,003,"New York","Allegany County",3,46,471,242,229
050,36,003,"New York","Allegany County",3,47,443,217,226
050,36,003,"New York","Allegany County",3,48,432,214,218
050,36,003,"New York","Allegany County",3,49,498,252,246
050,36,003,"New York","Allegany County",3,50,540,269,271
050,36,003,"New York","Allegany County",3,51,546,282,264
050,36,003,"New York","Allegany County",3,52,522,269,253
050,36,003,"New York","Allegany County",3,53,518,253,265
050,36,003,"New York","Allegany County",3,54,533,261,272
050,36,003,"New York","Allegany County",3,55,558,278,280
050,36,003,"New York","Allegany County",3,56,574,286,288
050,36,003,"New York","Allegany County",3,57,602,302,300
050,36,003,"New York","Allegany County",3,58,642,333,309
050,36,003,"New York","Allegany County",3,59,655,338,317
050,36,003,"New York","Allegany County",3,60,666,335,331
050,36,003,"New York","Allegany County",3,61,661,328,333
050,36,003,"New York","Allegany County",3,62,688,361,327
050,36,003,"New York","Allegany County",3,63,688,355,333
050,36,003,"New York","Allegany County",3,64,643,326,317
050,36,003,"New York","Allegany County",3,65,624,316,308
050,36,003,"New York","Allegany County",3,66,652,343,309
050,36,003,"New York","Allegany County",3,67,631,327,304
050,36,003,"New York","Allegany County",3,68,601,300,301
050,36,003,"New York","Allegany County",3,69,539,262,277
050,36,003,"New York","Allegany County",3,70,522,261,261
050,36,003,"New York","Allegany County",3,71,526,261,265
050,36,003,"New York","Allegany County",3,72,510,261,249
050,36,003,"New York","Allegany County",3,73,489,243,246
050,36,003,"New York","Allegany County",3,74,516,263,253
050,36,003,"New York","Allegany County",3,75,343,180,163
050,36,003,"New York","Allegany County",3,76,311,164,147
050,36,003,"New York","Allegany County",3,77,340,175,165
050,36,003,"New York","Allegany County",3,78,342,175,167
050,36,003,"New York","Allegany County",3,79,269,129,140
050,36,003,"New York","Allegany County",3,80,230,100,130
050,36,003,"New York","Allegany County",3,81,215,94,121
050,36,003,"New York","Allegany County",3,82,202,91,111
050,36,003,"New York","Allegany County",3,83,211,102,109
050,36,003,"New York","Allegany County",3,84,173,73,100
050,36,003,"New York","Allegany County",3,85,1032,380,652
050,36,003,"New York","Allegany County",4,0,492,265,227
050,36,003,"New York","Allegany County",4,1,437,242,195
050,36,003,"New York","Allegany County",4,2,480,232,248
050,36,003,"New York","Allegany County",4,3,460,243,217
050,36,003,"New York","Allegany County",4,4,499,234,265
050,36,003,"New York","Allegany County",4,5,495,250,245
050,36,003,"New York","Allegany County",4,6,519,263,256
050,36,003,"New York","Allegany County",4,7,517,288,229
050,36,003,"New York","Allegany County",4,8,502,282,220
050,36,003,"New York","Allegany County",4,9,508,265,243
050,36,003,"New York","Allegany County",4,10,486,260,226
050,36,003,"New York","Allegany County",4,11,522,270,252
050,36,003,"New York","Allegany County",4,12,528,263,265
050,36,003,"New York","Allegany County",4,13,556,266,290
050,36,003,"New York","Allegany County",4,14,543,260,283
050,36,003,"New York","Allegany County",4,15,550,281,269
050,36,003,"New York","Allegany County",4,16,567,294,273
050,36,003,"New York","Allegany County",4,17,593,311,282
050,36,003,"New York","Allegany County",4,18,1259,701,558
050,36,003,"New York","Allegany County",4,19,1763,1001,762
050,36,003,"New York","Allegany County",4,20,1507,842,665
050,36,003,"New York","Allegany County",4,21,1117,594,523
050,36,003,"New York","Allegany County",4,22,785,418,367
050,36,003,"New York","Allegany County",4,23,551,303,248
050,36,003,"New York","Allegany County",4,24,485,248,237
050,36,003,"New York","Allegany County",4,25,436,225,211
050,36,003,"New York","Allegany County",4,26,441,221,220
050,36,003,"New York","Allegany County",4,27,431,228,203
050,36,003,"New York","Allegany County",4,28,450,224,226
050,36,003,"New York","Allegany County",4,29,473,240,233
050,36,003,"New York","Allegany County",4,30,435,230,205
050,36,003,"New York","Allegany County",4,31,457,234,223
050,36,003,"New York","Allegany County",4,32,421,212,209
050,36,003,"New York","Allegany County",4,33,463,229,234
050,36,003,"New York","Allegany County",4,34,484,248,236
050,36,003,"New York","Allegany County",4,35,499,260,239
050,36,003,"New York","Allegany County",4,36,488,258,230
050,36,003,"New York","Allegany County",4,37,505,265,240
050,36,003,"New York","Allegany County",4,38,473,226,247
050,36,003,"New York","Allegany County",4,39,484,227,257
050,36,003,"New York","Allegany County",4,40,501,254,247
050,36,003,"New York","Allegany County",4,41,489,256,233
050,36,003,"New York","Allegany County",4,42,495,257,238
050,36,003,"New York","Allegany County",4,43,485,233,252
050,36,003,"New York","Allegany County",4,44,480,237,243
050,36,003,"New York","Allegany County",4,45,459,234,225
050,36,003,"New York","Allegany County",4,46,462,242,220
050,36,003,"New York","Allegany County",4,47,476,245,231
050,36,003,"New York","Allegany County",4,48,437,213,224
050,36,003,"New York","Allegany County",4,49,437,213,224
050,36,003,"New York","Allegany County",4,50,498,248,250
050,36,003,"New York","Allegany County",4,51,538,274,264
050,36,003,"New York","Allegany County",4,52,538,280,258
050,36,003,"New York","Allegany County",4,53,521,269,252
050,36,003,"New York","Allegany County",4,54,519,249,270
050,36,003,"New York","Allegany County",4,55,536,261,275
050,36,003,"New York","Allegany County",4,56,552,267,285
050,36,003,"New York","Allegany County",4,57,568,287,281
050,36,003,"New York","Allegany County",4,58,608,298,310
050,36,003,"New York","Allegany County",4,59,642,329,313
050,36,003,"New York","Allegany County",4,60,650,332,318
050,36,003,"New York","Allegany County",4,61,658,333,325
050,36,003,"New York","Allegany County",4,62,650,323,327
050,36,003,"New York","Allegany County",4,63,688,358,330
050,36,003,"New York","Allegany County",4,64,674,348,326
050,36,003,"New York","Allegany County",4,65,625,317,308
050,36,003,"New York","Allegany County",4,66,617,312,305
050,36,003,"New York","Allegany County",4,67,648,335,313
050,36,003,"New York","Allegany County",4,68,619,319,300
050,36,003,"New York","Allegany County",4,69,577,292,285
050,36,003,"New York","Allegany County",4,70,540,258,282
050,36,003,"New York","Allegany County",4,71,507,256,251
050,36,003,"New York","Allegany County",4,72,512,251,261
050,36,003,"New York","Allegany County",4,73,499,257,242
050,36,003,"New York","Allegany County",4,74,489,243,246
050,36,003,"New York","Allegany County",4,75,489,249,240
050,36,003,"New York","Allegany County",4,76,318,168,150
050,36,003,"New York","Allegany County",4,77,304,157,147
050,36,003,"New York","Allegany County",4,78,313,164,149
050,36,003,"New York","Allegany County",4,79,325,161,164
050,36,003,"New York","Allegany County",4,80,248,115,133
050,36,003,"New York","Allegany County",4,81,212,95,117
050,36,003,"New York","Allegany County",4,82,210,88,122
050,36,003,"New York","Allegany County",4,83,191,86,105
050,36,003,"New York","Allegany County",4,84,190,83,107
050,36,003,"New York","Allegany County",4,85,1071,396,675
050,36,003,"New York","Allegany County",5,0,491,265,226
050,36,003,"New York","Allegany County",5,1,515,275,240
050,36,003,"New York","Allegany County",5,2,452,252,200
050,36,003,"New York","Allegany County",5,3,485,228,257
050,36,003,"New York","Allegany County",5,4,457,244,213
050,36,003,"New York","Allegany County",5,5,506,239,267
050,36,003,"New York","Allegany County",5,6,494,254,240
050,36,003,"New York","Allegany County",5,7,525,272,253
050,36,003,"New York","Allegany County",5,8,520,292,228
050,36,003,"New York","Allegany County",5,9,503,280,223
050,36,003,"New York","Allegany County",5,10,504,262,242
050,36,003,"New York","Allegany County",5,11,488,265,223
050,36,003,"New York","Allegany County",5,12,517,266,251
050,36,003,"New York","Allegany County",5,13,530,269,261
050,36,003,"New York","Allegany County",5,14,552,260,292
050,36,003,"New York","Allegany County",5,15,543,261,282
050,36,003,"New York","Allegany County",5,16,558,289,269
050,36,003,"New York","Allegany County",5,17,581,304,277
050,36,003,"New York","Allegany County",5,18,1271,697,574
050,36,003,"New York","Allegany County",5,19,1759,994,765
050,36,003,"New York","Allegany County",5,20,1543,861,682
050,36,003,"New York","Allegany County",5,21,1088,603,485
050,36,003,"New York","Allegany County",5,22,786,427,359
050,36,003,"New York","Allegany County",5,23,530,271,259
050,36,003,"New York","Allegany County",5,24,501,273,228
050,36,003,"New York","Allegany County",5,25,457,228,229
050,36,003,"New York","Allegany County",5,26,408,206,202
050,36,003,"New York","Allegany County",5,27,412,208,204
050,36,003,"New York","Allegany County",5,28,424,226,198
050,36,003,"New York","Allegany County",5,29,447,227,220
050,36,003,"New York","Allegany County",5,30,487,245,242
050,36,003,"New York","Allegany County",5,31,446,240,206
050,36,003,"New York","Allegany County",5,32,472,245,227
050,36,003,"New York","Allegany County",5,33,422,207,215
050,36,003,"New York","Allegany County",5,34,460,231,229
050,36,003,"New York","Allegany County",5,35,478,245,233
050,36,003,"New York","Allegany County",5,36,482,247,235
050,36,003,"New York","Allegany County",5,37,488,252,236
050,36,003,"New York","Allegany County",5,38,507,267,240
050,36,003,"New York","Allegany County",5,39,479,228,251
050,36,003,"New York","Allegany County",5,40,493,235,258
050,36,003,"New York","Allegany County",5,41,496,253,243
050,36,003,"New York","Allegany County",5,42,498,255,243
050,36,003,"New York","Allegany County",5,43,486,253,233
050,36,003,"New York","Allegany County",5,44,477,229,248
050,36,003,"New York","Allegany County",5,45,485,236,249
050,36,003,"New York","Allegany County",5,46,462,231,231
050,36,003,"New York","Allegany County",5,47,462,241,221
050,36,003,"New York","Allegany County",5,48,471,243,228
050,36,003,"New York","Allegany County",5,49,451,220,231
050,36,003,"New York","Allegany County",5,50,439,215,224
050,36,003,"New York","Allegany County",5,51,488,245,243
050,36,003,"New York","Allegany County",5,52,537,269,268
050,36,003,"New York","Allegany County",5,53,538,281,257
050,36,003,"New York","Allegany County",5,54,510,258,252
050,36,003,"New York","Allegany County",5,55,512,244,268
050,36,003,"New York","Allegany County",5,56,537,259,278
050,36,003,"New York","Allegany County",5,57,560,279,281
050,36,003,"New York","Allegany County",5,58,567,284,283
050,36,003,"New York","Allegany County",5,59,607,296,311
050,36,003,"New York","Allegany County",5,60,624,315,309
050,36,003,"New York","Allegany County",5,61,654,329,325
050,36,003,"New York","Allegany County",5,62,650,324,326
050,36,003,"New York","Allegany County",5,63,652,321,331
050,36,003,"New York","Allegany County",5,64,674,355,319
050,36,003,"New York","Allegany County",5,65,652,338,314
050,36,003,"New York","Allegany County",5,66,609,302,307
050,36,003,"New York","Allegany County",5,67,608,302,306
050,36,003,"New York","Allegany County",5,68,639,327,312
050,36,003,"New York","Allegany County",5,69,605,313,292
050,36,003,"New York","Allegany County",5,70,570,284,286
050,36,003,"New York","Allegany County",5,71,532,255,277
050,36,003,"New York","Allegany County",5,72,494,247,247
050,36,003,"New York","Allegany County",5,73,496,242,254
050,36,003,"New York","Allegany County",5,74,489,251,238
050,36,003,"New York","Allegany County",5,75,464,233,231
050,36,003,"New York","Allegany County",5,76,477,248,229
050,36,003,"New York","Allegany County",5,77,312,163,149
050,36,003,"New York","Allegany County",5,78,281,149,132
050,36,003,"New York","Allegany County",5,79,300,155,145
050,36,003,"New York","Allegany County",5,80,303,144,159
050,36,003,"New York","Allegany County",5,81,232,110,122
050,36,003,"New York","Allegany County",5,82,206,92,114
050,36,003,"New York","Allegany County",5,83,201,87,114
050,36,003,"New York","Allegany County",5,84,169,67,102
050,36,003,"New York","Allegany County",5,85,1114,412,702
050,36,005,"New York","Bronx County",1,0,20514,10404,10110
050,36,005,"New York","Bronx County",1,1,20372,10418,9954
050,36,005,"New York","Bronx County",1,2,20705,10621,10084
050,36,005,"New York","Bronx County",1,3,20677,10509,10168
050,36,005,"New York","Bronx County",1,4,20703,10580,10123
050,36,005,"New York","Bronx County",1,5,20660,10217,10443
050,36,005,"New York","Bronx County",1,6,20219,10300,9919
050,36,005,"New York","Bronx County",1,7,20674,10605,10069
050,36,005,"New York","Bronx County",1,8,20808,10698,10110
050,36,005,"New York","Bronx County",1,9,20830,10684,10146
050,36,005,"New York","Bronx County",1,10,20638,10583,10055
050,36,005,"New York","Bronx County",1,11,20087,10276,9811
050,36,005,"New York","Bronx County",1,12,20188,10214,9974
050,36,005,"New York","Bronx County",1,13,20035,10307,9728
050,36,005,"New York","Bronx County",1,14,19557,10034,9523
050,36,005,"New York","Bronx County",1,15,19652,10053,9599
050,36,005,"New York","Bronx County",1,16,19695,10030,9665
050,36,005,"New York","Bronx County",1,17,19751,10060,9691
050,36,005,"New York","Bronx County",1,18,19798,10278,9520
050,36,005,"New York","Bronx County",1,19,19358,9912,9446
050,36,005,"New York","Bronx County",1,20,19591,9866,9725
050,36,005,"New York","Bronx County",1,21,19739,9834,9905
050,36,005,"New York","Bronx County",1,22,19722,9663,10059
050,36,005,"New York","Bronx County",1,23,20202,9838,10364
050,36,005,"New York","Bronx County",1,24,20953,10121,10832
050,36,005,"New York","Bronx County",1,25,22029,10610,11419
050,36,005,"New York","Bronx County",1,26,23003,11078,11925
050,36,005,"New York","Bronx County",1,27,23577,11273,12304
050,36,005,"New York","Bronx County",1,28,24132,11580,12552
050,36,005,"New York","Bronx County",1,29,24948,12013,12935
050,36,005,"New York","Bronx County",1,30,24467,11996,12471
050,36,005,"New York","Bronx County",1,31,23339,11429,11910
050,36,005,"New York","Bronx County",1,32,22276,10637,11639
050,36,005,"New York","Bronx County",1,33,21514,10254,11260
050,36,005,"New York","Bronx County",1,34,21161,10106,11055
050,36,005,"New York","Bronx County",1,35,20376,9703,10673
050,36,005,"New York","Bronx County",1,36,19755,9414,10341
050,36,005,"New York","Bronx County",1,37,19717,9355,10362
050,36,005,"New York","Bronx County",1,38,19342,9133,10209
050,36,005,"New York","Bronx County",1,39,19077,8937,10140
050,36,005,"New York","Bronx County",1,40,18981,8861,10120
050,36,005,"New York","Bronx County",1,41,18332,8469,9863
050,36,005,"New York","Bronx County",1,42,17868,8099,9769
050,36,005,"New York","Bronx County",1,43,17465,8003,9462
050,36,005,"New York","Bronx County",1,44,17249,7875,9374
050,36,005,"New York","Bronx County",1,45,16968,7825,9143
050,36,005,"New York","Bronx County",1,46,16956,7786,9170
050,36,005,"New York","Bronx County",1,47,16971,7860,9111
050,36,005,"New York","Bronx County",1,48,17520,8183,9337
050,36,005,"New York","Bronx County",1,49,18733,8742,9991
050,36,005,"New York","Bronx County",1,50,18594,8725,9869
050,36,005,"New York","Bronx County",1,51,18053,8456,9597
050,36,005,"New York","Bronx County",1,52,18328,8458,9870
050,36,005,"New York","Bronx County",1,53,18467,8508,9959
050,36,005,"New York","Bronx County",1,54,19283,9069,10214
050,36,005,"New York","Bronx County",1,55,19315,8929,10386
050,36,005,"New York","Bronx County",1,56,19082,8833,10249
050,36,005,"New York","Bronx County",1,57,18474,8432,10042
050,36,005,"New York","Bronx County",1,58,18040,8196,9844
050,36,005,"New York","Bronx County",1,59,17685,8089,9596
050,36,005,"New York","Bronx County",1,60,17559,8011,9548
050,36,005,"New York","Bronx County",1,61,16746,7590,9156
050,36,005,"New York","Bronx County",1,62,16072,7314,8758
050,36,005,"New York","Bronx County",1,63,15452,6969,8483
050,36,005,"New York","Bronx County",1,64,14924,6772,8152
050,36,005,"New York","Bronx County",1,65,14318,6499,7819
050,36,005,"New York","Bronx County",1,66,13204,5934,7270
050,36,005,"New York","Bronx County",1,67,12255,5419,6836
050,36,005,"New York","Bronx County",1,68,11717,5212,6505
050,36,005,"New York","Bronx County",1,69,11278,4900,6378
050,36,005,"New York","Bronx County",1,70,10953,4721,6232
050,36,005,"New York","Bronx County",1,71,10319,4461,5858
050,36,005,"New York","Bronx County",1,72,10031,4207,5824
050,36,005,"New York","Bronx County",1,73,9804,4102,5702
050,36,005,"New York","Bronx County",1,74,7983,3186,4797
050,36,005,"New York","Bronx County",1,75,7684,3054,4630
050,36,005,"New York","Bronx County",1,76,7475,2975,4500
050,36,005,"New York","Bronx County",1,77,7342,2849,4493
050,36,005,"New York","Bronx County",1,78,6416,2498,3918
050,36,005,"New York","Bronx County",1,79,5906,2248,3658
050,36,005,"New York","Bronx County",1,80,5675,2141,3534
050,36,005,"New York","Bronx County",1,81,5192,1920,3272
050,36,005,"New York","Bronx County",1,82,4793,1780,3013
050,36,005,"New York","Bronx County",1,83,4225,1572,2653
050,36,005,"New York","Bronx County",1,84,3976,1419,2557
050,36,005,"New York","Bronx County",1,85,25149,7577,17572
050,36,005,"New York","Bronx County",2,0,19910,10124,9786
050,36,005,"New York","Bronx County",2,1,20294,10348,9946
050,36,005,"New York","Bronx County",2,2,20482,10504,9978
050,36,005,"New York","Bronx County",2,3,20471,10429,10042
050,36,005,"New York","Bronx County",2,4,20562,10481,10081
050,36,005,"New York","Bronx County",2,5,20524,10228,10296
050,36,005,"New York","Bronx County",2,6,20237,10240,9997
050,36,005,"New York","Bronx County",2,7,20435,10452,9983
050,36,005,"New York","Bronx County",2,8,20615,10596,10019
050,36,005,"New York","Bronx County",2,9,20731,10640,10091
050,36,005,"New York","Bronx County",2,10,20595,10573,10022
050,36,005,"New York","Bronx County",2,11,19976,10216,9760
050,36,005,"New York","Bronx County",2,12,20136,10222,9914
050,36,005,"New York","Bronx County",2,13,19927,10221,9706
050,36,005,"New York","Bronx County",2,14,19544,10017,9527
050,36,005,"New York","Bronx County",2,15,19568,10027,9541
050,36,005,"New York","Bronx County",2,16,19599,9988,9611
050,36,005,"New York","Bronx County",2,17,19601,9981,9620
050,36,005,"New York","Bronx County",2,18,19535,10111,9424
050,36,005,"New York","Bronx County",2,19,19167,9822,9345
050,36,005,"New York","Bronx County",2,20,19582,9858,9724
050,36,005,"New York","Bronx County",2,21,19499,9688,9811
050,36,005,"New York","Bronx County",2,22,19617,9624,9993
050,36,005,"New York","Bronx County",2,23,19996,9744,10252
050,36,005,"New York","Bronx County",2,24,20582,9928,10654
050,36,005,"New York","Bronx County",2,25,21719,10457,11262
050,36,005,"New York","Bronx County",2,26,22668,10909,11759
050,36,005,"New York","Bronx County",2,27,23260,11132,12128
050,36,005,"New York","Bronx County",2,28,23852,11448,12404
050,36,005,"New York","Bronx County",2,29,24588,11840,12748
050,36,005,"New York","Bronx County",2,30,24495,11976,12519
050,36,005,"New York","Bronx County",2,31,23344,11421,11923
050,36,005,"New York","Bronx County",2,32,22330,10714,11616
050,36,005,"New York","Bronx County",2,33,21477,10243,11234
050,36,005,"New York","Bronx County",2,34,21074,10054,11020
050,36,005,"New York","Bronx County",2,35,20490,9779,10711
050,36,005,"New York","Bronx County",2,36,19632,9344,10288
050,36,005,"New York","Bronx County",2,37,19559,9293,10266
050,36,005,"New York","Bronx County",2,38,19353,9146,10207
050,36,005,"New York","Bronx County",2,39,18900,8856,10044
050,36,005,"New York","Bronx County",2,40,18998,8885,10113
050,36,005,"New York","Bronx County",2,41,18287,8454,9833
050,36,005,"New York","Bronx County",2,42,17760,8091,9669
050,36,005,"New York","Bronx County",2,43,17546,8012,9534
050,36,005,"New York","Bronx County",2,44,17112,7814,9298
050,36,005,"New York","Bronx County",2,45,16985,7806,9179
050,36,005,"New York","Bronx County",2,46,16785,7683,9102
050,36,005,"New York","Bronx County",2,47,16868,7806,9062
050,36,005,"New York","Bronx County",2,48,17312,8069,9243
050,36,005,"New York","Bronx County",2,49,18378,8571,9807
050,36,005,"New York","Bronx County",2,50,18479,8667,9812
050,36,005,"New York","Bronx County",2,51,17928,8401,9527
050,36,005,"New York","Bronx County",2,52,18189,8419,9770
050,36,005,"New York","Bronx County",2,53,18266,8393,9873
050,36,005,"New York","Bronx County",2,54,18942,8869,10073
050,36,005,"New York","Bronx County",2,55,19230,8913,10317
050,36,005,"New York","Bronx County",2,56,19036,8791,10245
050,36,005,"New York","Bronx County",2,57,18424,8415,10009
050,36,005,"New York","Bronx County",2,58,18013,8189,9824
050,36,005,"New York","Bronx County",2,59,17516,7962,9554
050,36,005,"New York","Bronx County",2,60,17519,7983,9536
050,36,005,"New York","Bronx County",2,61,16726,7560,9166
050,36,005,"New York","Bronx County",2,62,15928,7221,8707
050,36,005,"New York","Bronx County",2,63,15466,6964,8502
050,36,005,"New York","Bronx County",2,64,14791,6679,8112
050,36,005,"New York","Bronx County",2,65,14274,6461,7813
050,36,005,"New York","Bronx County",2,66,13271,5968,7303
050,36,005,"New York","Bronx County",2,67,12253,5420,6833
050,36,005,"New York","Bronx County",2,68,11544,5117,6427
050,36,005,"New York","Bronx County",2,69,11186,4858,6328
050,36,005,"New York","Bronx County",2,70,10846,4644,6202
050,36,005,"New York","Bronx County",2,71,10212,4381,5831
050,36,005,"New York","Bronx County",2,72,9859,4142,5717
050,36,005,"New York","Bronx County",2,73,9844,4101,5743
050,36,005,"New York","Bronx County",2,74,7985,3189,4796
050,36,005,"New York","Bronx County",2,75,7557,2978,4579
050,36,005,"New York","Bronx County",2,76,7262,2866,4396
050,36,005,"New York","Bronx County",2,77,7211,2784,4427
050,36,005,"New York","Bronx County",2,78,6393,2469,3924
050,36,005,"New York","Bronx County",2,79,5838,2203,3635
050,36,005,"New York","Bronx County",2,80,5506,2052,3454
050,36,005,"New York","Bronx County",2,81,5069,1877,3192
050,36,005,"New York","Bronx County",2,82,4703,1714,2989
050,36,005,"New York","Bronx County",2,83,4123,1485,2638
050,36,005,"New York","Bronx County",2,84,3832,1359,2473
050,36,005,"New York","Bronx County",2,85,23973,7175,16798
050,36,005,"New York","Bronx County",3,0,17767,9045,8722
050,36,005,"New York","Bronx County",3,1,18699,9518,9181
050,36,005,"New York","Bronx County",3,2,19224,9800,9424
050,36,005,"New York","Bronx County",3,3,19479,9999,9480
050,36,005,"New York","Bronx County",3,4,19541,9961,9580
050,36,005,"New York","Bronx County",3,5,19417,9790,9627
050,36,005,"New York","Bronx County",3,6,19551,9798,9753
050,36,005,"New York","Bronx County",3,7,19478,9817,9661
050,36,005,"New York","Bronx County",3,8,19615,10074,9541
050,36,005,"New York","Bronx County",3,9,19890,10236,9654
050,36,005,"New York","Bronx County",3,10,20001,10302,9699
050,36,005,"New York","Bronx County",3,11,19865,10177,9688
050,36,005,"New York","Bronx County",3,12,19279,9864,9415
050,36,005,"New York","Bronx County",3,13,19433,9874,9559
050,36,005,"New York","Bronx County",3,14,19261,9837,9424
050,36,005,"New York","Bronx County",3,15,19099,9821,9278
050,36,005,"New York","Bronx County",3,16,19053,9771,9282
050,36,005,"New York","Bronx County",3,17,19108,9762,9346
050,36,005,"New York","Bronx County",3,18,18955,9805,9150
050,36,005,"New York","Bronx County",3,19,18661,9665,8996
050,36,005,"New York","Bronx County",3,20,19212,9834,9378
050,36,005,"New York","Bronx County",3,21,19177,9551,9626
050,36,005,"New York","Bronx County",3,22,18998,9399,9599
050,36,005,"New York","Bronx County",3,23,19044,9395,9649
050,36,005,"New York","Bronx County",3,24,19512,9473,10039
050,36,005,"New York","Bronx County",3,25,20010,9696,10314
050,36,005,"New York","Bronx County",3,26,20689,9996,10693
050,36,005,"New York","Bronx County",3,27,21725,10384,11341
050,36,005,"New York","Bronx County",3,28,22118,10704,11414
050,36,005,"New York","Bronx County",3,29,22813,10875,11938
050,36,005,"New York","Bronx County",3,30,23202,11261,11941
050,36,005,"New York","Bronx County",3,31,23179,11280,11899
050,36,005,"New York","Bronx County",3,32,22242,10847,11395
050,36,005,"New York","Bronx County",3,33,21055,10160,10895
050,36,005,"New York","Bronx County",3,34,20459,9787,10672
050,36,005,"New York","Bronx County",3,35,20035,9569,10466
050,36,005,"New York","Bronx County",3,36,19535,9328,10207
050,36,005,"New York","Bronx County",3,37,18693,8919,9774
050,36,005,"New York","Bronx County",3,38,18808,8922,9886
050,36,005,"New York","Bronx County",3,39,18722,8840,9882
050,36,005,"New York","Bronx County",3,40,18134,8512,9622
050,36,005,"New York","Bronx County",3,41,18275,8575,9700
050,36,005,"New York","Bronx County",3,42,17586,8057,9529
050,36,005,"New York","Bronx County",3,43,17163,7863,9300
050,36,005,"New York","Bronx County",3,44,17100,7781,9319
050,36,005,"New York","Bronx County",3,45,16597,7579,9018
050,36,005,"New York","Bronx County",3,46,16383,7394,8989
050,36,005,"New York","Bronx County",3,47,16414,7610,8804
050,36,005,"New York","Bronx County",3,48,16466,7622,8844
050,36,005,"New York","Bronx County",3,49,16889,7855,9034
050,36,005,"New York","Bronx County",3,50,17818,8294,9524
050,36,005,"New York","Bronx County",3,51,18037,8468,9569
050,36,005,"New York","Bronx County",3,52,17455,8172,9283
050,36,005,"New York","Bronx County",3,53,17821,8235,9586
050,36,005,"New York","Bronx County",3,54,17780,8159,9621
050,36,005,"New York","Bronx County",3,55,18449,8601,9848
050,36,005,"New York","Bronx County",3,56,18742,8706,10036
050,36,005,"New York","Bronx County",3,57,18531,8536,9995
050,36,005,"New York","Bronx County",3,58,17844,8176,9668
050,36,005,"New York","Bronx County",3,59,17503,7883,9620
050,36,005,"New York","Bronx County",3,60,17091,7741,9350
050,36,005,"New York","Bronx County",3,61,17110,7803,9307
050,36,005,"New York","Bronx County",3,62,16211,7346,8865
050,36,005,"New York","Bronx County",3,63,15413,6990,8423
050,36,005,"New York","Bronx County",3,64,14951,6675,8276
050,36,005,"New York","Bronx County",3,65,14439,6492,7947
050,36,005,"New York","Bronx County",3,66,13796,6252,7544
050,36,005,"New York","Bronx County",3,67,12876,5717,7159
050,36,005,"New York","Bronx County",3,68,11849,5222,6627
050,36,005,"New York","Bronx County",3,69,11133,4900,6233
050,36,005,"New York","Bronx County",3,70,10758,4627,6131
050,36,005,"New York","Bronx County",3,71,10570,4499,6071
050,36,005,"New York","Bronx County",3,72,9858,4200,5658
050,36,005,"New York","Bronx County",3,73,9546,3996,5550
050,36,005,"New York","Bronx County",3,74,9457,3917,5540
050,36,005,"New York","Bronx County",3,75,7656,3011,4645
050,36,005,"New York","Bronx County",3,76,7285,2839,4446
050,36,005,"New York","Bronx County",3,77,6982,2751,4231
050,36,005,"New York","Bronx County",3,78,6911,2653,4258
050,36,005,"New York","Bronx County",3,79,6134,2311,3823
050,36,005,"New York","Bronx County",3,80,5531,2099,3432
050,36,005,"New York","Bronx County",3,81,5246,1901,3345
050,36,005,"New York","Bronx County",3,82,4788,1732,3056
050,36,005,"New York","Bronx County",3,83,4392,1553,2839
050,36,005,"New York","Bronx County",3,84,3915,1410,2505
050,36,005,"New York","Bronx County",3,85,24595,7403,17192
050,36,005,"New York","Bronx County",4,0,17771,9016,8755
050,36,005,"New York","Bronx County",4,1,16791,8506,8285
050,36,005,"New York","Bronx County",4,2,17830,9084,8746
050,36,005,"New York","Bronx County",4,3,18347,9384,8963
050,36,005,"New York","Bronx County",4,4,18437,9522,8915
050,36,005,"New York","Bronx County",4,5,18602,9389,9213
050,36,005,"New York","Bronx County",4,6,18475,9341,9134
050,36,005,"New York","Bronx County",4,7,18644,9341,9303
050,36,005,"New York","Bronx County",4,8,18650,9412,9238
050,36,005,"New York","Bronx County",4,9,19034,9802,9232
050,36,005,"New York","Bronx County",4,10,19384,9896,9488
050,36,005,"New York","Bronx County",4,11,19375,9910,9465
050,36,005,"New York","Bronx County",4,12,19317,9949,9368
050,36,005,"New York","Bronx County",4,13,18901,9728,9173
050,36,005,"New York","Bronx County",4,14,18893,9602,9291
050,36,005,"New York","Bronx County",4,15,18747,9558,9189
050,36,005,"New York","Bronx County",4,16,18709,9619,9090
050,36,005,"New York","Bronx County",4,17,18659,9572,9087
050,36,005,"New York","Bronx County",4,18,18461,9584,8877
050,36,005,"New York","Bronx County",4,19,17894,9231,8663
050,36,005,"New York","Bronx County",4,20,18439,9456,8983
050,36,005,"New York","Bronx County",4,21,18705,9485,9220
050,36,005,"New York","Bronx County",4,22,18522,9083,9439
050,36,005,"New York","Bronx County",4,23,18319,9031,9288
050,36,005,"New York","Bronx County",4,24,18370,9021,9349
050,36,005,"New York","Bronx County",4,25,18846,9152,9694
050,36,005,"New York","Bronx County",4,26,18958,9235,9723
050,36,005,"New York","Bronx County",4,27,19632,9330,10302
050,36,005,"New York","Bronx County",4,28,20576,9870,10706
050,36,005,"New York","Bronx County",4,29,21013,10106,10907
050,36,005,"New York","Bronx County",4,30,21245,10193,11052
050,36,005,"New York","Bronx County",4,31,21875,10607,11268
050,36,005,"New York","Bronx County",4,32,21823,10562,11261
050,36,005,"New York","Bronx County",4,33,20960,10255,10705
050,36,005,"New York","Bronx County",4,34,19879,9554,10325
050,36,005,"New York","Bronx County",4,35,19325,9288,10037
050,36,005,"New York","Bronx County",4,36,18811,8956,9855
050,36,005,"New York","Bronx County",4,37,18550,8843,9707
050,36,005,"New York","Bronx County",4,38,17738,8453,9285
050,36,005,"New York","Bronx County",4,39,17910,8506,9404
050,36,005,"New York","Bronx County",4,40,17648,8306,9342
050,36,005,"New York","Bronx County",4,41,17195,8042,9153
050,36,005,"New York","Bronx County",4,42,17320,8063,9257
050,36,005,"New York","Bronx County",4,43,16820,7806,9014
050,36,005,"New York","Bronx County",4,44,16545,7555,8990
050,36,005,"New York","Bronx County",4,45,16511,7466,9045
050,36,005,"New York","Bronx County",4,46,16000,7235,8765
050,36,005,"New York","Bronx County",4,47,15897,7198,8699
050,36,005,"New York","Bronx County",4,48,15795,7315,8480
050,36,005,"New York","Bronx County",4,49,15913,7342,8571
050,36,005,"New York","Bronx County",4,50,16292,7521,8771
050,36,005,"New York","Bronx County",4,51,17118,7990,9128
050,36,005,"New York","Bronx County",4,52,17497,8226,9271
050,36,005,"New York","Bronx County",4,53,16961,7891,9070
050,36,005,"New York","Bronx County",4,54,17216,7938,9278
050,36,005,"New York","Bronx County",4,55,17208,7872,9336
050,36,005,"New York","Bronx County",4,56,17819,8299,9520
050,36,005,"New York","Bronx County",4,57,18139,8364,9775
050,36,005,"New York","Bronx County",4,58,17933,8291,9642
050,36,005,"New York","Bronx County",4,59,17200,7848,9352
050,36,005,"New York","Bronx County",4,60,16829,7537,9292
050,36,005,"New York","Bronx County",4,61,16560,7479,9081
050,36,005,"New York","Bronx County",4,62,16461,7495,8966
050,36,005,"New York","Bronx County",4,63,15579,7074,8505
050,36,005,"New York","Bronx County",4,64,14730,6640,8090
050,36,005,"New York","Bronx County",4,65,14408,6423,7985
050,36,005,"New York","Bronx County",4,66,13919,6253,7666
050,36,005,"New York","Bronx County",4,67,13348,5995,7353
050,36,005,"New York","Bronx County",4,68,12467,5524,6943
050,36,005,"New York","Bronx County",4,69,11367,4960,6407
050,36,005,"New York","Bronx County",4,70,10699,4642,6057
050,36,005,"New York","Bronx County",4,71,10480,4504,5976
050,36,005,"New York","Bronx County",4,72,10200,4306,5894
050,36,005,"New York","Bronx County",4,73,9517,4051,5466
050,36,005,"New York","Bronx County",4,74,9176,3811,5365
050,36,005,"New York","Bronx County",4,75,9051,3722,5329
050,36,005,"New York","Bronx County",4,76,7391,2888,4503
050,36,005,"New York","Bronx County",4,77,7008,2714,4294
050,36,005,"New York","Bronx County",4,78,6707,2641,4066
050,36,005,"New York","Bronx County",4,79,6551,2450,4101
050,36,005,"New York","Bronx County",4,80,5778,2197,3581
050,36,005,"New York","Bronx County",4,81,5301,1957,3344
050,36,005,"New York","Bronx County",4,82,4965,1775,3190
050,36,005,"New York","Bronx County",4,83,4475,1581,2894
050,36,005,"New York","Bronx County",4,84,4151,1473,2678
050,36,005,"New York","Bronx County",4,85,25246,7711,17535
050,36,005,"New York","Bronx County",5,0,17442,8852,8590
050,36,005,"New York","Bronx County",5,1,17088,8639,8449
050,36,005,"New York","Bronx County",5,2,16401,8376,8025
050,36,005,"New York","Bronx County",5,3,17217,8743,8474
050,36,005,"New York","Bronx County",5,4,17752,9120,8632
050,36,005,"New York","Bronx County",5,5,17851,9198,8653
050,36,005,"New York","Bronx County",5,6,17930,9049,8881
050,36,005,"New York","Bronx County",5,7,17847,9029,8818
050,36,005,"New York","Bronx County",5,8,18131,9112,9019
050,36,005,"New York","Bronx County",5,9,18010,9086,8924
050,36,005,"New York","Bronx County",5,10,18604,9579,9025
050,36,005,"New York","Bronx County",5,11,18707,9510,9197
050,36,005,"New York","Bronx County",5,12,19073,9781,9292
050,36,005,"New York","Bronx County",5,13,18924,9787,9137
050,36,005,"New York","Bronx County",5,14,18501,9543,8958
050,36,005,"New York","Bronx County",5,15,18570,9430,9140
050,36,005,"New York","Bronx County",5,16,18366,9379,8987
050,36,005,"New York","Bronx County",5,17,18359,9401,8958
050,36,005,"New York","Bronx County",5,18,18221,9530,8691
050,36,005,"New York","Bronx County",5,19,17696,9179,8517
050,36,005,"New York","Bronx County",5,20,18034,9140,8894
050,36,005,"New York","Bronx County",5,21,18292,9288,9004
050,36,005,"New York","Bronx County",5,22,18436,9262,9174
050,36,005,"New York","Bronx County",5,23,18272,8962,9310
050,36,005,"New York","Bronx County",5,24,18210,8827,9383
050,36,005,"New York","Bronx County",5,25,18170,8887,9283
050,36,005,"New York","Bronx County",5,26,18277,8892,9385
050,36,005,"New York","Bronx County",5,27,18504,8867,9637
050,36,005,"New York","Bronx County",5,28,19054,9043,10011
050,36,005,"New York","Bronx County",5,29,20024,9569,10455
050,36,005,"New York","Bronx County",5,30,20026,9699,10327
050,36,005,"New York","Bronx County",5,31,20521,9849,10672
050,36,005,"New York","Bronx County",5,32,20962,10170,10792
050,36,005,"New York","Bronx County",5,33,20875,10159,10716
050,36,005,"New York","Bronx County",5,34,20162,9865,10297
050,36,005,"New York","Bronx County",5,35,19125,9240,9885
050,36,005,"New York","Bronx County",5,36,18515,8814,9701
050,36,005,"New York","Bronx County",5,37,18180,8672,9508
050,36,005,"New York","Bronx County",5,38,18008,8601,9407
050,36,005,"New York","Bronx County",5,39,17212,8207,9005
050,36,005,"New York","Bronx County",5,40,17260,8191,9069
050,36,005,"New York","Bronx County",5,41,16958,7984,8974
050,36,005,"New York","Bronx County",5,42,16650,7728,8922
050,36,005,"New York","Bronx County",5,43,16841,7913,8928
050,36,005,"New York","Bronx County",5,44,16374,7598,8776
050,36,005,"New York","Bronx County",5,45,16048,7292,8756
050,36,005,"New York","Bronx County",5,46,15995,7146,8849
050,36,005,"New York","Bronx County",5,47,15634,7088,8546
050,36,005,"New York","Bronx County",5,48,15423,6997,8426
050,36,005,"New York","Bronx County",5,49,15347,7076,8271
050,36,005,"New York","Bronx County",5,50,15351,6992,8359
050,36,005,"New York","Bronx County",5,51,15857,7302,8555
050,36,005,"New York","Bronx County",5,52,16532,7677,8855
050,36,005,"New York","Bronx County",5,53,17065,7946,9119
050,36,005,"New York","Bronx County",5,54,16513,7684,8829
050,36,005,"New York","Bronx County",5,55,16691,7696,8995
050,36,005,"New York","Bronx County",5,56,16651,7658,8993
050,36,005,"New York","Bronx County",5,57,17331,8018,9313
050,36,005,"New York","Bronx County",5,58,17585,8155,9430
050,36,005,"New York","Bronx County",5,59,17418,7992,9426
050,36,005,"New York","Bronx County",5,60,16645,7617,9028
050,36,005,"New York","Bronx County",5,61,16391,7322,9069
050,36,005,"New York","Bronx County",5,62,16043,7248,8795
050,36,005,"New York","Bronx County",5,63,15909,7254,8655
050,36,005,"New York","Bronx County",5,64,15012,6800,8212
050,36,005,"New York","Bronx County",5,65,14256,6418,7838
050,36,005,"New York","Bronx County",5,66,13964,6221,7743
050,36,005,"New York","Bronx County",5,67,13563,6047,7516
050,36,005,"New York","Bronx County",5,68,13035,5821,7214
050,36,005,"New York","Bronx County",5,69,12088,5313,6775
050,36,005,"New York","Bronx County",5,70,11039,4780,6259
050,36,005,"New York","Bronx County",5,71,10428,4522,5906
050,36,005,"New York","Bronx County",5,72,10162,4327,5835
050,36,005,"New York","Bronx County",5,73,9918,4182,5736
050,36,005,"New York","Bronx County",5,74,9162,3870,5292
050,36,005,"New York","Bronx County",5,75,8828,3644,5184
050,36,005,"New York","Bronx County",5,76,8743,3578,5165
050,36,005,"New York","Bronx County",5,77,7117,2788,4329
050,36,005,"New York","Bronx County",5,78,6775,2636,4139
050,36,005,"New York","Bronx County",5,79,6411,2475,3936
050,36,005,"New York","Bronx County",5,80,6214,2358,3856
050,36,005,"New York","Bronx County",5,81,5566,2072,3494
050,36,005,"New York","Bronx County",5,82,5022,1824,3198
050,36,005,"New York","Bronx County",5,83,4690,1637,3053
050,36,005,"New York","Bronx County",5,84,4217,1481,2736
050,36,005,"New York","Bronx County",5,85,26205,8107,18098
050,36,007,"New York","Broome County",1,0,1874,964,910
050,36,007,"New York","Broome County",1,1,1914,989,925
050,36,007,"New York","Broome County",1,2,2034,1064,970
050,36,007,"New York","Broome County",1,3,2117,1087,1030
050,36,007,"New York","Broome County",1,4,2114,1116,998
050,36,007,"New York","Broome County",1,5,2197,1145,1052
050,36,007,"New York","Broome County",1,6,2204,1169,1035
050,36,007,"New York","Broome County",1,7,2101,1109,992
050,36,007,"New York","Broome County",1,8,2181,1124,1057
050,36,007,"New York","Broome County",1,9,2126,1081,1045
050,36,007,"New York","Broome County",1,10,2174,1108,1066
050,36,007,"New York","Broome County",1,11,2189,1134,1055
050,36,007,"New York","Broome County",1,12,2263,1160,1103
050,36,007,"New York","Broome County",1,13,2260,1161,1099
050,36,007,"New York","Broome County",1,14,2236,1165,1071
050,36,007,"New York","Broome County",1,15,2269,1193,1076
050,36,007,"New York","Broome County",1,16,2275,1175,1100
050,36,007,"New York","Broome County",1,17,2287,1201,1086
050,36,007,"New York","Broome County",1,18,3533,1846,1687
050,36,007,"New York","Broome County",1,19,4888,2606,2282
050,36,007,"New York","Broome County",1,20,5197,2616,2581
050,36,007,"New York","Broome County",1,21,4571,2342,2229
050,36,007,"New York","Broome County",1,22,3887,1989,1898
050,36,007,"New York","Broome County",1,23,3078,1593,1485
050,36,007,"New York","Broome County",1,24,2849,1481,1368
050,36,007,"New York","Broome County",1,25,2516,1308,1208
050,36,007,"New York","Broome County",1,26,2413,1234,1179
050,36,007,"New York","Broome County",1,27,2338,1178,1160
050,36,007,"New York","Broome County",1,28,2259,1155,1104
050,36,007,"New York","Broome County",1,29,2152,1073,1079
050,36,007,"New York","Broome County",1,30,2083,1089,994
050,36,007,"New York","Broome County",1,31,2073,1051,1022
050,36,007,"New York","Broome County",1,32,2045,1020,1025
050,36,007,"New York","Broome County",1,33,2103,1074,1029
050,36,007,"New York","Broome County",1,34,2207,1124,1083
050,36,007,"New York","Broome County",1,35,2181,1073,1108
050,36,007,"New York","Broome County",1,36,2150,1058,1092
050,36,007,"New York","Broome County",1,37,2258,1130,1128
050,36,007,"New York","Broome County",1,38,2250,1149,1101
050,36,007,"New York","Broome County",1,39,2184,1094,1090
050,36,007,"New York","Broome County",1,40,2120,1051,1069
050,36,007,"New York","Broome County",1,41,2066,1053,1013
050,36,007,"New York","Broome County",1,42,1991,1002,989
050,36,007,"New York","Broome County",1,43,1934,951,983
050,36,007,"New York","Broome County",1,44,1869,927,942
050,36,007,"New York","Broome County",1,45,1932,965,967
050,36,007,"New York","Broome County",1,46,1824,890,934
050,36,007,"New York","Broome County",1,47,1807,890,917
050,36,007,"New York","Broome County",1,48,2007,1016,991
050,36,007,"New York","Broome County",1,49,2305,1144,1161
050,36,007,"New York","Broome County",1,50,2312,1188,1124
050,36,007,"New York","Broome County",1,51,2332,1152,1180
050,36,007,"New York","Broome County",1,52,2298,1140,1158
050,36,007,"New York","Broome County",1,53,2323,1153,1170
050,36,007,"New York","Broome County",1,54,2403,1175,1228
050,36,007,"New York","Broome County",1,55,2601,1265,1336
050,36,007,"New York","Broome County",1,56,2775,1350,1425
050,36,007,"New York","Broome County",1,57,2790,1362,1428
050,36,007,"New York","Broome County",1,58,2953,1465,1488
050,36,007,"New York","Broome County",1,59,3002,1506,1496
050,36,007,"New York","Broome County",1,60,2931,1464,1467
050,36,007,"New York","Broome County",1,61,2896,1426,1470
050,36,007,"New York","Broome County",1,62,2897,1443,1454
050,36,007,"New York","Broome County",1,63,2773,1379,1394
050,36,007,"New York","Broome County",1,64,2715,1367,1348
050,36,007,"New York","Broome County",1,65,2496,1246,1250
050,36,007,"New York","Broome County",1,66,2419,1192,1227
050,36,007,"New York","Broome County",1,67,2372,1174,1198
050,36,007,"New York","Broome County",1,68,2337,1133,1204
050,36,007,"New York","Broome County",1,69,2069,982,1087
050,36,007,"New York","Broome County",1,70,1990,969,1021
050,36,007,"New York","Broome County",1,71,1999,958,1041
050,36,007,"New York","Broome County",1,72,2041,965,1076
050,36,007,"New York","Broome County",1,73,2071,967,1104
050,36,007,"New York","Broome County",1,74,1436,656,780
050,36,007,"New York","Broome County",1,75,1398,608,790
050,36,007,"New York","Broome County",1,76,1435,654,781
050,36,007,"New York","Broome County",1,77,1477,669,808
050,36,007,"New York","Broome County",1,78,1243,551,692
050,36,007,"New York","Broome County",1,79,1134,477,657
050,36,007,"New York","Broome County",1,80,1057,474,583
050,36,007,"New York","Broome County",1,81,1022,415,607
050,36,007,"New York","Broome County",1,82,1026,422,604
050,36,007,"New York","Broome County",1,83,918,342,576
050,36,007,"New York","Broome County",1,84,862,319,543
050,36,007,"New York","Broome County",1,85,5995,1935,4060
050,36,007,"New York","Broome County",2,0,1832,927,905
050,36,007,"New York","Broome County",2,1,1898,981,917
050,36,007,"New York","Broome County",2,2,2007,1044,963
050,36,007,"New York","Broome County",2,3,2089,1077,1012
050,36,007,"New York","Broome County",2,4,2120,1111,1009
050,36,007,"New York","Broome County",2,5,2177,1139,1038
050,36,007,"New York","Broome County",2,6,2205,1163,1042
050,36,007,"New York","Broome County",2,7,2122,1121,1001
050,36,007,"New York","Broome County",2,8,2153,1116,1037
050,36,007,"New York","Broome County",2,9,2137,1091,1046
050,36,007,"New York","Broome County",2,10,2160,1099,1061
050,36,007,"New York","Broome County",2,11,2176,1122,1054
050,36,007,"New York","Broome County",2,12,2247,1153,1094
050,36,007,"New York","Broome County",2,13,2257,1157,1100
050,36,007,"New York","Broome County",2,14,2239,1163,1076
050,36,007,"New York","Broome County",2,15,2263,1187,1076
050,36,007,"New York","Broome County",2,16,2276,1183,1093
050,36,007,"New York","Broome County",2,17,2284,1194,1090
050,36,007,"New York","Broome County",2,18,3492,1818,1674
050,36,007,"New York","Broome County",2,19,4881,2604,2277
050,36,007,"New York","Broome County",2,20,5216,2628,2588
050,36,007,"New York","Broome County",2,21,4566,2344,2222
050,36,007,"New York","Broome County",2,22,3889,1993,1896
050,36,007,"New York","Broome County",2,23,3089,1592,1497
050,36,007,"New York","Broome County",2,24,2833,1486,1347
050,36,007,"New York","Broome County",2,25,2517,1301,1216
050,36,007,"New York","Broome County",2,26,2412,1234,1178
050,36,007,"New York","Broome County",2,27,2331,1179,1152
050,36,007,"New York","Broome County",2,28,2274,1156,1118
050,36,007,"New York","Broome County",2,29,2181,1094,1087
050,36,007,"New York","Broome County",2,30,2104,1080,1024
050,36,007,"New York","Broome County",2,31,2061,1052,1009
050,36,007,"New York","Broome County",2,32,2045,1026,1019
050,36,007,"New York","Broome County",2,33,2084,1059,1025
050,36,007,"New York","Broome County",2,34,2180,1112,1068
050,36,007,"New York","Broome County",2,35,2194,1089,1105
050,36,007,"New York","Broome County",2,36,2143,1052,1091
050,36,007,"New York","Broome County",2,37,2237,1116,1121
050,36,007,"New York","Broome County",2,38,2258,1145,1113
050,36,007,"New York","Broome County",2,39,2203,1109,1094
050,36,007,"New York","Broome County",2,40,2138,1064,1074
050,36,007,"New York","Broome County",2,41,2074,1051,1023
050,36,007,"New York","Broome County",2,42,1996,1008,988
050,36,007,"New York","Broome County",2,43,1961,970,991
050,36,007,"New York","Broome County",2,44,1867,923,944
050,36,007,"New York","Broome County",2,45,1924,960,964
050,36,007,"New York","Broome County",2,46,1838,904,934
050,36,007,"New York","Broome County",2,47,1804,886,918
050,36,007,"New York","Broome County",2,48,1956,985,971
050,36,007,"New York","Broome County",2,49,2236,1116,1120
050,36,007,"New York","Broome County",2,50,2316,1179,1137
050,36,007,"New York","Broome County",2,51,2318,1155,1163
050,36,007,"New York","Broome County",2,52,2293,1139,1154
050,36,007,"New York","Broome County",2,53,2315,1149,1166
050,36,007,"New York","Broome County",2,54,2367,1161,1206
050,36,007,"New York","Broome County",2,55,2543,1237,1306
050,36,007,"New York","Broome County",2,56,2732,1328,1404
050,36,007,"New York","Broome County",2,57,2784,1354,1430
050,36,007,"New York","Broome County",2,58,2902,1434,1468
050,36,007,"New York","Broome County",2,59,2992,1497,1495
050,36,007,"New York","Broome County",2,60,2929,1462,1467
050,36,007,"New York","Broome County",2,61,2870,1420,1450
050,36,007,"New York","Broome County",2,62,2881,1433,1448
050,36,007,"New York","Broome County",2,63,2810,1396,1414
050,36,007,"New York","Broome County",2,64,2691,1351,1340
050,36,007,"New York","Broome County",2,65,2524,1259,1265
050,36,007,"New York","Broome County",2,66,2430,1204,1226
050,36,007,"New York","Broome County",2,67,2353,1164,1189
050,36,007,"New York","Broome County",2,68,2313,1125,1188
050,36,007,"New York","Broome County",2,69,2133,1018,1115
050,36,007,"New York","Broome County",2,70,1982,959,1023
050,36,007,"New York","Broome County",2,71,1984,957,1027
050,36,007,"New York","Broome County",2,72,1992,944,1048
050,36,007,"New York","Broome County",2,73,2146,1003,1143
050,36,007,"New York","Broome County",2,74,1486,683,803
050,36,007,"New York","Broome County",2,75,1399,613,786
050,36,007,"New York","Broome County",2,76,1405,627,778
050,36,007,"New York","Broome County",2,77,1482,674,808
050,36,007,"New York","Broome County",2,78,1258,560,698
050,36,007,"New York","Broome County",2,79,1135,480,655
050,36,007,"New York","Broome County",2,80,1063,471,592
050,36,007,"New York","Broome County",2,81,1013,421,592
050,36,007,"New York","Broome County",2,82,1004,415,589
050,36,007,"New York","Broome County",2,83,916,352,564
050,36,007,"New York","Broome County",2,84,858,318,540
050,36,007,"New York","Broome County",2,85,5911,1929,3982
050,36,007,"New York","Broome County",3,0,1819,917,902
050,36,007,"New York","Broome County",3,1,1833,916,917
050,36,007,"New York","Broome County",3,2,1910,978,932
050,36,007,"New York","Broome County",3,3,2029,1042,987
050,36,007,"New York","Broome County",3,4,2088,1078,1010
050,36,007,"New York","Broome County",3,5,2107,1113,994
050,36,007,"New York","Broome County",3,6,2189,1132,1057
050,36,007,"New York","Broome County",3,7,2221,1167,1054
050,36,007,"New York","Broome County",3,8,2149,1132,1017
050,36,007,"New York","Broome County",3,9,2133,1096,1037
050,36,007,"New York","Broome County",3,10,2157,1094,1063
050,36,007,"New York","Broome County",3,11,2136,1094,1042
050,36,007,"New York","Broome County",3,12,2171,1130,1041
050,36,007,"New York","Broome County",3,13,2250,1162,1088
050,36,007,"New York","Broome County",3,14,2251,1152,1099
050,36,007,"New York","Broome County",3,15,2242,1160,1082
050,36,007,"New York","Broome County",3,16,2242,1181,1061
050,36,007,"New York","Broome County",3,17,2289,1184,1105
050,36,007,"New York","Broome County",3,18,3737,1902,1835
050,36,007,"New York","Broome County",3,19,5331,2867,2464
050,36,007,"New York","Broome County",3,20,5488,2768,2720
050,36,007,"New York","Broome County",3,21,4739,2450,2289
050,36,007,"New York","Broome County",3,22,4003,2049,1954
050,36,007,"New York","Broome County",3,23,3186,1603,1583
050,36,007,"New York","Broome County",3,24,2844,1522,1322
050,36,007,"New York","Broome County",3,25,2529,1299,1230
050,36,007,"New York","Broome County",3,26,2374,1207,1167
050,36,007,"New York","Broome County",3,27,2277,1168,1109
050,36,007,"New York","Broome County",3,28,2325,1164,1161
050,36,007,"New York","Broome County",3,29,2267,1136,1131
050,36,007,"New York","Broome County",3,30,2207,1106,1101
050,36,007,"New York","Broome County",3,31,2137,1087,1050
050,36,007,"New York","Broome County",3,32,2084,1061,1023
050,36,007,"New York","Broome County",3,33,2080,1037,1043
050,36,007,"New York","Broome County",3,34,2098,1069,1029
050,36,007,"New York","Broome County",3,35,2143,1072,1071
050,36,007,"New York","Broome County",3,36,2232,1106,1126
050,36,007,"New York","Broome County",3,37,2127,1053,1074
050,36,007,"New York","Broome County",3,38,2206,1093,1113
050,36,007,"New York","Broome County",3,39,2261,1144,1117
050,36,007,"New York","Broome County",3,40,2188,1107,1081
050,36,007,"New York","Broome County",3,41,2141,1065,1076
050,36,007,"New York","Broome County",3,42,2067,1042,1025
050,36,007,"New York","Broome County",3,43,1986,1003,983
050,36,007,"New York","Broome County",3,44,1963,965,998
050,36,007,"New York","Broome County",3,45,1873,917,956
050,36,007,"New York","Broome County",3,46,1939,976,963
050,36,007,"New York","Broome County",3,47,1823,880,943
050,36,007,"New York","Broome County",3,48,1806,906,900
050,36,007,"New York","Broome County",3,49,1947,961,986
050,36,007,"New York","Broome County",3,50,2225,1114,1111
050,36,007,"New York","Broome County",3,51,2326,1189,1137
050,36,007,"New York","Broome County",3,52,2289,1151,1138
050,36,007,"New York","Broome County",3,53,2265,1111,1154
050,36,007,"New York","Broome County",3,54,2300,1142,1158
050,36,007,"New York","Broome County",3,55,2347,1148,1199
050,36,007,"New York","Broome County",3,56,2514,1223,1291
050,36,007,"New York","Broome County",3,57,2696,1320,1376
050,36,007,"New York","Broome County",3,58,2754,1350,1404
050,36,007,"New York","Broome County",3,59,2856,1399,1457
050,36,007,"New York","Broome County",3,60,2940,1478,1462
050,36,007,"New York","Broome County",3,61,2887,1427,1460
050,36,007,"New York","Broome County",3,62,2817,1393,1424
050,36,007,"New York","Broome County",3,63,2805,1387,1418
050,36,007,"New York","Broome County",3,64,2753,1369,1384
050,36,007,"New York","Broome County",3,65,2623,1300,1323
050,36,007,"New York","Broome County",3,66,2465,1234,1231
050,36,007,"New York","Broome County",3,67,2354,1161,1193
050,36,007,"New York","Broome County",3,68,2298,1132,1166
050,36,007,"New York","Broome County",3,69,2251,1102,1149
050,36,007,"New York","Broome County",3,70,2038,970,1068
050,36,007,"New York","Broome County",3,71,1921,905,1016
050,36,007,"New York","Broome County",3,72,1949,937,1012
050,36,007,"New York","Broome County",3,73,1901,896,1005
050,36,007,"New York","Broome County",3,74,2081,976,1105
050,36,007,"New York","Broome County",3,75,1396,635,761
050,36,007,"New York","Broome County",3,76,1362,583,779
050,36,007,"New York","Broome County",3,77,1337,594,743
050,36,007,"New York","Broome County",3,78,1399,629,770
050,36,007,"New York","Broome County",3,79,1202,516,686
050,36,007,"New York","Broome County",3,80,1065,454,611
050,36,007,"New York","Broome County",3,81,1024,438,586
050,36,007,"New York","Broome County",3,82,922,382,540
050,36,007,"New York","Broome County",3,83,923,374,549
050,36,007,"New York","Broome County",3,84,838,331,507
050,36,007,"New York","Broome County",3,85,5815,1867,3948
050,36,007,"New York","Broome County",4,0,1858,944,914
050,36,007,"New York","Broome County",4,1,1786,900,886
050,36,007,"New York","Broome County",4,2,1845,931,914
050,36,007,"New York","Broome County",4,3,1873,968,905
050,36,007,"New York","Broome County",4,4,2040,1053,987
050,36,007,"New York","Broome County",4,5,2095,1074,1021
050,36,007,"New York","Broome County",4,6,2099,1106,993
050,36,007,"New York","Broome County",4,7,2184,1131,1053
050,36,007,"New York","Broome County",4,8,2201,1150,1051
050,36,007,"New York","Broome County",4,9,2144,1128,1016
050,36,007,"New York","Broome County",4,10,2122,1087,1035
050,36,007,"New York","Broome County",4,11,2155,1101,1054
050,36,007,"New York","Broome County",4,12,2143,1096,1047
050,36,007,"New York","Broome County",4,13,2188,1136,1052
050,36,007,"New York","Broome County",4,14,2240,1142,1098
050,36,007,"New York","Broome County",4,15,2254,1145,1109
050,36,007,"New York","Broome County",4,16,2269,1176,1093
050,36,007,"New York","Broome County",4,17,2278,1207,1071
050,36,007,"New York","Broome County",4,18,3728,1907,1821
050,36,007,"New York","Broome County",4,19,5329,2840,2489
050,36,007,"New York","Broome County",4,20,5430,2771,2659
050,36,007,"New York","Broome County",4,21,4672,2420,2252
050,36,007,"New York","Broome County",4,22,3986,2064,1922
050,36,007,"New York","Broome County",4,23,3221,1635,1586
050,36,007,"New York","Broome County",4,24,2869,1473,1396
050,36,007,"New York","Broome County",4,25,2471,1289,1182
050,36,007,"New York","Broome County",4,26,2357,1216,1141
050,36,007,"New York","Broome County",4,27,2226,1122,1104
050,36,007,"New York","Broome County",4,28,2226,1154,1072
050,36,007,"New York","Broome County",4,29,2242,1113,1129
050,36,007,"New York","Broome County",4,30,2230,1110,1120
050,36,007,"New York","Broome County",4,31,2191,1109,1082
050,36,007,"New York","Broome County",4,32,2112,1079,1033
050,36,007,"New York","Broome County",4,33,2084,1054,1030
050,36,007,"New York","Broome County",4,34,2078,1042,1036
050,36,007,"New York","Broome County",4,35,2104,1058,1046
050,36,007,"New York","Broome County",4,36,2137,1081,1056
050,36,007,"New York","Broome County",4,37,2231,1107,1124
050,36,007,"New York","Broome County",4,38,2135,1031,1104
050,36,007,"New York","Broome County",4,39,2210,1105,1105
050,36,007,"New York","Broome County",4,40,2224,1130,1094
050,36,007,"New York","Broome County",4,41,2204,1119,1085
050,36,007,"New York","Broome County",4,42,2117,1045,1072
050,36,007,"New York","Broome County",4,43,2051,1027,1024
050,36,007,"New York","Broome County",4,44,1991,1004,987
050,36,007,"New York","Broome County",4,45,1952,958,994
050,36,007,"New York","Broome County",4,46,1889,933,956
050,36,007,"New York","Broome County",4,47,1918,962,956
050,36,007,"New York","Broome County",4,48,1822,899,923
050,36,007,"New York","Broome County",4,49,1785,877,908
050,36,007,"New York","Broome County",4,50,1926,953,973
050,36,007,"New York","Broome County",4,51,2230,1111,1119
050,36,007,"New York","Broome County",4,52,2282,1170,1112
050,36,007,"New York","Broome County",4,53,2249,1128,1121
050,36,007,"New York","Broome County",4,54,2243,1104,1139
050,36,007,"New York","Broome County",4,55,2276,1121,1155
050,36,007,"New York","Broome County",4,56,2305,1128,1177
050,36,007,"New York","Broome County",4,57,2482,1206,1276
050,36,007,"New York","Broome County",4,58,2641,1289,1352
050,36,007,"New York","Broome County",4,59,2718,1325,1393
050,36,007,"New York","Broome County",4,60,2828,1393,1435
050,36,007,"New York","Broome County",4,61,2898,1444,1454
050,36,007,"New York","Broome County",4,62,2827,1406,1421
050,36,007,"New York","Broome County",4,63,2749,1357,1392
050,36,007,"New York","Broome County",4,64,2755,1366,1389
050,36,007,"New York","Broome County",4,65,2699,1330,1369
050,36,007,"New York","Broome County",4,66,2536,1247,1289
050,36,007,"New York","Broome County",4,67,2391,1191,1200
050,36,007,"New York","Broome County",4,68,2298,1132,1166
050,36,007,"New York","Broome County",4,69,2249,1113,1136
050,36,007,"New York","Broome County",4,70,2174,1059,1115
050,36,007,"New York","Broome County",4,71,2003,941,1062
050,36,007,"New York","Broome County",4,72,1900,890,1010
050,36,007,"New York","Broome County",4,73,1904,909,995
050,36,007,"New York","Broome County",4,74,1850,868,982
050,36,007,"New York","Broome County",4,75,1985,919,1066
050,36,007,"New York","Broome County",4,76,1361,602,759
050,36,007,"New York","Broome County",4,77,1294,548,746
050,36,007,"New York","Broome County",4,78,1275,556,719
050,36,007,"New York","Broome County",4,79,1353,599,754
050,36,007,"New York","Broome County",4,80,1139,492,647
050,36,007,"New York","Broome County",4,81,1033,427,606
050,36,007,"New York","Broome County",4,82,944,394,550
050,36,007,"New York","Broome County",4,83,849,350,499
050,36,007,"New York","Broome County",4,84,854,351,503
050,36,007,"New York","Broome County",4,85,5762,1849,3913
050,36,007,"New York","Broome County",5,0,1859,944,915
050,36,007,"New York","Broome County",5,1,1909,968,941
050,36,007,"New York","Broome County",5,2,1783,894,889
050,36,007,"New York","Broome County",5,3,1842,938,904
050,36,007,"New York","Broome County",5,4,1866,971,895
050,36,007,"New York","Broome County",5,5,2022,1031,991
050,36,007,"New York","Broome County",5,6,2075,1071,1004
050,36,007,"New York","Broome County",5,7,2078,1090,988
050,36,007,"New York","Broome County",5,8,2193,1130,1063
050,36,007,"New York","Broome County",5,9,2156,1134,1022
050,36,007,"New York","Broome County",5,10,2168,1151,1017
050,36,007,"New York","Broome County",5,11,2101,1079,1022
050,36,007,"New York","Broome County",5,12,2128,1090,1038
050,36,007,"New York","Broome County",5,13,2133,1092,1041
050,36,007,"New York","Broome County",5,14,2196,1138,1058
050,36,007,"New York","Broome County",5,15,2244,1144,1100
050,36,007,"New York","Broome County",5,16,2246,1154,1092
050,36,007,"New York","Broome County",5,17,2276,1183,1093
050,36,007,"New York","Broome County",5,18,3722,1926,1796
050,36,007,"New York","Broome County",5,19,5326,2844,2482
050,36,007,"New York","Broome County",5,20,5385,2728,2657
050,36,007,"New York","Broome County",5,21,4561,2398,2163
050,36,007,"New York","Broome County",5,22,3874,2009,1865
050,36,007,"New York","Broome County",5,23,3159,1618,1541
050,36,007,"New York","Broome County",5,24,2917,1532,1385
050,36,007,"New York","Broome County",5,25,2521,1269,1252
050,36,007,"New York","Broome County",5,26,2286,1181,1105
050,36,007,"New York","Broome County",5,27,2227,1154,1073
050,36,007,"New York","Broome County",5,28,2149,1100,1049
050,36,007,"New York","Broome County",5,29,2179,1129,1050
050,36,007,"New York","Broome County",5,30,2215,1094,1121
050,36,007,"New York","Broome County",5,31,2215,1112,1103
050,36,007,"New York","Broome County",5,32,2159,1076,1083
050,36,007,"New York","Broome County",5,33,2129,1072,1057
050,36,007,"New York","Broome County",5,34,2060,1042,1018
050,36,007,"New York","Broome County",5,35,2037,1009,1028
050,36,007,"New York","Broome County",5,36,2095,1042,1053
050,36,007,"New York","Broome County",5,37,2148,1083,1065
050,36,007,"New York","Broome County",5,38,2231,1116,1115
050,36,007,"New York","Broome County",5,39,2116,1035,1081
050,36,007,"New York","Broome County",5,40,2208,1079,1129
050,36,007,"New York","Broome County",5,41,2211,1127,1084
050,36,007,"New York","Broome County",5,42,2195,1111,1084
050,36,007,"New York","Broome County",5,43,2115,1053,1062
050,36,007,"New York","Broome County",5,44,2056,1032,1024
050,36,007,"New York","Broome County",5,45,2021,1032,989
050,36,007,"New York","Broome County",5,46,1950,960,990
050,36,007,"New York","Broome County",5,47,1868,915,953
050,36,007,"New York","Broome County",5,48,1930,969,961
050,36,007,"New York","Broome County",5,49,1816,883,933
050,36,007,"New York","Broome County",5,50,1798,883,915
050,36,007,"New York","Broome County",5,51,1912,945,967
050,36,007,"New York","Broome County",5,52,2212,1109,1103
050,36,007,"New York","Broome County",5,53,2259,1159,1100
050,36,007,"New York","Broome County",5,54,2231,1115,1116
050,36,007,"New York","Broome County",5,55,2225,1095,1130
050,36,007,"New York","Broome County",5,56,2252,1112,1140
050,36,007,"New York","Broome County",5,57,2276,1115,1161
050,36,007,"New York","Broome County",5,58,2432,1180,1252
050,36,007,"New York","Broome County",5,59,2642,1290,1352
050,36,007,"New York","Broome County",5,60,2708,1320,1388
050,36,007,"New York","Broome County",5,61,2793,1355,1438
050,36,007,"New York","Broome County",5,62,2871,1433,1438
050,36,007,"New York","Broome County",5,63,2766,1367,1399
050,36,007,"New York","Broome County",5,64,2697,1337,1360
050,36,007,"New York","Broome County",5,65,2702,1327,1375
050,36,007,"New York","Broome County",5,66,2629,1285,1344
050,36,007,"New York","Broome County",5,67,2460,1191,1269
050,36,007,"New York","Broome County",5,68,2359,1170,1189
050,36,007,"New York","Broome County",5,69,2263,1121,1142
050,36,007,"New York","Broome County",5,70,2182,1086,1096
050,36,007,"New York","Broome County",5,71,2122,1030,1092
050,36,007,"New York","Broome County",5,72,1983,926,1057
050,36,007,"New York","Broome County",5,73,1841,857,984
050,36,007,"New York","Broome County",5,74,1838,889,949
050,36,007,"New York","Broome County",5,75,1769,811,958
050,36,007,"New York","Broome County",5,76,1929,867,1062
050,36,007,"New York","Broome County",5,77,1311,577,734
050,36,007,"New York","Broome County",5,78,1224,511,713
050,36,007,"New York","Broome County",5,79,1221,520,701
050,36,007,"New York","Broome County",5,80,1271,573,698
050,36,007,"New York","Broome County",5,81,1107,466,641
050,36,007,"New York","Broome County",5,82,956,388,568
050,36,007,"New York","Broome County",5,83,876,359,517
050,36,007,"New York","Broome County",5,84,794,334,460
050,36,007,"New York","Broome County",5,85,5810,1873,3937
050,36,009,"New York","Cattaraugus County",1,0,839,440,399
050,36,009,"New York","Cattaraugus County",1,1,888,479,409
050,36,009,"New York","Cattaraugus County",1,2,813,426,387
050,36,009,"New York","Cattaraugus County",1,3,853,441,412
050,36,009,"New York","Cattaraugus County",1,4,904,478,426
050,36,009,"New York","Cattaraugus County",1,5,921,472,449
050,36,009,"New York","Cattaraugus County",1,6,942,501,441
050,36,009,"New York","Cattaraugus County",1,7,912,463,449
050,36,009,"New York","Cattaraugus County",1,8,912,447,465
050,36,009,"New York","Cattaraugus County",1,9,974,503,471
050,36,009,"New York","Cattaraugus County",1,10,990,501,489
050,36,009,"New York","Cattaraugus County",1,11,971,474,497
050,36,009,"New York","Cattaraugus County",1,12,1037,524,513
050,36,009,"New York","Cattaraugus County",1,13,1087,560,527
050,36,009,"New York","Cattaraugus County",1,14,1016,509,507
050,36,009,"New York","Cattaraugus County",1,15,1027,532,495
050,36,009,"New York","Cattaraugus County",1,16,1032,513,519
050,36,009,"New York","Cattaraugus County",1,17,1032,538,494
050,36,009,"New York","Cattaraugus County",1,18,1054,552,502
050,36,009,"New York","Cattaraugus County",1,19,1088,542,546
050,36,009,"New York","Cattaraugus County",1,20,1034,535,499
050,36,009,"New York","Cattaraugus County",1,21,1037,556,481
050,36,009,"New York","Cattaraugus County",1,22,927,478,449
050,36,009,"New York","Cattaraugus County",1,23,812,421,391
050,36,009,"New York","Cattaraugus County",1,24,800,403,397
050,36,009,"New York","Cattaraugus County",1,25,828,410,418
050,36,009,"New York","Cattaraugus County",1,26,791,406,385
050,36,009,"New York","Cattaraugus County",1,27,798,397,401
050,36,009,"New York","Cattaraugus County",1,28,833,434,399
050,36,009,"New York","Cattaraugus County",1,29,850,427,423
050,36,009,"New York","Cattaraugus County",1,30,830,430,400
050,36,009,"New York","Cattaraugus County",1,31,821,418,403
050,36,009,"New York","Cattaraugus County",1,32,809,393,416
050,36,009,"New York","Cattaraugus County",1,33,852,426,426
050,36,009,"New York","Cattaraugus County",1,34,877,450,427
050,36,009,"New York","Cattaraugus County",1,35,868,443,425
050,36,009,"New York","Cattaraugus County",1,36,852,444,408
050,36,009,"New York","Cattaraugus County",1,37,863,440,423
050,36,009,"New York","Cattaraugus County",1,38,885,437,448
050,36,009,"New York","Cattaraugus County",1,39,880,446,434
050,36,009,"New York","Cattaraugus County",1,40,891,453,438
050,36,009,"New York","Cattaraugus County",1,41,827,433,394
050,36,009,"New York","Cattaraugus County",1,42,839,415,424
050,36,009,"New York","Cattaraugus County",1,43,837,420,417
050,36,009,"New York","Cattaraugus County",1,44,843,429,414
050,36,009,"New York","Cattaraugus County",1,45,822,411,411
050,36,009,"New York","Cattaraugus County",1,46,819,418,401
050,36,009,"New York","Cattaraugus County",1,47,855,417,438
050,36,009,"New York","Cattaraugus County",1,48,928,464,464
050,36,009,"New York","Cattaraugus County",1,49,974,482,492
050,36,009,"New York","Cattaraugus County",1,50,965,485,480
050,36,009,"New York","Cattaraugus County",1,51,982,502,480
050,36,009,"New York","Cattaraugus County",1,52,977,507,470
050,36,009,"New York","Cattaraugus County",1,53,989,509,480
050,36,009,"New York","Cattaraugus County",1,54,1052,521,531
050,36,009,"New York","Cattaraugus County",1,55,1143,575,568
050,36,009,"New York","Cattaraugus County",1,56,1149,591,558
050,36,009,"New York","Cattaraugus County",1,57,1175,594,581
050,36,009,"New York","Cattaraugus County",1,58,1179,594,585
050,36,009,"New York","Cattaraugus County",1,59,1162,590,572
050,36,009,"New York","Cattaraugus County",1,60,1191,609,582
050,36,009,"New York","Cattaraugus County",1,61,1245,610,635
050,36,009,"New York","Cattaraugus County",1,62,1219,598,621
050,36,009,"New York","Cattaraugus County",1,63,1142,575,567
050,36,009,"New York","Cattaraugus County",1,64,1156,579,577
050,36,009,"New York","Cattaraugus County",1,65,1133,577,556
050,36,009,"New York","Cattaraugus County",1,66,1053,527,526
050,36,009,"New York","Cattaraugus County",1,67,1051,536,515
050,36,009,"New York","Cattaraugus County",1,68,1027,497,530
050,36,009,"New York","Cattaraugus County",1,69,902,445,457
050,36,009,"New York","Cattaraugus County",1,70,898,431,467
050,36,009,"New York","Cattaraugus County",1,71,874,442,432
050,36,009,"New York","Cattaraugus County",1,72,858,447,411
050,36,009,"New York","Cattaraugus County",1,73,827,410,417
050,36,009,"New York","Cattaraugus County",1,74,564,276,288
050,36,009,"New York","Cattaraugus County",1,75,586,286,300
050,36,009,"New York","Cattaraugus County",1,76,563,273,290
050,36,009,"New York","Cattaraugus County",1,77,550,257,293
050,36,009,"New York","Cattaraugus County",1,78,498,232,266
050,36,009,"New York","Cattaraugus County",1,79,412,193,219
050,36,009,"New York","Cattaraugus County",1,80,381,168,213
050,36,009,"New York","Cattaraugus County",1,81,371,155,216
050,36,009,"New York","Cattaraugus County",1,82,357,163,194
050,36,009,"New York","Cattaraugus County",1,83,314,141,173
050,36,009,"New York","Cattaraugus County",1,84,281,127,154
050,36,009,"New York","Cattaraugus County",1,85,1634,572,1062
050,36,009,"New York","Cattaraugus County",2,0,867,452,415
050,36,009,"New York","Cattaraugus County",2,1,875,468,407
050,36,009,"New York","Cattaraugus County",2,2,833,440,393
050,36,009,"New York","Cattaraugus County",2,3,842,438,404
050,36,009,"New York","Cattaraugus County",2,4,903,475,428
050,36,009,"New York","Cattaraugus County",2,5,923,476,447
050,36,009,"New York","Cattaraugus County",2,6,944,498,446
050,36,009,"New York","Cattaraugus County",2,7,920,471,449
050,36,009,"New York","Cattaraugus County",2,8,913,454,459
050,36,009,"New York","Cattaraugus County",2,9,960,493,467
050,36,009,"New York","Cattaraugus County",2,10,988,502,486
050,36,009,"New York","Cattaraugus County",2,11,970,479,491
050,36,009,"New York","Cattaraugus County",2,12,1028,515,513
050,36,009,"New York","Cattaraugus County",2,13,1073,549,524
050,36,009,"New York","Cattaraugus County",2,14,1034,523,511
050,36,009,"New York","Cattaraugus County",2,15,1024,527,497
050,36,009,"New York","Cattaraugus County",2,16,1039,521,518
050,36,009,"New York","Cattaraugus County",2,17,1029,530,499
050,36,009,"New York","Cattaraugus County",2,18,1049,546,503
050,36,009,"New York","Cattaraugus County",2,19,1086,544,542
050,36,009,"New York","Cattaraugus County",2,20,1036,538,498
050,36,009,"New York","Cattaraugus County",2,21,1028,548,480
050,36,009,"New York","Cattaraugus County",2,22,933,484,449
050,36,009,"New York","Cattaraugus County",2,23,815,419,396
050,36,009,"New York","Cattaraugus County",2,24,791,399,392
050,36,009,"New York","Cattaraugus County",2,25,816,407,409
050,36,009,"New York","Cattaraugus County",2,26,795,401,394
050,36,009,"New York","Cattaraugus County",2,27,795,400,395
050,36,009,"New York","Cattaraugus County",2,28,827,424,403
050,36,009,"New York","Cattaraugus County",2,29,842,428,414
050,36,009,"New York","Cattaraugus County",2,30,844,434,410
050,36,009,"New York","Cattaraugus County",2,31,812,416,396
050,36,009,"New York","Cattaraugus County",2,32,805,395,410
050,36,009,"New York","Cattaraugus County",2,33,845,419,426
050,36,009,"New York","Cattaraugus County",2,34,873,444,429
050,36,009,"New York","Cattaraugus County",2,35,875,445,430
050,36,009,"New York","Cattaraugus County",2,36,847,439,408
050,36,009,"New York","Cattaraugus County",2,37,863,442,421
050,36,009,"New York","Cattaraugus County",2,38,882,437,445
050,36,009,"New York","Cattaraugus County",2,39,879,440,439
050,36,009,"New York","Cattaraugus County",2,40,896,456,440
050,36,009,"New York","Cattaraugus County",2,41,839,436,403
050,36,009,"New York","Cattaraugus County",2,42,832,416,416
050,36,009,"New York","Cattaraugus County",2,43,841,419,422
050,36,009,"New York","Cattaraugus County",2,44,834,425,409
050,36,009,"New York","Cattaraugus County",2,45,830,416,414
050,36,009,"New York","Cattaraugus County",2,46,812,412,400
050,36,009,"New York","Cattaraugus County",2,47,846,419,427
050,36,009,"New York","Cattaraugus County",2,48,912,454,458
050,36,009,"New York","Cattaraugus County",2,49,968,480,488
050,36,009,"New York","Cattaraugus County",2,50,972,487,485
050,36,009,"New York","Cattaraugus County",2,51,976,496,480
050,36,009,"New York","Cattaraugus County",2,52,970,501,469
050,36,009,"New York","Cattaraugus County",2,53,984,508,476
050,36,009,"New York","Cattaraugus County",2,54,1035,521,514
050,36,009,"New York","Cattaraugus County",2,55,1119,563,556
050,36,009,"New York","Cattaraugus County",2,56,1150,591,559
050,36,009,"New York","Cattaraugus County",2,57,1171,594,577
050,36,009,"New York","Cattaraugus County",2,58,1170,589,581
050,36,009,"New York","Cattaraugus County",2,59,1164,590,574
050,36,009,"New York","Cattaraugus County",2,60,1178,598,580
050,36,009,"New York","Cattaraugus County",2,61,1221,604,617
050,36,009,"New York","Cattaraugus County",2,62,1220,598,622
050,36,009,"New York","Cattaraugus County",2,63,1168,586,582
050,36,009,"New York","Cattaraugus County",2,64,1143,571,572
050,36,009,"New York","Cattaraugus County",2,65,1128,574,554
050,36,009,"New York","Cattaraugus County",2,66,1064,537,527
050,36,009,"New York","Cattaraugus County",2,67,1044,529,515
050,36,009,"New York","Cattaraugus County",2,68,1023,501,522
050,36,009,"New York","Cattaraugus County",2,69,938,462,476
050,36,009,"New York","Cattaraugus County",2,70,896,430,466
050,36,009,"New York","Cattaraugus County",2,71,881,442,439
050,36,009,"New York","Cattaraugus County",2,72,838,432,406
050,36,009,"New York","Cattaraugus County",2,73,871,436,435
050,36,009,"New York","Cattaraugus County",2,74,583,285,298
050,36,009,"New York","Cattaraugus County",2,75,573,279,294
050,36,009,"New York","Cattaraugus County",2,76,554,270,284
050,36,009,"New York","Cattaraugus County",2,77,557,263,294
050,36,009,"New York","Cattaraugus County",2,78,497,230,267
050,36,009,"New York","Cattaraugus County",2,79,422,197,225
050,36,009,"New York","Cattaraugus County",2,80,387,174,213
050,36,009,"New York","Cattaraugus County",2,81,364,151,213
050,36,009,"New York","Cattaraugus County",2,82,360,159,201
050,36,009,"New York","Cattaraugus County",2,83,313,142,171
050,36,009,"New York","Cattaraugus County",2,84,282,126,156
050,36,009,"New York","Cattaraugus County",2,85,1645,581,1064
050,36,009,"New York","Cattaraugus County",3,0,814,433,381
050,36,009,"New York","Cattaraugus County",3,1,850,435,415
050,36,009,"New York","Cattaraugus County",3,2,880,468,412
050,36,009,"New York","Cattaraugus County",3,3,829,441,388
050,36,009,"New York","Cattaraugus County",3,4,840,448,392
050,36,009,"New York","Cattaraugus County",3,5,914,480,434
050,36,009,"New York","Cattaraugus County",3,6,915,477,438
050,36,009,"New York","Cattaraugus County",3,7,943,499,444
050,36,009,"New York","Cattaraugus County",3,8,926,480,446
050,36,009,"New York","Cattaraugus County",3,9,917,456,461
050,36,009,"New York","Cattaraugus County",3,10,948,494,454
050,36,009,"New York","Cattaraugus County",3,11,988,500,488
050,36,009,"New York","Cattaraugus County",3,12,946,476,470
050,36,009,"New York","Cattaraugus County",3,13,1032,513,519
050,36,009,"New York","Cattaraugus County",3,14,1069,553,516
050,36,009,"New York","Cattaraugus County",3,15,1024,530,494
050,36,009,"New York","Cattaraugus County",3,16,1004,519,485
050,36,009,"New York","Cattaraugus County",3,17,1028,514,514
050,36,009,"New York","Cattaraugus County",3,18,1052,532,520
050,36,009,"New York","Cattaraugus County",3,19,1074,538,536
050,36,009,"New York","Cattaraugus County",3,20,1053,560,493
050,36,009,"New York","Cattaraugus County",3,21,1019,535,484
050,36,009,"New York","Cattaraugus County",3,22,971,506,465
050,36,009,"New York","Cattaraugus County",3,23,843,446,397
050,36,009,"New York","Cattaraugus County",3,24,776,396,380
050,36,009,"New York","Cattaraugus County",3,25,793,409,384
050,36,009,"New York","Cattaraugus County",3,26,768,377,391
050,36,009,"New York","Cattaraugus County",3,27,780,391,389
050,36,009,"New York","Cattaraugus County",3,28,807,407,400
050,36,009,"New York","Cattaraugus County",3,29,827,434,393
050,36,009,"New York","Cattaraugus County",3,30,855,452,403
050,36,009,"New York","Cattaraugus County",3,31,852,437,415
050,36,009,"New York","Cattaraugus County",3,32,796,415,381
050,36,009,"New York","Cattaraugus County",3,33,826,393,433
050,36,009,"New York","Cattaraugus County",3,34,865,426,439
050,36,009,"New York","Cattaraugus County",3,35,873,446,427
050,36,009,"New York","Cattaraugus County",3,36,870,440,430
050,36,009,"New York","Cattaraugus County",3,37,845,442,403
050,36,009,"New York","Cattaraugus County",3,38,871,456,415
050,36,009,"New York","Cattaraugus County",3,39,894,449,445
050,36,009,"New York","Cattaraugus County",3,40,892,443,449
050,36,009,"New York","Cattaraugus County",3,41,890,445,445
050,36,009,"New York","Cattaraugus County",3,42,857,445,412
050,36,009,"New York","Cattaraugus County",3,43,820,408,412
050,36,009,"New York","Cattaraugus County",3,44,844,423,421
050,36,009,"New York","Cattaraugus County",3,45,825,409,416
050,36,009,"New York","Cattaraugus County",3,46,816,400,416
050,36,009,"New York","Cattaraugus County",3,47,822,411,411
050,36,009,"New York","Cattaraugus County",3,48,840,421,419
050,36,009,"New York","Cattaraugus County",3,49,904,449,455
050,36,009,"New York","Cattaraugus County",3,50,983,487,496
050,36,009,"New York","Cattaraugus County",3,51,961,481,480
050,36,009,"New York","Cattaraugus County",3,52,960,487,473
050,36,009,"New York","Cattaraugus County",3,53,978,503,475
050,36,009,"New York","Cattaraugus County",3,54,997,509,488
050,36,009,"New York","Cattaraugus County",3,55,1031,523,508
050,36,009,"New York","Cattaraugus County",3,56,1103,555,548
050,36,009,"New York","Cattaraugus County",3,57,1148,588,560
050,36,009,"New York","Cattaraugus County",3,58,1152,590,562
050,36,009,"New York","Cattaraugus County",3,59,1163,581,582
050,36,009,"New York","Cattaraugus County",3,60,1160,580,580
050,36,009,"New York","Cattaraugus County",3,61,1163,588,575
050,36,009,"New York","Cattaraugus County",3,62,1203,590,613
050,36,009,"New York","Cattaraugus County",3,63,1197,587,610
050,36,009,"New York","Cattaraugus County",3,64,1157,573,584
050,36,009,"New York","Cattaraugus County",3,65,1112,564,548
050,36,009,"New York","Cattaraugus County",3,66,1114,570,544
050,36,009,"New York","Cattaraugus County",3,67,1036,514,522
050,36,009,"New York","Cattaraugus County",3,68,1028,512,516
050,36,009,"New York","Cattaraugus County",3,69,991,490,501
050,36,009,"New York","Cattaraugus County",3,70,896,437,459
050,36,009,"New York","Cattaraugus County",3,71,863,420,443
050,36,009,"New York","Cattaraugus County",3,72,855,427,428
050,36,009,"New York","Cattaraugus County",3,73,797,406,391
050,36,009,"New York","Cattaraugus County",3,74,842,416,426
050,36,009,"New York","Cattaraugus County",3,75,552,268,284
050,36,009,"New York","Cattaraugus County",3,76,553,271,282
050,36,009,"New York","Cattaraugus County",3,77,529,258,271
050,36,009,"New York","Cattaraugus County",3,78,537,245,292
050,36,009,"New York","Cattaraugus County",3,79,463,212,251
050,36,009,"New York","Cattaraugus County",3,80,401,183,218
050,36,009,"New York","Cattaraugus County",3,81,356,154,202
050,36,009,"New York","Cattaraugus County",3,82,330,141,189
050,36,009,"New York","Cattaraugus County",3,83,341,146,195
050,36,009,"New York","Cattaraugus County",3,84,268,119,149
050,36,009,"New York","Cattaraugus County",3,85,1632,582,1050
050,36,009,"New York","Cattaraugus County",4,0,788,393,395
050,36,009,"New York","Cattaraugus County",4,1,804,429,375
050,36,009,"New York","Cattaraugus County",4,2,846,423,423
050,36,009,"New York","Cattaraugus County",4,3,874,464,410
050,36,009,"New York","Cattaraugus County",4,4,828,438,390
050,36,009,"New York","Cattaraugus County",4,5,837,450,387
050,36,009,"New York","Cattaraugus County",4,6,917,486,431
050,36,009,"New York","Cattaraugus County",4,7,909,472,437
050,36,009,"New York","Cattaraugus County",4,8,945,496,449
050,36,009,"New York","Cattaraugus County",4,9,912,469,443
050,36,009,"New York","Cattaraugus County",4,10,933,472,461
050,36,009,"New York","Cattaraugus County",4,11,947,494,453
050,36,009,"New York","Cattaraugus County",4,12,997,503,494
050,36,009,"New York","Cattaraugus County",4,13,959,479,480
050,36,009,"New York","Cattaraugus County",4,14,1036,518,518
050,36,009,"New York","Cattaraugus County",4,15,1074,548,526
050,36,009,"New York","Cattaraugus County",4,16,1028,526,502
050,36,009,"New York","Cattaraugus County",4,17,1002,515,487
050,36,009,"New York","Cattaraugus County",4,18,1053,520,533
050,36,009,"New York","Cattaraugus County",4,19,1056,524,532
050,36,009,"New York","Cattaraugus County",4,20,1010,530,480
050,36,009,"New York","Cattaraugus County",4,21,1026,553,473
050,36,009,"New York","Cattaraugus County",4,22,959,494,465
050,36,009,"New York","Cattaraugus County",4,23,878,449,429
050,36,009,"New York","Cattaraugus County",4,24,810,436,374
050,36,009,"New York","Cattaraugus County",4,25,764,404,360
050,36,009,"New York","Cattaraugus County",4,26,774,400,374
050,36,009,"New York","Cattaraugus County",4,27,783,380,403
050,36,009,"New York","Cattaraugus County",4,28,775,387,388
050,36,009,"New York","Cattaraugus County",4,29,805,424,381
050,36,009,"New York","Cattaraugus County",4,30,833,432,401
050,36,009,"New York","Cattaraugus County",4,31,850,442,408
050,36,009,"New York","Cattaraugus County",4,32,867,444,423
050,36,009,"New York","Cattaraugus County",4,33,820,419,401
050,36,009,"New York","Cattaraugus County",4,34,843,404,439
050,36,009,"New York","Cattaraugus County",4,35,884,435,449
050,36,009,"New York","Cattaraugus County",4,36,866,441,425
050,36,009,"New York","Cattaraugus County",4,37,867,426,441
050,36,009,"New York","Cattaraugus County",4,38,854,452,402
050,36,009,"New York","Cattaraugus County",4,39,889,457,432
050,36,009,"New York","Cattaraugus County",4,40,897,445,452
050,36,009,"New York","Cattaraugus County",4,41,878,440,438
050,36,009,"New York","Cattaraugus County",4,42,897,455,442
050,36,009,"New York","Cattaraugus County",4,43,860,441,419
050,36,009,"New York","Cattaraugus County",4,44,836,431,405
050,36,009,"New York","Cattaraugus County",4,45,832,414,418
050,36,009,"New York","Cattaraugus County",4,46,810,405,405
050,36,009,"New York","Cattaraugus County",4,47,808,397,411
050,36,009,"New York","Cattaraugus County",4,48,821,415,406
050,36,009,"New York","Cattaraugus County",4,49,841,426,415
050,36,009,"New York","Cattaraugus County",4,50,915,455,460
050,36,009,"New York","Cattaraugus County",4,51,972,486,486
050,36,009,"New York","Cattaraugus County",4,52,951,470,481
050,36,009,"New York","Cattaraugus County",4,53,952,480,472
050,36,009,"New York","Cattaraugus County",4,54,983,509,474
050,36,009,"New York","Cattaraugus County",4,55,987,502,485
050,36,009,"New York","Cattaraugus County",4,56,1024,514,510
050,36,009,"New York","Cattaraugus County",4,57,1105,556,549
050,36,009,"New York","Cattaraugus County",4,58,1144,590,554
050,36,009,"New York","Cattaraugus County",4,59,1156,590,566
050,36,009,"New York","Cattaraugus County",4,60,1167,580,587
050,36,009,"New York","Cattaraugus County",4,61,1142,567,575
050,36,009,"New York","Cattaraugus County",4,62,1140,578,562
050,36,009,"New York","Cattaraugus County",4,63,1160,575,585
050,36,009,"New York","Cattaraugus County",4,64,1183,574,609
050,36,009,"New York","Cattaraugus County",4,65,1135,554,581
050,36,009,"New York","Cattaraugus County",4,66,1095,561,534
050,36,009,"New York","Cattaraugus County",4,67,1075,548,527
050,36,009,"New York","Cattaraugus County",4,68,1005,488,517
050,36,009,"New York","Cattaraugus County",4,69,1006,503,503
050,36,009,"New York","Cattaraugus County",4,70,961,477,484
050,36,009,"New York","Cattaraugus County",4,71,851,418,433
050,36,009,"New York","Cattaraugus County",4,72,830,400,430
050,36,009,"New York","Cattaraugus County",4,73,819,395,424
050,36,009,"New York","Cattaraugus County",4,74,766,385,381
050,36,009,"New York","Cattaraugus County",4,75,807,396,411
050,36,009,"New York","Cattaraugus County",4,76,532,257,275
050,36,009,"New York","Cattaraugus County",4,77,520,261,259
050,36,009,"New York","Cattaraugus County",4,78,506,244,262
050,36,009,"New York","Cattaraugus County",4,79,491,220,271
050,36,009,"New York","Cattaraugus County",4,80,434,195,239
050,36,009,"New York","Cattaraugus County",4,81,354,154,200
050,36,009,"New York","Cattaraugus County",4,82,326,144,182
050,36,009,"New York","Cattaraugus County",4,83,302,125,177
050,36,009,"New York","Cattaraugus County",4,84,304,128,176
050,36,009,"New York","Cattaraugus County",4,85,1568,567,1001
050,36,009,"New York","Cattaraugus County",5,0,789,395,394
050,36,009,"New York","Cattaraugus County",5,1,789,396,393
050,36,009,"New York","Cattaraugus County",5,2,796,417,379
050,36,009,"New York","Cattaraugus County",5,3,858,438,420
050,36,009,"New York","Cattaraugus County",5,4,879,467,412
050,36,009,"New York","Cattaraugus County",5,5,829,442,387
050,36,009,"New York","Cattaraugus County",5,6,853,451,402
050,36,009,"New York","Cattaraugus County",5,7,912,473,439
050,36,009,"New York","Cattaraugus County",5,8,915,471,444
050,36,009,"New York","Cattaraugus County",5,9,941,498,443
050,36,009,"New York","Cattaraugus County",5,10,900,466,434
050,36,009,"New York","Cattaraugus County",5,11,912,452,460
050,36,009,"New York","Cattaraugus County",5,12,960,496,464
050,36,009,"New York","Cattaraugus County",5,13,1005,505,500
050,36,009,"New York","Cattaraugus County",5,14,945,475,470
050,36,009,"New York","Cattaraugus County",5,15,1035,519,516
050,36,009,"New York","Cattaraugus County",5,16,1085,551,534
050,36,009,"New York","Cattaraugus County",5,17,1007,518,489
050,36,009,"New York","Cattaraugus County",5,18,1027,519,508
050,36,009,"New York","Cattaraugus County",5,19,1044,499,545
050,36,009,"New York","Cattaraugus County",5,20,1015,531,484
050,36,009,"New York","Cattaraugus County",5,21,991,528,463
050,36,009,"New York","Cattaraugus County",5,22,981,521,460
050,36,009,"New York","Cattaraugus County",5,23,861,443,418
050,36,009,"New York","Cattaraugus County",5,24,847,434,413
050,36,009,"New York","Cattaraugus County",5,25,809,438,371
050,36,009,"New York","Cattaraugus County",5,26,749,390,359
050,36,009,"New York","Cattaraugus County",5,27,793,409,384
050,36,009,"New York","Cattaraugus County",5,28,783,377,406
050,36,009,"New York","Cattaraugus County",5,29,756,377,379
050,36,009,"New York","Cattaraugus County",5,30,834,447,387
050,36,009,"New York","Cattaraugus County",5,31,813,426,387
050,36,009,"New York","Cattaraugus County",5,32,830,438,392
050,36,009,"New York","Cattaraugus County",5,33,878,450,428
050,36,009,"New York","Cattaraugus County",5,34,832,423,409
050,36,009,"New York","Cattaraugus County",5,35,854,403,451
050,36,009,"New York","Cattaraugus County",5,36,864,426,438
050,36,009,"New York","Cattaraugus County",5,37,876,444,432
050,36,009,"New York","Cattaraugus County",5,38,862,424,438
050,36,009,"New York","Cattaraugus County",5,39,848,439,409
050,36,009,"New York","Cattaraugus County",5,40,886,457,429
050,36,009,"New York","Cattaraugus County",5,41,871,419,452
050,36,009,"New York","Cattaraugus County",5,42,884,440,444
050,36,009,"New York","Cattaraugus County",5,43,869,434,435
050,36,009,"New York","Cattaraugus County",5,44,879,466,413
050,36,009,"New York","Cattaraugus County",5,45,822,421,401
050,36,009,"New York","Cattaraugus County",5,46,823,409,414
050,36,009,"New York","Cattaraugus County",5,47,815,411,404
050,36,009,"New York","Cattaraugus County",5,48,821,414,407
050,36,009,"New York","Cattaraugus County",5,49,825,415,410
050,36,009,"New York","Cattaraugus County",5,50,844,428,416
050,36,009,"New York","Cattaraugus County",5,51,907,454,453
050,36,009,"New York","Cattaraugus County",5,52,954,478,476
050,36,009,"New York","Cattaraugus County",5,53,963,476,487
050,36,009,"New York","Cattaraugus County",5,54,965,488,477
050,36,009,"New York","Cattaraugus County",5,55,989,520,469
050,36,009,"New York","Cattaraugus County",5,56,969,493,476
050,36,009,"New York","Cattaraugus County",5,57,1026,512,514
050,36,009,"New York","Cattaraugus County",5,58,1099,554,545
050,36,009,"New York","Cattaraugus County",5,59,1133,581,552
050,36,009,"New York","Cattaraugus County",5,60,1140,576,564
050,36,009,"New York","Cattaraugus County",5,61,1146,566,580
050,36,009,"New York","Cattaraugus County",5,62,1127,560,567
050,36,009,"New York","Cattaraugus County",5,63,1120,568,552
050,36,009,"New York","Cattaraugus County",5,64,1154,568,586
050,36,009,"New York","Cattaraugus County",5,65,1172,564,608
050,36,009,"New York","Cattaraugus County",5,66,1118,544,574
050,36,009,"New York","Cattaraugus County",5,67,1064,539,525
050,36,009,"New York","Cattaraugus County",5,68,1052,531,521
050,36,009,"New York","Cattaraugus County",5,69,972,478,494
050,36,009,"New York","Cattaraugus County",5,70,988,492,496
050,36,009,"New York","Cattaraugus County",5,71,944,463,481
050,36,009,"New York","Cattaraugus County",5,72,819,392,427
050,36,009,"New York","Cattaraugus County",5,73,792,369,423
050,36,009,"New York","Cattaraugus County",5,74,790,376,414
050,36,009,"New York","Cattaraugus County",5,75,737,370,367
050,36,009,"New York","Cattaraugus County",5,76,772,377,395
050,36,009,"New York","Cattaraugus County",5,77,497,245,252
050,36,009,"New York","Cattaraugus County",5,78,507,250,257
050,36,009,"New York","Cattaraugus County",5,79,467,224,243
050,36,009,"New York","Cattaraugus County",5,80,458,199,259
050,36,009,"New York","Cattaraugus County",5,81,391,169,222
050,36,009,"New York","Cattaraugus County",5,82,324,141,183
050,36,009,"New York","Cattaraugus County",5,83,304,131,173
050,36,009,"New York","Cattaraugus County",5,84,267,110,157
050,36,009,"New York","Cattaraugus County",5,85,1577,585,992
050,36,011,"New York","Cayuga County",1,0,691,356,335
050,36,011,"New York","Cayuga County",1,1,731,383,348
050,36,011,"New York","Cayuga County",1,2,745,376,369
050,36,011,"New York","Cayuga County",1,3,787,397,390
050,36,011,"New York","Cayuga County",1,4,773,405,368
050,36,011,"New York","Cayuga County",1,5,773,407,366
050,36,011,"New York","Cayuga County",1,6,766,378,388
050,36,011,"New York","Cayuga County",1,7,769,403,366
050,36,011,"New York","Cayuga County",1,8,820,426,394
050,36,011,"New York","Cayuga County",1,9,863,431,432
050,36,011,"New York","Cayuga County",1,10,877,467,410
050,36,011,"New York","Cayuga County",1,11,918,485,433
050,36,011,"New York","Cayuga County",1,12,931,482,449
050,36,011,"New York","Cayuga County",1,13,902,474,428
050,36,011,"New York","Cayuga County",1,14,897,460,437
050,36,011,"New York","Cayuga County",1,15,923,474,449
050,36,011,"New York","Cayuga County",1,16,926,499,427
050,36,011,"New York","Cayuga County",1,17,918,476,442
050,36,011,"New York","Cayuga County",1,18,893,463,430
050,36,011,"New York","Cayuga County",1,19,785,397,388
050,36,011,"New York","Cayuga County",1,20,821,411,410
050,36,011,"New York","Cayuga County",1,21,844,424,420
050,36,011,"New York","Cayuga County",1,22,882,472,410
050,36,011,"New York","Cayuga County",1,23,937,511,426
050,36,011,"New York","Cayuga County",1,24,883,506,377
050,36,011,"New York","Cayuga County",1,25,888,486,402
050,36,011,"New York","Cayuga County",1,26,907,505,402
050,36,011,"New York","Cayuga County",1,27,925,511,414
050,36,011,"New York","Cayuga County",1,28,951,522,429
050,36,011,"New York","Cayuga County",1,29,952,520,432
050,36,011,"New York","Cayuga County",1,30,912,498,414
050,36,011,"New York","Cayuga County",1,31,914,509,405
050,36,011,"New York","Cayuga County",1,32,925,503,422
050,36,011,"New York","Cayuga County",1,33,946,519,427
050,36,011,"New York","Cayuga County",1,34,937,513,424
050,36,011,"New York","Cayuga County",1,35,948,527,421
050,36,011,"New York","Cayuga County",1,36,941,486,455
050,36,011,"New York","Cayuga County",1,37,996,489,507
050,36,011,"New York","Cayuga County",1,38,960,511,449
050,36,011,"New York","Cayuga County",1,39,908,502,406
050,36,011,"New York","Cayuga County",1,40,925,501,424
050,36,011,"New York","Cayuga County",1,41,856,440,416
050,36,011,"New York","Cayuga County",1,42,882,479,403
050,36,011,"New York","Cayuga County",1,43,842,463,379
050,36,011,"New York","Cayuga County",1,44,805,405,400
050,36,011,"New York","Cayuga County",1,45,816,447,369
050,36,011,"New York","Cayuga County",1,46,799,443,356
050,36,011,"New York","Cayuga County",1,47,823,442,381
050,36,011,"New York","Cayuga County",1,48,957,494,463
050,36,011,"New York","Cayuga County",1,49,1047,550,497
050,36,011,"New York","Cayuga County",1,50,1015,526,489
050,36,011,"New York","Cayuga County",1,51,989,501,488
050,36,011,"New York","Cayuga County",1,52,1066,552,514
050,36,011,"New York","Cayuga County",1,53,1060,560,500
050,36,011,"New York","Cayuga County",1,54,1095,583,512
050,36,011,"New York","Cayuga County",1,55,1145,601,544
050,36,011,"New York","Cayuga County",1,56,1230,610,620
050,36,011,"New York","Cayuga County",1,57,1194,621,573
050,36,011,"New York","Cayuga County",1,58,1233,629,604
050,36,011,"New York","Cayuga County",1,59,1217,618,599
050,36,011,"New York","Cayuga County",1,60,1205,595,610
050,36,011,"New York","Cayuga County",1,61,1245,601,644
050,36,011,"New York","Cayuga County",1,62,1194,579,615
050,36,011,"New York","Cayuga County",1,63,1150,563,587
050,36,011,"New York","Cayuga County",1,64,1159,573,586
050,36,011,"New York","Cayuga County",1,65,1136,583,553
050,36,011,"New York","Cayuga County",1,66,1046,550,496
050,36,011,"New York","Cayuga County",1,67,980,507,473
050,36,011,"New York","Cayuga County",1,68,994,500,494
050,36,011,"New York","Cayuga County",1,69,892,457,435
050,36,011,"New York","Cayuga County",1,70,826,429,397
050,36,011,"New York","Cayuga County",1,71,861,424,437
050,36,011,"New York","Cayuga County",1,72,874,437,437
050,36,011,"New York","Cayuga County",1,73,860,423,437
050,36,011,"New York","Cayuga County",1,74,604,284,320
050,36,011,"New York","Cayuga County",1,75,562,267,295
050,36,011,"New York","Cayuga County",1,76,539,248,291
050,36,011,"New York","Cayuga County",1,77,567,274,293
050,36,011,"New York","Cayuga County",1,78,490,233,257
050,36,011,"New York","Cayuga County",1,79,400,180,220
050,36,011,"New York","Cayuga County",1,80,382,163,219
050,36,011,"New York","Cayuga County",1,81,396,176,220
050,36,011,"New York","Cayuga County",1,82,362,167,195
050,36,011,"New York","Cayuga County",1,83,299,147,152
050,36,011,"New York","Cayuga County",1,84,274,111,163
050,36,011,"New York","Cayuga County",1,85,1895,662,1233
050,36,011,"New York","Cayuga County",2,0,712,362,350
050,36,011,"New York","Cayuga County",2,1,719,376,343
050,36,011,"New York","Cayuga County",2,2,743,378,365
050,36,011,"New York","Cayuga County",2,3,771,390,381
050,36,011,"New York","Cayuga County",2,4,776,403,373
050,36,011,"New York","Cayuga County",2,5,768,402,366
050,36,011,"New York","Cayuga County",2,6,767,384,383
050,36,011,"New York","Cayuga County",2,7,764,396,368
050,36,011,"New York","Cayuga County",2,8,806,419,387
050,36,011,"New York","Cayuga County",2,9,850,431,419
050,36,011,"New York","Cayuga County",2,10,872,457,415
050,36,011,"New York","Cayuga County",2,11,907,479,428
050,36,011,"New York","Cayuga County",2,12,936,488,448
050,36,011,"New York","Cayuga County",2,13,905,474,431
050,36,011,"New York","Cayuga County",2,14,903,466,437
050,36,011,"New York","Cayuga County",2,15,923,473,450
050,36,011,"New York","Cayuga County",2,16,930,500,430
050,36,011,"New York","Cayuga County",2,17,913,475,438
050,36,011,"New York","Cayuga County",2,18,883,455,428
050,36,011,"New York","Cayuga County",2,19,801,405,396
050,36,011,"New York","Cayuga County",2,20,840,418,422
050,36,011,"New York","Cayuga County",2,21,854,428,426
050,36,011,"New York","Cayuga County",2,22,877,465,412
050,36,011,"New York","Cayuga County",2,23,922,503,419
050,36,011,"New York","Cayuga County",2,24,891,504,387
050,36,011,"New York","Cayuga County",2,25,882,489,393
050,36,011,"New York","Cayuga County",2,26,901,500,401
050,36,011,"New York","Cayuga County",2,27,917,508,409
050,36,011,"New York","Cayuga County",2,28,939,514,425
050,36,011,"New York","Cayuga County",2,29,949,520,429
050,36,011,"New York","Cayuga County",2,30,921,501,420
050,36,011,"New York","Cayuga County",2,31,914,503,411
050,36,011,"New York","Cayuga County",2,32,917,500,417
050,36,011,"New York","Cayuga County",2,33,934,510,424
050,36,011,"New York","Cayuga County",2,34,937,512,425
050,36,011,"New York","Cayuga County",2,35,953,529,424
050,36,011,"New York","Cayuga County",2,36,930,485,445
050,36,011,"New York","Cayuga County",2,37,983,487,496
050,36,011,"New York","Cayuga County",2,38,978,512,466
050,36,011,"New York","Cayuga County",2,39,916,500,416
050,36,011,"New York","Cayuga County",2,40,928,503,425
050,36,011,"New York","Cayuga County",2,41,871,453,418
050,36,011,"New York","Cayuga County",2,42,869,464,405
050,36,011,"New York","Cayuga County",2,43,855,466,389
050,36,011,"New York","Cayuga County",2,44,798,408,390
050,36,011,"New York","Cayuga County",2,45,822,442,380
050,36,011,"New York","Cayuga County",2,46,797,437,360
050,36,011,"New York","Cayuga County",2,47,808,438,370
050,36,011,"New York","Cayuga County",2,48,921,479,442
050,36,011,"New York","Cayuga County",2,49,1025,539,486
050,36,011,"New York","Cayuga County",2,50,1022,528,494
050,36,011,"New York","Cayuga County",2,51,986,501,485
050,36,011,"New York","Cayuga County",2,52,1040,534,506
050,36,011,"New York","Cayuga County",2,53,1056,555,501
050,36,011,"New York","Cayuga County",2,54,1080,577,503
050,36,011,"New York","Cayuga County",2,55,1134,597,537
050,36,011,"New York","Cayuga County",2,56,1214,611,603
050,36,011,"New York","Cayuga County",2,57,1196,614,582
050,36,011,"New York","Cayuga County",2,58,1222,627,595
050,36,011,"New York","Cayuga County",2,59,1221,619,602
050,36,011,"New York","Cayuga County",2,60,1203,599,604
050,36,011,"New York","Cayuga County",2,61,1221,590,631
050,36,011,"New York","Cayuga County",2,62,1199,580,619
050,36,011,"New York","Cayuga County",2,63,1173,570,603
050,36,011,"New York","Cayuga County",2,64,1146,565,581
050,36,011,"New York","Cayuga County",2,65,1138,581,557
050,36,011,"New York","Cayuga County",2,66,1067,558,509
050,36,011,"New York","Cayuga County",2,67,989,511,478
050,36,011,"New York","Cayuga County",2,68,977,497,480
050,36,011,"New York","Cayuga County",2,69,915,464,451
050,36,011,"New York","Cayuga County",2,70,835,430,405
050,36,011,"New York","Cayuga County",2,71,848,426,422
050,36,011,"New York","Cayuga County",2,72,858,425,433
050,36,011,"New York","Cayuga County",2,73,902,448,454
050,36,011,"New York","Cayuga County",2,74,621,294,327
050,36,011,"New York","Cayuga County",2,75,573,273,300
050,36,011,"New York","Cayuga County",2,76,536,248,288
050,36,011,"New York","Cayuga County",2,77,571,272,299
050,36,011,"New York","Cayuga County",2,78,493,236,257
050,36,011,"New York","Cayuga County",2,79,416,192,224
050,36,011,"New York","Cayuga County",2,80,382,165,217
050,36,011,"New York","Cayuga County",2,81,387,171,216
050,36,011,"New York","Cayuga County",2,82,362,163,199
050,36,011,"New York","Cayuga County",2,83,304,148,156
050,36,011,"New York","Cayuga County",2,84,275,116,159
050,36,011,"New York","Cayuga County",2,85,1887,666,1221
050,36,011,"New York","Cayuga County",3,0,677,349,328
050,36,011,"New York","Cayuga County",3,1,715,352,363
050,36,011,"New York","Cayuga County",3,2,728,380,348
050,36,011,"New York","Cayuga County",3,3,760,398,362
050,36,011,"New York","Cayuga County",3,4,789,393,396
050,36,011,"New York","Cayuga County",3,5,779,407,372
050,36,011,"New York","Cayuga County",3,6,779,403,376
050,36,011,"New York","Cayuga County",3,7,782,390,392
050,36,011,"New York","Cayuga County",3,8,763,404,359
050,36,011,"New York","Cayuga County",3,9,799,416,383
050,36,011,"New York","Cayuga County",3,10,846,433,413
050,36,011,"New York","Cayuga County",3,11,877,452,425
050,36,011,"New York","Cayuga County",3,12,908,481,427
050,36,011,"New York","Cayuga County",3,13,922,483,439
050,36,011,"New York","Cayuga County",3,14,918,473,445
050,36,011,"New York","Cayuga County",3,15,919,472,447
050,36,011,"New York","Cayuga County",3,16,925,483,442
050,36,011,"New York","Cayuga County",3,17,909,470,439
050,36,011,"New York","Cayuga County",3,18,843,440,403
050,36,011,"New York","Cayuga County",3,19,773,391,382
050,36,011,"New York","Cayuga County",3,20,820,408,412
050,36,011,"New York","Cayuga County",3,21,851,438,413
050,36,011,"New York","Cayuga County",3,22,839,434,405
050,36,011,"New York","Cayuga County",3,23,881,469,412
050,36,011,"New York","Cayuga County",3,24,889,487,402
050,36,011,"New York","Cayuga County",3,25,861,485,376
050,36,011,"New York","Cayuga County",3,26,884,485,399
050,36,011,"New York","Cayuga County",3,27,901,503,398
050,36,011,"New York","Cayuga County",3,28,927,496,431
050,36,011,"New York","Cayuga County",3,29,939,510,429
050,36,011,"New York","Cayuga County",3,30,944,513,431
050,36,011,"New York","Cayuga County",3,31,932,508,424
050,36,011,"New York","Cayuga County",3,32,914,482,432
050,36,011,"New York","Cayuga County",3,33,894,481,413
050,36,011,"New York","Cayuga County",3,34,921,497,424
050,36,011,"New York","Cayuga County",3,35,959,526,433
050,36,011,"New York","Cayuga County",3,36,926,505,421
050,36,011,"New York","Cayuga County",3,37,913,474,439
050,36,011,"New York","Cayuga County",3,38,986,494,492
050,36,011,"New York","Cayuga County",3,39,962,499,463
050,36,011,"New York","Cayuga County",3,40,920,505,415
050,36,011,"New York","Cayuga County",3,41,913,497,416
050,36,011,"New York","Cayuga County",3,42,870,453,417
050,36,011,"New York","Cayuga County",3,43,857,454,403
050,36,011,"New York","Cayuga County",3,44,839,446,393
050,36,011,"New York","Cayuga County",3,45,803,421,382
050,36,011,"New York","Cayuga County",3,46,795,413,382
050,36,011,"New York","Cayuga County",3,47,763,408,355
050,36,011,"New York","Cayuga County",3,48,820,449,371
050,36,011,"New York","Cayuga County",3,49,911,479,432
050,36,011,"New York","Cayuga County",3,50,1017,526,491
050,36,011,"New York","Cayuga County",3,51,1005,519,486
050,36,011,"New York","Cayuga County",3,52,985,488,497
050,36,011,"New York","Cayuga County",3,53,1029,526,503
050,36,011,"New York","Cayuga County",3,54,1043,550,493
050,36,011,"New York","Cayuga County",3,55,1074,576,498
050,36,011,"New York","Cayuga County",3,56,1111,581,530
050,36,011,"New York","Cayuga County",3,57,1185,595,590
050,36,011,"New York","Cayuga County",3,58,1189,616,573
050,36,011,"New York","Cayuga County",3,59,1186,592,594
050,36,011,"New York","Cayuga County",3,60,1205,610,595
050,36,011,"New York","Cayuga County",3,61,1190,586,604
050,36,011,"New York","Cayuga County",3,62,1218,598,620
050,36,011,"New York","Cayuga County",3,63,1183,567,616
050,36,011,"New York","Cayuga County",3,64,1138,554,584
050,36,011,"New York","Cayuga County",3,65,1122,550,572
050,36,011,"New York","Cayuga County",3,66,1135,585,550
050,36,011,"New York","Cayuga County",3,67,1043,535,508
050,36,011,"New York","Cayuga County",3,68,979,504,475
050,36,011,"New York","Cayuga County",3,69,945,472,473
050,36,011,"New York","Cayuga County",3,70,897,447,450
050,36,011,"New York","Cayuga County",3,71,812,421,391
050,36,011,"New York","Cayuga County",3,72,835,418,417
050,36,011,"New York","Cayuga County",3,73,831,417,414
050,36,011,"New York","Cayuga County",3,74,876,432,444
050,36,011,"New York","Cayuga County",3,75,588,282,306
050,36,011,"New York","Cayuga County",3,76,560,263,297
050,36,011,"New York","Cayuga County",3,77,507,235,272
050,36,011,"New York","Cayuga County",3,78,542,256,286
050,36,011,"New York","Cayuga County",3,79,456,220,236
050,36,011,"New York","Cayuga County",3,80,390,179,211
050,36,011,"New York","Cayuga County",3,81,357,153,204
050,36,011,"New York","Cayuga County",3,82,375,162,213
050,36,011,"New York","Cayuga County",3,83,320,148,172
050,36,011,"New York","Cayuga County",3,84,270,125,145
050,36,011,"New York","Cayuga County",3,85,1808,653,1155
050,36,011,"New York","Cayuga County",4,0,659,348,311
050,36,011,"New York","Cayuga County",4,1,708,370,338
050,36,011,"New York","Cayuga County",4,2,717,348,369
050,36,011,"New York","Cayuga County",4,3,734,387,347
050,36,011,"New York","Cayuga County",4,4,769,409,360
050,36,011,"New York","Cayuga County",4,5,788,404,384
050,36,011,"New York","Cayuga County",4,6,784,405,379
050,36,011,"New York","Cayuga County",4,7,761,395,366
050,36,011,"New York","Cayuga County",4,8,780,387,393
050,36,011,"New York","Cayuga County",4,9,752,397,355
050,36,011,"New York","Cayuga County",4,10,794,409,385
050,36,011,"New York","Cayuga County",4,11,838,428,410
050,36,011,"New York","Cayuga County",4,12,871,440,431
050,36,011,"New York","Cayuga County",4,13,873,462,411
050,36,011,"New York","Cayuga County",4,14,924,486,438
050,36,011,"New York","Cayuga County",4,15,933,479,454
050,36,011,"New York","Cayuga County",4,16,923,486,437
050,36,011,"New York","Cayuga County",4,17,877,446,431
050,36,011,"New York","Cayuga County",4,18,813,428,385
050,36,011,"New York","Cayuga County",4,19,695,362,333
050,36,011,"New York","Cayuga County",4,20,780,391,389
050,36,011,"New York","Cayuga County",4,21,837,423,414
050,36,011,"New York","Cayuga County",4,22,841,439,402
050,36,011,"New York","Cayuga County",4,23,846,449,397
050,36,011,"New York","Cayuga County",4,24,845,462,383
050,36,011,"New York","Cayuga County",4,25,870,474,396
050,36,011,"New York","Cayuga County",4,26,848,479,369
050,36,011,"New York","Cayuga County",4,27,921,515,406
050,36,011,"New York","Cayuga County",4,28,881,486,395
050,36,011,"New York","Cayuga County",4,29,928,490,438
050,36,011,"New York","Cayuga County",4,30,915,490,425
050,36,011,"New York","Cayuga County",4,31,947,504,443
050,36,011,"New York","Cayuga County",4,32,933,492,441
050,36,011,"New York","Cayuga County",4,33,881,472,409
050,36,011,"New York","Cayuga County",4,34,892,468,424
050,36,011,"New York","Cayuga County",4,35,933,508,425
050,36,011,"New York","Cayuga County",4,36,952,514,438
050,36,011,"New York","Cayuga County",4,37,925,505,420
050,36,011,"New York","Cayuga County",4,38,914,479,435
050,36,011,"New York","Cayuga County",4,39,953,459,494
050,36,011,"New York","Cayuga County",4,40,966,504,462
050,36,011,"New York","Cayuga County",4,41,920,497,423
050,36,011,"New York","Cayuga County",4,42,926,509,417
050,36,011,"New York","Cayuga County",4,43,851,443,408
050,36,011,"New York","Cayuga County",4,44,838,429,409
050,36,011,"New York","Cayuga County",4,45,832,460,372
050,36,011,"New York","Cayuga County",4,46,794,408,386
050,36,011,"New York","Cayuga County",4,47,768,392,376
050,36,011,"New York","Cayuga County",4,48,776,414,362
050,36,011,"New York","Cayuga County",4,49,804,438,366
050,36,011,"New York","Cayuga County",4,50,919,483,436
050,36,011,"New York","Cayuga County",4,51,996,518,478
050,36,011,"New York","Cayuga County",4,52,979,496,483
050,36,011,"New York","Cayuga County",4,53,994,487,507
050,36,011,"New York","Cayuga County",4,54,1022,519,503
050,36,011,"New York","Cayuga County",4,55,1033,542,491
050,36,011,"New York","Cayuga County",4,56,1076,574,502
050,36,011,"New York","Cayuga County",4,57,1084,559,525
050,36,011,"New York","Cayuga County",4,58,1195,600,595
050,36,011,"New York","Cayuga County",4,59,1159,595,564
050,36,011,"New York","Cayuga County",4,60,1192,589,603
050,36,011,"New York","Cayuga County",4,61,1196,594,602
050,36,011,"New York","Cayuga County",4,62,1175,584,591
050,36,011,"New York","Cayuga County",4,63,1202,585,617
050,36,011,"New York","Cayuga County",4,64,1160,557,603
050,36,011,"New York","Cayuga County",4,65,1123,545,578
050,36,011,"New York","Cayuga County",4,66,1117,545,572
050,36,011,"New York","Cayuga County",4,67,1111,569,542
050,36,011,"New York","Cayuga County",4,68,1006,512,494
050,36,011,"New York","Cayuga County",4,69,956,492,464
050,36,011,"New York","Cayuga County",4,70,930,460,470
050,36,011,"New York","Cayuga County",4,71,872,441,431
050,36,011,"New York","Cayuga County",4,72,797,408,389
050,36,011,"New York","Cayuga County",4,73,811,403,408
050,36,011,"New York","Cayuga County",4,74,792,392,400
050,36,011,"New York","Cayuga County",4,75,829,410,419
050,36,011,"New York","Cayuga County",4,76,574,268,306
050,36,011,"New York","Cayuga County",4,77,540,249,291
050,36,011,"New York","Cayuga County",4,78,482,218,264
050,36,011,"New York","Cayuga County",4,79,516,237,279
050,36,011,"New York","Cayuga County",4,80,440,208,232
050,36,011,"New York","Cayuga County",4,81,377,168,209
050,36,011,"New York","Cayuga County",4,82,347,146,201
050,36,011,"New York","Cayuga County",4,83,335,145,190
050,36,011,"New York","Cayuga County",4,84,287,127,160
050,36,011,"New York","Cayuga County",4,85,1745,643,1102
050,36,011,"New York","Cayuga County",5,0,660,347,313
050,36,011,"New York","Cayuga County",5,1,659,343,316
050,36,011,"New York","Cayuga County",5,2,696,354,342
050,36,011,"New York","Cayuga County",5,3,725,354,371
050,36,011,"New York","Cayuga County",5,4,738,390,348
050,36,011,"New York","Cayuga County",5,5,761,400,361
050,36,011,"New York","Cayuga County",5,6,779,395,384
050,36,011,"New York","Cayuga County",5,7,775,399,376
050,36,011,"New York","Cayuga County",5,8,768,400,368
050,36,011,"New York","Cayuga County",5,9,782,388,394
050,36,011,"New York","Cayuga County",5,10,765,402,363
050,36,011,"New York","Cayuga County",5,11,788,412,376
050,36,011,"New York","Cayuga County",5,12,842,428,414
050,36,011,"New York","Cayuga County",5,13,854,430,424
050,36,011,"New York","Cayuga County",5,14,884,459,425
050,36,011,"New York","Cayuga County",5,15,956,482,474
050,36,011,"New York","Cayuga County",5,16,939,504,435
050,36,011,"New York","Cayuga County",5,17,887,451,436
050,36,011,"New York","Cayuga County",5,18,808,414,394
050,36,011,"New York","Cayuga County",5,19,708,373,335
050,36,011,"New York","Cayuga County",5,20,748,381,367
050,36,011,"New York","Cayuga County",5,21,835,420,415
050,36,011,"New York","Cayuga County",5,22,864,449,415
050,36,011,"New York","Cayuga County",5,23,870,471,399
050,36,011,"New York","Cayuga County",5,24,842,455,387
050,36,011,"New York","Cayuga County",5,25,864,480,384
050,36,011,"New York","Cayuga County",5,26,877,484,393
050,36,011,"New York","Cayuga County",5,27,851,490,361
050,36,011,"New York","Cayuga County",5,28,915,502,413
050,36,011,"New York","Cayuga County",5,29,863,468,395
050,36,011,"New York","Cayuga County",5,30,915,481,434
050,36,011,"New York","Cayuga County",5,31,953,516,437
050,36,011,"New York","Cayuga County",5,32,939,507,432
050,36,011,"New York","Cayuga County",5,33,913,490,423
050,36,011,"New York","Cayuga County",5,34,888,469,419
050,36,011,"New York","Cayuga County",5,35,917,502,415
050,36,011,"New York","Cayuga County",5,36,936,505,431
050,36,011,"New York","Cayuga County",5,37,963,514,449
050,36,011,"New York","Cayuga County",5,38,933,507,426
050,36,011,"New York","Cayuga County",5,39,919,476,443
050,36,011,"New York","Cayuga County",5,40,973,473,500
050,36,011,"New York","Cayuga County",5,41,940,497,443
050,36,011,"New York","Cayuga County",5,42,928,515,413
050,36,011,"New York","Cayuga County",5,43,944,514,430
050,36,011,"New York","Cayuga County",5,44,857,434,423
050,36,011,"New York","Cayuga County",5,45,853,448,405
050,36,011,"New York","Cayuga County",5,46,828,455,373
050,36,011,"New York","Cayuga County",5,47,768,396,372
050,36,011,"New York","Cayuga County",5,48,764,396,368
050,36,011,"New York","Cayuga County",5,49,791,427,364
050,36,011,"New York","Cayuga County",5,50,808,439,369
050,36,011,"New York","Cayuga County",5,51,897,480,417
050,36,011,"New York","Cayuga County",5,52,990,509,481
050,36,011,"New York","Cayuga County",5,53,963,494,469
050,36,011,"New York","Cayuga County",5,54,979,475,504
050,36,011,"New York","Cayuga County",5,55,1023,520,503
050,36,011,"New York","Cayuga County",5,56,1017,532,485
050,36,011,"New York","Cayuga County",5,57,1047,560,487
050,36,011,"New York","Cayuga County",5,58,1088,563,525
050,36,011,"New York","Cayuga County",5,59,1175,585,590
050,36,011,"New York","Cayuga County",5,60,1152,589,563
050,36,011,"New York","Cayuga County",5,61,1184,580,604
050,36,011,"New York","Cayuga County",5,62,1196,600,596
050,36,011,"New York","Cayuga County",5,63,1152,566,586
050,36,011,"New York","Cayuga County",5,64,1185,571,614
050,36,011,"New York","Cayuga County",5,65,1138,546,592
050,36,011,"New York","Cayuga County",5,66,1112,538,574
050,36,011,"New York","Cayuga County",5,67,1102,533,569
050,36,011,"New York","Cayuga County",5,68,1086,558,528
050,36,011,"New York","Cayuga County",5,69,982,500,482
050,36,011,"New York","Cayuga County",5,70,940,479,461
050,36,011,"New York","Cayuga County",5,71,909,447,462
050,36,011,"New York","Cayuga County",5,72,864,434,430
050,36,011,"New York","Cayuga County",5,73,764,391,373
050,36,011,"New York","Cayuga County",5,74,783,388,395
050,36,011,"New York","Cayuga County",5,75,747,367,380
050,36,011,"New York","Cayuga County",5,76,801,388,413
050,36,011,"New York","Cayuga County",5,77,556,256,300
050,36,011,"New York","Cayuga County",5,78,521,236,285
050,36,011,"New York","Cayuga County",5,79,451,199,252
050,36,011,"New York","Cayuga County",5,80,498,221,277
050,36,011,"New York","Cayuga County",5,81,424,201,223
050,36,011,"New York","Cayuga County",5,82,372,160,212
050,36,011,"New York","Cayuga County",5,83,305,130,175
050,36,011,"New York","Cayuga County",5,84,305,127,178
050,36,011,"New York","Cayuga County",5,85,1744,648,1096
050,36,013,"New York","Chautauqua County",1,0,1289,660,629
050,36,013,"New York","Chautauqua County",1,1,1318,679,639
050,36,013,"New York","Chautauqua County",1,2,1367,683,684
050,36,013,"New York","Chautauqua County",1,3,1423,721,702
050,36,013,"New York","Chautauqua County",1,4,1533,748,785
050,36,013,"New York","Chautauqua County",1,5,1463,715,748
050,36,013,"New York","Chautauqua County",1,6,1435,719,716
050,36,013,"New York","Chautauqua County",1,7,1434,759,675
050,36,013,"New York","Chautauqua County",1,8,1424,722,702
050,36,013,"New York","Chautauqua County",1,9,1447,711,736
050,36,013,"New York","Chautauqua County",1,10,1485,740,745
050,36,013,"New York","Chautauqua County",1,11,1501,766,735
050,36,013,"New York","Chautauqua County",1,12,1553,806,747
050,36,013,"New York","Chautauqua County",1,13,1615,851,764
050,36,013,"New York","Chautauqua County",1,14,1534,819,715
050,36,013,"New York","Chautauqua County",1,15,1531,787,744
050,36,013,"New York","Chautauqua County",1,16,1579,808,771
050,36,013,"New York","Chautauqua County",1,17,1592,839,753
050,36,013,"New York","Chautauqua County",1,18,1978,976,1002
050,36,013,"New York","Chautauqua County",1,19,1975,955,1020
050,36,013,"New York","Chautauqua County",1,20,1768,924,844
050,36,013,"New York","Chautauqua County",1,21,1573,806,767
050,36,013,"New York","Chautauqua County",1,22,1524,800,724
050,36,013,"New York","Chautauqua County",1,23,1501,790,711
050,36,013,"New York","Chautauqua County",1,24,1475,786,689
050,36,013,"New York","Chautauqua County",1,25,1415,745,670
050,36,013,"New York","Chautauqua County",1,26,1425,780,645
050,36,013,"New York","Chautauqua County",1,27,1447,759,688
050,36,013,"New York","Chautauqua County",1,28,1458,777,681
050,36,013,"New York","Chautauqua County",1,29,1481,775,706
050,36,013,"New York","Chautauqua County",1,30,1517,748,769
050,36,013,"New York","Chautauqua County",1,31,1530,779,751
050,36,013,"New York","Chautauqua County",1,32,1538,778,760
050,36,013,"New York","Chautauqua County",1,33,1473,744,729
050,36,013,"New York","Chautauqua County",1,34,1465,771,694
050,36,013,"New York","Chautauqua County",1,35,1435,723,712
050,36,013,"New York","Chautauqua County",1,36,1400,703,697
050,36,013,"New York","Chautauqua County",1,37,1458,730,728
050,36,013,"New York","Chautauqua County",1,38,1446,737,709
050,36,013,"New York","Chautauqua County",1,39,1434,731,703
050,36,013,"New York","Chautauqua County",1,40,1424,723,701
050,36,013,"New York","Chautauqua County",1,41,1348,675,673
050,36,013,"New York","Chautauqua County",1,42,1350,649,701
050,36,013,"New York","Chautauqua County",1,43,1321,634,687
050,36,013,"New York","Chautauqua County",1,44,1342,650,692
050,36,013,"New York","Chautauqua County",1,45,1389,707,682
050,36,013,"New York","Chautauqua County",1,46,1358,687,671
050,36,013,"New York","Chautauqua County",1,47,1361,660,701
050,36,013,"New York","Chautauqua County",1,48,1502,754,748
050,36,013,"New York","Chautauqua County",1,49,1685,853,832
050,36,013,"New York","Chautauqua County",1,50,1592,814,778
050,36,013,"New York","Chautauqua County",1,51,1576,803,773
050,36,013,"New York","Chautauqua County",1,52,1584,795,789
050,36,013,"New York","Chautauqua County",1,53,1631,828,803
050,36,013,"New York","Chautauqua County",1,54,1687,853,834
050,36,013,"New York","Chautauqua County",1,55,1749,870,879
050,36,013,"New York","Chautauqua County",1,56,1862,922,940
050,36,013,"New York","Chautauqua County",1,57,1914,954,960
050,36,013,"New York","Chautauqua County",1,58,1958,988,970
050,36,013,"New York","Chautauqua County",1,59,1990,984,1006
050,36,013,"New York","Chautauqua County",1,60,1955,974,981
050,36,013,"New York","Chautauqua County",1,61,2008,1005,1003
050,36,013,"New York","Chautauqua County",1,62,2037,1031,1006
050,36,013,"New York","Chautauqua County",1,63,1991,974,1017
050,36,013,"New York","Chautauqua County",1,64,1888,927,961
050,36,013,"New York","Chautauqua County",1,65,1876,934,942
050,36,013,"New York","Chautauqua County",1,66,1864,948,916
050,36,013,"New York","Chautauqua County",1,67,1741,897,844
050,36,013,"New York","Chautauqua County",1,68,1677,853,824
050,36,013,"New York","Chautauqua County",1,69,1516,763,753
050,36,013,"New York","Chautauqua County",1,70,1433,700,733
050,36,013,"New York","Chautauqua County",1,71,1351,657,694
050,36,013,"New York","Chautauqua County",1,72,1378,654,724
050,36,013,"New York","Chautauqua County",1,73,1396,657,739
050,36,013,"New York","Chautauqua County",1,74,961,458,503
050,36,013,"New York","Chautauqua County",1,75,988,466,522
050,36,013,"New York","Chautauqua County",1,76,956,436,520
050,36,013,"New York","Chautauqua County",1,77,1022,447,575
050,36,013,"New York","Chautauqua County",1,78,869,407,462
050,36,013,"New York","Chautauqua County",1,79,751,349,402
050,36,013,"New York","Chautauqua County",1,80,669,311,358
050,36,013,"New York","Chautauqua County",1,81,622,280,342
050,36,013,"New York","Chautauqua County",1,82,571,245,326
050,36,013,"New York","Chautauqua County",1,83,514,204,310
050,36,013,"New York","Chautauqua County",1,84,499,190,309
050,36,013,"New York","Chautauqua County",1,85,3262,1137,2125
050,36,013,"New York","Chautauqua County",2,0,1301,660,641
050,36,013,"New York","Chautauqua County",2,1,1305,670,635
050,36,013,"New York","Chautauqua County",2,2,1353,681,672
050,36,013,"New York","Chautauqua County",2,3,1407,710,697
050,36,013,"New York","Chautauqua County",2,4,1508,743,765
050,36,013,"New York","Chautauqua County",2,5,1479,723,756
050,36,013,"New York","Chautauqua County",2,6,1446,723,723
050,36,013,"New York","Chautauqua County",2,7,1439,753,686
050,36,013,"New York","Chautauqua County",2,8,1419,724,695
050,36,013,"New York","Chautauqua County",2,9,1439,711,728
050,36,013,"New York","Chautauqua County",2,10,1481,737,744
050,36,013,"New York","Chautauqua County",2,11,1494,759,735
050,36,013,"New York","Chautauqua County",2,12,1546,800,746
050,36,013,"New York","Chautauqua County",2,13,1604,844,760
050,36,013,"New York","Chautauqua County",2,14,1551,823,728
050,36,013,"New York","Chautauqua County",2,15,1535,795,740
050,36,013,"New York","Chautauqua County",2,16,1572,805,767
050,36,013,"New York","Chautauqua County",2,17,1594,831,763
050,36,013,"New York","Chautauqua County",2,18,1951,965,986
050,36,013,"New York","Chautauqua County",2,19,1966,945,1021
050,36,013,"New York","Chautauqua County",2,20,1775,918,857
050,36,013,"New York","Chautauqua County",2,21,1559,801,758
050,36,013,"New York","Chautauqua County",2,22,1508,785,723
050,36,013,"New York","Chautauqua County",2,23,1484,776,708
050,36,013,"New York","Chautauqua County",2,24,1456,773,683
050,36,013,"New York","Chautauqua County",2,25,1418,749,669
050,36,013,"New York","Chautauqua County",2,26,1415,765,650
050,36,013,"New York","Chautauqua County",2,27,1427,755,672
050,36,013,"New York","Chautauqua County",2,28,1439,761,678
050,36,013,"New York","Chautauqua County",2,29,1462,765,697
050,36,013,"New York","Chautauqua County",2,30,1507,747,760
050,36,013,"New York","Chautauqua County",2,31,1513,764,749
050,36,013,"New York","Chautauqua County",2,32,1530,772,758
050,36,013,"New York","Chautauqua County",2,33,1479,747,732
050,36,013,"New York","Chautauqua County",2,34,1466,763,703
050,36,013,"New York","Chautauqua County",2,35,1446,736,710
050,36,013,"New York","Chautauqua County",2,36,1401,704,697
050,36,013,"New York","Chautauqua County",2,37,1448,724,724
050,36,013,"New York","Chautauqua County",2,38,1448,736,712
050,36,013,"New York","Chautauqua County",2,39,1442,735,707
050,36,013,"New York","Chautauqua County",2,40,1427,729,698
050,36,013,"New York","Chautauqua County",2,41,1361,682,679
050,36,013,"New York","Chautauqua County",2,42,1339,649,690
050,36,013,"New York","Chautauqua County",2,43,1335,642,693
050,36,013,"New York","Chautauqua County",2,44,1321,638,683
050,36,013,"New York","Chautauqua County",2,45,1386,699,687
050,36,013,"New York","Chautauqua County",2,46,1350,681,669
050,36,013,"New York","Chautauqua County",2,47,1353,661,692
050,36,013,"New York","Chautauqua County",2,48,1470,734,736
050,36,013,"New York","Chautauqua County",2,49,1645,829,816
050,36,013,"New York","Chautauqua County",2,50,1618,826,792
050,36,013,"New York","Chautauqua County",2,51,1572,799,773
050,36,013,"New York","Chautauqua County",2,52,1568,790,778
050,36,013,"New York","Chautauqua County",2,53,1627,827,800
050,36,013,"New York","Chautauqua County",2,54,1661,838,823
050,36,013,"New York","Chautauqua County",2,55,1728,863,865
050,36,013,"New York","Chautauqua County",2,56,1841,917,924
050,36,013,"New York","Chautauqua County",2,57,1896,944,952
050,36,013,"New York","Chautauqua County",2,58,1944,979,965
050,36,013,"New York","Chautauqua County",2,59,1992,992,1000
050,36,013,"New York","Chautauqua County",2,60,1956,972,984
050,36,013,"New York","Chautauqua County",2,61,1985,992,993
050,36,013,"New York","Chautauqua County",2,62,2020,1016,1004
050,36,013,"New York","Chautauqua County",2,63,2015,994,1021
050,36,013,"New York","Chautauqua County",2,64,1898,930,968
050,36,013,"New York","Chautauqua County",2,65,1873,932,941
050,36,013,"New York","Chautauqua County",2,66,1861,942,919
050,36,013,"New York","Chautauqua County",2,67,1754,899,855
050,36,013,"New York","Chautauqua County",2,68,1678,855,823
050,36,013,"New York","Chautauqua County",2,69,1558,783,775
050,36,013,"New York","Chautauqua County",2,70,1438,707,731
050,36,013,"New York","Chautauqua County",2,71,1364,660,704
050,36,013,"New York","Chautauqua County",2,72,1341,642,699
050,36,013,"New York","Chautauqua County",2,73,1451,683,768
050,36,013,"New York","Chautauqua County",2,74,993,470,523
050,36,013,"New York","Chautauqua County",2,75,981,466,515
050,36,013,"New York","Chautauqua County",2,76,952,438,514
050,36,013,"New York","Chautauqua County",2,77,1021,447,574
050,36,013,"New York","Chautauqua County",2,78,873,400,473
050,36,013,"New York","Chautauqua County",2,79,770,363,407
050,36,013,"New York","Chautauqua County",2,80,669,315,354
050,36,013,"New York","Chautauqua County",2,81,618,279,339
050,36,013,"New York","Chautauqua County",2,82,574,248,326
050,36,013,"New York","Chautauqua County",2,83,518,208,310
050,36,013,"New York","Chautauqua County",2,84,498,192,306
050,36,013,"New York","Chautauqua County",2,85,3270,1141,2129
050,36,013,"New York","Chautauqua County",3,0,1230,615,615
050,36,013,"New York","Chautauqua County",3,1,1300,670,630
050,36,013,"New York","Chautauqua County",3,2,1303,678,625
050,36,013,"New York","Chautauqua County",3,3,1378,689,689
050,36,013,"New York","Chautauqua County",3,4,1409,716,693
050,36,013,"New York","Chautauqua County",3,5,1495,738,757
050,36,013,"New York","Chautauqua County",3,6,1504,751,753
050,36,013,"New York","Chautauqua County",3,7,1455,730,725
050,36,013,"New York","Chautauqua County",3,8,1421,740,681
050,36,013,"New York","Chautauqua County",3,9,1416,721,695
050,36,013,"New York","Chautauqua County",3,10,1430,711,719
050,36,013,"New York","Chautauqua County",3,11,1465,730,735
050,36,013,"New York","Chautauqua County",3,12,1497,753,744
050,36,013,"New York","Chautauqua County",3,13,1561,808,753
050,36,013,"New York","Chautauqua County",3,14,1581,832,749
050,36,013,"New York","Chautauqua County",3,15,1528,808,720
050,36,013,"New York","Chautauqua County",3,16,1541,805,736
050,36,013,"New York","Chautauqua County",3,17,1607,824,783
050,36,013,"New York","Chautauqua County",3,18,1932,960,972
050,36,013,"New York","Chautauqua County",3,19,1924,924,1000
050,36,013,"New York","Chautauqua County",3,20,1731,872,859
050,36,013,"New York","Chautauqua County",3,21,1541,798,743
050,36,013,"New York","Chautauqua County",3,22,1464,744,720
050,36,013,"New York","Chautauqua County",3,23,1430,725,705
050,36,013,"New York","Chautauqua County",3,24,1410,731,679
050,36,013,"New York","Chautauqua County",3,25,1403,735,668
050,36,013,"New York","Chautauqua County",3,26,1370,720,650
050,36,013,"New York","Chautauqua County",3,27,1388,727,661
050,36,013,"New York","Chautauqua County",3,28,1374,720,654
050,36,013,"New York","Chautauqua County",3,29,1433,768,665
050,36,013,"New York","Chautauqua County",3,30,1414,718,696
050,36,013,"New York","Chautauqua County",3,31,1505,741,764
050,36,013,"New York","Chautauqua County",3,32,1494,724,770
050,36,013,"New York","Chautauqua County",3,33,1514,768,746
050,36,013,"New York","Chautauqua County",3,34,1496,760,736
050,36,013,"New York","Chautauqua County",3,35,1457,759,698
050,36,013,"New York","Chautauqua County",3,36,1442,731,711
050,36,013,"New York","Chautauqua County",3,37,1405,706,699
050,36,013,"New York","Chautauqua County",3,38,1420,712,708
050,36,013,"New York","Chautauqua County",3,39,1468,740,728
050,36,013,"New York","Chautauqua County",3,40,1441,741,700
050,36,013,"New York","Chautauqua County",3,41,1416,719,697
050,36,013,"New York","Chautauqua County",3,42,1359,672,687
050,36,013,"New York","Chautauqua County",3,43,1344,652,692
050,36,013,"New York","Chautauqua County",3,44,1323,637,686
050,36,013,"New York","Chautauqua County",3,45,1312,639,673
050,36,013,"New York","Chautauqua County",3,46,1342,665,677
050,36,013,"New York","Chautauqua County",3,47,1340,667,673
050,36,013,"New York","Chautauqua County",3,48,1363,676,687
050,36,013,"New York","Chautauqua County",3,49,1455,716,739
050,36,013,"New York","Chautauqua County",3,50,1643,839,804
050,36,013,"New York","Chautauqua County",3,51,1620,816,804
050,36,013,"New York","Chautauqua County",3,52,1558,793,765
050,36,013,"New York","Chautauqua County",3,53,1568,811,757
050,36,013,"New York","Chautauqua County",3,54,1601,804,797
050,36,013,"New York","Chautauqua County",3,55,1656,822,834
050,36,013,"New York","Chautauqua County",3,56,1728,862,866
050,36,013,"New York","Chautauqua County",3,57,1848,918,930
050,36,013,"New York","Chautauqua County",3,58,1873,936,937
050,36,013,"New York","Chautauqua County",3,59,1930,974,956
050,36,013,"New York","Chautauqua County",3,60,1997,991,1006
050,36,013,"New York","Chautauqua County",3,61,1955,981,974
050,36,013,"New York","Chautauqua County",3,62,1936,960,976
050,36,013,"New York","Chautauqua County",3,63,1995,1004,991
050,36,013,"New York","Chautauqua County",3,64,1992,980,1012
050,36,013,"New York","Chautauqua County",3,65,1866,903,963
050,36,013,"New York","Chautauqua County",3,66,1852,920,932
050,36,013,"New York","Chautauqua County",3,67,1818,914,904
050,36,013,"New York","Chautauqua County",3,68,1759,897,862
050,36,013,"New York","Chautauqua County",3,69,1629,825,804
050,36,013,"New York","Chautauqua County",3,70,1528,764,764
050,36,013,"New York","Chautauqua County",3,71,1397,681,716
050,36,013,"New York","Chautauqua County",3,72,1340,654,686
050,36,013,"New York","Chautauqua County",3,73,1282,605,677
050,36,013,"New York","Chautauqua County",3,74,1383,644,739
050,36,013,"New York","Chautauqua County",3,75,953,450,503
050,36,013,"New York","Chautauqua County",3,76,944,444,500
050,36,013,"New York","Chautauqua County",3,77,910,409,501
050,36,013,"New York","Chautauqua County",3,78,958,416,542
050,36,013,"New York","Chautauqua County",3,79,835,377,458
050,36,013,"New York","Chautauqua County",3,80,700,335,365
050,36,013,"New York","Chautauqua County",3,81,633,290,343
050,36,013,"New York","Chautauqua County",3,82,546,239,307
050,36,013,"New York","Chautauqua County",3,83,536,224,312
050,36,013,"New York","Chautauqua County",3,84,470,188,282
050,36,013,"New York","Chautauqua County",3,85,3113,1079,2034
050,36,013,"New York","Chautauqua County",4,0,1273,652,621
050,36,013,"New York","Chautauqua County",4,1,1213,594,619
050,36,013,"New York","Chautauqua County",4,2,1313,679,634
050,36,013,"New York","Chautauqua County",4,3,1329,699,630
050,36,013,"New York","Chautauqua County",4,4,1364,671,693
050,36,013,"New York","Chautauqua County",4,5,1392,712,680
050,36,013,"New York","Chautauqua County",4,6,1475,727,748
050,36,013,"New York","Chautauqua County",4,7,1511,752,759
050,36,013,"New York","Chautauqua County",4,8,1434,715,719
050,36,013,"New York","Chautauqua County",4,9,1419,746,673
050,36,013,"New York","Chautauqua County",4,10,1406,719,687
050,36,013,"New York","Chautauqua County",4,11,1424,712,712
050,36,013,"New York","Chautauqua County",4,12,1495,744,751
050,36,013,"New York","Chautauqua County",4,13,1513,776,737
050,36,013,"New York","Chautauqua County",4,14,1537,793,744
050,36,013,"New York","Chautauqua County",4,15,1577,830,747
050,36,013,"New York","Chautauqua County",4,16,1552,830,722
050,36,013,"New York","Chautauqua County",4,17,1559,817,742
050,36,013,"New York","Chautauqua County",4,18,1910,958,952
050,36,013,"New York","Chautauqua County",4,19,1866,900,966
050,36,013,"New York","Chautauqua County",4,20,1721,894,827
050,36,013,"New York","Chautauqua County",4,21,1542,795,747
050,36,013,"New York","Chautauqua County",4,22,1510,787,723
050,36,013,"New York","Chautauqua County",4,23,1424,720,704
050,36,013,"New York","Chautauqua County",4,24,1382,722,660
050,36,013,"New York","Chautauqua County",4,25,1369,717,652
050,36,013,"New York","Chautauqua County",4,26,1401,729,672
050,36,013,"New York","Chautauqua County",4,27,1342,696,646
050,36,013,"New York","Chautauqua County",4,28,1341,710,631
050,36,013,"New York","Chautauqua County",4,29,1370,729,641
050,36,013,"New York","Chautauqua County",4,30,1422,750,672
050,36,013,"New York","Chautauqua County",4,31,1412,728,684
050,36,013,"New York","Chautauqua County",4,32,1522,745,777
050,36,013,"New York","Chautauqua County",4,33,1485,726,759
050,36,013,"New York","Chautauqua County",4,34,1535,778,757
050,36,013,"New York","Chautauqua County",4,35,1512,759,753
050,36,013,"New York","Chautauqua County",4,36,1497,785,712
050,36,013,"New York","Chautauqua County",4,37,1470,751,719
050,36,013,"New York","Chautauqua County",4,38,1401,704,697
050,36,013,"New York","Chautauqua County",4,39,1447,725,722
050,36,013,"New York","Chautauqua County",4,40,1488,762,726
050,36,013,"New York","Chautauqua County",4,41,1449,747,702
050,36,013,"New York","Chautauqua County",4,42,1433,722,711
050,36,013,"New York","Chautauqua County",4,43,1357,670,687
050,36,013,"New York","Chautauqua County",4,44,1333,636,697
050,36,013,"New York","Chautauqua County",4,45,1328,646,682
050,36,013,"New York","Chautauqua County",4,46,1298,627,671
050,36,013,"New York","Chautauqua County",4,47,1348,662,686
050,36,013,"New York","Chautauqua County",4,48,1335,679,656
050,36,013,"New York","Chautauqua County",4,49,1348,655,693
050,36,013,"New York","Chautauqua County",4,50,1460,723,737
050,36,013,"New York","Chautauqua County",4,51,1645,820,825
050,36,013,"New York","Chautauqua County",4,52,1592,807,785
050,36,013,"New York","Chautauqua County",4,53,1576,811,765
050,36,013,"New York","Chautauqua County",4,54,1541,791,750
050,36,013,"New York","Chautauqua County",4,55,1570,780,790
050,36,013,"New York","Chautauqua County",4,56,1630,811,819
050,36,013,"New York","Chautauqua County",4,57,1727,862,865
050,36,013,"New York","Chautauqua County",4,58,1823,906,917
050,36,013,"New York","Chautauqua County",4,59,1833,915,918
050,36,013,"New York","Chautauqua County",4,60,1923,975,948
050,36,013,"New York","Chautauqua County",4,61,1983,979,1004
050,36,013,"New York","Chautauqua County",4,62,1898,942,956
050,36,013,"New York","Chautauqua County",4,63,1910,949,961
050,36,013,"New York","Chautauqua County",4,64,1970,987,983
050,36,013,"New York","Chautauqua County",4,65,1962,957,1005
050,36,013,"New York","Chautauqua County",4,66,1824,870,954
050,36,013,"New York","Chautauqua County",4,67,1812,903,909
050,36,013,"New York","Chautauqua County",4,68,1787,893,894
050,36,013,"New York","Chautauqua County",4,69,1704,865,839
050,36,013,"New York","Chautauqua County",4,70,1587,798,789
050,36,013,"New York","Chautauqua County",4,71,1488,734,754
050,36,013,"New York","Chautauqua County",4,72,1349,658,691
050,36,013,"New York","Chautauqua County",4,73,1300,624,676
050,36,013,"New York","Chautauqua County",4,74,1212,567,645
050,36,013,"New York","Chautauqua County",4,75,1350,627,723
050,36,013,"New York","Chautauqua County",4,76,902,430,472
050,36,013,"New York","Chautauqua County",4,77,906,414,492
050,36,013,"New York","Chautauqua County",4,78,838,378,460
050,36,013,"New York","Chautauqua County",4,79,917,397,520
050,36,013,"New York","Chautauqua County",4,80,767,344,423
050,36,013,"New York","Chautauqua County",4,81,664,306,358
050,36,013,"New York","Chautauqua County",4,82,568,261,307
050,36,013,"New York","Chautauqua County",4,83,505,213,292
050,36,013,"New York","Chautauqua County",4,84,484,198,286
050,36,013,"New York","Chautauqua County",4,85,2953,1020,1933
050,36,013,"New York","Chautauqua County",5,0,1270,651,619
050,36,013,"New York","Chautauqua County",5,1,1311,674,637
050,36,013,"New York","Chautauqua County",5,2,1215,598,617
050,36,013,"New York","Chautauqua County",5,3,1328,671,657
050,36,013,"New York","Chautauqua County",5,4,1314,687,627
050,36,013,"New York","Chautauqua County",5,5,1369,680,689
050,36,013,"New York","Chautauqua County",5,6,1385,695,690
050,36,013,"New York","Chautauqua County",5,7,1499,740,759
050,36,013,"New York","Chautauqua County",5,8,1500,741,759
050,36,013,"New York","Chautauqua County",5,9,1448,722,726
050,36,013,"New York","Chautauqua County",5,10,1431,757,674
050,36,013,"New York","Chautauqua County",5,11,1410,730,680
050,36,013,"New York","Chautauqua County",5,12,1417,711,706
050,36,013,"New York","Chautauqua County",5,13,1509,740,769
050,36,013,"New York","Chautauqua County",5,14,1499,754,745
050,36,013,"New York","Chautauqua County",5,15,1534,793,741
050,36,013,"New York","Chautauqua County",5,16,1586,842,744
050,36,013,"New York","Chautauqua County",5,17,1585,846,739
050,36,013,"New York","Chautauqua County",5,18,1880,939,941
050,36,013,"New York","Chautauqua County",5,19,1877,915,962
050,36,013,"New York","Chautauqua County",5,20,1695,884,811
050,36,013,"New York","Chautauqua County",5,21,1541,801,740
050,36,013,"New York","Chautauqua County",5,22,1508,766,742
050,36,013,"New York","Chautauqua County",5,23,1471,765,706
050,36,013,"New York","Chautauqua County",5,24,1387,713,674
050,36,013,"New York","Chautauqua County",5,25,1380,709,671
050,36,013,"New York","Chautauqua County",5,26,1331,679,652
050,36,013,"New York","Chautauqua County",5,27,1365,708,657
050,36,013,"New York","Chautauqua County",5,28,1315,669,646
050,36,013,"New York","Chautauqua County",5,29,1334,720,614
050,36,013,"New York","Chautauqua County",5,30,1370,707,663
050,36,013,"New York","Chautauqua County",5,31,1433,755,678
050,36,013,"New York","Chautauqua County",5,32,1422,720,702
050,36,013,"New York","Chautauqua County",5,33,1502,747,755
050,36,013,"New York","Chautauqua County",5,34,1491,727,764
050,36,013,"New York","Chautauqua County",5,35,1547,786,761
050,36,013,"New York","Chautauqua County",5,36,1534,776,758
050,36,013,"New York","Chautauqua County",5,37,1509,795,714
050,36,013,"New York","Chautauqua County",5,38,1464,747,717
050,36,013,"New York","Chautauqua County",5,39,1423,713,710
050,36,013,"New York","Chautauqua County",5,40,1470,737,733
050,36,013,"New York","Chautauqua County",5,41,1481,739,742
050,36,013,"New York","Chautauqua County",5,42,1456,746,710
050,36,013,"New York","Chautauqua County",5,43,1441,737,704
050,36,013,"New York","Chautauqua County",5,44,1350,662,688
050,36,013,"New York","Chautauqua County",5,45,1360,658,702
050,36,013,"New York","Chautauqua County",5,46,1300,626,674
050,36,013,"New York","Chautauqua County",5,47,1301,627,674
050,36,013,"New York","Chautauqua County",5,48,1380,680,700
050,36,013,"New York","Chautauqua County",5,49,1319,663,656
050,36,013,"New York","Chautauqua County",5,50,1354,662,692
050,36,013,"New York","Chautauqua County",5,51,1447,707,740
050,36,013,"New York","Chautauqua County",5,52,1612,809,803
050,36,013,"New York","Chautauqua County",5,53,1606,828,778
050,36,013,"New York","Chautauqua County",5,54,1540,783,757
050,36,013,"New York","Chautauqua County",5,55,1534,778,756
050,36,013,"New York","Chautauqua County",5,56,1570,784,786
050,36,013,"New York","Chautauqua County",5,57,1644,813,831
050,36,013,"New York","Chautauqua County",5,58,1694,840,854
050,36,013,"New York","Chautauqua County",5,59,1794,894,900
050,36,013,"New York","Chautauqua County",5,60,1824,904,920
050,36,013,"New York","Chautauqua County",5,61,1912,966,946
050,36,013,"New York","Chautauqua County",5,62,1940,951,989
050,36,013,"New York","Chautauqua County",5,63,1869,919,950
050,36,013,"New York","Chautauqua County",5,64,1888,934,954
050,36,013,"New York","Chautauqua County",5,65,1961,985,976
050,36,013,"New York","Chautauqua County",5,66,1933,938,995
050,36,013,"New York","Chautauqua County",5,67,1784,855,929
050,36,013,"New York","Chautauqua County",5,68,1776,876,900
050,36,013,"New York","Chautauqua County",5,69,1746,865,881
050,36,013,"New York","Chautauqua County",5,70,1667,837,830
050,36,013,"New York","Chautauqua County",5,71,1548,765,783
050,36,013,"New York","Chautauqua County",5,72,1447,710,737
050,36,013,"New York","Chautauqua County",5,73,1308,630,678
050,36,013,"New York","Chautauqua County",5,74,1234,596,638
050,36,013,"New York","Chautauqua County",5,75,1177,542,635
050,36,013,"New York","Chautauqua County",5,76,1283,595,688
050,36,013,"New York","Chautauqua County",5,77,865,405,460
050,36,013,"New York","Chautauqua County",5,78,842,386,456
050,36,013,"New York","Chautauqua County",5,79,809,363,446
050,36,013,"New York","Chautauqua County",5,80,846,364,482
050,36,013,"New York","Chautauqua County",5,81,723,311,412
050,36,013,"New York","Chautauqua County",5,82,605,281,324
050,36,013,"New York","Chautauqua County",5,83,533,236,297
050,36,013,"New York","Chautauqua County",5,84,458,189,269
050,36,013,"New York","Chautauqua County",5,85,2871,999,1872
050,36,015,"New York","Chemung County",1,0,844,436,408
050,36,015,"New York","Chemung County",1,1,863,439,424
050,36,015,"New York","Chemung County",1,2,917,450,467
050,36,015,"New York","Chemung County",1,3,947,488,459
050,36,015,"New York","Chemung County",1,4,952,475,477
050,36,015,"New York","Chemung County",1,5,982,491,491
050,36,015,"New York","Chemung County",1,6,956,479,477
050,36,015,"New York","Chemung County",1,7,1007,503,504
050,36,015,"New York","Chemung County",1,8,1035,513,522
050,36,015,"New York","Chemung County",1,9,1000,523,477
050,36,015,"New York","Chemung County",1,10,1020,531,489
050,36,015,"New York","Chemung County",1,11,1054,541,513
050,36,015,"New York","Chemung County",1,12,1059,550,509
050,36,015,"New York","Chemung County",1,13,1111,555,556
050,36,015,"New York","Chemung County",1,14,1034,516,518
050,36,015,"New York","Chemung County",1,15,1025,525,500
050,36,015,"New York","Chemung County",1,16,1040,534,506
050,36,015,"New York","Chemung County",1,17,1065,519,546
050,36,015,"New York","Chemung County",1,18,1051,520,531
050,36,015,"New York","Chemung County",1,19,953,481,472
050,36,015,"New York","Chemung County",1,20,1011,512,499
050,36,015,"New York","Chemung County",1,21,995,488,507
050,36,015,"New York","Chemung County",1,22,952,504,448
050,36,015,"New York","Chemung County",1,23,904,493,411
050,36,015,"New York","Chemung County",1,24,984,530,454
050,36,015,"New York","Chemung County",1,25,991,514,477
050,36,015,"New York","Chemung County",1,26,992,517,475
050,36,015,"New York","Chemung County",1,27,1008,535,473
050,36,015,"New York","Chemung County",1,28,1004,524,480
050,36,015,"New York","Chemung County",1,29,1078,573,505
050,36,015,"New York","Chemung County",1,30,1101,585,516
050,36,015,"New York","Chemung County",1,31,1061,576,485
050,36,015,"New York","Chemung County",1,32,1035,542,493
050,36,015,"New York","Chemung County",1,33,1019,538,481
050,36,015,"New York","Chemung County",1,34,1056,570,486
050,36,015,"New York","Chemung County",1,35,1051,544,507
050,36,015,"New York","Chemung County",1,36,1049,523,526
050,36,015,"New York","Chemung County",1,37,1001,495,506
050,36,015,"New York","Chemung County",1,38,1047,532,515
050,36,015,"New York","Chemung County",1,39,1059,546,513
050,36,015,"New York","Chemung County",1,40,1040,529,511
050,36,015,"New York","Chemung County",1,41,974,503,471
050,36,015,"New York","Chemung County",1,42,944,485,459
050,36,015,"New York","Chemung County",1,43,982,524,458
050,36,015,"New York","Chemung County",1,44,947,501,446
050,36,015,"New York","Chemung County",1,45,938,492,446
050,36,015,"New York","Chemung County",1,46,918,484,434
050,36,015,"New York","Chemung County",1,47,926,492,434
050,36,015,"New York","Chemung County",1,48,1036,544,492
050,36,015,"New York","Chemung County",1,49,1113,560,553
050,36,015,"New York","Chemung County",1,50,1041,531,510
050,36,015,"New York","Chemung County",1,51,1095,564,531
050,36,015,"New York","Chemung County",1,52,1051,524,527
050,36,015,"New York","Chemung County",1,53,1073,531,542
050,36,015,"New York","Chemung County",1,54,1117,536,581
050,36,015,"New York","Chemung County",1,55,1180,580,600
050,36,015,"New York","Chemung County",1,56,1264,630,634
050,36,015,"New York","Chemung County",1,57,1255,628,627
050,36,015,"New York","Chemung County",1,58,1266,623,643
050,36,015,"New York","Chemung County",1,59,1227,587,640
050,36,015,"New York","Chemung County",1,60,1236,603,633
050,36,015,"New York","Chemung County",1,61,1263,606,657
050,36,015,"New York","Chemung County",1,62,1259,612,647
050,36,015,"New York","Chemung County",1,63,1252,619,633
050,36,015,"New York","Chemung County",1,64,1158,581,577
050,36,015,"New York","Chemung County",1,65,1135,559,576
050,36,015,"New York","Chemung County",1,66,1144,581,563
050,36,015,"New York","Chemung County",1,67,1060,513,547
050,36,015,"New York","Chemung County",1,68,1019,483,536
050,36,015,"New York","Chemung County",1,69,960,443,517
050,36,015,"New York","Chemung County",1,70,926,438,488
050,36,015,"New York","Chemung County",1,71,911,426,485
050,36,015,"New York","Chemung County",1,72,909,417,492
050,36,015,"New York","Chemung County",1,73,895,435,460
050,36,015,"New York","Chemung County",1,74,634,281,353
050,36,015,"New York","Chemung County",1,75,594,263,331
050,36,015,"New York","Chemung County",1,76,577,258,319
050,36,015,"New York","Chemung County",1,77,608,274,334
050,36,015,"New York","Chemung County",1,78,503,214,289
050,36,015,"New York","Chemung County",1,79,440,191,249
050,36,015,"New York","Chemung County",1,80,415,186,229
050,36,015,"New York","Chemung County",1,81,424,170,254
050,36,015,"New York","Chemung County",1,82,400,152,248
050,36,015,"New York","Chemung County",1,83,335,141,194
050,36,015,"New York","Chemung County",1,84,332,130,202
050,36,015,"New York","Chemung County",1,85,2053,744,1309
050,36,015,"New York","Chemung County",2,0,840,439,401
050,36,015,"New York","Chemung County",2,1,856,437,419
050,36,015,"New York","Chemung County",2,2,901,448,453
050,36,015,"New York","Chemung County",2,3,931,475,456
050,36,015,"New York","Chemung County",2,4,952,478,474
050,36,015,"New York","Chemung County",2,5,978,490,488
050,36,015,"New York","Chemung County",2,6,964,484,480
050,36,015,"New York","Chemung County",2,7,987,492,495
050,36,015,"New York","Chemung County",2,8,1024,509,515
050,36,015,"New York","Chemung County",2,9,1006,519,487
050,36,015,"New York","Chemung County",2,10,1011,526,485
050,36,015,"New York","Chemung County",2,11,1034,535,499
050,36,015,"New York","Chemung County",2,12,1061,550,511
050,36,015,"New York","Chemung County",2,13,1092,550,542
050,36,015,"New York","Chemung County",2,14,1049,524,525
050,36,015,"New York","Chemung County",2,15,1026,520,506
050,36,015,"New York","Chemung County",2,16,1037,530,507
050,36,015,"New York","Chemung County",2,17,1062,524,538
050,36,015,"New York","Chemung County",2,18,1028,507,521
050,36,015,"New York","Chemung County",2,19,949,473,476
050,36,015,"New York","Chemung County",2,20,1014,510,504
050,36,015,"New York","Chemung County",2,21,995,485,510
050,36,015,"New York","Chemung County",2,22,949,498,451
050,36,015,"New York","Chemung County",2,23,903,487,416
050,36,015,"New York","Chemung County",2,24,957,512,445
050,36,015,"New York","Chemung County",2,25,978,507,471
050,36,015,"New York","Chemung County",2,26,987,512,475
050,36,015,"New York","Chemung County",2,27,990,521,469
050,36,015,"New York","Chemung County",2,28,996,517,479
050,36,015,"New York","Chemung County",2,29,1055,554,501
050,36,015,"New York","Chemung County",2,30,1086,573,513
050,36,015,"New York","Chemung County",2,31,1056,565,491
050,36,015,"New York","Chemung County",2,32,1026,538,488
050,36,015,"New York","Chemung County",2,33,1011,529,482
050,36,015,"New York","Chemung County",2,34,1044,558,486
050,36,015,"New York","Chemung County",2,35,1049,544,505
050,36,015,"New York","Chemung County",2,36,1028,511,517
050,36,015,"New York","Chemung County",2,37,1009,497,512
050,36,015,"New York","Chemung County",2,38,1034,517,517
050,36,015,"New York","Chemung County",2,39,1040,529,511
050,36,015,"New York","Chemung County",2,40,1042,527,515
050,36,015,"New York","Chemung County",2,41,982,501,481
050,36,015,"New York","Chemung County",2,42,939,481,458
050,36,015,"New York","Chemung County",2,43,974,512,462
050,36,015,"New York","Chemung County",2,44,938,494,444
050,36,015,"New York","Chemung County",2,45,935,488,447
050,36,015,"New York","Chemung County",2,46,916,480,436
050,36,015,"New York","Chemung County",2,47,911,481,430
050,36,015,"New York","Chemung County",2,48,1004,526,478
050,36,015,"New York","Chemung County",2,49,1087,549,538
050,36,015,"New York","Chemung County",2,50,1049,530,519
050,36,015,"New York","Chemung County",2,51,1070,546,524
050,36,015,"New York","Chemung County",2,52,1049,527,522
050,36,015,"New York","Chemung County",2,53,1061,523,538
050,36,015,"New York","Chemung County",2,54,1101,530,571
050,36,015,"New York","Chemung County",2,55,1161,566,595
050,36,015,"New York","Chemung County",2,56,1235,614,621
050,36,015,"New York","Chemung County",2,57,1252,624,628
050,36,015,"New York","Chemung County",2,58,1255,619,636
050,36,015,"New York","Chemung County",2,59,1244,599,645
050,36,015,"New York","Chemung County",2,60,1229,597,632
050,36,015,"New York","Chemung County",2,61,1242,596,646
050,36,015,"New York","Chemung County",2,62,1254,610,644
050,36,015,"New York","Chemung County",2,63,1259,622,637
050,36,015,"New York","Chemung County",2,64,1165,583,582
050,36,015,"New York","Chemung County",2,65,1133,564,569
050,36,015,"New York","Chemung County",2,66,1144,574,570
050,36,015,"New York","Chemung County",2,67,1071,523,548
050,36,015,"New York","Chemung County",2,68,1014,481,533
050,36,015,"New York","Chemung County",2,69,974,451,523
050,36,015,"New York","Chemung County",2,70,924,434,490
050,36,015,"New York","Chemung County",2,71,907,422,485
050,36,015,"New York","Chemung County",2,72,893,410,483
050,36,015,"New York","Chemung County",2,73,940,448,492
050,36,015,"New York","Chemung County",2,74,656,300,356
050,36,015,"New York","Chemung County",2,75,600,266,334
050,36,015,"New York","Chemung County",2,76,570,250,320
050,36,015,"New York","Chemung County",2,77,606,273,333
050,36,015,"New York","Chemung County",2,78,509,220,289
050,36,015,"New York","Chemung County",2,79,446,191,255
050,36,015,"New York","Chemung County",2,80,416,184,232
050,36,015,"New York","Chemung County",2,81,413,171,242
050,36,015,"New York","Chemung County",2,82,403,155,248
050,36,015,"New York","Chemung County",2,83,337,139,198
050,36,015,"New York","Chemung County",2,84,321,126,195
050,36,015,"New York","Chemung County",2,85,2042,742,1300
050,36,015,"New York","Chemung County",3,0,814,422,392
050,36,015,"New York","Chemung County",3,1,839,427,412
050,36,015,"New York","Chemung County",3,2,848,439,409
050,36,015,"New York","Chemung County",3,3,893,448,445
050,36,015,"New York","Chemung County",3,4,929,486,443
050,36,015,"New York","Chemung County",3,5,969,478,491
050,36,015,"New York","Chemung County",3,6,976,483,493
050,36,015,"New York","Chemung County",3,7,943,485,458
050,36,015,"New York","Chemung County",3,8,1001,497,504
050,36,015,"New York","Chemung County",3,9,1005,492,513
050,36,015,"New York","Chemung County",3,10,986,508,478
050,36,015,"New York","Chemung County",3,11,998,525,473
050,36,015,"New York","Chemung County",3,12,1017,525,492
050,36,015,"New York","Chemung County",3,13,1045,539,506
050,36,015,"New York","Chemung County",3,14,1086,542,544
050,36,015,"New York","Chemung County",3,15,1045,528,517
050,36,015,"New York","Chemung County",3,16,1033,518,515
050,36,015,"New York","Chemung County",3,17,1030,541,489
050,36,015,"New York","Chemung County",3,18,992,485,507
050,36,015,"New York","Chemung County",3,19,924,454,470
050,36,015,"New York","Chemung County",3,20,1029,520,509
050,36,015,"New York","Chemung County",3,21,1050,524,526
050,36,015,"New York","Chemung County",3,22,1008,525,483
050,36,015,"New York","Chemung County",3,23,906,484,422
050,36,015,"New York","Chemung County",3,24,936,507,429
050,36,015,"New York","Chemung County",3,25,935,506,429
050,36,015,"New York","Chemung County",3,26,966,515,451
050,36,015,"New York","Chemung County",3,27,995,535,460
050,36,015,"New York","Chemung County",3,28,997,531,466
050,36,015,"New York","Chemung County",3,29,1020,540,480
050,36,015,"New York","Chemung County",3,30,1066,580,486
050,36,015,"New York","Chemung County",3,31,1085,574,511
050,36,015,"New York","Chemung County",3,32,1055,564,491
050,36,015,"New York","Chemung County",3,33,1015,538,477
050,36,015,"New York","Chemung County",3,34,1044,547,497
050,36,015,"New York","Chemung County",3,35,1054,563,491
050,36,015,"New York","Chemung County",3,36,1049,546,503
050,36,015,"New York","Chemung County",3,37,1012,508,504
050,36,015,"New York","Chemung County",3,38,1033,527,506
050,36,015,"New York","Chemung County",3,39,1043,521,522
050,36,015,"New York","Chemung County",3,40,1048,537,511
050,36,015,"New York","Chemung County",3,41,1058,535,523
050,36,015,"New York","Chemung County",3,42,983,502,481
050,36,015,"New York","Chemung County",3,43,961,495,466
050,36,015,"New York","Chemung County",3,44,972,515,457
050,36,015,"New York","Chemung County",3,45,927,486,441
050,36,015,"New York","Chemung County",3,46,951,509,442
050,36,015,"New York","Chemung County",3,47,914,480,434
050,36,015,"New York","Chemung County",3,48,920,487,433
050,36,015,"New York","Chemung County",3,49,991,513,478
050,36,015,"New York","Chemung County",3,50,1078,546,532
050,36,015,"New York","Chemung County",3,51,1028,521,507
050,36,015,"New York","Chemung County",3,52,1064,554,510
050,36,015,"New York","Chemung County",3,53,1044,529,515
050,36,015,"New York","Chemung County",3,54,1050,510,540
050,36,015,"New York","Chemung County",3,55,1092,535,557
050,36,015,"New York","Chemung County",3,56,1138,557,581
050,36,015,"New York","Chemung County",3,57,1206,594,612
050,36,015,"New York","Chemung County",3,58,1207,602,605
050,36,015,"New York","Chemung County",3,59,1241,614,627
050,36,015,"New York","Chemung County",3,60,1236,596,640
050,36,015,"New York","Chemung County",3,61,1187,576,611
050,36,015,"New York","Chemung County",3,62,1217,588,629
050,36,015,"New York","Chemung County",3,63,1217,594,623
050,36,015,"New York","Chemung County",3,64,1210,595,615
050,36,015,"New York","Chemung County",3,65,1133,565,568
050,36,015,"New York","Chemung County",3,66,1124,554,570
050,36,015,"New York","Chemung County",3,67,1107,552,555
050,36,015,"New York","Chemung County",3,68,1035,504,531
050,36,015,"New York","Chemung County",3,69,992,471,521
050,36,015,"New York","Chemung County",3,70,948,441,507
050,36,015,"New York","Chemung County",3,71,905,420,485
050,36,015,"New York","Chemung County",3,72,886,415,471
050,36,015,"New York","Chemung County",3,73,844,379,465
050,36,015,"New York","Chemung County",3,74,912,429,483
050,36,015,"New York","Chemung County",3,75,632,290,342
050,36,015,"New York","Chemung County",3,76,577,254,323
050,36,015,"New York","Chemung County",3,77,545,242,303
050,36,015,"New York","Chemung County",3,78,547,242,305
050,36,015,"New York","Chemung County",3,79,490,214,276
050,36,015,"New York","Chemung County",3,80,411,171,240
050,36,015,"New York","Chemung County",3,81,382,165,217
050,36,015,"New York","Chemung County",3,82,374,153,221
050,36,015,"New York","Chemung County",3,83,361,145,216
050,36,015,"New York","Chemung County",3,84,298,111,187
050,36,015,"New York","Chemung County",3,85,1925,702,1223
050,36,015,"New York","Chemung County",4,0,806,425,381
050,36,015,"New York","Chemung County",4,1,827,431,396
050,36,015,"New York","Chemung County",4,2,859,439,420
050,36,015,"New York","Chemung County",4,3,850,441,409
050,36,015,"New York","Chemung County",4,4,896,447,449
050,36,015,"New York","Chemung County",4,5,905,469,436
050,36,015,"New York","Chemung County",4,6,986,486,500
050,36,015,"New York","Chemung County",4,7,979,485,494
050,36,015,"New York","Chemung County",4,8,944,484,460
050,36,015,"New York","Chemung County",4,9,999,488,511
050,36,015,"New York","Chemung County",4,10,998,489,509
050,36,015,"New York","Chemung County",4,11,990,516,474
050,36,015,"New York","Chemung County",4,12,1002,524,478
050,36,015,"New York","Chemung County",4,13,1011,521,490
050,36,015,"New York","Chemung County",4,14,1027,529,498
050,36,015,"New York","Chemung County",4,15,1080,535,545
050,36,015,"New York","Chemung County",4,16,1024,522,502
050,36,015,"New York","Chemung County",4,17,1038,526,512
050,36,015,"New York","Chemung County",4,18,947,491,456
050,36,015,"New York","Chemung County",4,19,870,422,448
050,36,015,"New York","Chemung County",4,20,948,456,492
050,36,015,"New York","Chemung County",4,21,1023,506,517
050,36,015,"New York","Chemung County",4,22,1004,519,485
050,36,015,"New York","Chemung County",4,23,945,498,447
050,36,015,"New York","Chemung County",4,24,878,476,402
050,36,015,"New York","Chemung County",4,25,905,489,416
050,36,015,"New York","Chemung County",4,26,924,499,425
050,36,015,"New York","Chemung County",4,27,976,511,465
050,36,015,"New York","Chemung County",4,28,968,510,458
050,36,015,"New York","Chemung County",4,29,1005,527,478
050,36,015,"New York","Chemung County",4,30,1034,562,472
050,36,015,"New York","Chemung County",4,31,1016,534,482
050,36,015,"New York","Chemung County",4,32,1075,563,512
050,36,015,"New York","Chemung County",4,33,1033,546,487
050,36,015,"New York","Chemung County",4,34,998,519,479
050,36,015,"New York","Chemung County",4,35,1006,517,489
050,36,015,"New York","Chemung County",4,36,1021,534,487
050,36,015,"New York","Chemung County",4,37,1032,516,516
050,36,015,"New York","Chemung County",4,38,1004,491,513
050,36,015,"New York","Chemung County",4,39,1001,499,502
050,36,015,"New York","Chemung County",4,40,1029,519,510
050,36,015,"New York","Chemung County",4,41,1020,517,503
050,36,015,"New York","Chemung County",4,42,1002,489,513
050,36,015,"New York","Chemung County",4,43,973,495,478
050,36,015,"New York","Chemung County",4,44,925,464,461
050,36,015,"New York","Chemung County",4,45,940,485,455
050,36,015,"New York","Chemung County",4,46,921,483,438
050,36,015,"New York","Chemung County",4,47,918,479,439
050,36,015,"New York","Chemung County",4,48,903,472,431
050,36,015,"New York","Chemung County",4,49,866,450,416
050,36,015,"New York","Chemung County",4,50,959,488,471
050,36,015,"New York","Chemung County",4,51,1050,518,532
050,36,015,"New York","Chemung County",4,52,1001,498,503
050,36,015,"New York","Chemung County",4,53,1045,543,502
050,36,015,"New York","Chemung County",4,54,1006,494,512
050,36,015,"New York","Chemung County",4,55,1040,504,536
050,36,015,"New York","Chemung County",4,56,1074,528,546
050,36,015,"New York","Chemung County",4,57,1104,519,585
050,36,015,"New York","Chemung County",4,58,1161,571,590
050,36,015,"New York","Chemung County",4,59,1199,598,601
050,36,015,"New York","Chemung County",4,60,1223,602,621
050,36,015,"New York","Chemung County",4,61,1201,585,616
050,36,015,"New York","Chemung County",4,62,1172,570,602
050,36,015,"New York","Chemung County",4,63,1196,573,623
050,36,015,"New York","Chemung County",4,64,1189,570,619
050,36,015,"New York","Chemung County",4,65,1184,581,603
050,36,015,"New York","Chemung County",4,66,1106,549,557
050,36,015,"New York","Chemung County",4,67,1088,535,553
050,36,015,"New York","Chemung County",4,68,1075,531,544
050,36,015,"New York","Chemung County",4,69,1002,491,511
050,36,015,"New York","Chemung County",4,70,966,455,511
050,36,015,"New York","Chemung County",4,71,920,433,487
050,36,015,"New York","Chemung County",4,72,869,400,469
050,36,015,"New York","Chemung County",4,73,856,396,460
050,36,015,"New York","Chemung County",4,74,821,359,462
050,36,015,"New York","Chemung County",4,75,873,411,462
050,36,015,"New York","Chemung County",4,76,606,276,330
050,36,015,"New York","Chemung County",4,77,562,250,312
050,36,015,"New York","Chemung County",4,78,513,228,285
050,36,015,"New York","Chemung County",4,79,527,234,293
050,36,015,"New York","Chemung County",4,80,463,194,269
050,36,015,"New York","Chemung County",4,81,393,154,239
050,36,015,"New York","Chemung County",4,82,352,147,205
050,36,015,"New York","Chemung County",4,83,339,148,191
050,36,015,"New York","Chemung County",4,84,336,131,205
050,36,015,"New York","Chemung County",4,85,1839,670,1169
050,36,015,"New York","Chemung County",5,0,807,425,382
050,36,015,"New York","Chemung County",5,1,861,464,397
050,36,015,"New York","Chemung County",5,2,837,440,397
050,36,015,"New York","Chemung County",5,3,850,431,419
050,36,015,"New York","Chemung County",5,4,841,453,388
050,36,015,"New York","Chemung County",5,5,895,450,445
050,36,015,"New York","Chemung County",5,6,892,463,429
050,36,015,"New York","Chemung County",5,7,976,488,488
050,36,015,"New York","Chemung County",5,8,965,480,485
050,36,015,"New York","Chemung County",5,9,943,498,445
050,36,015,"New York","Chemung County",5,10,998,492,506
050,36,015,"New York","Chemung County",5,11,979,476,503
050,36,015,"New York","Chemung County",5,12,1009,516,493
050,36,015,"New York","Chemung County",5,13,998,521,477
050,36,015,"New York","Chemung County",5,14,1004,513,491
050,36,015,"New York","Chemung County",5,15,1029,527,502
050,36,015,"New York","Chemung County",5,16,1083,546,537
050,36,015,"New York","Chemung County",5,17,1024,529,495
050,36,015,"New York","Chemung County",5,18,942,475,467
050,36,015,"New York","Chemung County",5,19,838,420,418
050,36,015,"New York","Chemung County",5,20,932,451,481
050,36,015,"New York","Chemung County",5,21,975,469,506
050,36,015,"New York","Chemung County",5,22,1040,543,497
050,36,015,"New York","Chemung County",5,23,977,497,480
050,36,015,"New York","Chemung County",5,24,945,492,453
050,36,015,"New York","Chemung County",5,25,882,467,415
050,36,015,"New York","Chemung County",5,26,891,499,392
050,36,015,"New York","Chemung County",5,27,938,518,420
050,36,015,"New York","Chemung County",5,28,965,512,453
050,36,015,"New York","Chemung County",5,29,989,521,468
050,36,015,"New York","Chemung County",5,30,1001,536,465
050,36,015,"New York","Chemung County",5,31,1035,564,471
050,36,015,"New York","Chemung County",5,32,1023,528,495
050,36,015,"New York","Chemung County",5,33,1077,559,518
050,36,015,"New York","Chemung County",5,34,1089,560,529
050,36,015,"New York","Chemung County",5,35,1006,525,481
050,36,015,"New York","Chemung County",5,36,998,517,481
050,36,015,"New York","Chemung County",5,37,1015,525,490
050,36,015,"New York","Chemung County",5,38,1029,518,511
050,36,015,"New York","Chemung County",5,39,1005,490,515
050,36,015,"New York","Chemung County",5,40,1005,497,508
050,36,015,"New York","Chemung County",5,41,1027,525,502
050,36,015,"New York","Chemung County",5,42,1017,522,495
050,36,015,"New York","Chemung County",5,43,1033,513,520
050,36,015,"New York","Chemung County",5,44,969,489,480
050,36,015,"New York","Chemung County",5,45,923,464,459
050,36,015,"New York","Chemung County",5,46,954,500,454
050,36,015,"New York","Chemung County",5,47,910,476,434
050,36,015,"New York","Chemung County",5,48,917,475,442
050,36,015,"New York","Chemung County",5,49,896,465,431
050,36,015,"New York","Chemung County",5,50,873,454,419
050,36,015,"New York","Chemung County",5,51,942,478,464
050,36,015,"New York","Chemung County",5,52,1035,508,527
050,36,015,"New York","Chemung County",5,53,981,484,497
050,36,015,"New York","Chemung County",5,54,1039,526,513
050,36,015,"New York","Chemung County",5,55,1006,502,504
050,36,015,"New York","Chemung County",5,56,1041,518,523
050,36,015,"New York","Chemung County",5,57,1044,508,536
050,36,015,"New York","Chemung County",5,58,1078,504,574
050,36,015,"New York","Chemung County",5,59,1162,577,585
050,36,015,"New York","Chemung County",5,60,1188,593,595
050,36,015,"New York","Chemung County",5,61,1189,579,610
050,36,015,"New York","Chemung County",5,62,1180,585,595
050,36,015,"New York","Chemung County",5,63,1146,556,590
050,36,015,"New York","Chemung County",5,64,1170,556,614
050,36,015,"New York","Chemung County",5,65,1154,556,598
050,36,015,"New York","Chemung County",5,66,1172,576,596
050,36,015,"New York","Chemung County",5,67,1078,533,545
050,36,015,"New York","Chemung County",5,68,1066,518,548
050,36,015,"New York","Chemung County",5,69,1047,524,523
050,36,015,"New York","Chemung County",5,70,977,477,500
050,36,015,"New York","Chemung County",5,71,933,436,497
050,36,015,"New York","Chemung County",5,72,891,419,472
050,36,015,"New York","Chemung County",5,73,845,382,463
050,36,015,"New York","Chemung County",5,74,834,380,454
050,36,015,"New York","Chemung County",5,75,791,345,446
050,36,015,"New York","Chemung County",5,76,846,393,453
050,36,015,"New York","Chemung County",5,77,580,270,310
050,36,015,"New York","Chemung County",5,78,531,232,299
050,36,015,"New York","Chemung County",5,79,498,221,277
050,36,015,"New York","Chemung County",5,80,500,215,285
050,36,015,"New York","Chemung County",5,81,444,178,266
050,36,015,"New York","Chemung County",5,82,368,140,228
050,36,015,"New York","Chemung County",5,83,325,139,186
050,36,015,"New York","Chemung County",5,84,312,131,181
050,36,015,"New York","Chemung County",5,85,1825,666,1159
050,36,017,"New York","Chenango County",1,0,444,227,217
050,36,017,"New York","Chenango County",1,1,448,218,230
050,36,017,"New York","Chenango County",1,2,487,247,240
050,36,017,"New York","Chenango County",1,3,526,282,244
050,36,017,"New York","Chenango County",1,4,510,255,255
050,36,017,"New York","Chenango County",1,5,544,270,274
050,36,017,"New York","Chenango County",1,6,538,274,264
050,36,017,"New York","Chenango County",1,7,561,277,284
050,36,017,"New York","Chenango County",1,8,543,270,273
050,36,017,"New York","Chenango County",1,9,549,283,266
050,36,017,"New York","Chenango County",1,10,545,270,275
050,36,017,"New York","Chenango County",1,11,579,305,274
050,36,017,"New York","Chenango County",1,12,599,320,279
050,36,017,"New York","Chenango County",1,13,592,303,289
050,36,017,"New York","Chenango County",1,14,567,306,261
050,36,017,"New York","Chenango County",1,15,558,294,264
050,36,017,"New York","Chenango County",1,16,593,307,286
050,36,017,"New York","Chenango County",1,17,575,304,271
050,36,017,"New York","Chenango County",1,18,550,284,266
050,36,017,"New York","Chenango County",1,19,431,220,211
050,36,017,"New York","Chenango County",1,20,430,222,208
050,36,017,"New York","Chenango County",1,21,471,250,221
050,36,017,"New York","Chenango County",1,22,498,246,252
050,36,017,"New York","Chenango County",1,23,490,254,236
050,36,017,"New York","Chenango County",1,24,507,269,238
050,36,017,"New York","Chenango County",1,25,500,241,259
050,36,017,"New York","Chenango County",1,26,534,255,279
050,36,017,"New York","Chenango County",1,27,554,281,273
050,36,017,"New York","Chenango County",1,28,579,296,283
050,36,017,"New York","Chenango County",1,29,570,290,280
050,36,017,"New York","Chenango County",1,30,514,262,252
050,36,017,"New York","Chenango County",1,31,486,245,241
050,36,017,"New York","Chenango County",1,32,497,252,245
050,36,017,"New York","Chenango County",1,33,486,245,241
050,36,017,"New York","Chenango County",1,34,511,268,243
050,36,017,"New York","Chenango County",1,35,520,286,234
050,36,017,"New York","Chenango County",1,36,539,282,257
050,36,017,"New York","Chenango County",1,37,574,277,297
050,36,017,"New York","Chenango County",1,38,534,277,257
050,36,017,"New York","Chenango County",1,39,503,261,242
050,36,017,"New York","Chenango County",1,40,537,269,268
050,36,017,"New York","Chenango County",1,41,531,266,265
050,36,017,"New York","Chenango County",1,42,532,270,262
050,36,017,"New York","Chenango County",1,43,516,262,254
050,36,017,"New York","Chenango County",1,44,515,263,252
050,36,017,"New York","Chenango County",1,45,482,254,228
050,36,017,"New York","Chenango County",1,46,461,224,237
050,36,017,"New York","Chenango County",1,47,528,272,256
050,36,017,"New York","Chenango County",1,48,611,303,308
050,36,017,"New York","Chenango County",1,49,651,325,326
050,36,017,"New York","Chenango County",1,50,660,318,342
050,36,017,"New York","Chenango County",1,51,613,306,307
050,36,017,"New York","Chenango County",1,52,599,314,285
050,36,017,"New York","Chenango County",1,53,618,330,288
050,36,017,"New York","Chenango County",1,54,690,344,346
050,36,017,"New York","Chenango County",1,55,756,361,395
050,36,017,"New York","Chenango County",1,56,767,362,405
050,36,017,"New York","Chenango County",1,57,749,376,373
050,36,017,"New York","Chenango County",1,58,760,382,378
050,36,017,"New York","Chenango County",1,59,784,406,378
050,36,017,"New York","Chenango County",1,60,797,430,367
050,36,017,"New York","Chenango County",1,61,801,420,381
050,36,017,"New York","Chenango County",1,62,794,384,410
050,36,017,"New York","Chenango County",1,63,793,385,408
050,36,017,"New York","Chenango County",1,64,746,388,358
050,36,017,"New York","Chenango County",1,65,696,346,350
050,36,017,"New York","Chenango County",1,66,679,349,330
050,36,017,"New York","Chenango County",1,67,632,323,309
050,36,017,"New York","Chenango County",1,68,597,309,288
050,36,017,"New York","Chenango County",1,69,559,290,269
050,36,017,"New York","Chenango County",1,70,552,279,273
050,36,017,"New York","Chenango County",1,71,544,271,273
050,36,017,"New York","Chenango County",1,72,559,273,286
050,36,017,"New York","Chenango County",1,73,566,279,287
050,36,017,"New York","Chenango County",1,74,413,197,216
050,36,017,"New York","Chenango County",1,75,400,187,213
050,36,017,"New York","Chenango County",1,76,406,202,204
050,36,017,"New York","Chenango County",1,77,404,210,194
050,36,017,"New York","Chenango County",1,78,340,164,176
050,36,017,"New York","Chenango County",1,79,311,150,161
050,36,017,"New York","Chenango County",1,80,262,138,124
050,36,017,"New York","Chenango County",1,81,248,108,140
050,36,017,"New York","Chenango County",1,82,234,101,133
050,36,017,"New York","Chenango County",1,83,207,100,107
050,36,017,"New York","Chenango County",1,84,206,98,108
050,36,017,"New York","Chenango County",1,85,1078,422,656
050,36,017,"New York","Chenango County",2,0,453,223,230
050,36,017,"New York","Chenango County",2,1,445,218,227
050,36,017,"New York","Chenango County",2,2,477,240,237
050,36,017,"New York","Chenango County",2,3,516,273,243
050,36,017,"New York","Chenango County",2,4,517,262,255
050,36,017,"New York","Chenango County",2,5,534,265,269
050,36,017,"New York","Chenango County",2,6,544,276,268
050,36,017,"New York","Chenango County",2,7,554,276,278
050,36,017,"New York","Chenango County",2,8,546,272,274
050,36,017,"New York","Chenango County",2,9,547,280,267
050,36,017,"New York","Chenango County",2,10,545,274,271
050,36,017,"New York","Chenango County",2,11,570,298,272
050,36,017,"New York","Chenango County",2,12,596,318,278
050,36,017,"New York","Chenango County",2,13,594,307,287
050,36,017,"New York","Chenango County",2,14,570,303,267
050,36,017,"New York","Chenango County",2,15,563,299,264
050,36,017,"New York","Chenango County",2,16,582,303,279
050,36,017,"New York","Chenango County",2,17,580,305,275
050,36,017,"New York","Chenango County",2,18,528,275,253
050,36,017,"New York","Chenango County",2,19,432,221,211
050,36,017,"New York","Chenango County",2,20,442,227,215
050,36,017,"New York","Chenango County",2,21,461,241,220
050,36,017,"New York","Chenango County",2,22,491,244,247
050,36,017,"New York","Chenango County",2,23,495,253,242
050,36,017,"New York","Chenango County",2,24,498,264,234
050,36,017,"New York","Chenango County",2,25,496,245,251
050,36,017,"New York","Chenango County",2,26,525,246,279
050,36,017,"New York","Chenango County",2,27,543,271,272
050,36,017,"New York","Chenango County",2,28,572,292,280
050,36,017,"New York","Chenango County",2,29,570,289,281
050,36,017,"New York","Chenango County",2,30,526,267,259
050,36,017,"New York","Chenango County",2,31,492,250,242
050,36,017,"New York","Chenango County",2,32,495,250,245
050,36,017,"New York","Chenango County",2,33,490,247,243
050,36,017,"New York","Chenango County",2,34,507,264,243
050,36,017,"New York","Chenango County",2,35,526,284,242
050,36,017,"New York","Chenango County",2,36,531,281,250
050,36,017,"New York","Chenango County",2,37,569,277,292
050,36,017,"New York","Chenango County",2,38,542,277,265
050,36,017,"New York","Chenango County",2,39,508,264,244
050,36,017,"New York","Chenango County",2,40,534,270,264
050,36,017,"New York","Chenango County",2,41,528,263,265
050,36,017,"New York","Chenango County",2,42,529,266,263
050,36,017,"New York","Chenango County",2,43,523,265,258
050,36,017,"New York","Chenango County",2,44,508,262,246
050,36,017,"New York","Chenango County",2,45,489,256,233
050,36,017,"New York","Chenango County",2,46,461,228,233
050,36,017,"New York","Chenango County",2,47,511,260,251
050,36,017,"New York","Chenango County",2,48,592,297,295
050,36,017,"New York","Chenango County",2,49,640,319,321
050,36,017,"New York","Chenango County",2,50,657,320,337
050,36,017,"New York","Chenango County",2,51,618,306,312
050,36,017,"New York","Chenango County",2,52,601,311,290
050,36,017,"New York","Chenango County",2,53,613,326,287
050,36,017,"New York","Chenango County",2,54,666,336,330
050,36,017,"New York","Chenango County",2,55,742,355,387
050,36,017,"New York","Chenango County",2,56,764,361,403
050,36,017,"New York","Chenango County",2,57,753,374,379
050,36,017,"New York","Chenango County",2,58,761,381,380
050,36,017,"New York","Chenango County",2,59,778,401,377
050,36,017,"New York","Chenango County",2,60,784,418,366
050,36,017,"New York","Chenango County",2,61,797,420,377
050,36,017,"New York","Chenango County",2,62,788,390,398
050,36,017,"New York","Chenango County",2,63,801,391,410
050,36,017,"New York","Chenango County",2,64,749,381,368
050,36,017,"New York","Chenango County",2,65,702,351,351
050,36,017,"New York","Chenango County",2,66,682,348,334
050,36,017,"New York","Chenango County",2,67,640,328,312
050,36,017,"New York","Chenango County",2,68,603,311,292
050,36,017,"New York","Chenango County",2,69,569,296,273
050,36,017,"New York","Chenango County",2,70,552,281,271
050,36,017,"New York","Chenango County",2,71,545,272,273
050,36,017,"New York","Chenango County",2,72,542,266,276
050,36,017,"New York","Chenango County",2,73,587,290,297
050,36,017,"New York","Chenango County",2,74,416,201,215
050,36,017,"New York","Chenango County",2,75,397,185,212
050,36,017,"New York","Chenango County",2,76,392,190,202
050,36,017,"New York","Chenango County",2,77,407,209,198
050,36,017,"New York","Chenango County",2,78,341,170,171
050,36,017,"New York","Chenango County",2,79,306,145,161
050,36,017,"New York","Chenango County",2,80,266,140,126
050,36,017,"New York","Chenango County",2,81,245,108,137
050,36,017,"New York","Chenango County",2,82,233,102,131
050,36,017,"New York","Chenango County",2,83,210,98,112
050,36,017,"New York","Chenango County",2,84,198,96,102
050,36,017,"New York","Chenango County",2,85,1072,426,646
050,36,017,"New York","Chenango County",3,0,441,242,199
050,36,017,"New York","Chenango County",3,1,479,243,236
050,36,017,"New York","Chenango County",3,2,447,215,232
050,36,017,"New York","Chenango County",3,3,482,252,230
050,36,017,"New York","Chenango County",3,4,515,273,242
050,36,017,"New York","Chenango County",3,5,526,265,261
050,36,017,"New York","Chenango County",3,6,537,268,269
050,36,017,"New York","Chenango County",3,7,536,274,262
050,36,017,"New York","Chenango County",3,8,556,270,286
050,36,017,"New York","Chenango County",3,9,528,268,260
050,36,017,"New York","Chenango County",3,10,544,276,268
050,36,017,"New York","Chenango County",3,11,540,269,271
050,36,017,"New York","Chenango County",3,12,580,290,290
050,36,017,"New York","Chenango County",3,13,604,317,287
050,36,017,"New York","Chenango County",3,14,584,300,284
050,36,017,"New York","Chenango County",3,15,581,312,269
050,36,017,"New York","Chenango County",3,16,568,297,271
050,36,017,"New York","Chenango County",3,17,567,295,272
050,36,017,"New York","Chenango County",3,18,489,266,223
050,36,017,"New York","Chenango County",3,19,408,213,195
050,36,017,"New York","Chenango County",3,20,466,242,224
050,36,017,"New York","Chenango County",3,21,475,248,227
050,36,017,"New York","Chenango County",3,22,468,242,226
050,36,017,"New York","Chenango County",3,23,493,254,239
050,36,017,"New York","Chenango County",3,24,498,259,239
050,36,017,"New York","Chenango County",3,25,482,255,227
050,36,017,"New York","Chenango County",3,26,515,240,275
050,36,017,"New York","Chenango County",3,27,496,241,255
050,36,017,"New York","Chenango County",3,28,526,264,262
050,36,017,"New York","Chenango County",3,29,560,283,277
050,36,017,"New York","Chenango County",3,30,554,281,273
050,36,017,"New York","Chenango County",3,31,535,274,261
050,36,017,"New York","Chenango County",3,32,495,247,248
050,36,017,"New York","Chenango County",3,33,506,255,251
050,36,017,"New York","Chenango County",3,34,508,260,248
050,36,017,"New York","Chenango County",3,35,503,262,241
050,36,017,"New York","Chenango County",3,36,517,288,229
050,36,017,"New York","Chenango County",3,37,536,272,264
050,36,017,"New York","Chenango County",3,38,558,268,290
050,36,017,"New York","Chenango County",3,39,545,278,267
050,36,017,"New York","Chenango County",3,40,501,261,240
050,36,017,"New York","Chenango County",3,41,538,271,267
050,36,017,"New York","Chenango County",3,42,504,255,249
050,36,017,"New York","Chenango County",3,43,518,260,258
050,36,017,"New York","Chenango County",3,44,537,269,268
050,36,017,"New York","Chenango County",3,45,503,259,244
050,36,017,"New York","Chenango County",3,46,486,254,232
050,36,017,"New York","Chenango County",3,47,456,226,230
050,36,017,"New York","Chenango County",3,48,512,253,259
050,36,017,"New York","Chenango County",3,49,580,293,287
050,36,017,"New York","Chenango County",3,50,624,312,312
050,36,017,"New York","Chenango County",3,51,645,313,332
050,36,017,"New York","Chenango County",3,52,622,318,304
050,36,017,"New York","Chenango County",3,53,602,306,296
050,36,017,"New York","Chenango County",3,54,612,323,289
050,36,017,"New York","Chenango County",3,55,674,341,333
050,36,017,"New York","Chenango County",3,56,733,362,371
050,36,017,"New York","Chenango County",3,57,739,360,379
050,36,017,"New York","Chenango County",3,58,754,372,382
050,36,017,"New York","Chenango County",3,59,750,375,375
050,36,017,"New York","Chenango County",3,60,750,385,365
050,36,017,"New York","Chenango County",3,61,771,409,362
050,36,017,"New York","Chenango County",3,62,773,407,366
050,36,017,"New York","Chenango County",3,63,783,392,391
050,36,017,"New York","Chenango County",3,64,783,374,409
050,36,017,"New York","Chenango County",3,65,722,366,356
050,36,017,"New York","Chenango County",3,66,685,340,345
050,36,017,"New York","Chenango County",3,67,654,331,323
050,36,017,"New York","Chenango County",3,68,630,323,307
050,36,017,"New York","Chenango County",3,69,571,292,279
050,36,017,"New York","Chenango County",3,70,562,293,269
050,36,017,"New York","Chenango County",3,71,538,272,266
050,36,017,"New York","Chenango County",3,72,535,265,270
050,36,017,"New York","Chenango County",3,73,525,255,270
050,36,017,"New York","Chenango County",3,74,559,277,282
050,36,017,"New York","Chenango County",3,75,395,190,205
050,36,017,"New York","Chenango County",3,76,377,176,201
050,36,017,"New York","Chenango County",3,77,380,187,193
050,36,017,"New York","Chenango County",3,78,372,187,185
050,36,017,"New York","Chenango County",3,79,317,155,162
050,36,017,"New York","Chenango County",3,80,292,145,147
050,36,017,"New York","Chenango County",3,81,253,121,132
050,36,017,"New York","Chenango County",3,82,228,102,126
050,36,017,"New York","Chenango County",3,83,222,98,124
050,36,017,"New York","Chenango County",3,84,189,89,100
050,36,017,"New York","Chenango County",3,85,1065,423,642
050,36,017,"New York","Chenango County",4,0,467,235,232
050,36,017,"New York","Chenango County",4,1,448,238,210
050,36,017,"New York","Chenango County",4,2,476,243,233
050,36,017,"New York","Chenango County",4,3,454,215,239
050,36,017,"New York","Chenango County",4,4,489,251,238
050,36,017,"New York","Chenango County",4,5,521,282,239
050,36,017,"New York","Chenango County",4,6,519,262,257
050,36,017,"New York","Chenango County",4,7,526,267,259
050,36,017,"New York","Chenango County",4,8,535,281,254
050,36,017,"New York","Chenango County",4,9,567,279,288
050,36,017,"New York","Chenango County",4,10,535,271,264
050,36,017,"New York","Chenango County",4,11,557,288,269
050,36,017,"New York","Chenango County",4,12,559,282,277
050,36,017,"New York","Chenango County",4,13,577,296,281
050,36,017,"New York","Chenango County",4,14,612,317,295
050,36,017,"New York","Chenango County",4,15,598,312,286
050,36,017,"New York","Chenango County",4,16,578,310,268
050,36,017,"New York","Chenango County",4,17,573,300,273
050,36,017,"New York","Chenango County",4,18,476,253,223
050,36,017,"New York","Chenango County",4,19,365,199,166
050,36,017,"New York","Chenango County",4,20,423,227,196
050,36,017,"New York","Chenango County",4,21,497,252,245
050,36,017,"New York","Chenango County",4,22,481,241,240
050,36,017,"New York","Chenango County",4,23,476,248,228
050,36,017,"New York","Chenango County",4,24,484,245,239
050,36,017,"New York","Chenango County",4,25,478,250,228
050,36,017,"New York","Chenango County",4,26,507,264,243
050,36,017,"New York","Chenango County",4,27,490,238,252
050,36,017,"New York","Chenango County",4,28,497,242,255
050,36,017,"New York","Chenango County",4,29,501,247,254
050,36,017,"New York","Chenango County",4,30,561,278,283
050,36,017,"New York","Chenango County",4,31,583,304,279
050,36,017,"New York","Chenango County",4,32,537,268,269
050,36,017,"New York","Chenango County",4,33,516,265,251
050,36,017,"New York","Chenango County",4,34,522,253,269
050,36,017,"New York","Chenango County",4,35,502,254,248
050,36,017,"New York","Chenango County",4,36,528,274,254
050,36,017,"New York","Chenango County",4,37,548,298,250
050,36,017,"New York","Chenango County",4,38,536,288,248
050,36,017,"New York","Chenango County",4,39,561,273,288
050,36,017,"New York","Chenango County",4,40,560,289,271
050,36,017,"New York","Chenango County",4,41,485,253,232
050,36,017,"New York","Chenango County",4,42,541,270,271
050,36,017,"New York","Chenango County",4,43,506,256,250
050,36,017,"New York","Chenango County",4,44,522,260,262
050,36,017,"New York","Chenango County",4,45,533,268,265
050,36,017,"New York","Chenango County",4,46,503,259,244
050,36,017,"New York","Chenango County",4,47,490,259,231
050,36,017,"New York","Chenango County",4,48,465,227,238
050,36,017,"New York","Chenango County",4,49,507,241,266
050,36,017,"New York","Chenango County",4,50,580,291,289
050,36,017,"New York","Chenango County",4,51,624,309,315
050,36,017,"New York","Chenango County",4,52,645,318,327
050,36,017,"New York","Chenango County",4,53,613,310,303
050,36,017,"New York","Chenango County",4,54,600,302,298
050,36,017,"New York","Chenango County",4,55,628,325,303
050,36,017,"New York","Chenango County",4,56,670,342,328
050,36,017,"New York","Chenango County",4,57,710,355,355
050,36,017,"New York","Chenango County",4,58,745,368,377
050,36,017,"New York","Chenango County",4,59,748,376,372
050,36,017,"New York","Chenango County",4,60,732,369,363
050,36,017,"New York","Chenango County",4,61,750,384,366
050,36,017,"New York","Chenango County",4,62,756,399,357
050,36,017,"New York","Chenango County",4,63,755,398,357
050,36,017,"New York","Chenango County",4,64,762,377,385
050,36,017,"New York","Chenango County",4,65,753,360,393
050,36,017,"New York","Chenango County",4,66,715,370,345
050,36,017,"New York","Chenango County",4,67,669,327,342
050,36,017,"New York","Chenango County",4,68,640,323,317
050,36,017,"New York","Chenango County",4,69,609,305,304
050,36,017,"New York","Chenango County",4,70,568,292,276
050,36,017,"New York","Chenango County",4,71,540,276,264
050,36,017,"New York","Chenango County",4,72,520,261,259
050,36,017,"New York","Chenango County",4,73,515,256,259
050,36,017,"New York","Chenango County",4,74,512,247,265
050,36,017,"New York","Chenango County",4,75,532,263,269
050,36,017,"New York","Chenango County",4,76,369,175,194
050,36,017,"New York","Chenango County",4,77,355,167,188
050,36,017,"New York","Chenango County",4,78,343,163,180
050,36,017,"New York","Chenango County",4,79,337,168,169
050,36,017,"New York","Chenango County",4,80,299,149,150
050,36,017,"New York","Chenango County",4,81,265,120,145
050,36,017,"New York","Chenango County",4,82,248,121,127
050,36,017,"New York","Chenango County",4,83,204,86,118
050,36,017,"New York","Chenango County",4,84,191,89,102
050,36,017,"New York","Chenango County",4,85,1057,416,641
050,36,017,"New York","Chenango County",5,0,468,236,232
050,36,017,"New York","Chenango County",5,1,474,243,231
050,36,017,"New York","Chenango County",5,2,459,246,213
050,36,017,"New York","Chenango County",5,3,475,241,234
050,36,017,"New York","Chenango County",5,4,443,215,228
050,36,017,"New York","Chenango County",5,5,500,257,243
050,36,017,"New York","Chenango County",5,6,517,281,236
050,36,017,"New York","Chenango County",5,7,520,264,256
050,36,017,"New York","Chenango County",5,8,527,269,258
050,36,017,"New York","Chenango County",5,9,540,281,259
050,36,017,"New York","Chenango County",5,10,558,266,292
050,36,017,"New York","Chenango County",5,11,530,265,265
050,36,017,"New York","Chenango County",5,12,556,285,271
050,36,017,"New York","Chenango County",5,13,552,283,269
050,36,017,"New York","Chenango County",5,14,578,296,282
050,36,017,"New York","Chenango County",5,15,610,322,288
050,36,017,"New York","Chenango County",5,16,595,306,289
050,36,017,"New York","Chenango County",5,17,570,312,258
050,36,017,"New York","Chenango County",5,18,465,257,208
050,36,017,"New York","Chenango County",5,19,350,183,167
050,36,017,"New York","Chenango County",5,20,394,210,184
050,36,017,"New York","Chenango County",5,21,450,241,209
050,36,017,"New York","Chenango County",5,22,511,251,260
050,36,017,"New York","Chenango County",5,23,487,256,231
050,36,017,"New York","Chenango County",5,24,467,239,228
050,36,017,"New York","Chenango County",5,25,500,254,246
050,36,017,"New York","Chenango County",5,26,475,241,234
050,36,017,"New York","Chenango County",5,27,477,268,209
050,36,017,"New York","Chenango County",5,28,488,239,249
050,36,017,"New York","Chenango County",5,29,482,227,255
050,36,017,"New York","Chenango County",5,30,506,241,265
050,36,017,"New York","Chenango County",5,31,563,282,281
050,36,017,"New York","Chenango County",5,32,583,302,281
050,36,017,"New York","Chenango County",5,33,537,268,269
050,36,017,"New York","Chenango County",5,34,519,260,259
050,36,017,"New York","Chenango County",5,35,516,252,264
050,36,017,"New York","Chenango County",5,36,506,265,241
050,36,017,"New York","Chenango County",5,37,534,268,266
050,36,017,"New York","Chenango County",5,38,521,283,238
050,36,017,"New York","Chenango County",5,39,533,287,246
050,36,017,"New York","Chenango County",5,40,569,283,286
050,36,017,"New York","Chenango County",5,41,566,285,281
050,36,017,"New York","Chenango County",5,42,485,250,235
050,36,017,"New York","Chenango County",5,43,538,274,264
050,36,017,"New York","Chenango County",5,44,508,258,250
050,36,017,"New York","Chenango County",5,45,509,251,258
050,36,017,"New York","Chenango County",5,46,527,272,255
050,36,017,"New York","Chenango County",5,47,499,267,232
050,36,017,"New York","Chenango County",5,48,493,249,244
050,36,017,"New York","Chenango County",5,49,457,227,230
050,36,017,"New York","Chenango County",5,50,504,241,263
050,36,017,"New York","Chenango County",5,51,571,284,287
050,36,017,"New York","Chenango County",5,52,622,312,310
050,36,017,"New York","Chenango County",5,53,645,312,333
050,36,017,"New York","Chenango County",5,54,610,311,299
050,36,017,"New York","Chenango County",5,55,598,297,301
050,36,017,"New York","Chenango County",5,56,624,326,298
050,36,017,"New York","Chenango County",5,57,656,344,312
050,36,017,"New York","Chenango County",5,58,720,362,358
050,36,017,"New York","Chenango County",5,59,731,366,365
050,36,017,"New York","Chenango County",5,60,728,364,364
050,36,017,"New York","Chenango County",5,61,729,371,358
050,36,017,"New York","Chenango County",5,62,741,379,362
050,36,017,"New York","Chenango County",5,63,747,396,351
050,36,017,"New York","Chenango County",5,64,752,393,359
050,36,017,"New York","Chenango County",5,65,734,360,374
050,36,017,"New York","Chenango County",5,66,746,366,380
050,36,017,"New York","Chenango County",5,67,701,357,344
050,36,017,"New York","Chenango County",5,68,651,318,333
050,36,017,"New York","Chenango County",5,69,607,303,304
050,36,017,"New York","Chenango County",5,70,604,304,300
050,36,017,"New York","Chenango County",5,71,552,281,271
050,36,017,"New York","Chenango County",5,72,533,263,270
050,36,017,"New York","Chenango County",5,73,495,247,248
050,36,017,"New York","Chenango County",5,74,511,252,259
050,36,017,"New York","Chenango County",5,75,481,233,248
050,36,017,"New York","Chenango County",5,76,506,250,256
050,36,017,"New York","Chenango County",5,77,354,166,188
050,36,017,"New York","Chenango County",5,78,328,150,178
050,36,017,"New York","Chenango County",5,79,312,145,167
050,36,017,"New York","Chenango County",5,80,324,168,156
050,36,017,"New York","Chenango County",5,81,280,129,151
050,36,017,"New York","Chenango County",5,82,254,117,137
050,36,017,"New York","Chenango County",5,83,235,112,123
050,36,017,"New York","Chenango County",5,84,180,79,101
050,36,017,"New York","Chenango County",5,85,1067,422,645
050,36,019,"New York","Clinton County",1,0,710,368,342
050,36,019,"New York","Clinton County",1,1,735,391,344
050,36,019,"New York","Clinton County",1,2,761,386,375
050,36,019,"New York","Clinton County",1,3,787,393,394
050,36,019,"New York","Clinton County",1,4,804,405,399
050,36,019,"New York","Clinton County",1,5,811,416,395
050,36,019,"New York","Clinton County",1,6,796,425,371
050,36,019,"New York","Clinton County",1,7,822,443,379
050,36,019,"New York","Clinton County",1,8,841,439,402
050,36,019,"New York","Clinton County",1,9,824,390,434
050,36,019,"New York","Clinton County",1,10,848,442,406
050,36,019,"New York","Clinton County",1,11,842,437,405
050,36,019,"New York","Clinton County",1,12,877,466,411
050,36,019,"New York","Clinton County",1,13,850,425,425
050,36,019,"New York","Clinton County",1,14,840,419,421
050,36,019,"New York","Clinton County",1,15,813,418,395
050,36,019,"New York","Clinton County",1,16,832,421,411
050,36,019,"New York","Clinton County",1,17,829,440,389
050,36,019,"New York","Clinton County",1,18,1252,607,645
050,36,019,"New York","Clinton County",1,19,1532,753,779
050,36,019,"New York","Clinton County",1,20,1675,832,843
050,36,019,"New York","Clinton County",1,21,1669,807,862
050,36,019,"New York","Clinton County",1,22,1364,642,722
050,36,019,"New York","Clinton County",1,23,1266,661,605
050,36,019,"New York","Clinton County",1,24,1005,552,453
050,36,019,"New York","Clinton County",1,25,1000,562,438
050,36,019,"New York","Clinton County",1,26,993,547,446
050,36,019,"New York","Clinton County",1,27,1011,556,455
050,36,019,"New York","Clinton County",1,28,952,489,463
050,36,019,"New York","Clinton County",1,29,979,538,441
050,36,019,"New York","Clinton County",1,30,966,554,412
050,36,019,"New York","Clinton County",1,31,936,546,390
050,36,019,"New York","Clinton County",1,32,988,595,393
050,36,019,"New York","Clinton County",1,33,973,531,442
050,36,019,"New York","Clinton County",1,34,1011,562,449
050,36,019,"New York","Clinton County",1,35,1023,573,450
050,36,019,"New York","Clinton County",1,36,993,544,449
050,36,019,"New York","Clinton County",1,37,1007,555,452
050,36,019,"New York","Clinton County",1,38,974,516,458
050,36,019,"New York","Clinton County",1,39,992,538,454
050,36,019,"New York","Clinton County",1,40,1049,582,467
050,36,019,"New York","Clinton County",1,41,970,536,434
050,36,019,"New York","Clinton County",1,42,928,522,406
050,36,019,"New York","Clinton County",1,43,927,511,416
050,36,019,"New York","Clinton County",1,44,870,477,393
050,36,019,"New York","Clinton County",1,45,902,494,408
050,36,019,"New York","Clinton County",1,46,894,491,403
050,36,019,"New York","Clinton County",1,47,939,504,435
050,36,019,"New York","Clinton County",1,48,998,531,467
050,36,019,"New York","Clinton County",1,49,1026,555,471
050,36,019,"New York","Clinton County",1,50,998,532,466
050,36,019,"New York","Clinton County",1,51,983,527,456
050,36,019,"New York","Clinton County",1,52,983,534,449
050,36,019,"New York","Clinton County",1,53,1064,553,511
050,36,019,"New York","Clinton County",1,54,1109,553,556
050,36,019,"New York","Clinton County",1,55,1193,580,613
050,36,019,"New York","Clinton County",1,56,1254,618,636
050,36,019,"New York","Clinton County",1,57,1242,647,595
050,36,019,"New York","Clinton County",1,58,1218,643,575
050,36,019,"New York","Clinton County",1,59,1196,610,586
050,36,019,"New York","Clinton County",1,60,1175,575,600
050,36,019,"New York","Clinton County",1,61,1195,576,619
050,36,019,"New York","Clinton County",1,62,1231,626,605
050,36,019,"New York","Clinton County",1,63,1080,549,531
050,36,019,"New York","Clinton County",1,64,1079,544,535
050,36,019,"New York","Clinton County",1,65,1048,533,515
050,36,019,"New York","Clinton County",1,66,971,500,471
050,36,019,"New York","Clinton County",1,67,917,459,458
050,36,019,"New York","Clinton County",1,68,893,441,452
050,36,019,"New York","Clinton County",1,69,842,401,441
050,36,019,"New York","Clinton County",1,70,831,411,420
050,36,019,"New York","Clinton County",1,71,849,421,428
050,36,019,"New York","Clinton County",1,72,822,402,420
050,36,019,"New York","Clinton County",1,73,793,389,404
050,36,019,"New York","Clinton County",1,74,539,250,289
050,36,019,"New York","Clinton County",1,75,512,246,266
050,36,019,"New York","Clinton County",1,76,527,255,272
050,36,019,"New York","Clinton County",1,77,535,260,275
050,36,019,"New York","Clinton County",1,78,457,210,247
050,36,019,"New York","Clinton County",1,79,417,190,227
050,36,019,"New York","Clinton County",1,80,357,160,197
050,36,019,"New York","Clinton County",1,81,356,154,202
050,36,019,"New York","Clinton County",1,82,341,153,188
050,36,019,"New York","Clinton County",1,83,299,122,177
050,36,019,"New York","Clinton County",1,84,296,117,179
050,36,019,"New York","Clinton County",1,85,1550,581,969
050,36,019,"New York","Clinton County",2,0,687,351,336
050,36,019,"New York","Clinton County",2,1,727,384,343
050,36,019,"New York","Clinton County",2,2,756,389,367
050,36,019,"New York","Clinton County",2,3,782,394,388
050,36,019,"New York","Clinton County",2,4,802,405,397
050,36,019,"New York","Clinton County",2,5,807,414,393
050,36,019,"New York","Clinton County",2,6,802,425,377
050,36,019,"New York","Clinton County",2,7,815,439,376
050,36,019,"New York","Clinton County",2,8,833,439,394
050,36,019,"New York","Clinton County",2,9,829,404,425
050,36,019,"New York","Clinton County",2,10,843,431,412
050,36,019,"New York","Clinton County",2,11,840,436,404
050,36,019,"New York","Clinton County",2,12,874,460,414
050,36,019,"New York","Clinton County",2,13,853,432,421
050,36,019,"New York","Clinton County",2,14,840,421,419
050,36,019,"New York","Clinton County",2,15,816,415,401
050,36,019,"New York","Clinton County",2,16,831,423,408
050,36,019,"New York","Clinton County",2,17,833,438,395
050,36,019,"New York","Clinton County",2,18,1240,601,639
050,36,019,"New York","Clinton County",2,19,1520,749,771
050,36,019,"New York","Clinton County",2,20,1688,833,855
050,36,019,"New York","Clinton County",2,21,1665,809,856
050,36,019,"New York","Clinton County",2,22,1359,649,710
050,36,019,"New York","Clinton County",2,23,1259,645,614
050,36,019,"New York","Clinton County",2,24,1002,549,453
050,36,019,"New York","Clinton County",2,25,986,552,434
050,36,019,"New York","Clinton County",2,26,982,542,440
050,36,019,"New York","Clinton County",2,27,1001,549,452
050,36,019,"New York","Clinton County",2,28,960,497,463
050,36,019,"New York","Clinton County",2,29,985,537,448
050,36,019,"New York","Clinton County",2,30,971,547,424
050,36,019,"New York","Clinton County",2,31,936,543,393
050,36,019,"New York","Clinton County",2,32,971,580,391
050,36,019,"New York","Clinton County",2,33,977,547,430
050,36,019,"New York","Clinton County",2,34,999,552,447
050,36,019,"New York","Clinton County",2,35,1021,568,453
050,36,019,"New York","Clinton County",2,36,992,545,447
050,36,019,"New York","Clinton County",2,37,1002,551,451
050,36,019,"New York","Clinton County",2,38,987,528,459
050,36,019,"New York","Clinton County",2,39,992,537,455
050,36,019,"New York","Clinton County",2,40,1038,571,467
050,36,019,"New York","Clinton County",2,41,986,544,442
050,36,019,"New York","Clinton County",2,42,931,519,412
050,36,019,"New York","Clinton County",2,43,932,515,417
050,36,019,"New York","Clinton County",2,44,870,477,393
050,36,019,"New York","Clinton County",2,45,898,490,408
050,36,019,"New York","Clinton County",2,46,885,484,401
050,36,019,"New York","Clinton County",2,47,926,502,424
050,36,019,"New York","Clinton County",2,48,978,519,459
050,36,019,"New York","Clinton County",2,49,1018,546,472
050,36,019,"New York","Clinton County",2,50,1000,533,467
050,36,019,"New York","Clinton County",2,51,978,523,455
050,36,019,"New York","Clinton County",2,52,979,530,449
050,36,019,"New York","Clinton County",2,53,1042,546,496
050,36,019,"New York","Clinton County",2,54,1090,550,540
050,36,019,"New York","Clinton County",2,55,1170,571,599
050,36,019,"New York","Clinton County",2,56,1236,606,630
050,36,019,"New York","Clinton County",2,57,1243,638,605
050,36,019,"New York","Clinton County",2,58,1217,639,578
050,36,019,"New York","Clinton County",2,59,1205,618,587
050,36,019,"New York","Clinton County",2,60,1172,579,593
050,36,019,"New York","Clinton County",2,61,1184,571,613
050,36,019,"New York","Clinton County",2,62,1224,615,609
050,36,019,"New York","Clinton County",2,63,1119,568,551
050,36,019,"New York","Clinton County",2,64,1072,542,530
050,36,019,"New York","Clinton County",2,65,1055,537,518
050,36,019,"New York","Clinton County",2,66,988,504,484
050,36,019,"New York","Clinton County",2,67,921,463,458
050,36,019,"New York","Clinton County",2,68,890,441,449
050,36,019,"New York","Clinton County",2,69,854,409,445
050,36,019,"New York","Clinton County",2,70,831,406,425
050,36,019,"New York","Clinton County",2,71,843,414,429
050,36,019,"New York","Clinton County",2,72,813,396,417
050,36,019,"New York","Clinton County",2,73,839,412,427
050,36,019,"New York","Clinton County",2,74,557,266,291
050,36,019,"New York","Clinton County",2,75,517,246,271
050,36,019,"New York","Clinton County",2,76,521,253,268
050,36,019,"New York","Clinton County",2,77,541,262,279
050,36,019,"New York","Clinton County",2,78,462,216,246
050,36,019,"New York","Clinton County",2,79,410,186,224
050,36,019,"New York","Clinton County",2,80,364,164,200
050,36,019,"New York","Clinton County",2,81,347,153,194
050,36,019,"New York","Clinton County",2,82,341,153,188
050,36,019,"New York","Clinton County",2,83,304,129,175
050,36,019,"New York","Clinton County",2,84,292,118,174
050,36,019,"New York","Clinton County",2,85,1551,575,976
050,36,019,"New York","Clinton County",3,0,641,341,300
050,36,019,"New York","Clinton County",3,1,696,367,329
050,36,019,"New York","Clinton County",3,2,743,391,352
050,36,019,"New York","Clinton County",3,3,754,384,370
050,36,019,"New York","Clinton County",3,4,802,406,396
050,36,019,"New York","Clinton County",3,5,817,407,410
050,36,019,"New York","Clinton County",3,6,812,419,393
050,36,019,"New York","Clinton County",3,7,800,426,374
050,36,019,"New York","Clinton County",3,8,804,430,374
050,36,019,"New York","Clinton County",3,9,832,443,389
050,36,019,"New York","Clinton County",3,10,821,398,423
050,36,019,"New York","Clinton County",3,11,843,432,411
050,36,019,"New York","Clinton County",3,12,829,430,399
050,36,019,"New York","Clinton County",3,13,884,466,418
050,36,019,"New York","Clinton County",3,14,854,435,419
050,36,019,"New York","Clinton County",3,15,834,419,415
050,36,019,"New York","Clinton County",3,16,828,425,403
050,36,019,"New York","Clinton County",3,17,841,429,412
050,36,019,"New York","Clinton County",3,18,1246,597,649
050,36,019,"New York","Clinton County",3,19,1520,750,770
050,36,019,"New York","Clinton County",3,20,1689,815,874
050,36,019,"New York","Clinton County",3,21,1672,807,865
050,36,019,"New York","Clinton County",3,22,1350,659,691
050,36,019,"New York","Clinton County",3,23,1241,612,629
050,36,019,"New York","Clinton County",3,24,991,518,473
050,36,019,"New York","Clinton County",3,25,934,528,406
050,36,019,"New York","Clinton County",3,26,920,502,418
050,36,019,"New York","Clinton County",3,27,948,529,419
050,36,019,"New York","Clinton County",3,28,951,501,450
050,36,019,"New York","Clinton County",3,29,991,532,459
050,36,019,"New York","Clinton County",3,30,962,509,453
050,36,019,"New York","Clinton County",3,31,960,521,439
050,36,019,"New York","Clinton County",3,32,923,532,391
050,36,019,"New York","Clinton County",3,33,963,563,400
050,36,019,"New York","Clinton County",3,34,948,528,420
050,36,019,"New York","Clinton County",3,35,977,524,453
050,36,019,"New York","Clinton County",3,36,993,540,453
050,36,019,"New York","Clinton County",3,37,972,532,440
050,36,019,"New York","Clinton County",3,38,994,536,458
050,36,019,"New York","Clinton County",3,39,993,530,463
050,36,019,"New York","Clinton County",3,40,955,504,451
050,36,019,"New York","Clinton County",3,41,1017,555,462
050,36,019,"New York","Clinton County",3,42,970,530,440
050,36,019,"New York","Clinton County",3,43,919,505,414
050,36,019,"New York","Clinton County",3,44,911,489,422
050,36,019,"New York","Clinton County",3,45,861,463,398
050,36,019,"New York","Clinton County",3,46,872,464,408
050,36,019,"New York","Clinton County",3,47,883,482,401
050,36,019,"New York","Clinton County",3,48,894,472,422
050,36,019,"New York","Clinton County",3,49,958,499,459
050,36,019,"New York","Clinton County",3,50,1000,537,463
050,36,019,"New York","Clinton County",3,51,960,502,458
050,36,019,"New York","Clinton County",3,52,956,498,458
050,36,019,"New York","Clinton County",3,53,958,514,444
050,36,019,"New York","Clinton County",3,54,1002,520,482
050,36,019,"New York","Clinton County",3,55,1067,524,543
050,36,019,"New York","Clinton County",3,56,1149,560,589
050,36,019,"New York","Clinton County",3,57,1205,584,621
050,36,019,"New York","Clinton County",3,58,1226,630,596
050,36,019,"New York","Clinton County",3,59,1205,628,577
050,36,019,"New York","Clinton County",3,60,1195,616,579
050,36,019,"New York","Clinton County",3,61,1160,566,594
050,36,019,"New York","Clinton County",3,62,1203,589,614
050,36,019,"New York","Clinton County",3,63,1181,586,595
050,36,019,"New York","Clinton County",3,64,1106,569,537
050,36,019,"New York","Clinton County",3,65,1049,532,517
050,36,019,"New York","Clinton County",3,66,1034,522,512
050,36,019,"New York","Clinton County",3,67,971,497,474
050,36,019,"New York","Clinton County",3,68,900,450,450
050,36,019,"New York","Clinton County",3,69,868,426,442
050,36,019,"New York","Clinton County",3,70,835,397,438
050,36,019,"New York","Clinton County",3,71,816,396,420
050,36,019,"New York","Clinton County",3,72,828,402,426
050,36,019,"New York","Clinton County",3,73,788,382,406
050,36,019,"New York","Clinton County",3,74,800,394,406
050,36,019,"New York","Clinton County",3,75,533,257,276
050,36,019,"New York","Clinton County",3,76,506,238,268
050,36,019,"New York","Clinton County",3,77,500,240,260
050,36,019,"New York","Clinton County",3,78,529,246,283
050,36,019,"New York","Clinton County",3,79,433,204,229
050,36,019,"New York","Clinton County",3,80,387,173,214
050,36,019,"New York","Clinton County",3,81,357,157,200
050,36,019,"New York","Clinton County",3,82,321,136,185
050,36,019,"New York","Clinton County",3,83,319,148,171
050,36,019,"New York","Clinton County",3,84,279,117,162
050,36,019,"New York","Clinton County",3,85,1554,565,989
050,36,019,"New York","Clinton County",4,0,674,338,336
050,36,019,"New York","Clinton County",4,1,645,334,311
050,36,019,"New York","Clinton County",4,2,713,377,336
050,36,019,"New York","Clinton County",4,3,734,390,344
050,36,019,"New York","Clinton County",4,4,759,390,369
050,36,019,"New York","Clinton County",4,5,798,410,388
050,36,019,"New York","Clinton County",4,6,802,401,401
050,36,019,"New York","Clinton County",4,7,804,412,392
050,36,019,"New York","Clinton County",4,8,801,428,373
050,36,019,"New York","Clinton County",4,9,804,427,377
050,36,019,"New York","Clinton County",4,10,832,441,391
050,36,019,"New York","Clinton County",4,11,824,400,424
050,36,019,"New York","Clinton County",4,12,851,438,413
050,36,019,"New York","Clinton County",4,13,846,439,407
050,36,019,"New York","Clinton County",4,14,889,465,424
050,36,019,"New York","Clinton County",4,15,862,447,415
050,36,019,"New York","Clinton County",4,16,834,417,417
050,36,019,"New York","Clinton County",4,17,828,424,404
050,36,019,"New York","Clinton County",4,18,1253,590,663
050,36,019,"New York","Clinton County",4,19,1485,734,751
050,36,019,"New York","Clinton County",4,20,1633,799,834
050,36,019,"New York","Clinton County",4,21,1651,778,873
050,36,019,"New York","Clinton County",4,22,1322,651,671
050,36,019,"New York","Clinton County",4,23,1217,609,608
050,36,019,"New York","Clinton County",4,24,975,493,482
050,36,019,"New York","Clinton County",4,25,906,472,434
050,36,019,"New York","Clinton County",4,26,848,474,374
050,36,019,"New York","Clinton County",4,27,870,467,403
050,36,019,"New York","Clinton County",4,28,889,491,398
050,36,019,"New York","Clinton County",4,29,944,499,445
050,36,019,"New York","Clinton County",4,30,944,490,454
050,36,019,"New York","Clinton County",4,31,945,488,457
050,36,019,"New York","Clinton County",4,32,929,492,437
050,36,019,"New York","Clinton County",4,33,905,520,385
050,36,019,"New York","Clinton County",4,34,935,530,405
050,36,019,"New York","Clinton County",4,35,923,500,423
050,36,019,"New York","Clinton County",4,36,951,511,440
050,36,019,"New York","Clinton County",4,37,999,535,464
050,36,019,"New York","Clinton County",4,38,962,512,450
050,36,019,"New York","Clinton County",4,39,1006,546,460
050,36,019,"New York","Clinton County",4,40,969,500,469
050,36,019,"New York","Clinton County",4,41,952,501,451
050,36,019,"New York","Clinton County",4,42,995,536,459
050,36,019,"New York","Clinton County",4,43,958,512,446
050,36,019,"New York","Clinton County",4,44,895,479,416
050,36,019,"New York","Clinton County",4,45,891,469,422
050,36,019,"New York","Clinton County",4,46,832,443,389
050,36,019,"New York","Clinton County",4,47,875,464,411
050,36,019,"New York","Clinton County",4,48,865,450,415
050,36,019,"New York","Clinton County",4,49,877,449,428
050,36,019,"New York","Clinton County",4,50,943,487,456
050,36,019,"New York","Clinton County",4,51,994,522,472
050,36,019,"New York","Clinton County",4,52,964,501,463
050,36,019,"New York","Clinton County",4,53,947,484,463
050,36,019,"New York","Clinton County",4,54,935,492,443
050,36,019,"New York","Clinton County",4,55,988,502,486
050,36,019,"New York","Clinton County",4,56,1037,507,530
050,36,019,"New York","Clinton County",4,57,1123,538,585
050,36,019,"New York","Clinton County",4,58,1189,573,616
050,36,019,"New York","Clinton County",4,59,1209,609,600
050,36,019,"New York","Clinton County",4,60,1196,627,569
050,36,019,"New York","Clinton County",4,61,1181,601,580
050,36,019,"New York","Clinton County",4,62,1149,562,587
050,36,019,"New York","Clinton County",4,63,1153,562,591
050,36,019,"New York","Clinton County",4,64,1156,579,577
050,36,019,"New York","Clinton County",4,65,1074,548,526
050,36,019,"New York","Clinton County",4,66,1038,517,521
050,36,019,"New York","Clinton County",4,67,1011,508,503
050,36,019,"New York","Clinton County",4,68,958,493,465
050,36,019,"New York","Clinton County",4,69,874,432,442
050,36,019,"New York","Clinton County",4,70,848,418,430
050,36,019,"New York","Clinton County",4,71,814,388,426
050,36,019,"New York","Clinton County",4,72,807,382,425
050,36,019,"New York","Clinton County",4,73,802,386,416
050,36,019,"New York","Clinton County",4,74,763,369,394
050,36,019,"New York","Clinton County",4,75,756,375,381
050,36,019,"New York","Clinton County",4,76,520,248,272
050,36,019,"New York","Clinton County",4,77,487,231,256
050,36,019,"New York","Clinton County",4,78,480,228,252
050,36,019,"New York","Clinton County",4,79,492,225,267
050,36,019,"New York","Clinton County",4,80,410,195,215
050,36,019,"New York","Clinton County",4,81,374,166,208
050,36,019,"New York","Clinton County",4,82,324,140,184
050,36,019,"New York","Clinton County",4,83,299,133,166
050,36,019,"New York","Clinton County",4,84,301,143,158
050,36,019,"New York","Clinton County",4,85,1540,572,968
050,36,019,"New York","Clinton County",5,0,671,337,334
050,36,019,"New York","Clinton County",5,1,685,343,342
050,36,019,"New York","Clinton County",5,2,653,332,321
050,36,019,"New York","Clinton County",5,3,712,373,339
050,36,019,"New York","Clinton County",5,4,733,393,340
050,36,019,"New York","Clinton County",5,5,746,377,369
050,36,019,"New York","Clinton County",5,6,796,403,393
050,36,019,"New York","Clinton County",5,7,802,401,401
050,36,019,"New York","Clinton County",5,8,813,413,400
050,36,019,"New York","Clinton County",5,9,804,433,371
050,36,019,"New York","Clinton County",5,10,814,430,384
050,36,019,"New York","Clinton County",5,11,823,433,390
050,36,019,"New York","Clinton County",5,12,848,416,432
050,36,019,"New York","Clinton County",5,13,847,435,412
050,36,019,"New York","Clinton County",5,14,836,436,400
050,36,019,"New York","Clinton County",5,15,895,475,420
050,36,019,"New York","Clinton County",5,16,863,442,421
050,36,019,"New York","Clinton County",5,17,839,429,410
050,36,019,"New York","Clinton County",5,18,1238,582,656
050,36,019,"New York","Clinton County",5,19,1501,735,766
050,36,019,"New York","Clinton County",5,20,1621,805,816
050,36,019,"New York","Clinton County",5,21,1614,778,836
050,36,019,"New York","Clinton County",5,22,1323,636,687
050,36,019,"New York","Clinton County",5,23,1227,630,597
050,36,019,"New York","Clinton County",5,24,963,500,463
050,36,019,"New York","Clinton County",5,25,905,468,437
050,36,019,"New York","Clinton County",5,26,827,419,408
050,36,019,"New York","Clinton County",5,27,854,484,370
050,36,019,"New York","Clinton County",5,28,863,454,409
050,36,019,"New York","Clinton County",5,29,918,527,391
050,36,019,"New York","Clinton County",5,30,956,513,443
050,36,019,"New York","Clinton County",5,31,953,493,460
050,36,019,"New York","Clinton County",5,32,964,506,458
050,36,019,"New York","Clinton County",5,33,950,507,443
050,36,019,"New York","Clinton County",5,34,922,533,389
050,36,019,"New York","Clinton County",5,35,941,537,404
050,36,019,"New York","Clinton County",5,36,936,506,430
050,36,019,"New York","Clinton County",5,37,940,507,433
050,36,019,"New York","Clinton County",5,38,1026,562,464
050,36,019,"New York","Clinton County",5,39,974,523,451
050,36,019,"New York","Clinton County",5,40,1004,546,458
050,36,019,"New York","Clinton County",5,41,980,510,470
050,36,019,"New York","Clinton County",5,42,961,510,451
050,36,019,"New York","Clinton County",5,43,1004,539,465
050,36,019,"New York","Clinton County",5,44,956,518,438
050,36,019,"New York","Clinton County",5,45,901,485,416
050,36,019,"New York","Clinton County",5,46,892,476,416
050,36,019,"New York","Clinton County",5,47,859,468,391
050,36,019,"New York","Clinton County",5,48,898,475,423
050,36,019,"New York","Clinton County",5,49,855,448,407
050,36,019,"New York","Clinton County",5,50,872,451,421
050,36,019,"New York","Clinton County",5,51,934,480,454
050,36,019,"New York","Clinton County",5,52,995,518,477
050,36,019,"New York","Clinton County",5,53,964,500,464
050,36,019,"New York","Clinton County",5,54,943,480,463
050,36,019,"New York","Clinton County",5,55,932,490,442
050,36,019,"New York","Clinton County",5,56,985,510,475
050,36,019,"New York","Clinton County",5,57,1016,491,525
050,36,019,"New York","Clinton County",5,58,1112,528,584
050,36,019,"New York","Clinton County",5,59,1188,568,620
050,36,019,"New York","Clinton County",5,60,1197,608,589
050,36,019,"New York","Clinton County",5,61,1181,608,573
050,36,019,"New York","Clinton County",5,62,1191,607,584
050,36,019,"New York","Clinton County",5,63,1133,556,577
050,36,019,"New York","Clinton County",5,64,1135,558,577
050,36,019,"New York","Clinton County",5,65,1150,582,568
050,36,019,"New York","Clinton County",5,66,1067,534,533
050,36,019,"New York","Clinton County",5,67,1013,507,506
050,36,019,"New York","Clinton County",5,68,990,500,490
050,36,019,"New York","Clinton County",5,69,932,475,457
050,36,019,"New York","Clinton County",5,70,845,420,425
050,36,019,"New York","Clinton County",5,71,831,410,421
050,36,019,"New York","Clinton County",5,72,811,381,430
050,36,019,"New York","Clinton County",5,73,784,373,411
050,36,019,"New York","Clinton County",5,74,783,377,406
050,36,019,"New York","Clinton County",5,75,731,349,382
050,36,019,"New York","Clinton County",5,76,739,360,379
050,36,019,"New York","Clinton County",5,77,497,239,258
050,36,019,"New York","Clinton County",5,78,460,217,243
050,36,019,"New York","Clinton County",5,79,452,213,239
050,36,019,"New York","Clinton County",5,80,473,217,256
050,36,019,"New York","Clinton County",5,81,392,183,209
050,36,019,"New York","Clinton County",5,82,336,146,190
050,36,019,"New York","Clinton County",5,83,301,135,166
050,36,019,"New York","Clinton County",5,84,288,127,161
050,36,019,"New York","Clinton County",5,85,1556,604,952
050,36,021,"New York","Columbia County",1,0,462,233,229
050,36,021,"New York","Columbia County",1,1,501,263,238
050,36,021,"New York","Columbia County",1,2,496,256,240
050,36,021,"New York","Columbia County",1,3,508,268,240
050,36,021,"New York","Columbia County",1,4,525,270,255
050,36,021,"New York","Columbia County",1,5,525,260,265
050,36,021,"New York","Columbia County",1,6,531,269,262
050,36,021,"New York","Columbia County",1,7,557,299,258
050,36,021,"New York","Columbia County",1,8,586,299,287
050,36,021,"New York","Columbia County",1,9,568,287,281
050,36,021,"New York","Columbia County",1,10,550,287,263
050,36,021,"New York","Columbia County",1,11,574,307,267
050,36,021,"New York","Columbia County",1,12,607,320,287
050,36,021,"New York","Columbia County",1,13,634,341,293
050,36,021,"New York","Columbia County",1,14,651,355,296
050,36,021,"New York","Columbia County",1,15,701,373,328
050,36,021,"New York","Columbia County",1,16,682,363,319
050,36,021,"New York","Columbia County",1,17,680,350,330
050,36,021,"New York","Columbia County",1,18,604,317,287
050,36,021,"New York","Columbia County",1,19,519,291,228
050,36,021,"New York","Columbia County",1,20,597,312,285
050,36,021,"New York","Columbia County",1,21,573,297,276
050,36,021,"New York","Columbia County",1,22,586,308,278
050,36,021,"New York","Columbia County",1,23,628,327,301
050,36,021,"New York","Columbia County",1,24,602,327,275
050,36,021,"New York","Columbia County",1,25,639,338,301
050,36,021,"New York","Columbia County",1,26,715,360,355
050,36,021,"New York","Columbia County",1,27,708,366,342
050,36,021,"New York","Columbia County",1,28,680,332,348
050,36,021,"New York","Columbia County",1,29,672,349,323
050,36,021,"New York","Columbia County",1,30,666,329,337
050,36,021,"New York","Columbia County",1,31,661,346,315
050,36,021,"New York","Columbia County",1,32,675,341,334
050,36,021,"New York","Columbia County",1,33,646,332,314
050,36,021,"New York","Columbia County",1,34,689,344,345
050,36,021,"New York","Columbia County",1,35,645,312,333
050,36,021,"New York","Columbia County",1,36,671,329,342
050,36,021,"New York","Columbia County",1,37,692,327,365
050,36,021,"New York","Columbia County",1,38,698,347,351
050,36,021,"New York","Columbia County",1,39,692,347,345
050,36,021,"New York","Columbia County",1,40,686,345,341
050,36,021,"New York","Columbia County",1,41,661,326,335
050,36,021,"New York","Columbia County",1,42,640,312,328
050,36,021,"New York","Columbia County",1,43,653,329,324
050,36,021,"New York","Columbia County",1,44,661,332,329
050,36,021,"New York","Columbia County",1,45,687,340,347
050,36,021,"New York","Columbia County",1,46,686,347,339
050,36,021,"New York","Columbia County",1,47,725,362,363
050,36,021,"New York","Columbia County",1,48,788,408,380
050,36,021,"New York","Columbia County",1,49,822,417,405
050,36,021,"New York","Columbia County",1,50,851,445,406
050,36,021,"New York","Columbia County",1,51,863,452,411
050,36,021,"New York","Columbia County",1,52,884,453,431
050,36,021,"New York","Columbia County",1,53,911,454,457
050,36,021,"New York","Columbia County",1,54,958,474,484
050,36,021,"New York","Columbia County",1,55,1011,516,495
050,36,021,"New York","Columbia County",1,56,1041,528,513
050,36,021,"New York","Columbia County",1,57,1036,533,503
050,36,021,"New York","Columbia County",1,58,1099,564,535
050,36,021,"New York","Columbia County",1,59,1074,546,528
050,36,021,"New York","Columbia County",1,60,1054,559,495
050,36,021,"New York","Columbia County",1,61,1036,520,516
050,36,021,"New York","Columbia County",1,62,1054,523,531
050,36,021,"New York","Columbia County",1,63,1017,504,513
050,36,021,"New York","Columbia County",1,64,1042,528,514
050,36,021,"New York","Columbia County",1,65,1037,519,518
050,36,021,"New York","Columbia County",1,66,982,475,507
050,36,021,"New York","Columbia County",1,67,991,480,511
050,36,021,"New York","Columbia County",1,68,972,474,498
050,36,021,"New York","Columbia County",1,69,857,434,423
050,36,021,"New York","Columbia County",1,70,875,425,450
050,36,021,"New York","Columbia County",1,71,863,422,441
050,36,021,"New York","Columbia County",1,72,854,422,432
050,36,021,"New York","Columbia County",1,73,895,421,474
050,36,021,"New York","Columbia County",1,74,617,315,302
050,36,021,"New York","Columbia County",1,75,599,311,288
050,36,021,"New York","Columbia County",1,76,611,297,314
050,36,021,"New York","Columbia County",1,77,619,291,328
050,36,021,"New York","Columbia County",1,78,534,264,270
050,36,021,"New York","Columbia County",1,79,430,209,221
050,36,021,"New York","Columbia County",1,80,381,181,200
050,36,021,"New York","Columbia County",1,81,370,163,207
050,36,021,"New York","Columbia County",1,82,325,148,177
050,36,021,"New York","Columbia County",1,83,283,129,154
050,36,021,"New York","Columbia County",1,84,253,89,164
050,36,021,"New York","Columbia County",1,85,1676,673,1003
050,36,021,"New York","Columbia County",2,0,466,239,227
050,36,021,"New York","Columbia County",2,1,489,254,235
050,36,021,"New York","Columbia County",2,2,498,257,241
050,36,021,"New York","Columbia County",2,3,507,266,241
050,36,021,"New York","Columbia County",2,4,525,268,257
050,36,021,"New York","Columbia County",2,5,526,263,263
050,36,021,"New York","Columbia County",2,6,531,269,262
050,36,021,"New York","Columbia County",2,7,550,290,260
050,36,021,"New York","Columbia County",2,8,574,296,278
050,36,021,"New York","Columbia County",2,9,569,289,280
050,36,021,"New York","Columbia County",2,10,555,286,269
050,36,021,"New York","Columbia County",2,11,563,300,263
050,36,021,"New York","Columbia County",2,12,602,320,282
050,36,021,"New York","Columbia County",2,13,630,336,294
050,36,021,"New York","Columbia County",2,14,652,356,296
050,36,021,"New York","Columbia County",2,15,692,372,320
050,36,021,"New York","Columbia County",2,16,688,369,319
050,36,021,"New York","Columbia County",2,17,679,351,328
050,36,021,"New York","Columbia County",2,18,590,309,281
050,36,021,"New York","Columbia County",2,19,521,284,237
050,36,021,"New York","Columbia County",2,20,593,316,277
050,36,021,"New York","Columbia County",2,21,577,300,277
050,36,021,"New York","Columbia County",2,22,588,308,280
050,36,021,"New York","Columbia County",2,23,624,326,298
050,36,021,"New York","Columbia County",2,24,602,325,277
050,36,021,"New York","Columbia County",2,25,640,342,298
050,36,021,"New York","Columbia County",2,26,699,357,342
050,36,021,"New York","Columbia County",2,27,708,364,344
050,36,021,"New York","Columbia County",2,28,684,339,345
050,36,021,"New York","Columbia County",2,29,670,340,330
050,36,021,"New York","Columbia County",2,30,678,337,341
050,36,021,"New York","Columbia County",2,31,661,342,319
050,36,021,"New York","Columbia County",2,32,677,347,330
050,36,021,"New York","Columbia County",2,33,655,337,318
050,36,021,"New York","Columbia County",2,34,683,345,338
050,36,021,"New York","Columbia County",2,35,662,323,339
050,36,021,"New York","Columbia County",2,36,669,328,341
050,36,021,"New York","Columbia County",2,37,691,328,363
050,36,021,"New York","Columbia County",2,38,704,347,357
050,36,021,"New York","Columbia County",2,39,698,348,350
050,36,021,"New York","Columbia County",2,40,698,350,348
050,36,021,"New York","Columbia County",2,41,670,332,338
050,36,021,"New York","Columbia County",2,42,641,314,327
050,36,021,"New York","Columbia County",2,43,654,328,326
050,36,021,"New York","Columbia County",2,44,649,328,321
050,36,021,"New York","Columbia County",2,45,691,344,347
050,36,021,"New York","Columbia County",2,46,682,347,335
050,36,021,"New York","Columbia County",2,47,710,357,353
050,36,021,"New York","Columbia County",2,48,772,398,374
050,36,021,"New York","Columbia County",2,49,816,414,402
050,36,021,"New York","Columbia County",2,50,851,443,408
050,36,021,"New York","Columbia County",2,51,857,449,408
050,36,021,"New York","Columbia County",2,52,878,453,425
050,36,021,"New York","Columbia County",2,53,897,450,447
050,36,021,"New York","Columbia County",2,54,942,466,476
050,36,021,"New York","Columbia County",2,55,1000,507,493
050,36,021,"New York","Columbia County",2,56,1036,530,506
050,36,021,"New York","Columbia County",2,57,1038,532,506
050,36,021,"New York","Columbia County",2,58,1083,554,529
050,36,021,"New York","Columbia County",2,59,1088,557,531
050,36,021,"New York","Columbia County",2,60,1059,554,505
050,36,021,"New York","Columbia County",2,61,1038,528,510
050,36,021,"New York","Columbia County",2,62,1052,523,529
050,36,021,"New York","Columbia County",2,63,1031,509,522
050,36,021,"New York","Columbia County",2,64,1020,513,507
050,36,021,"New York","Columbia County",2,65,1041,522,519
050,36,021,"New York","Columbia County",2,66,991,484,507
050,36,021,"New York","Columbia County",2,67,978,473,505
050,36,021,"New York","Columbia County",2,68,967,471,496
050,36,021,"New York","Columbia County",2,69,884,444,440
050,36,021,"New York","Columbia County",2,70,864,424,440
050,36,021,"New York","Columbia County",2,71,860,420,440
050,36,021,"New York","Columbia County",2,72,831,410,421
050,36,021,"New York","Columbia County",2,73,926,439,487
050,36,021,"New York","Columbia County",2,74,635,317,318
050,36,021,"New York","Columbia County",2,75,601,310,291
050,36,021,"New York","Columbia County",2,76,599,296,303
050,36,021,"New York","Columbia County",2,77,625,299,326
050,36,021,"New York","Columbia County",2,78,528,256,272
050,36,021,"New York","Columbia County",2,79,441,217,224
050,36,021,"New York","Columbia County",2,80,388,186,202
050,36,021,"New York","Columbia County",2,81,361,164,197
050,36,021,"New York","Columbia County",2,82,326,148,178
050,36,021,"New York","Columbia County",2,83,278,125,153
050,36,021,"New York","Columbia County",2,84,246,90,156
050,36,021,"New York","Columbia County",2,85,1621,661,960
050,36,021,"New York","Columbia County",3,0,425,226,199
050,36,021,"New York","Columbia County",3,1,473,237,236
050,36,021,"New York","Columbia County",3,2,499,258,241
050,36,021,"New York","Columbia County",3,3,503,255,248
050,36,021,"New York","Columbia County",3,4,513,280,233
050,36,021,"New York","Columbia County",3,5,537,276,261
050,36,021,"New York","Columbia County",3,6,517,259,258
050,36,021,"New York","Columbia County",3,7,519,260,259
050,36,021,"New York","Columbia County",3,8,568,297,271
050,36,021,"New York","Columbia County",3,9,569,292,277
050,36,021,"New York","Columbia County",3,10,567,287,280
050,36,021,"New York","Columbia County",3,11,553,283,270
050,36,021,"New York","Columbia County",3,12,549,286,263
050,36,021,"New York","Columbia County",3,13,607,315,292
050,36,021,"New York","Columbia County",3,14,646,348,298
050,36,021,"New York","Columbia County",3,15,660,361,299
050,36,021,"New York","Columbia County",3,16,682,375,307
050,36,021,"New York","Columbia County",3,17,684,364,320
050,36,021,"New York","Columbia County",3,18,583,307,276
050,36,021,"New York","Columbia County",3,19,483,246,237
050,36,021,"New York","Columbia County",3,20,593,327,266
050,36,021,"New York","Columbia County",3,21,593,310,283
050,36,021,"New York","Columbia County",3,22,596,301,295
050,36,021,"New York","Columbia County",3,23,636,325,311
050,36,021,"New York","Columbia County",3,24,579,313,266
050,36,021,"New York","Columbia County",3,25,639,353,286
050,36,021,"New York","Columbia County",3,26,645,348,297
050,36,021,"New York","Columbia County",3,27,692,357,335
050,36,021,"New York","Columbia County",3,28,700,349,351
050,36,021,"New York","Columbia County",3,29,693,341,352
050,36,021,"New York","Columbia County",3,30,698,350,348
050,36,021,"New York","Columbia County",3,31,704,340,364
050,36,021,"New York","Columbia County",3,32,714,371,343
050,36,021,"New York","Columbia County",3,33,705,349,356
050,36,021,"New York","Columbia County",3,34,703,358,345
050,36,021,"New York","Columbia County",3,35,749,383,366
050,36,021,"New York","Columbia County",3,36,704,347,357
050,36,021,"New York","Columbia County",3,37,694,336,358
050,36,021,"New York","Columbia County",3,38,718,352,366
050,36,021,"New York","Columbia County",3,39,735,365,370
050,36,021,"New York","Columbia County",3,40,723,371,352
050,36,021,"New York","Columbia County",3,41,717,367,350
050,36,021,"New York","Columbia County",3,42,693,339,354
050,36,021,"New York","Columbia County",3,43,667,332,335
050,36,021,"New York","Columbia County",3,44,657,327,330
050,36,021,"New York","Columbia County",3,45,681,348,333
050,36,021,"New York","Columbia County",3,46,695,348,347
050,36,021,"New York","Columbia County",3,47,679,338,341
050,36,021,"New York","Columbia County",3,48,719,370,349
050,36,021,"New York","Columbia County",3,49,762,399,363
050,36,021,"New York","Columbia County",3,50,827,418,409
050,36,021,"New York","Columbia County",3,51,861,442,419
050,36,021,"New York","Columbia County",3,52,869,464,405
050,36,021,"New York","Columbia County",3,53,876,454,422
050,36,021,"New York","Columbia County",3,54,902,454,448
050,36,021,"New York","Columbia County",3,55,956,482,474
050,36,021,"New York","Columbia County",3,56,1024,521,503
050,36,021,"New York","Columbia County",3,57,1043,537,506
050,36,021,"New York","Columbia County",3,58,1051,541,510
050,36,021,"New York","Columbia County",3,59,1088,569,519
050,36,021,"New York","Columbia County",3,60,1088,557,531
050,36,021,"New York","Columbia County",3,61,1059,546,513
050,36,021,"New York","Columbia County",3,62,1062,541,521
050,36,021,"New York","Columbia County",3,63,1035,504,531
050,36,021,"New York","Columbia County",3,64,1040,516,524
050,36,021,"New York","Columbia County",3,65,1042,521,521
050,36,021,"New York","Columbia County",3,66,1019,509,510
050,36,021,"New York","Columbia County",3,67,988,487,501
050,36,021,"New York","Columbia County",3,68,983,473,510
050,36,021,"New York","Columbia County",3,69,944,463,481
050,36,021,"New York","Columbia County",3,70,888,447,441
050,36,021,"New York","Columbia County",3,71,854,417,437
050,36,021,"New York","Columbia County",3,72,837,408,429
050,36,021,"New York","Columbia County",3,73,821,398,423
050,36,021,"New York","Columbia County",3,74,913,436,477
050,36,021,"New York","Columbia County",3,75,624,309,315
050,36,021,"New York","Columbia County",3,76,576,294,282
050,36,021,"New York","Columbia County",3,77,576,282,294
050,36,021,"New York","Columbia County",3,78,614,297,317
050,36,021,"New York","Columbia County",3,79,511,235,276
050,36,021,"New York","Columbia County",3,80,425,216,209
050,36,021,"New York","Columbia County",3,81,379,183,196
050,36,021,"New York","Columbia County",3,82,345,156,189
050,36,021,"New York","Columbia County",3,83,302,133,169
050,36,021,"New York","Columbia County",3,84,263,122,141
050,36,021,"New York","Columbia County",3,85,1656,648,1008
050,36,021,"New York","Columbia County",4,0,455,231,224
050,36,021,"New York","Columbia County",4,1,418,219,199
050,36,021,"New York","Columbia County",4,2,476,235,241
050,36,021,"New York","Columbia County",4,3,489,258,231
050,36,021,"New York","Columbia County",4,4,482,239,243
050,36,021,"New York","Columbia County",4,5,504,274,230
050,36,021,"New York","Columbia County",4,6,517,266,251
050,36,021,"New York","Columbia County",4,7,503,249,254
050,36,021,"New York","Columbia County",4,8,495,249,246
050,36,021,"New York","Columbia County",4,9,540,275,265
050,36,021,"New York","Columbia County",4,10,554,284,270
050,36,021,"New York","Columbia County",4,11,550,287,263
050,36,021,"New York","Columbia County",4,12,548,288,260
050,36,021,"New York","Columbia County",4,13,555,290,265
050,36,021,"New York","Columbia County",4,14,596,320,276
050,36,021,"New York","Columbia County",4,15,666,364,302
050,36,021,"New York","Columbia County",4,16,659,374,285
050,36,021,"New York","Columbia County",4,17,684,373,311
050,36,021,"New York","Columbia County",4,18,560,303,257
050,36,021,"New York","Columbia County",4,19,460,237,223
050,36,021,"New York","Columbia County",4,20,529,277,252
050,36,021,"New York","Columbia County",4,21,588,321,267
050,36,021,"New York","Columbia County",4,22,593,314,279
050,36,021,"New York","Columbia County",4,23,594,295,299
050,36,021,"New York","Columbia County",4,24,585,302,283
050,36,021,"New York","Columbia County",4,25,583,319,264
050,36,021,"New York","Columbia County",4,26,596,336,260
050,36,021,"New York","Columbia County",4,27,612,320,292
050,36,021,"New York","Columbia County",4,28,645,338,307
050,36,021,"New York","Columbia County",4,29,658,328,330
050,36,021,"New York","Columbia County",4,30,672,317,355
050,36,021,"New York","Columbia County",4,31,672,341,331
050,36,021,"New York","Columbia County",4,32,727,347,380
050,36,021,"New York","Columbia County",4,33,698,365,333
050,36,021,"New York","Columbia County",4,34,699,344,355
050,36,021,"New York","Columbia County",4,35,705,362,343
050,36,021,"New York","Columbia County",4,36,736,375,361
050,36,021,"New York","Columbia County",4,37,673,328,345
050,36,021,"New York","Columbia County",4,38,685,333,352
050,36,021,"New York","Columbia County",4,39,734,357,377
050,36,021,"New York","Columbia County",4,40,734,358,376
050,36,021,"New York","Columbia County",4,41,727,367,360
050,36,021,"New York","Columbia County",4,42,720,366,354
050,36,021,"New York","Columbia County",4,43,691,351,340
050,36,021,"New York","Columbia County",4,44,660,328,332
050,36,021,"New York","Columbia County",4,45,680,339,341
050,36,021,"New York","Columbia County",4,46,669,338,331
050,36,021,"New York","Columbia County",4,47,690,349,341
050,36,021,"New York","Columbia County",4,48,687,342,345
050,36,021,"New York","Columbia County",4,49,697,351,346
050,36,021,"New York","Columbia County",4,50,771,406,365
050,36,021,"New York","Columbia County",4,51,831,416,415
050,36,021,"New York","Columbia County",4,52,868,450,418
050,36,021,"New York","Columbia County",4,53,853,448,405
050,36,021,"New York","Columbia County",4,54,879,461,418
050,36,021,"New York","Columbia County",4,55,900,456,444
050,36,021,"New York","Columbia County",4,56,954,489,465
050,36,021,"New York","Columbia County",4,57,1020,518,502
050,36,021,"New York","Columbia County",4,58,1025,529,496
050,36,021,"New York","Columbia County",4,59,1041,535,506
050,36,021,"New York","Columbia County",4,60,1066,561,505
050,36,021,"New York","Columbia County",4,61,1071,540,531
050,36,021,"New York","Columbia County",4,62,1062,551,511
050,36,021,"New York","Columbia County",4,63,1024,518,506
050,36,021,"New York","Columbia County",4,64,1017,497,520
050,36,021,"New York","Columbia County",4,65,1065,527,538
050,36,021,"New York","Columbia County",4,66,1012,505,507
050,36,021,"New York","Columbia County",4,67,985,494,491
050,36,021,"New York","Columbia County",4,68,975,482,493
050,36,021,"New York","Columbia County",4,69,951,459,492
050,36,021,"New York","Columbia County",4,70,942,460,482
050,36,021,"New York","Columbia County",4,71,879,448,431
050,36,021,"New York","Columbia County",4,72,841,405,436
050,36,021,"New York","Columbia County",4,73,830,403,427
050,36,021,"New York","Columbia County",4,74,810,397,413
050,36,021,"New York","Columbia County",4,75,892,428,464
050,36,021,"New York","Columbia County",4,76,607,295,312
050,36,021,"New York","Columbia County",4,77,569,288,281
050,36,021,"New York","Columbia County",4,78,561,276,285
050,36,021,"New York","Columbia County",4,79,595,289,306
050,36,021,"New York","Columbia County",4,80,503,235,268
050,36,021,"New York","Columbia County",4,81,411,205,206
050,36,021,"New York","Columbia County",4,82,366,180,186
050,36,021,"New York","Columbia County",4,83,320,145,175
050,36,021,"New York","Columbia County",4,84,269,110,159
050,36,021,"New York","Columbia County",4,85,1693,676,1017
050,36,021,"New York","Columbia County",5,0,455,232,223
050,36,021,"New York","Columbia County",5,1,425,219,206
050,36,021,"New York","Columbia County",5,2,416,215,201
050,36,021,"New York","Columbia County",5,3,460,220,240
050,36,021,"New York","Columbia County",5,4,476,257,219
050,36,021,"New York","Columbia County",5,5,478,235,243
050,36,021,"New York","Columbia County",5,6,493,268,225
050,36,021,"New York","Columbia County",5,7,509,258,251
050,36,021,"New York","Columbia County",5,8,501,247,254
050,36,021,"New York","Columbia County",5,9,502,259,243
050,36,021,"New York","Columbia County",5,10,533,267,266
050,36,021,"New York","Columbia County",5,11,531,274,257
050,36,021,"New York","Columbia County",5,12,548,281,267
050,36,021,"New York","Columbia County",5,13,543,281,262
050,36,021,"New York","Columbia County",5,14,548,298,250
050,36,021,"New York","Columbia County",5,15,614,339,275
050,36,021,"New York","Columbia County",5,16,663,375,288
050,36,021,"New York","Columbia County",5,17,654,371,283
050,36,021,"New York","Columbia County",5,18,561,309,252
050,36,021,"New York","Columbia County",5,19,459,246,213
050,36,021,"New York","Columbia County",5,20,508,268,240
050,36,021,"New York","Columbia County",5,21,526,274,252
050,36,021,"New York","Columbia County",5,22,580,310,270
050,36,021,"New York","Columbia County",5,23,591,314,277
050,36,021,"New York","Columbia County",5,24,564,292,272
050,36,021,"New York","Columbia County",5,25,587,316,271
050,36,021,"New York","Columbia County",5,26,571,314,257
050,36,021,"New York","Columbia County",5,27,555,301,254
050,36,021,"New York","Columbia County",5,28,598,319,279
050,36,021,"New York","Columbia County",5,29,620,322,298
050,36,021,"New York","Columbia County",5,30,680,334,346
050,36,021,"New York","Columbia County",5,31,643,292,351
050,36,021,"New York","Columbia County",5,32,695,365,330
050,36,021,"New York","Columbia County",5,33,717,345,372
050,36,021,"New York","Columbia County",5,34,689,356,333
050,36,021,"New York","Columbia County",5,35,723,360,363
050,36,021,"New York","Columbia County",5,36,697,364,333
050,36,021,"New York","Columbia County",5,37,730,364,366
050,36,021,"New York","Columbia County",5,38,663,333,330
050,36,021,"New York","Columbia County",5,39,710,339,371
050,36,021,"New York","Columbia County",5,40,726,357,369
050,36,021,"New York","Columbia County",5,41,735,366,369
050,36,021,"New York","Columbia County",5,42,714,356,358
050,36,021,"New York","Columbia County",5,43,714,367,347
050,36,021,"New York","Columbia County",5,44,679,346,333
050,36,021,"New York","Columbia County",5,45,675,332,343
050,36,021,"New York","Columbia County",5,46,665,331,334
050,36,021,"New York","Columbia County",5,47,669,327,342
050,36,021,"New York","Columbia County",5,48,681,343,338
050,36,021,"New York","Columbia County",5,49,675,334,341
050,36,021,"New York","Columbia County",5,50,696,350,346
050,36,021,"New York","Columbia County",5,51,767,407,360
050,36,021,"New York","Columbia County",5,52,843,423,420
050,36,021,"New York","Columbia County",5,53,848,440,408
050,36,021,"New York","Columbia County",5,54,866,452,414
050,36,021,"New York","Columbia County",5,55,880,467,413
050,36,021,"New York","Columbia County",5,56,895,460,435
050,36,021,"New York","Columbia County",5,57,938,471,467
050,36,021,"New York","Columbia County",5,58,1002,512,490
050,36,021,"New York","Columbia County",5,59,1030,534,496
050,36,021,"New York","Columbia County",5,60,1035,532,503
050,36,021,"New York","Columbia County",5,61,1056,558,498
050,36,021,"New York","Columbia County",5,62,1070,552,518
050,36,021,"New York","Columbia County",5,63,1029,527,502
050,36,021,"New York","Columbia County",5,64,1015,509,506
050,36,021,"New York","Columbia County",5,65,1020,498,522
050,36,021,"New York","Columbia County",5,66,1033,513,520
050,36,021,"New York","Columbia County",5,67,1019,509,510
050,36,021,"New York","Columbia County",5,68,981,492,489
050,36,021,"New York","Columbia County",5,69,969,474,495
050,36,021,"New York","Columbia County",5,70,959,459,500
050,36,021,"New York","Columbia County",5,71,936,459,477
050,36,021,"New York","Columbia County",5,72,875,450,425
050,36,021,"New York","Columbia County",5,73,834,402,432
050,36,021,"New York","Columbia County",5,74,824,402,422
050,36,021,"New York","Columbia County",5,75,791,384,407
050,36,021,"New York","Columbia County",5,76,852,412,440
050,36,021,"New York","Columbia County",5,77,586,280,306
050,36,021,"New York","Columbia County",5,78,549,277,272
050,36,021,"New York","Columbia County",5,79,537,261,276
050,36,021,"New York","Columbia County",5,80,570,288,282
050,36,021,"New York","Columbia County",5,81,477,222,255
050,36,021,"New York","Columbia County",5,82,385,192,193
050,36,021,"New York","Columbia County",5,83,334,164,170
050,36,021,"New York","Columbia County",5,84,291,124,167
050,36,021,"New York","Columbia County",5,85,1729,692,1037
050,36,023,"New York","Cortland County",1,0,436,225,211
050,36,023,"New York","Cortland County",1,1,453,238,215
050,36,023,"New York","Cortland County",1,2,455,237,218
050,36,023,"New York","Cortland County",1,3,491,269,222
050,36,023,"New York","Cortland County",1,4,506,262,244
050,36,023,"New York","Cortland County",1,5,494,264,230
050,36,023,"New York","Cortland County",1,6,485,246,239
050,36,023,"New York","Cortland County",1,7,463,240,223
050,36,023,"New York","Cortland County",1,8,452,236,216
050,36,023,"New York","Cortland County",1,9,460,242,218
050,36,023,"New York","Cortland County",1,10,489,248,241
050,36,023,"New York","Cortland County",1,11,546,266,280
050,36,023,"New York","Cortland County",1,12,539,260,279
050,36,023,"New York","Cortland County",1,13,546,280,266
050,36,023,"New York","Cortland County",1,14,552,291,261
050,36,023,"New York","Cortland County",1,15,540,292,248
050,36,023,"New York","Cortland County",1,16,549,290,259
050,36,023,"New York","Cortland County",1,17,579,274,305
050,36,023,"New York","Cortland County",1,18,1149,473,676
050,36,023,"New York","Cortland County",1,19,1586,738,848
050,36,023,"New York","Cortland County",1,20,1511,688,823
050,36,023,"New York","Cortland County",1,21,1459,678,781
050,36,023,"New York","Cortland County",1,22,1214,584,630
050,36,023,"New York","Cortland County",1,23,723,386,337
050,36,023,"New York","Cortland County",1,24,641,319,322
050,36,023,"New York","Cortland County",1,25,579,281,298
050,36,023,"New York","Cortland County",1,26,559,271,288
050,36,023,"New York","Cortland County",1,27,516,263,253
050,36,023,"New York","Cortland County",1,28,507,239,268
050,36,023,"New York","Cortland County",1,29,529,270,259
050,36,023,"New York","Cortland County",1,30,536,293,243
050,36,023,"New York","Cortland County",1,31,512,274,238
050,36,023,"New York","Cortland County",1,32,487,259,228
050,36,023,"New York","Cortland County",1,33,494,243,251
050,36,023,"New York","Cortland County",1,34,529,268,261
050,36,023,"New York","Cortland County",1,35,516,247,269
050,36,023,"New York","Cortland County",1,36,472,229,243
050,36,023,"New York","Cortland County",1,37,523,281,242
050,36,023,"New York","Cortland County",1,38,511,269,242
050,36,023,"New York","Cortland County",1,39,508,259,249
050,36,023,"New York","Cortland County",1,40,503,241,262
050,36,023,"New York","Cortland County",1,41,506,266,240
050,36,023,"New York","Cortland County",1,42,537,290,247
050,36,023,"New York","Cortland County",1,43,467,239,228
050,36,023,"New York","Cortland County",1,44,450,237,213
050,36,023,"New York","Cortland County",1,45,462,247,215
050,36,023,"New York","Cortland County",1,46,445,226,219
050,36,023,"New York","Cortland County",1,47,468,224,244
050,36,023,"New York","Cortland County",1,48,538,266,272
050,36,023,"New York","Cortland County",1,49,583,303,280
050,36,023,"New York","Cortland County",1,50,544,286,258
050,36,023,"New York","Cortland County",1,51,559,283,276
050,36,023,"New York","Cortland County",1,52,537,266,271
050,36,023,"New York","Cortland County",1,53,573,309,264
050,36,023,"New York","Cortland County",1,54,575,294,281
050,36,023,"New York","Cortland County",1,55,615,297,318
050,36,023,"New York","Cortland County",1,56,650,310,340
050,36,023,"New York","Cortland County",1,57,660,329,331
050,36,023,"New York","Cortland County",1,58,652,307,345
050,36,023,"New York","Cortland County",1,59,641,313,328
050,36,023,"New York","Cortland County",1,60,625,330,295
050,36,023,"New York","Cortland County",1,61,595,309,286
050,36,023,"New York","Cortland County",1,62,612,310,302
050,36,023,"New York","Cortland County",1,63,582,311,271
050,36,023,"New York","Cortland County",1,64,546,270,276
050,36,023,"New York","Cortland County",1,65,557,261,296
050,36,023,"New York","Cortland County",1,66,513,248,265
050,36,023,"New York","Cortland County",1,67,499,242,257
050,36,023,"New York","Cortland County",1,68,492,246,246
050,36,023,"New York","Cortland County",1,69,481,232,249
050,36,023,"New York","Cortland County",1,70,446,221,225
050,36,023,"New York","Cortland County",1,71,457,223,234
050,36,023,"New York","Cortland County",1,72,453,220,233
050,36,023,"New York","Cortland County",1,73,427,207,220
050,36,023,"New York","Cortland County",1,74,300,147,153
050,36,023,"New York","Cortland County",1,75,294,143,151
050,36,023,"New York","Cortland County",1,76,317,144,173
050,36,023,"New York","Cortland County",1,77,277,115,162
050,36,023,"New York","Cortland County",1,78,254,120,134
050,36,023,"New York","Cortland County",1,79,235,109,126
050,36,023,"New York","Cortland County",1,80,215,89,126
050,36,023,"New York","Cortland County",1,81,203,91,112
050,36,023,"New York","Cortland County",1,82,173,81,92
050,36,023,"New York","Cortland County",1,83,151,67,84
050,36,023,"New York","Cortland County",1,84,152,61,91
050,36,023,"New York","Cortland County",1,85,883,317,566
050,36,023,"New York","Cortland County",2,0,464,243,221
050,36,023,"New York","Cortland County",2,1,442,231,211
050,36,023,"New York","Cortland County",2,2,453,237,216
050,36,023,"New York","Cortland County",2,3,483,261,222
050,36,023,"New York","Cortland County",2,4,505,266,239
050,36,023,"New York","Cortland County",2,5,495,263,232
050,36,023,"New York","Cortland County",2,6,490,252,238
050,36,023,"New York","Cortland County",2,7,468,241,227
050,36,023,"New York","Cortland County",2,8,454,236,218
050,36,023,"New York","Cortland County",2,9,459,241,218
050,36,023,"New York","Cortland County",2,10,480,245,235
050,36,023,"New York","Cortland County",2,11,529,260,269
050,36,023,"New York","Cortland County",2,12,544,262,282
050,36,023,"New York","Cortland County",2,13,545,276,269
050,36,023,"New York","Cortland County",2,14,551,288,263
050,36,023,"New York","Cortland County",2,15,541,291,250
050,36,023,"New York","Cortland County",2,16,548,289,259
050,36,023,"New York","Cortland County",2,17,571,277,294
050,36,023,"New York","Cortland County",2,18,1153,474,679
050,36,023,"New York","Cortland County",2,19,1579,729,850
050,36,023,"New York","Cortland County",2,20,1525,691,834
050,36,023,"New York","Cortland County",2,21,1455,675,780
050,36,023,"New York","Cortland County",2,22,1216,588,628
050,36,023,"New York","Cortland County",2,23,726,387,339
050,36,023,"New York","Cortland County",2,24,639,323,316
050,36,023,"New York","Cortland County",2,25,581,284,297
050,36,023,"New York","Cortland County",2,26,550,264,286
050,36,023,"New York","Cortland County",2,27,517,262,255
050,36,023,"New York","Cortland County",2,28,512,247,265
050,36,023,"New York","Cortland County",2,29,528,265,263
050,36,023,"New York","Cortland County",2,30,535,286,249
050,36,023,"New York","Cortland County",2,31,519,279,240
050,36,023,"New York","Cortland County",2,32,490,259,231
050,36,023,"New York","Cortland County",2,33,492,247,245
050,36,023,"New York","Cortland County",2,34,519,264,255
050,36,023,"New York","Cortland County",2,35,527,255,272
050,36,023,"New York","Cortland County",2,36,473,228,245
050,36,023,"New York","Cortland County",2,37,510,269,241
050,36,023,"New York","Cortland County",2,38,518,273,245
050,36,023,"New York","Cortland County",2,39,510,263,247
050,36,023,"New York","Cortland County",2,40,507,248,259
050,36,023,"New York","Cortland County",2,41,507,263,244
050,36,023,"New York","Cortland County",2,42,526,281,245
050,36,023,"New York","Cortland County",2,43,483,248,235
050,36,023,"New York","Cortland County",2,44,453,236,217
050,36,023,"New York","Cortland County",2,45,459,247,212
050,36,023,"New York","Cortland County",2,46,450,232,218
050,36,023,"New York","Cortland County",2,47,458,223,235
050,36,023,"New York","Cortland County",2,48,522,257,265
050,36,023,"New York","Cortland County",2,49,572,296,276
050,36,023,"New York","Cortland County",2,50,554,290,264
050,36,023,"New York","Cortland County",2,51,549,278,271
050,36,023,"New York","Cortland County",2,52,536,268,268
050,36,023,"New York","Cortland County",2,53,566,301,265
050,36,023,"New York","Cortland County",2,54,574,296,278
050,36,023,"New York","Cortland County",2,55,603,293,310
050,36,023,"New York","Cortland County",2,56,642,307,335
050,36,023,"New York","Cortland County",2,57,656,325,331
050,36,023,"New York","Cortland County",2,58,650,310,340
050,36,023,"New York","Cortland County",2,59,647,313,334
050,36,023,"New York","Cortland County",2,60,624,325,299
050,36,023,"New York","Cortland County",2,61,598,312,286
050,36,023,"New York","Cortland County",2,62,606,310,296
050,36,023,"New York","Cortland County",2,63,590,314,276
050,36,023,"New York","Cortland County",2,64,547,275,272
050,36,023,"New York","Cortland County",2,65,552,261,291
050,36,023,"New York","Cortland County",2,66,523,252,271
050,36,023,"New York","Cortland County",2,67,494,238,256
050,36,023,"New York","Cortland County",2,68,486,243,243
050,36,023,"New York","Cortland County",2,69,488,237,251
050,36,023,"New York","Cortland County",2,70,449,219,230
050,36,023,"New York","Cortland County",2,71,449,220,229
050,36,023,"New York","Cortland County",2,72,438,214,224
050,36,023,"New York","Cortland County",2,73,443,216,227
050,36,023,"New York","Cortland County",2,74,309,150,159
050,36,023,"New York","Cortland County",2,75,296,145,151
050,36,023,"New York","Cortland County",2,76,305,140,165
050,36,023,"New York","Cortland County",2,77,285,119,166
050,36,023,"New York","Cortland County",2,78,253,115,138
050,36,023,"New York","Cortland County",2,79,236,109,127
050,36,023,"New York","Cortland County",2,80,216,93,123
050,36,023,"New York","Cortland County",2,81,202,87,115
050,36,023,"New York","Cortland County",2,82,176,84,92
050,36,023,"New York","Cortland County",2,83,151,69,82
050,36,023,"New York","Cortland County",2,84,145,59,86
050,36,023,"New York","Cortland County",2,85,870,311,559
050,36,023,"New York","Cortland County",3,0,429,218,211
050,36,023,"New York","Cortland County",3,1,450,233,217
050,36,023,"New York","Cortland County",3,2,450,232,218
050,36,023,"New York","Cortland County",3,3,446,245,201
050,36,023,"New York","Cortland County",3,4,492,265,227
050,36,023,"New York","Cortland County",3,5,507,267,240
050,36,023,"New York","Cortland County",3,6,492,260,232
050,36,023,"New York","Cortland County",3,7,471,244,227
050,36,023,"New York","Cortland County",3,8,475,248,227
050,36,023,"New York","Cortland County",3,9,448,236,212
050,36,023,"New York","Cortland County",3,10,454,237,217
050,36,023,"New York","Cortland County",3,11,476,243,233
050,36,023,"New York","Cortland County",3,12,518,264,254
050,36,023,"New York","Cortland County",3,13,538,260,278
050,36,023,"New York","Cortland County",3,14,536,270,266
050,36,023,"New York","Cortland County",3,15,528,270,258
050,36,023,"New York","Cortland County",3,16,524,287,237
050,36,023,"New York","Cortland County",3,17,547,286,261
050,36,023,"New York","Cortland County",3,18,1207,500,707
050,36,023,"New York","Cortland County",3,19,1613,729,884
050,36,023,"New York","Cortland County",3,20,1545,689,856
050,36,023,"New York","Cortland County",3,21,1461,673,788
050,36,023,"New York","Cortland County",3,22,1219,600,619
050,36,023,"New York","Cortland County",3,23,717,384,333
050,36,023,"New York","Cortland County",3,24,611,324,287
050,36,023,"New York","Cortland County",3,25,577,289,288
050,36,023,"New York","Cortland County",3,26,534,250,284
050,36,023,"New York","Cortland County",3,27,532,256,276
050,36,023,"New York","Cortland County",3,28,523,264,259
050,36,023,"New York","Cortland County",3,29,526,252,274
050,36,023,"New York","Cortland County",3,30,534,279,255
050,36,023,"New York","Cortland County",3,31,519,272,247
050,36,023,"New York","Cortland County",3,32,512,268,244
050,36,023,"New York","Cortland County",3,33,494,274,220
050,36,023,"New York","Cortland County",3,34,480,241,239
050,36,023,"New York","Cortland County",3,35,520,254,266
050,36,023,"New York","Cortland County",3,36,518,256,262
050,36,023,"New York","Cortland County",3,37,469,232,237
050,36,023,"New York","Cortland County",3,38,520,267,253
050,36,023,"New York","Cortland County",3,39,517,273,244
050,36,023,"New York","Cortland County",3,40,505,264,241
050,36,023,"New York","Cortland County",3,41,509,253,256
050,36,023,"New York","Cortland County",3,42,505,262,243
050,36,023,"New York","Cortland County",3,43,511,260,251
050,36,023,"New York","Cortland County",3,44,499,255,244
050,36,023,"New York","Cortland County",3,45,432,234,198
050,36,023,"New York","Cortland County",3,46,466,252,214
050,36,023,"New York","Cortland County",3,47,431,220,211
050,36,023,"New York","Cortland County",3,48,464,227,237
050,36,023,"New York","Cortland County",3,49,509,246,263
050,36,023,"New York","Cortland County",3,50,561,282,279
050,36,023,"New York","Cortland County",3,51,560,290,270
050,36,023,"New York","Cortland County",3,52,538,281,257
050,36,023,"New York","Cortland County",3,53,552,290,262
050,36,023,"New York","Cortland County",3,54,535,276,259
050,36,023,"New York","Cortland County",3,55,555,284,271
050,36,023,"New York","Cortland County",3,56,598,297,301
050,36,023,"New York","Cortland County",3,57,629,302,327
050,36,023,"New York","Cortland County",3,58,649,315,334
050,36,023,"New York","Cortland County",3,59,642,307,335
050,36,023,"New York","Cortland County",3,60,651,317,334
050,36,023,"New York","Cortland County",3,61,601,316,285
050,36,023,"New York","Cortland County",3,62,588,297,291
050,36,023,"New York","Cortland County",3,63,607,317,290
050,36,023,"New York","Cortland County",3,64,573,296,277
050,36,023,"New York","Cortland County",3,65,534,266,268
050,36,023,"New York","Cortland County",3,66,539,255,284
050,36,023,"New York","Cortland County",3,67,510,239,271
050,36,023,"New York","Cortland County",3,68,481,228,253
050,36,023,"New York","Cortland County",3,69,491,244,247
050,36,023,"New York","Cortland County",3,70,458,223,235
050,36,023,"New York","Cortland County",3,71,436,215,221
050,36,023,"New York","Cortland County",3,72,438,215,223
050,36,023,"New York","Cortland County",3,73,403,186,217
050,36,023,"New York","Cortland County",3,74,421,202,219
050,36,023,"New York","Cortland County",3,75,292,142,150
050,36,023,"New York","Cortland County",3,76,284,135,149
050,36,023,"New York","Cortland County",3,77,287,128,159
050,36,023,"New York","Cortland County",3,78,270,115,155
050,36,023,"New York","Cortland County",3,79,247,112,135
050,36,023,"New York","Cortland County",3,80,229,103,126
050,36,023,"New York","Cortland County",3,81,200,79,121
050,36,023,"New York","Cortland County",3,82,172,76,96
050,36,023,"New York","Cortland County",3,83,162,76,86
050,36,023,"New York","Cortland County",3,84,143,64,79
050,36,023,"New York","Cortland County",3,85,817,298,519
050,36,023,"New York","Cortland County",4,0,415,202,213
050,36,023,"New York","Cortland County",4,1,424,207,217
050,36,023,"New York","Cortland County",4,2,445,229,216
050,36,023,"New York","Cortland County",4,3,441,224,217
050,36,023,"New York","Cortland County",4,4,446,242,204
050,36,023,"New York","Cortland County",4,5,500,264,236
050,36,023,"New York","Cortland County",4,6,488,255,233
050,36,023,"New York","Cortland County",4,7,498,262,236
050,36,023,"New York","Cortland County",4,8,464,235,229
050,36,023,"New York","Cortland County",4,9,465,238,227
050,36,023,"New York","Cortland County",4,10,442,228,214
050,36,023,"New York","Cortland County",4,11,446,230,216
050,36,023,"New York","Cortland County",4,12,480,248,232
050,36,023,"New York","Cortland County",4,13,525,266,259
050,36,023,"New York","Cortland County",4,14,524,248,276
050,36,023,"New York","Cortland County",4,15,526,262,264
050,36,023,"New York","Cortland County",4,16,530,268,262
050,36,023,"New York","Cortland County",4,17,528,285,243
050,36,023,"New York","Cortland County",4,18,1205,509,696
050,36,023,"New York","Cortland County",4,19,1659,758,901
050,36,023,"New York","Cortland County",4,20,1557,672,885
050,36,023,"New York","Cortland County",4,21,1459,657,802
050,36,023,"New York","Cortland County",4,22,1216,584,632
050,36,023,"New York","Cortland County",4,23,709,389,320
050,36,023,"New York","Cortland County",4,24,634,339,295
050,36,023,"New York","Cortland County",4,25,548,285,263
050,36,023,"New York","Cortland County",4,26,526,247,279
050,36,023,"New York","Cortland County",4,27,519,256,263
050,36,023,"New York","Cortland County",4,28,528,254,274
050,36,023,"New York","Cortland County",4,29,532,271,261
050,36,023,"New York","Cortland County",4,30,488,225,263
050,36,023,"New York","Cortland County",4,31,532,278,254
050,36,023,"New York","Cortland County",4,32,523,267,256
050,36,023,"New York","Cortland County",4,33,497,253,244
050,36,023,"New York","Cortland County",4,34,477,266,211
050,36,023,"New York","Cortland County",4,35,499,250,249
050,36,023,"New York","Cortland County",4,36,516,260,256
050,36,023,"New York","Cortland County",4,37,522,266,256
050,36,023,"New York","Cortland County",4,38,476,230,246
050,36,023,"New York","Cortland County",4,39,508,264,244
050,36,023,"New York","Cortland County",4,40,512,272,240
050,36,023,"New York","Cortland County",4,41,513,268,245
050,36,023,"New York","Cortland County",4,42,506,251,255
050,36,023,"New York","Cortland County",4,43,490,243,247
050,36,023,"New York","Cortland County",4,44,507,257,250
050,36,023,"New York","Cortland County",4,45,482,250,232
050,36,023,"New York","Cortland County",4,46,424,227,197
050,36,023,"New York","Cortland County",4,47,456,243,213
050,36,023,"New York","Cortland County",4,48,441,227,214
050,36,023,"New York","Cortland County",4,49,441,217,224
050,36,023,"New York","Cortland County",4,50,504,238,266
050,36,023,"New York","Cortland County",4,51,547,276,271
050,36,023,"New York","Cortland County",4,52,560,294,266
050,36,023,"New York","Cortland County",4,53,546,292,254
050,36,023,"New York","Cortland County",4,54,537,275,262
050,36,023,"New York","Cortland County",4,55,529,270,259
050,36,023,"New York","Cortland County",4,56,544,283,261
050,36,023,"New York","Cortland County",4,57,580,288,292
050,36,023,"New York","Cortland County",4,58,609,290,319
050,36,023,"New York","Cortland County",4,59,650,311,339
050,36,023,"New York","Cortland County",4,60,638,311,327
050,36,023,"New York","Cortland County",4,61,630,308,322
050,36,023,"New York","Cortland County",4,62,591,309,282
050,36,023,"New York","Cortland County",4,63,577,298,279
050,36,023,"New York","Cortland County",4,64,595,305,290
050,36,023,"New York","Cortland County",4,65,542,282,260
050,36,023,"New York","Cortland County",4,66,531,270,261
050,36,023,"New York","Cortland County",4,67,532,244,288
050,36,023,"New York","Cortland County",4,68,490,229,261
050,36,023,"New York","Cortland County",4,69,487,234,253
050,36,023,"New York","Cortland County",4,70,472,232,240
050,36,023,"New York","Cortland County",4,71,455,223,232
050,36,023,"New York","Cortland County",4,72,427,212,215
050,36,023,"New York","Cortland County",4,73,409,197,212
050,36,023,"New York","Cortland County",4,74,386,178,208
050,36,023,"New York","Cortland County",4,75,404,194,210
050,36,023,"New York","Cortland County",4,76,275,133,142
050,36,023,"New York","Cortland County",4,77,271,128,143
050,36,023,"New York","Cortland County",4,78,269,122,147
050,36,023,"New York","Cortland County",4,79,255,106,149
050,36,023,"New York","Cortland County",4,80,231,102,129
050,36,023,"New York","Cortland County",4,81,220,95,125
050,36,023,"New York","Cortland County",4,82,182,71,111
050,36,023,"New York","Cortland County",4,83,153,62,91
050,36,023,"New York","Cortland County",4,84,158,69,89
050,36,023,"New York","Cortland County",4,85,806,298,508
050,36,023,"New York","Cortland County",5,0,417,203,214
050,36,023,"New York","Cortland County",5,1,393,193,200
050,36,023,"New York","Cortland County",5,2,439,217,222
050,36,023,"New York","Cortland County",5,3,436,227,209
050,36,023,"New York","Cortland County",5,4,434,224,210
050,36,023,"New York","Cortland County",5,5,433,235,198
050,36,023,"New York","Cortland County",5,6,511,272,239
050,36,023,"New York","Cortland County",5,7,495,258,237
050,36,023,"New York","Cortland County",5,8,497,261,236
050,36,023,"New York","Cortland County",5,9,468,242,226
050,36,023,"New York","Cortland County",5,10,450,237,213
050,36,023,"New York","Cortland County",5,11,439,226,213
050,36,023,"New York","Cortland County",5,12,439,222,217
050,36,023,"New York","Cortland County",5,13,472,245,227
050,36,023,"New York","Cortland County",5,14,508,255,253
050,36,023,"New York","Cortland County",5,15,531,261,270
050,36,023,"New York","Cortland County",5,16,526,262,264
050,36,023,"New York","Cortland County",5,17,532,267,265
050,36,023,"New York","Cortland County",5,18,1181,507,674
050,36,023,"New York","Cortland County",5,19,1658,763,895
050,36,023,"New York","Cortland County",5,20,1560,685,875
050,36,023,"New York","Cortland County",5,21,1449,637,812
050,36,023,"New York","Cortland County",5,22,1192,571,621
050,36,023,"New York","Cortland County",5,23,707,373,334
050,36,023,"New York","Cortland County",5,24,605,329,276
050,36,023,"New York","Cortland County",5,25,554,301,253
050,36,023,"New York","Cortland County",5,26,483,247,236
050,36,023,"New York","Cortland County",5,27,505,243,262
050,36,023,"New York","Cortland County",5,28,526,262,264
050,36,023,"New York","Cortland County",5,29,526,247,279
050,36,023,"New York","Cortland County",5,30,515,265,250
050,36,023,"New York","Cortland County",5,31,496,217,279
050,36,023,"New York","Cortland County",5,32,544,275,269
050,36,023,"New York","Cortland County",5,33,505,264,241
050,36,023,"New York","Cortland County",5,34,462,243,219
050,36,023,"New York","Cortland County",5,35,486,266,220
050,36,023,"New York","Cortland County",5,36,505,254,251
050,36,023,"New York","Cortland County",5,37,518,266,252
050,36,023,"New York","Cortland County",5,38,528,258,270
050,36,023,"New York","Cortland County",5,39,472,228,244
050,36,023,"New York","Cortland County",5,40,503,257,246
050,36,023,"New York","Cortland County",5,41,512,273,239
050,36,023,"New York","Cortland County",5,42,516,271,245
050,36,023,"New York","Cortland County",5,43,489,237,252
050,36,023,"New York","Cortland County",5,44,508,253,255
050,36,023,"New York","Cortland County",5,45,495,251,244
050,36,023,"New York","Cortland County",5,46,481,253,228
050,36,023,"New York","Cortland County",5,47,424,226,198
050,36,023,"New York","Cortland County",5,48,458,243,215
050,36,023,"New York","Cortland County",5,49,432,229,203
050,36,023,"New York","Cortland County",5,50,429,211,218
050,36,023,"New York","Cortland County",5,51,497,236,261
050,36,023,"New York","Cortland County",5,52,557,283,274
050,36,023,"New York","Cortland County",5,53,567,308,259
050,36,023,"New York","Cortland County",5,54,526,276,250
050,36,023,"New York","Cortland County",5,55,521,262,259
050,36,023,"New York","Cortland County",5,56,521,266,255
050,36,023,"New York","Cortland County",5,57,539,278,261
050,36,023,"New York","Cortland County",5,58,556,272,284
050,36,023,"New York","Cortland County",5,59,612,293,319
050,36,023,"New York","Cortland County",5,60,641,308,333
050,36,023,"New York","Cortland County",5,61,605,295,310
050,36,023,"New York","Cortland County",5,62,616,296,320
050,36,023,"New York","Cortland County",5,63,587,314,273
050,36,023,"New York","Cortland County",5,64,578,287,291
050,36,023,"New York","Cortland County",5,65,563,286,277
050,36,023,"New York","Cortland County",5,66,535,283,252
050,36,023,"New York","Cortland County",5,67,524,262,262
050,36,023,"New York","Cortland County",5,68,526,243,283
050,36,023,"New York","Cortland County",5,69,491,228,263
050,36,023,"New York","Cortland County",5,70,464,219,245
050,36,023,"New York","Cortland County",5,71,470,228,242
050,36,023,"New York","Cortland County",5,72,449,217,232
050,36,023,"New York","Cortland County",5,73,410,197,213
050,36,023,"New York","Cortland County",5,74,399,195,204
050,36,023,"New York","Cortland County",5,75,375,172,203
050,36,023,"New York","Cortland County",5,76,384,182,202
050,36,023,"New York","Cortland County",5,77,262,126,136
050,36,023,"New York","Cortland County",5,78,263,124,139
050,36,023,"New York","Cortland County",5,79,256,115,141
050,36,023,"New York","Cortland County",5,80,240,97,143
050,36,023,"New York","Cortland County",5,81,225,90,135
050,36,023,"New York","Cortland County",5,82,197,85,112
050,36,023,"New York","Cortland County",5,83,168,62,106
050,36,023,"New York","Cortland County",5,84,149,58,91
050,36,023,"New York","Cortland County",5,85,835,310,525
050,36,025,"New York","Delaware County",1,0,366,188,178
050,36,025,"New York","Delaware County",1,1,360,191,169
050,36,025,"New York","Delaware County",1,2,371,207,164
050,36,025,"New York","Delaware County",1,3,355,186,169
050,36,025,"New York","Delaware County",1,4,344,166,178
050,36,025,"New York","Delaware County",1,5,370,180,190
050,36,025,"New York","Delaware County",1,6,363,181,182
050,36,025,"New York","Delaware County",1,7,389,204,185
050,36,025,"New York","Delaware County",1,8,366,196,170
050,36,025,"New York","Delaware County",1,9,429,212,217
050,36,025,"New York","Delaware County",1,10,415,221,194
050,36,025,"New York","Delaware County",1,11,451,230,221
050,36,025,"New York","Delaware County",1,12,461,236,225
050,36,025,"New York","Delaware County",1,13,463,239,224
050,36,025,"New York","Delaware County",1,14,457,216,241
050,36,025,"New York","Delaware County",1,15,431,220,211
050,36,025,"New York","Delaware County",1,16,448,228,220
050,36,025,"New York","Delaware County",1,17,490,258,232
050,36,025,"New York","Delaware County",1,18,753,433,320
050,36,025,"New York","Delaware County",1,19,811,468,343
050,36,025,"New York","Delaware County",1,20,647,370,277
050,36,025,"New York","Delaware County",1,21,555,280,275
050,36,025,"New York","Delaware County",1,22,458,230,228
050,36,025,"New York","Delaware County",1,23,409,210,199
050,36,025,"New York","Delaware County",1,24,408,222,186
050,36,025,"New York","Delaware County",1,25,440,227,213
050,36,025,"New York","Delaware County",1,26,455,237,218
050,36,025,"New York","Delaware County",1,27,438,225,213
050,36,025,"New York","Delaware County",1,28,434,241,193
050,36,025,"New York","Delaware County",1,29,434,238,196
050,36,025,"New York","Delaware County",1,30,461,241,220
050,36,025,"New York","Delaware County",1,31,469,247,222
050,36,025,"New York","Delaware County",1,32,441,231,210
050,36,025,"New York","Delaware County",1,33,443,225,218
050,36,025,"New York","Delaware County",1,34,462,230,232
050,36,025,"New York","Delaware County",1,35,454,226,228
050,36,025,"New York","Delaware County",1,36,415,216,199
050,36,025,"New York","Delaware County",1,37,451,227,224
050,36,025,"New York","Delaware County",1,38,448,224,224
050,36,025,"New York","Delaware County",1,39,468,225,243
050,36,025,"New York","Delaware County",1,40,457,224,233
050,36,025,"New York","Delaware County",1,41,429,206,223
050,36,025,"New York","Delaware County",1,42,428,215,213
050,36,025,"New York","Delaware County",1,43,452,218,234
050,36,025,"New York","Delaware County",1,44,417,201,216
050,36,025,"New York","Delaware County",1,45,437,227,210
050,36,025,"New York","Delaware County",1,46,454,237,217
050,36,025,"New York","Delaware County",1,47,463,242,221
050,36,025,"New York","Delaware County",1,48,529,272,257
050,36,025,"New York","Delaware County",1,49,592,301,291
050,36,025,"New York","Delaware County",1,50,584,290,294
050,36,025,"New York","Delaware County",1,51,563,289,274
050,36,025,"New York","Delaware County",1,52,572,279,293
050,36,025,"New York","Delaware County",1,53,583,291,292
050,36,025,"New York","Delaware County",1,54,611,300,311
050,36,025,"New York","Delaware County",1,55,623,325,298
050,36,025,"New York","Delaware County",1,56,728,376,352
050,36,025,"New York","Delaware County",1,57,715,352,363
050,36,025,"New York","Delaware County",1,58,764,364,400
050,36,025,"New York","Delaware County",1,59,712,359,353
050,36,025,"New York","Delaware County",1,60,752,387,365
050,36,025,"New York","Delaware County",1,61,810,417,393
050,36,025,"New York","Delaware County",1,62,803,409,394
050,36,025,"New York","Delaware County",1,63,785,401,384
050,36,025,"New York","Delaware County",1,64,760,397,363
050,36,025,"New York","Delaware County",1,65,757,396,361
050,36,025,"New York","Delaware County",1,66,725,373,352
050,36,025,"New York","Delaware County",1,67,678,344,334
050,36,025,"New York","Delaware County",1,68,679,338,341
050,36,025,"New York","Delaware County",1,69,656,332,324
050,36,025,"New York","Delaware County",1,70,631,317,314
050,36,025,"New York","Delaware County",1,71,640,335,305
050,36,025,"New York","Delaware County",1,72,650,341,309
050,36,025,"New York","Delaware County",1,73,631,318,313
050,36,025,"New York","Delaware County",1,74,458,221,237
050,36,025,"New York","Delaware County",1,75,467,233,234
050,36,025,"New York","Delaware County",1,76,468,240,228
050,36,025,"New York","Delaware County",1,77,478,237,241
050,36,025,"New York","Delaware County",1,78,390,190,200
050,36,025,"New York","Delaware County",1,79,356,177,179
050,36,025,"New York","Delaware County",1,80,300,129,171
050,36,025,"New York","Delaware County",1,81,276,129,147
050,36,025,"New York","Delaware County",1,82,259,117,142
050,36,025,"New York","Delaware County",1,83,245,107,138
050,36,025,"New York","Delaware County",1,84,223,109,114
050,36,025,"New York","Delaware County",1,85,1238,480,758
050,36,025,"New York","Delaware County",2,0,382,200,182
050,36,025,"New York","Delaware County",2,1,360,191,169
050,36,025,"New York","Delaware County",2,2,366,202,164
050,36,025,"New York","Delaware County",2,3,357,192,165
050,36,025,"New York","Delaware County",2,4,349,173,176
050,36,025,"New York","Delaware County",2,5,362,175,187
050,36,025,"New York","Delaware County",2,6,367,183,184
050,36,025,"New York","Delaware County",2,7,379,197,182
050,36,025,"New York","Delaware County",2,8,368,196,172
050,36,025,"New York","Delaware County",2,9,410,207,203
050,36,025,"New York","Delaware County",2,10,419,219,200
050,36,025,"New York","Delaware County",2,11,437,226,211
050,36,025,"New York","Delaware County",2,12,460,236,224
050,36,025,"New York","Delaware County",2,13,461,238,223
050,36,025,"New York","Delaware County",2,14,458,222,236
050,36,025,"New York","Delaware County",2,15,437,220,217
050,36,025,"New York","Delaware County",2,16,447,229,218
050,36,025,"New York","Delaware County",2,17,484,254,230
050,36,025,"New York","Delaware County",2,18,747,426,321
050,36,025,"New York","Delaware County",2,19,805,465,340
050,36,025,"New York","Delaware County",2,20,649,372,277
050,36,025,"New York","Delaware County",2,21,551,282,269
050,36,025,"New York","Delaware County",2,22,455,229,226
050,36,025,"New York","Delaware County",2,23,417,213,204
050,36,025,"New York","Delaware County",2,24,405,216,189
050,36,025,"New York","Delaware County",2,25,432,226,206
050,36,025,"New York","Delaware County",2,26,451,234,217
050,36,025,"New York","Delaware County",2,27,442,228,214
050,36,025,"New York","Delaware County",2,28,429,234,195
050,36,025,"New York","Delaware County",2,29,433,237,196
050,36,025,"New York","Delaware County",2,30,455,240,215
050,36,025,"New York","Delaware County",2,31,462,242,220
050,36,025,"New York","Delaware County",2,32,448,234,214
050,36,025,"New York","Delaware County",2,33,447,228,219
050,36,025,"New York","Delaware County",2,34,457,229,228
050,36,025,"New York","Delaware County",2,35,454,226,228
050,36,025,"New York","Delaware County",2,36,423,218,205
050,36,025,"New York","Delaware County",2,37,446,227,219
050,36,025,"New York","Delaware County",2,38,453,226,227
050,36,025,"New York","Delaware County",2,39,463,227,236
050,36,025,"New York","Delaware County",2,40,466,228,238
050,36,025,"New York","Delaware County",2,41,438,211,227
050,36,025,"New York","Delaware County",2,42,427,213,214
050,36,025,"New York","Delaware County",2,43,451,219,232
050,36,025,"New York","Delaware County",2,44,419,202,217
050,36,025,"New York","Delaware County",2,45,435,221,214
050,36,025,"New York","Delaware County",2,46,445,233,212
050,36,025,"New York","Delaware County",2,47,459,241,218
050,36,025,"New York","Delaware County",2,48,512,264,248
050,36,025,"New York","Delaware County",2,49,582,298,284
050,36,025,"New York","Delaware County",2,50,587,296,291
050,36,025,"New York","Delaware County",2,51,567,288,279
050,36,025,"New York","Delaware County",2,52,568,281,287
050,36,025,"New York","Delaware County",2,53,581,288,293
050,36,025,"New York","Delaware County",2,54,603,298,305
050,36,025,"New York","Delaware County",2,55,619,319,300
050,36,025,"New York","Delaware County",2,56,701,364,337
050,36,025,"New York","Delaware County",2,57,719,357,362
050,36,025,"New York","Delaware County",2,58,753,363,390
050,36,025,"New York","Delaware County",2,59,726,360,366
050,36,025,"New York","Delaware County",2,60,743,382,361
050,36,025,"New York","Delaware County",2,61,794,408,386
050,36,025,"New York","Delaware County",2,62,803,409,394
050,36,025,"New York","Delaware County",2,63,794,406,388
050,36,025,"New York","Delaware County",2,64,760,394,366
050,36,025,"New York","Delaware County",2,65,756,395,361
050,36,025,"New York","Delaware County",2,66,731,377,354
050,36,025,"New York","Delaware County",2,67,687,350,337
050,36,025,"New York","Delaware County",2,68,673,337,336
050,36,025,"New York","Delaware County",2,69,657,330,327
050,36,025,"New York","Delaware County",2,70,632,317,315
050,36,025,"New York","Delaware County",2,71,637,329,308
050,36,025,"New York","Delaware County",2,72,634,333,301
050,36,025,"New York","Delaware County",2,73,663,341,322
050,36,025,"New York","Delaware County",2,74,467,229,238
050,36,025,"New York","Delaware County",2,75,463,227,236
050,36,025,"New York","Delaware County",2,76,457,230,227
050,36,025,"New York","Delaware County",2,77,485,242,243
050,36,025,"New York","Delaware County",2,78,400,195,205
050,36,025,"New York","Delaware County",2,79,351,177,174
050,36,025,"New York","Delaware County",2,80,313,140,173
050,36,025,"New York","Delaware County",2,81,270,121,149
050,36,025,"New York","Delaware County",2,82,261,120,141
050,36,025,"New York","Delaware County",2,83,245,106,139
050,36,025,"New York","Delaware County",2,84,222,106,116
050,36,025,"New York","Delaware County",2,85,1248,490,758
050,36,025,"New York","Delaware County",3,0,356,164,192
050,36,025,"New York","Delaware County",3,1,370,192,178
050,36,025,"New York","Delaware County",3,2,369,198,171
050,36,025,"New York","Delaware County",3,3,373,208,165
050,36,025,"New York","Delaware County",3,4,358,196,162
050,36,025,"New York","Delaware County",3,5,355,173,182
050,36,025,"New York","Delaware County",3,6,367,170,197
050,36,025,"New York","Delaware County",3,7,366,180,186
050,36,025,"New York","Delaware County",3,8,379,202,177
050,36,025,"New York","Delaware County",3,9,378,203,175
050,36,025,"New York","Delaware County",3,10,406,204,202
050,36,025,"New York","Delaware County",3,11,418,223,195
050,36,025,"New York","Delaware County",3,12,430,223,207
050,36,025,"New York","Delaware County",3,13,453,237,216
050,36,025,"New York","Delaware County",3,14,461,239,222
050,36,025,"New York","Delaware County",3,15,468,229,239
050,36,025,"New York","Delaware County",3,16,457,232,225
050,36,025,"New York","Delaware County",3,17,460,238,222
050,36,025,"New York","Delaware County",3,18,802,462,340
050,36,025,"New York","Delaware County",3,19,858,497,361
050,36,025,"New York","Delaware County",3,20,670,388,282
050,36,025,"New York","Delaware County",3,21,561,301,260
050,36,025,"New York","Delaware County",3,22,452,224,228
050,36,025,"New York","Delaware County",3,23,442,220,222
050,36,025,"New York","Delaware County",3,24,401,207,194
050,36,025,"New York","Delaware County",3,25,404,211,193
050,36,025,"New York","Delaware County",3,26,418,216,202
050,36,025,"New York","Delaware County",3,27,418,223,195
050,36,025,"New York","Delaware County",3,28,427,219,208
050,36,025,"New York","Delaware County",3,29,450,244,206
050,36,025,"New York","Delaware County",3,30,465,246,219
050,36,025,"New York","Delaware County",3,31,468,244,224
050,36,025,"New York","Delaware County",3,32,490,255,235
050,36,025,"New York","Delaware County",3,33,475,257,218
050,36,025,"New York","Delaware County",3,34,472,245,227
050,36,025,"New York","Delaware County",3,35,475,238,237
050,36,025,"New York","Delaware County",3,36,495,251,244
050,36,025,"New York","Delaware County",3,37,443,234,209
050,36,025,"New York","Delaware County",3,38,486,246,240
050,36,025,"New York","Delaware County",3,39,479,246,233
050,36,025,"New York","Delaware County",3,40,476,239,237
050,36,025,"New York","Delaware County",3,41,502,251,251
050,36,025,"New York","Delaware County",3,42,472,239,233
050,36,025,"New York","Delaware County",3,43,444,218,226
050,36,025,"New York","Delaware County",3,44,464,223,241
050,36,025,"New York","Delaware County",3,45,435,218,217
050,36,025,"New York","Delaware County",3,46,441,221,220
050,36,025,"New York","Delaware County",3,47,460,245,215
050,36,025,"New York","Delaware County",3,48,467,242,225
050,36,025,"New York","Delaware County",3,49,522,265,257
050,36,025,"New York","Delaware County",3,50,577,294,283
050,36,025,"New York","Delaware County",3,51,604,303,301
050,36,025,"New York","Delaware County",3,52,570,287,283
050,36,025,"New York","Delaware County",3,53,565,288,277
050,36,025,"New York","Delaware County",3,54,580,285,295
050,36,025,"New York","Delaware County",3,55,614,305,309
050,36,025,"New York","Delaware County",3,56,629,318,311
050,36,025,"New York","Delaware County",3,57,711,365,346
050,36,025,"New York","Delaware County",3,58,724,360,364
050,36,025,"New York","Delaware County",3,59,764,364,400
050,36,025,"New York","Delaware County",3,60,743,379,364
050,36,025,"New York","Delaware County",3,61,757,386,371
050,36,025,"New York","Delaware County",3,62,791,410,381
050,36,025,"New York","Delaware County",3,63,805,406,399
050,36,025,"New York","Delaware County",3,64,796,405,391
050,36,025,"New York","Delaware County",3,65,762,393,369
050,36,025,"New York","Delaware County",3,66,753,391,362
050,36,025,"New York","Delaware County",3,67,728,381,347
050,36,025,"New York","Delaware County",3,68,695,348,347
050,36,025,"New York","Delaware County",3,69,657,328,329
050,36,025,"New York","Delaware County",3,70,645,313,332
050,36,025,"New York","Delaware County",3,71,630,317,313
050,36,025,"New York","Delaware County",3,72,623,322,301
050,36,025,"New York","Delaware County",3,73,617,326,291
050,36,025,"New York","Delaware County",3,74,652,342,310
050,36,025,"New York","Delaware County",3,75,439,209,230
050,36,025,"New York","Delaware County",3,76,447,215,232
050,36,025,"New York","Delaware County",3,77,442,223,219
050,36,025,"New York","Delaware County",3,78,474,232,242
050,36,025,"New York","Delaware County",3,79,388,193,195
050,36,025,"New York","Delaware County",3,80,322,156,166
050,36,025,"New York","Delaware County",3,81,292,126,166
050,36,025,"New York","Delaware County",3,82,254,119,135
050,36,025,"New York","Delaware County",3,83,229,96,133
050,36,025,"New York","Delaware County",3,84,230,98,132
050,36,025,"New York","Delaware County",3,85,1251,511,740
050,36,025,"New York","Delaware County",4,0,348,170,178
050,36,025,"New York","Delaware County",4,1,353,173,180
050,36,025,"New York","Delaware County",4,2,363,188,175
050,36,025,"New York","Delaware County",4,3,369,197,172
050,36,025,"New York","Delaware County",4,4,386,215,171
050,36,025,"New York","Delaware County",4,5,357,197,160
050,36,025,"New York","Delaware County",4,6,350,170,180
050,36,025,"New York","Delaware County",4,7,377,176,201
050,36,025,"New York","Delaware County",4,8,365,188,177
050,36,025,"New York","Delaware County",4,9,391,206,185
050,36,025,"New York","Delaware County",4,10,363,198,165
050,36,025,"New York","Delaware County",4,11,407,207,200
050,36,025,"New York","Delaware County",4,12,428,228,200
050,36,025,"New York","Delaware County",4,13,421,222,199
050,36,025,"New York","Delaware County",4,14,456,238,218
050,36,025,"New York","Delaware County",4,15,468,239,229
050,36,025,"New York","Delaware County",4,16,481,235,246
050,36,025,"New York","Delaware County",4,17,470,246,224
050,36,025,"New York","Delaware County",4,18,833,474,359
050,36,025,"New York","Delaware County",4,19,927,543,384
050,36,025,"New York","Delaware County",4,20,702,412,290
050,36,025,"New York","Delaware County",4,21,563,302,261
050,36,025,"New York","Delaware County",4,22,453,249,204
050,36,025,"New York","Delaware County",4,23,431,204,227
050,36,025,"New York","Delaware County",4,24,426,218,208
050,36,025,"New York","Delaware County",4,25,398,209,189
050,36,025,"New York","Delaware County",4,26,397,201,196
050,36,025,"New York","Delaware County",4,27,400,203,197
050,36,025,"New York","Delaware County",4,28,438,226,212
050,36,025,"New York","Delaware County",4,29,445,227,218
050,36,025,"New York","Delaware County",4,30,441,237,204
050,36,025,"New York","Delaware County",4,31,454,240,214
050,36,025,"New York","Delaware County",4,32,464,239,225
050,36,025,"New York","Delaware County",4,33,506,263,243
050,36,025,"New York","Delaware County",4,34,474,254,220
050,36,025,"New York","Delaware County",4,35,466,244,222
050,36,025,"New York","Delaware County",4,36,490,252,238
050,36,025,"New York","Delaware County",4,37,494,253,241
050,36,025,"New York","Delaware County",4,38,452,235,217
050,36,025,"New York","Delaware County",4,39,496,245,251
050,36,025,"New York","Delaware County",4,40,477,243,234
050,36,025,"New York","Delaware County",4,41,486,237,249
050,36,025,"New York","Delaware County",4,42,509,257,252
050,36,025,"New York","Delaware County",4,43,504,256,248
050,36,025,"New York","Delaware County",4,44,452,225,227
050,36,025,"New York","Delaware County",4,45,473,232,241
050,36,025,"New York","Delaware County",4,46,443,220,223
050,36,025,"New York","Delaware County",4,47,449,226,223
050,36,025,"New York","Delaware County",4,48,464,245,219
050,36,025,"New York","Delaware County",4,49,468,241,227
050,36,025,"New York","Delaware County",4,50,506,263,243
050,36,025,"New York","Delaware County",4,51,574,293,281
050,36,025,"New York","Delaware County",4,52,606,313,293
050,36,025,"New York","Delaware County",4,53,573,285,288
050,36,025,"New York","Delaware County",4,54,563,288,275
050,36,025,"New York","Delaware County",4,55,579,281,298
050,36,025,"New York","Delaware County",4,56,627,308,319
050,36,025,"New York","Delaware County",4,57,641,322,319
050,36,025,"New York","Delaware County",4,58,711,379,332
050,36,025,"New York","Delaware County",4,59,713,354,359
050,36,025,"New York","Delaware County",4,60,751,364,387
050,36,025,"New York","Delaware County",4,61,757,389,368
050,36,025,"New York","Delaware County",4,62,765,389,376
050,36,025,"New York","Delaware County",4,63,806,417,389
050,36,025,"New York","Delaware County",4,64,799,404,395
050,36,025,"New York","Delaware County",4,65,790,404,386
050,36,025,"New York","Delaware County",4,66,753,392,361
050,36,025,"New York","Delaware County",4,67,733,385,348
050,36,025,"New York","Delaware County",4,68,702,358,344
050,36,025,"New York","Delaware County",4,69,679,336,343
050,36,025,"New York","Delaware County",4,70,629,309,320
050,36,025,"New York","Delaware County",4,71,637,305,332
050,36,025,"New York","Delaware County",4,72,614,308,306
050,36,025,"New York","Delaware County",4,73,607,314,293
050,36,025,"New York","Delaware County",4,74,614,328,286
050,36,025,"New York","Delaware County",4,75,634,330,304
050,36,025,"New York","Delaware County",4,76,422,200,222
050,36,025,"New York","Delaware County",4,77,420,198,222
050,36,025,"New York","Delaware County",4,78,415,207,208
050,36,025,"New York","Delaware County",4,79,459,227,232
050,36,025,"New York","Delaware County",4,80,366,177,189
050,36,025,"New York","Delaware County",4,81,299,145,154
050,36,025,"New York","Delaware County",4,82,276,122,154
050,36,025,"New York","Delaware County",4,83,232,98,134
050,36,025,"New York","Delaware County",4,84,214,84,130
050,36,025,"New York","Delaware County",4,85,1280,528,752
050,36,025,"New York","Delaware County",5,0,349,171,178
050,36,025,"New York","Delaware County",5,1,336,156,180
050,36,025,"New York","Delaware County",5,2,336,167,169
050,36,025,"New York","Delaware County",5,3,351,176,175
050,36,025,"New York","Delaware County",5,4,371,199,172
050,36,025,"New York","Delaware County",5,5,369,205,164
050,36,025,"New York","Delaware County",5,6,342,189,153
050,36,025,"New York","Delaware County",5,7,345,160,185
050,36,025,"New York","Delaware County",5,8,368,174,194
050,36,025,"New York","Delaware County",5,9,357,185,172
050,36,025,"New York","Delaware County",5,10,387,202,185
050,36,025,"New York","Delaware County",5,11,370,203,167
050,36,025,"New York","Delaware County",5,12,413,210,203
050,36,025,"New York","Delaware County",5,13,434,236,198
050,36,025,"New York","Delaware County",5,14,409,218,191
050,36,025,"New York","Delaware County",5,15,472,248,224
050,36,025,"New York","Delaware County",5,16,477,238,239
050,36,025,"New York","Delaware County",5,17,507,256,251
050,36,025,"New York","Delaware County",5,18,839,482,357
050,36,025,"New York","Delaware County",5,19,922,538,384
050,36,025,"New York","Delaware County",5,20,693,408,285
050,36,025,"New York","Delaware County",5,21,553,296,257
050,36,025,"New York","Delaware County",5,22,443,236,207
050,36,025,"New York","Delaware County",5,23,421,224,197
050,36,025,"New York","Delaware County",5,24,390,197,193
050,36,025,"New York","Delaware County",5,25,425,217,208
050,36,025,"New York","Delaware County",5,26,373,195,178
050,36,025,"New York","Delaware County",5,27,385,187,198
050,36,025,"New York","Delaware County",5,28,399,193,206
050,36,025,"New York","Delaware County",5,29,438,227,211
050,36,025,"New York","Delaware County",5,30,427,217,210
050,36,025,"New York","Delaware County",5,31,447,238,209
050,36,025,"New York","Delaware County",5,32,466,243,223
050,36,025,"New York","Delaware County",5,33,473,248,225
050,36,025,"New York","Delaware County",5,34,509,259,250
050,36,025,"New York","Delaware County",5,35,465,248,217
050,36,025,"New York","Delaware County",5,36,462,245,217
050,36,025,"New York","Delaware County",5,37,487,251,236
050,36,025,"New York","Delaware County",5,38,510,263,247
050,36,025,"New York","Delaware County",5,39,466,244,222
050,36,025,"New York","Delaware County",5,40,493,246,247
050,36,025,"New York","Delaware County",5,41,472,236,236
050,36,025,"New York","Delaware County",5,42,487,241,246
050,36,025,"New York","Delaware County",5,43,514,261,253
050,36,025,"New York","Delaware County",5,44,500,251,249
050,36,025,"New York","Delaware County",5,45,458,224,234
050,36,025,"New York","Delaware County",5,46,470,230,240
050,36,025,"New York","Delaware County",5,47,447,218,229
050,36,025,"New York","Delaware County",5,48,449,229,220
050,36,025,"New York","Delaware County",5,49,465,243,222
050,36,025,"New York","Delaware County",5,50,468,244,224
050,36,025,"New York","Delaware County",5,51,513,266,247
050,36,025,"New York","Delaware County",5,52,568,283,285
050,36,025,"New York","Delaware County",5,53,607,311,296
050,36,025,"New York","Delaware County",5,54,575,282,293
050,36,025,"New York","Delaware County",5,55,565,288,277
050,36,025,"New York","Delaware County",5,56,574,272,302
050,36,025,"New York","Delaware County",5,57,632,316,316
050,36,025,"New York","Delaware County",5,58,638,320,318
050,36,025,"New York","Delaware County",5,59,704,368,336
050,36,025,"New York","Delaware County",5,60,716,359,357
050,36,025,"New York","Delaware County",5,61,764,375,389
050,36,025,"New York","Delaware County",5,62,742,381,361
050,36,025,"New York","Delaware County",5,63,766,390,376
050,36,025,"New York","Delaware County",5,64,810,420,390
050,36,025,"New York","Delaware County",5,65,780,396,384
050,36,025,"New York","Delaware County",5,66,793,406,387
050,36,025,"New York","Delaware County",5,67,749,393,356
050,36,025,"New York","Delaware County",5,68,726,380,346
050,36,025,"New York","Delaware County",5,69,673,351,322
050,36,025,"New York","Delaware County",5,70,661,320,341
050,36,025,"New York","Delaware County",5,71,624,308,316
050,36,025,"New York","Delaware County",5,72,613,294,319
050,36,025,"New York","Delaware County",5,73,598,303,295
050,36,025,"New York","Delaware County",5,74,591,306,285
050,36,025,"New York","Delaware County",5,75,593,317,276
050,36,025,"New York","Delaware County",5,76,619,321,298
050,36,025,"New York","Delaware County",5,77,404,193,211
050,36,025,"New York","Delaware County",5,78,403,185,218
050,36,025,"New York","Delaware County",5,79,395,202,193
050,36,025,"New York","Delaware County",5,80,438,213,225
050,36,025,"New York","Delaware County",5,81,337,162,175
050,36,025,"New York","Delaware County",5,82,273,139,134
050,36,025,"New York","Delaware County",5,83,251,102,149
050,36,025,"New York","Delaware County",5,84,209,84,125
050,36,025,"New York","Delaware County",5,85,1297,537,760
050,36,027,"New York","Dutchess County",1,0,2584,1330,1254
050,36,027,"New York","Dutchess County",1,1,2644,1332,1312
050,36,027,"New York","Dutchess County",1,2,2752,1392,1360
050,36,027,"New York","Dutchess County",1,3,2757,1428,1329
050,36,027,"New York","Dutchess County",1,4,2864,1441,1423
050,36,027,"New York","Dutchess County",1,5,2895,1493,1402
050,36,027,"New York","Dutchess County",1,6,2866,1499,1367
050,36,027,"New York","Dutchess County",1,7,2952,1546,1406
050,36,027,"New York","Dutchess County",1,8,2988,1559,1429
050,36,027,"New York","Dutchess County",1,9,3046,1551,1495
050,36,027,"New York","Dutchess County",1,10,3194,1622,1572
050,36,027,"New York","Dutchess County",1,11,3139,1595,1544
050,36,027,"New York","Dutchess County",1,12,3343,1730,1613
050,36,027,"New York","Dutchess County",1,13,3460,1778,1682
050,36,027,"New York","Dutchess County",1,14,3429,1745,1684
050,36,027,"New York","Dutchess County",1,15,3544,1830,1714
050,36,027,"New York","Dutchess County",1,16,3781,1973,1808
050,36,027,"New York","Dutchess County",1,17,3914,2040,1874
050,36,027,"New York","Dutchess County",1,18,4649,2266,2383
050,36,027,"New York","Dutchess County",1,19,5218,2498,2720
050,36,027,"New York","Dutchess County",1,20,4862,2350,2512
050,36,027,"New York","Dutchess County",1,21,4572,2249,2323
050,36,027,"New York","Dutchess County",1,22,4122,2036,2086
050,36,027,"New York","Dutchess County",1,23,3630,1841,1789
050,36,027,"New York","Dutchess County",1,24,3617,1901,1716
050,36,027,"New York","Dutchess County",1,25,3482,1841,1641
050,36,027,"New York","Dutchess County",1,26,3470,1863,1607
050,36,027,"New York","Dutchess County",1,27,3573,1909,1664
050,36,027,"New York","Dutchess County",1,28,3602,1855,1747
050,36,027,"New York","Dutchess County",1,29,3580,1897,1683
050,36,027,"New York","Dutchess County",1,30,3616,1909,1707
050,36,027,"New York","Dutchess County",1,31,3519,1824,1695
050,36,027,"New York","Dutchess County",1,32,3475,1790,1685
050,36,027,"New York","Dutchess County",1,33,3466,1797,1669
050,36,027,"New York","Dutchess County",1,34,3525,1806,1719
050,36,027,"New York","Dutchess County",1,35,3507,1831,1676
050,36,027,"New York","Dutchess County",1,36,3477,1775,1702
050,36,027,"New York","Dutchess County",1,37,3537,1784,1753
050,36,027,"New York","Dutchess County",1,38,3549,1793,1756
050,36,027,"New York","Dutchess County",1,39,3591,1859,1732
050,36,027,"New York","Dutchess County",1,40,3636,1869,1767
050,36,027,"New York","Dutchess County",1,41,3567,1821,1746
050,36,027,"New York","Dutchess County",1,42,3373,1724,1649
050,36,027,"New York","Dutchess County",1,43,3428,1777,1651
050,36,027,"New York","Dutchess County",1,44,3477,1772,1705
050,36,027,"New York","Dutchess County",1,45,3557,1822,1735
050,36,027,"New York","Dutchess County",1,46,3477,1771,1706
050,36,027,"New York","Dutchess County",1,47,3600,1797,1803
050,36,027,"New York","Dutchess County",1,48,3751,1906,1845
050,36,027,"New York","Dutchess County",1,49,4277,2144,2133
050,36,027,"New York","Dutchess County",1,50,4259,2170,2089
050,36,027,"New York","Dutchess County",1,51,4195,2121,2074
050,36,027,"New York","Dutchess County",1,52,4168,2043,2125
050,36,027,"New York","Dutchess County",1,53,4359,2164,2195
050,36,027,"New York","Dutchess County",1,54,4633,2300,2333
050,36,027,"New York","Dutchess County",1,55,4764,2351,2413
050,36,027,"New York","Dutchess County",1,56,4777,2364,2413
050,36,027,"New York","Dutchess County",1,57,4828,2412,2416
050,36,027,"New York","Dutchess County",1,58,4827,2417,2410
050,36,027,"New York","Dutchess County",1,59,4854,2417,2437
050,36,027,"New York","Dutchess County",1,60,4731,2396,2335
050,36,027,"New York","Dutchess County",1,61,4534,2330,2204
050,36,027,"New York","Dutchess County",1,62,4366,2258,2108
050,36,027,"New York","Dutchess County",1,63,4241,2133,2108
050,36,027,"New York","Dutchess County",1,64,4019,2000,2019
050,36,027,"New York","Dutchess County",1,65,3890,1889,2001
050,36,027,"New York","Dutchess County",1,66,3695,1835,1860
050,36,027,"New York","Dutchess County",1,67,3489,1751,1738
050,36,027,"New York","Dutchess County",1,68,3352,1617,1735
050,36,027,"New York","Dutchess County",1,69,3085,1449,1636
050,36,027,"New York","Dutchess County",1,70,2884,1389,1495
050,36,027,"New York","Dutchess County",1,71,2815,1333,1482
050,36,027,"New York","Dutchess County",1,72,2948,1373,1575
050,36,027,"New York","Dutchess County",1,73,2905,1351,1554
050,36,027,"New York","Dutchess County",1,74,2096,959,1137
050,36,027,"New York","Dutchess County",1,75,2103,981,1122
050,36,027,"New York","Dutchess County",1,76,2074,911,1163
050,36,027,"New York","Dutchess County",1,77,2033,913,1120
050,36,027,"New York","Dutchess County",1,78,1739,791,948
050,36,027,"New York","Dutchess County",1,79,1564,686,878
050,36,027,"New York","Dutchess County",1,80,1429,621,808
050,36,027,"New York","Dutchess County",1,81,1343,589,754
050,36,027,"New York","Dutchess County",1,82,1291,561,730
050,36,027,"New York","Dutchess County",1,83,1144,482,662
050,36,027,"New York","Dutchess County",1,84,1059,417,642
050,36,027,"New York","Dutchess County",1,85,6594,2349,4245
050,36,027,"New York","Dutchess County",2,0,2629,1344,1285
050,36,027,"New York","Dutchess County",2,1,2633,1333,1300
050,36,027,"New York","Dutchess County",2,2,2736,1385,1351
050,36,027,"New York","Dutchess County",2,3,2752,1419,1333
050,36,027,"New York","Dutchess County",2,4,2847,1446,1401
050,36,027,"New York","Dutchess County",2,5,2894,1484,1410
050,36,027,"New York","Dutchess County",2,6,2881,1501,1380
050,36,027,"New York","Dutchess County",2,7,2926,1531,1395
050,36,027,"New York","Dutchess County",2,8,2975,1552,1423
050,36,027,"New York","Dutchess County",2,9,3034,1555,1479
050,36,027,"New York","Dutchess County",2,10,3161,1605,1556
050,36,027,"New York","Dutchess County",2,11,3146,1601,1545
050,36,027,"New York","Dutchess County",2,12,3308,1704,1604
050,36,027,"New York","Dutchess County",2,13,3426,1766,1660
050,36,027,"New York","Dutchess County",2,14,3439,1755,1684
050,36,027,"New York","Dutchess County",2,15,3534,1820,1714
050,36,027,"New York","Dutchess County",2,16,3736,1951,1785
050,36,027,"New York","Dutchess County",2,17,3892,2034,1858
050,36,027,"New York","Dutchess County",2,18,4571,2244,2327
050,36,027,"New York","Dutchess County",2,19,5086,2436,2650
050,36,027,"New York","Dutchess County",2,20,4802,2311,2491
050,36,027,"New York","Dutchess County",2,21,4471,2199,2272
050,36,027,"New York","Dutchess County",2,22,4049,2001,2048
050,36,027,"New York","Dutchess County",2,23,3605,1820,1785
050,36,027,"New York","Dutchess County",2,24,3591,1879,1712
050,36,027,"New York","Dutchess County",2,25,3477,1831,1646
050,36,027,"New York","Dutchess County",2,26,3454,1843,1611
050,36,027,"New York","Dutchess County",2,27,3529,1877,1652
050,36,027,"New York","Dutchess County",2,28,3587,1857,1730
050,36,027,"New York","Dutchess County",2,29,3575,1873,1702
050,36,027,"New York","Dutchess County",2,30,3618,1899,1719
050,36,027,"New York","Dutchess County",2,31,3526,1822,1704
050,36,027,"New York","Dutchess County",2,32,3485,1788,1697
050,36,027,"New York","Dutchess County",2,33,3464,1790,1674
050,36,027,"New York","Dutchess County",2,34,3511,1797,1714
050,36,027,"New York","Dutchess County",2,35,3533,1832,1701
050,36,027,"New York","Dutchess County",2,36,3463,1770,1693
050,36,027,"New York","Dutchess County",2,37,3521,1774,1747
050,36,027,"New York","Dutchess County",2,38,3553,1787,1766
050,36,027,"New York","Dutchess County",2,39,3561,1832,1729
050,36,027,"New York","Dutchess County",2,40,3650,1874,1776
050,36,027,"New York","Dutchess County",2,41,3565,1814,1751
050,36,027,"New York","Dutchess County",2,42,3392,1727,1665
050,36,027,"New York","Dutchess County",2,43,3434,1764,1670
050,36,027,"New York","Dutchess County",2,44,3424,1753,1671
050,36,027,"New York","Dutchess County",2,45,3537,1805,1732
050,36,027,"New York","Dutchess County",2,46,3473,1767,1706
050,36,027,"New York","Dutchess County",2,47,3546,1773,1773
050,36,027,"New York","Dutchess County",2,48,3690,1858,1832
050,36,027,"New York","Dutchess County",2,49,4153,2090,2063
050,36,027,"New York","Dutchess County",2,50,4253,2157,2096
050,36,027,"New York","Dutchess County",2,51,4185,2115,2070
050,36,027,"New York","Dutchess County",2,52,4143,2039,2104
050,36,027,"New York","Dutchess County",2,53,4306,2128,2178
050,36,027,"New York","Dutchess County",2,54,4546,2255,2291
050,36,027,"New York","Dutchess County",2,55,4712,2326,2386
050,36,027,"New York","Dutchess County",2,56,4770,2349,2421
050,36,027,"New York","Dutchess County",2,57,4801,2389,2412
050,36,027,"New York","Dutchess County",2,58,4808,2405,2403
050,36,027,"New York","Dutchess County",2,59,4853,2415,2438
050,36,027,"New York","Dutchess County",2,60,4727,2378,2349
050,36,027,"New York","Dutchess County",2,61,4539,2322,2217
050,36,027,"New York","Dutchess County",2,62,4372,2261,2111
050,36,027,"New York","Dutchess County",2,63,4284,2170,2114
050,36,027,"New York","Dutchess County",2,64,4024,2001,2023
050,36,027,"New York","Dutchess County",2,65,3895,1902,1993
050,36,027,"New York","Dutchess County",2,66,3740,1845,1895
050,36,027,"New York","Dutchess County",2,67,3503,1748,1755
050,36,027,"New York","Dutchess County",2,68,3343,1625,1718
050,36,027,"New York","Dutchess County",2,69,3133,1477,1656
050,36,027,"New York","Dutchess County",2,70,2920,1392,1528
050,36,027,"New York","Dutchess County",2,71,2816,1334,1482
050,36,027,"New York","Dutchess County",2,72,2853,1334,1519
050,36,027,"New York","Dutchess County",2,73,3022,1405,1617
050,36,027,"New York","Dutchess County",2,74,2152,985,1167
050,36,027,"New York","Dutchess County",2,75,2084,964,1120
050,36,027,"New York","Dutchess County",2,76,2043,902,1141
050,36,027,"New York","Dutchess County",2,77,2066,918,1148
050,36,027,"New York","Dutchess County",2,78,1772,795,977
050,36,027,"New York","Dutchess County",2,79,1571,693,878
050,36,027,"New York","Dutchess County",2,80,1450,632,818
050,36,027,"New York","Dutchess County",2,81,1335,584,751
050,36,027,"New York","Dutchess County",2,82,1291,556,735
050,36,027,"New York","Dutchess County",2,83,1151,495,656
050,36,027,"New York","Dutchess County",2,84,1054,423,631
050,36,027,"New York","Dutchess County",2,85,6539,2329,4210
050,36,027,"New York","Dutchess County",3,0,2602,1343,1259
050,36,027,"New York","Dutchess County",3,1,2668,1352,1316
050,36,027,"New York","Dutchess County",3,2,2754,1394,1360
050,36,027,"New York","Dutchess County",3,3,2759,1400,1359
050,36,027,"New York","Dutchess County",3,4,2813,1441,1372
050,36,027,"New York","Dutchess County",3,5,2871,1459,1412
050,36,027,"New York","Dutchess County",3,6,2929,1496,1433
050,36,027,"New York","Dutchess County",3,7,2925,1516,1409
050,36,027,"New York","Dutchess County",3,8,2982,1560,1422
050,36,027,"New York","Dutchess County",3,9,2998,1564,1434
050,36,027,"New York","Dutchess County",3,10,3045,1562,1483
050,36,027,"New York","Dutchess County",3,11,3176,1617,1559
050,36,027,"New York","Dutchess County",3,12,3182,1610,1572
050,36,027,"New York","Dutchess County",3,13,3322,1707,1615
050,36,027,"New York","Dutchess County",3,14,3451,1777,1674
050,36,027,"New York","Dutchess County",3,15,3513,1800,1713
050,36,027,"New York","Dutchess County",3,16,3602,1883,1719
050,36,027,"New York","Dutchess County",3,17,3802,2006,1796
050,36,027,"New York","Dutchess County",3,18,4746,2358,2388
050,36,027,"New York","Dutchess County",3,19,5363,2564,2799
050,36,027,"New York","Dutchess County",3,20,5048,2383,2665
050,36,027,"New York","Dutchess County",3,21,4609,2264,2345
050,36,027,"New York","Dutchess County",3,22,4054,2036,2018
050,36,027,"New York","Dutchess County",3,23,3559,1801,1758
050,36,027,"New York","Dutchess County",3,24,3655,1928,1727
050,36,027,"New York","Dutchess County",3,25,3595,1882,1713
050,36,027,"New York","Dutchess County",3,26,3480,1855,1625
050,36,027,"New York","Dutchess County",3,27,3489,1859,1630
050,36,027,"New York","Dutchess County",3,28,3698,1969,1729
050,36,027,"New York","Dutchess County",3,29,3665,1874,1791
050,36,027,"New York","Dutchess County",3,30,3720,1964,1756
050,36,027,"New York","Dutchess County",3,31,3748,1940,1808
050,36,027,"New York","Dutchess County",3,32,3677,1879,1798
050,36,027,"New York","Dutchess County",3,33,3574,1869,1705
050,36,027,"New York","Dutchess County",3,34,3595,1865,1730
050,36,027,"New York","Dutchess County",3,35,3661,1892,1769
050,36,027,"New York","Dutchess County",3,36,3696,1910,1786
050,36,027,"New York","Dutchess County",3,37,3553,1806,1747
050,36,027,"New York","Dutchess County",3,38,3598,1815,1783
050,36,027,"New York","Dutchess County",3,39,3657,1867,1790
050,36,027,"New York","Dutchess County",3,40,3699,1906,1793
050,36,027,"New York","Dutchess County",3,41,3740,1916,1824
050,36,027,"New York","Dutchess County",3,42,3642,1855,1787
050,36,027,"New York","Dutchess County",3,43,3489,1773,1716
050,36,027,"New York","Dutchess County",3,44,3502,1805,1697
050,36,027,"New York","Dutchess County",3,45,3454,1800,1654
050,36,027,"New York","Dutchess County",3,46,3585,1851,1734
050,36,027,"New York","Dutchess County",3,47,3520,1786,1734
050,36,027,"New York","Dutchess County",3,48,3533,1756,1777
050,36,027,"New York","Dutchess County",3,49,3792,1920,1872
050,36,027,"New York","Dutchess County",3,50,4161,2103,2058
050,36,027,"New York","Dutchess County",3,51,4279,2179,2100
050,36,027,"New York","Dutchess County",3,52,4149,2092,2057
050,36,027,"New York","Dutchess County",3,53,4118,2033,2085
050,36,027,"New York","Dutchess County",3,54,4302,2148,2154
050,36,027,"New York","Dutchess County",3,55,4480,2230,2250
050,36,027,"New York","Dutchess County",3,56,4704,2326,2378
050,36,027,"New York","Dutchess County",3,57,4701,2318,2383
050,36,027,"New York","Dutchess County",3,58,4776,2365,2411
050,36,027,"New York","Dutchess County",3,59,4769,2388,2381
050,36,027,"New York","Dutchess County",3,60,4765,2360,2405
050,36,027,"New York","Dutchess County",3,61,4672,2347,2325
050,36,027,"New York","Dutchess County",3,62,4431,2268,2163
050,36,027,"New York","Dutchess County",3,63,4317,2211,2106
050,36,027,"New York","Dutchess County",3,64,4205,2121,2084
050,36,027,"New York","Dutchess County",3,65,3961,1967,1994
050,36,027,"New York","Dutchess County",3,66,3801,1838,1963
050,36,027,"New York","Dutchess County",3,67,3629,1777,1852
050,36,027,"New York","Dutchess County",3,68,3439,1677,1762
050,36,027,"New York","Dutchess County",3,69,3253,1567,1686
050,36,027,"New York","Dutchess County",3,70,3095,1451,1644
050,36,027,"New York","Dutchess County",3,71,2863,1355,1508
050,36,027,"New York","Dutchess County",3,72,2759,1294,1465
050,36,027,"New York","Dutchess County",3,73,2780,1308,1472
050,36,027,"New York","Dutchess County",3,74,2951,1363,1588
050,36,027,"New York","Dutchess County",3,75,2077,954,1123
050,36,027,"New York","Dutchess County",3,76,2000,930,1070
050,36,027,"New York","Dutchess County",3,77,1986,871,1115
050,36,027,"New York","Dutchess County",3,78,2003,876,1127
050,36,027,"New York","Dutchess County",3,79,1658,737,921
050,36,027,"New York","Dutchess County",3,80,1490,652,838
050,36,027,"New York","Dutchess County",3,81,1360,600,760
050,36,027,"New York","Dutchess County",3,82,1287,547,740
050,36,027,"New York","Dutchess County",3,83,1192,501,691
050,36,027,"New York","Dutchess County",3,84,1059,435,624
050,36,027,"New York","Dutchess County",3,85,6514,2335,4179
050,36,027,"New York","Dutchess County",4,0,2709,1372,1337
050,36,027,"New York","Dutchess County",4,1,2616,1319,1297
050,36,027,"New York","Dutchess County",4,2,2713,1399,1314
050,36,027,"New York","Dutchess County",4,3,2775,1398,1377
050,36,027,"New York","Dutchess County",4,4,2769,1398,1371
050,36,027,"New York","Dutchess County",4,5,2811,1452,1359
050,36,027,"New York","Dutchess County",4,6,2894,1456,1438
050,36,027,"New York","Dutchess County",4,7,2940,1512,1428
050,36,027,"New York","Dutchess County",4,8,2973,1555,1418
050,36,027,"New York","Dutchess County",4,9,3014,1590,1424
050,36,027,"New York","Dutchess County",4,10,3026,1583,1443
050,36,027,"New York","Dutchess County",4,11,3081,1567,1514
050,36,027,"New York","Dutchess County",4,12,3166,1610,1556
050,36,027,"New York","Dutchess County",4,13,3171,1622,1549
050,36,027,"New York","Dutchess County",4,14,3358,1720,1638
050,36,027,"New York","Dutchess County",4,15,3538,1834,1704
050,36,027,"New York","Dutchess County",4,16,3534,1831,1703
050,36,027,"New York","Dutchess County",4,17,3678,1935,1743
050,36,027,"New York","Dutchess County",4,18,4604,2307,2297
050,36,027,"New York","Dutchess County",4,19,5202,2529,2673
050,36,027,"New York","Dutchess County",4,20,4878,2307,2571
050,36,027,"New York","Dutchess County",4,21,4591,2204,2387
050,36,027,"New York","Dutchess County",4,22,4016,1989,2027
050,36,027,"New York","Dutchess County",4,23,3442,1764,1678
050,36,027,"New York","Dutchess County",4,24,3474,1791,1683
050,36,027,"New York","Dutchess County",4,25,3522,1813,1709
050,36,027,"New York","Dutchess County",4,26,3452,1790,1662
050,36,027,"New York","Dutchess County",4,27,3388,1788,1600
050,36,027,"New York","Dutchess County",4,28,3442,1802,1640
050,36,027,"New York","Dutchess County",4,29,3633,1905,1728
050,36,027,"New York","Dutchess County",4,30,3681,1848,1833
050,36,027,"New York","Dutchess County",4,31,3738,1942,1796
050,36,027,"New York","Dutchess County",4,32,3786,1950,1836
050,36,027,"New York","Dutchess County",4,33,3659,1889,1770
050,36,027,"New York","Dutchess County",4,34,3593,1852,1741
050,36,027,"New York","Dutchess County",4,35,3669,1884,1785
050,36,027,"New York","Dutchess County",4,36,3729,1913,1816
050,36,027,"New York","Dutchess County",4,37,3773,1956,1817
050,36,027,"New York","Dutchess County",4,38,3618,1847,1771
050,36,027,"New York","Dutchess County",4,39,3668,1874,1794
050,36,027,"New York","Dutchess County",4,40,3708,1871,1837
050,36,027,"New York","Dutchess County",4,41,3756,1905,1851
050,36,027,"New York","Dutchess County",4,42,3798,1946,1852
050,36,027,"New York","Dutchess County",4,43,3703,1890,1813
050,36,027,"New York","Dutchess County",4,44,3488,1791,1697
050,36,027,"New York","Dutchess County",4,45,3539,1807,1732
050,36,027,"New York","Dutchess County",4,46,3444,1787,1657
050,36,027,"New York","Dutchess County",4,47,3596,1850,1746
050,36,027,"New York","Dutchess County",4,48,3542,1783,1759
050,36,027,"New York","Dutchess County",4,49,3546,1783,1763
050,36,027,"New York","Dutchess County",4,50,3736,1877,1859
050,36,027,"New York","Dutchess County",4,51,4151,2087,2064
050,36,027,"New York","Dutchess County",4,52,4203,2139,2064
050,36,027,"New York","Dutchess County",4,53,4119,2081,2038
050,36,027,"New York","Dutchess County",4,54,4095,2030,2065
050,36,027,"New York","Dutchess County",4,55,4201,2073,2128
050,36,027,"New York","Dutchess County",4,56,4422,2198,2224
050,36,027,"New York","Dutchess County",4,57,4601,2270,2331
050,36,027,"New York","Dutchess County",4,58,4628,2275,2353
050,36,027,"New York","Dutchess County",4,59,4760,2352,2408
050,36,027,"New York","Dutchess County",4,60,4649,2305,2344
050,36,027,"New York","Dutchess County",4,61,4683,2313,2370
050,36,027,"New York","Dutchess County",4,62,4519,2283,2236
050,36,027,"New York","Dutchess County",4,63,4275,2183,2092
050,36,027,"New York","Dutchess County",4,64,4253,2179,2074
050,36,027,"New York","Dutchess County",4,65,4102,2052,2050
050,36,027,"New York","Dutchess County",4,66,3918,1934,1984
050,36,027,"New York","Dutchess County",4,67,3697,1777,1920
050,36,027,"New York","Dutchess County",4,68,3571,1742,1829
050,36,027,"New York","Dutchess County",4,69,3335,1605,1730
050,36,027,"New York","Dutchess County",4,70,3185,1526,1659
050,36,027,"New York","Dutchess County",4,71,3022,1398,1624
050,36,027,"New York","Dutchess County",4,72,2802,1315,1487
050,36,027,"New York","Dutchess County",4,73,2690,1264,1426
050,36,027,"New York","Dutchess County",4,74,2722,1287,1435
050,36,027,"New York","Dutchess County",4,75,2859,1314,1545
050,36,027,"New York","Dutchess County",4,76,2018,920,1098
050,36,027,"New York","Dutchess County",4,77,1959,907,1052
050,36,027,"New York","Dutchess County",4,78,1940,837,1103
050,36,027,"New York","Dutchess County",4,79,1905,840,1065
050,36,027,"New York","Dutchess County",4,80,1585,701,884
050,36,027,"New York","Dutchess County",4,81,1406,611,795
050,36,027,"New York","Dutchess County",4,82,1314,573,741
050,36,027,"New York","Dutchess County",4,83,1205,510,695
050,36,027,"New York","Dutchess County",4,84,1103,436,667
050,36,027,"New York","Dutchess County",4,85,6532,2350,4182
050,36,027,"New York","Dutchess County",5,0,2708,1372,1336
050,36,027,"New York","Dutchess County",5,1,2694,1371,1323
050,36,027,"New York","Dutchess County",5,2,2619,1332,1287
050,36,027,"New York","Dutchess County",5,3,2706,1378,1328
050,36,027,"New York","Dutchess County",5,4,2760,1391,1369
050,36,027,"New York","Dutchess County",5,5,2790,1399,1391
050,36,027,"New York","Dutchess County",5,6,2817,1441,1376
050,36,027,"New York","Dutchess County",5,7,2883,1464,1419
050,36,027,"New York","Dutchess County",5,8,2965,1527,1438
050,36,027,"New York","Dutchess County",5,9,2981,1559,1422
050,36,027,"New York","Dutchess County",5,10,3027,1597,1430
050,36,027,"New York","Dutchess County",5,11,3066,1608,1458
050,36,027,"New York","Dutchess County",5,12,3095,1562,1533
050,36,027,"New York","Dutchess County",5,13,3169,1611,1558
050,36,027,"New York","Dutchess County",5,14,3196,1643,1553
050,36,027,"New York","Dutchess County",5,15,3440,1781,1659
050,36,027,"New York","Dutchess County",5,16,3600,1880,1720
050,36,027,"New York","Dutchess County",5,17,3608,1886,1722
050,36,027,"New York","Dutchess County",5,18,4517,2253,2264
050,36,027,"New York","Dutchess County",5,19,5211,2516,2695
050,36,027,"New York","Dutchess County",5,20,4940,2385,2555
050,36,027,"New York","Dutchess County",5,21,4541,2161,2380
050,36,027,"New York","Dutchess County",5,22,4034,1963,2071
050,36,027,"New York","Dutchess County",5,23,3463,1751,1712
050,36,027,"New York","Dutchess County",5,24,3368,1774,1594
050,36,027,"New York","Dutchess County",5,25,3358,1732,1626
050,36,027,"New York","Dutchess County",5,26,3371,1698,1673
050,36,027,"New York","Dutchess County",5,27,3373,1774,1599
050,36,027,"New York","Dutchess County",5,28,3377,1753,1624
050,36,027,"New York","Dutchess County",5,29,3410,1770,1640
050,36,027,"New York","Dutchess County",5,30,3630,1897,1733
050,36,027,"New York","Dutchess County",5,31,3682,1821,1861
050,36,027,"New York","Dutchess County",5,32,3749,1926,1823
050,36,027,"New York","Dutchess County",5,33,3831,1985,1846
050,36,027,"New York","Dutchess County",5,34,3699,1898,1801
050,36,027,"New York","Dutchess County",5,35,3686,1887,1799
050,36,027,"New York","Dutchess County",5,36,3727,1916,1811
050,36,027,"New York","Dutchess County",5,37,3744,1948,1796
050,36,027,"New York","Dutchess County",5,38,3751,1931,1820
050,36,027,"New York","Dutchess County",5,39,3644,1869,1775
050,36,027,"New York","Dutchess County",5,40,3792,1945,1847
050,36,027,"New York","Dutchess County",5,41,3772,1889,1883
050,36,027,"New York","Dutchess County",5,42,3781,1930,1851
050,36,027,"New York","Dutchess County",5,43,3851,1948,1903
050,36,027,"New York","Dutchess County",5,44,3714,1907,1807
050,36,027,"New York","Dutchess County",5,45,3511,1792,1719
050,36,027,"New York","Dutchess County",5,46,3564,1845,1719
050,36,027,"New York","Dutchess County",5,47,3473,1803,1670
050,36,027,"New York","Dutchess County",5,48,3600,1821,1779
050,36,027,"New York","Dutchess County",5,49,3597,1820,1777
050,36,027,"New York","Dutchess County",5,50,3530,1792,1738
050,36,027,"New York","Dutchess County",5,51,3741,1868,1873
050,36,027,"New York","Dutchess County",5,52,4109,2077,2032
050,36,027,"New York","Dutchess County",5,53,4229,2155,2074
050,36,027,"New York","Dutchess County",5,54,4090,2051,2039
050,36,027,"New York","Dutchess County",5,55,4027,1999,2028
050,36,027,"New York","Dutchess County",5,56,4143,2058,2085
050,36,027,"New York","Dutchess County",5,57,4341,2137,2204
050,36,027,"New York","Dutchess County",5,58,4533,2221,2312
050,36,027,"New York","Dutchess County",5,59,4584,2238,2346
050,36,027,"New York","Dutchess County",5,60,4636,2298,2338
050,36,027,"New York","Dutchess County",5,61,4583,2267,2316
050,36,027,"New York","Dutchess County",5,62,4572,2268,2304
050,36,027,"New York","Dutchess County",5,63,4378,2193,2185
050,36,027,"New York","Dutchess County",5,64,4211,2137,2074
050,36,027,"New York","Dutchess County",5,65,4182,2137,2045
050,36,027,"New York","Dutchess County",5,66,4012,2000,2012
050,36,027,"New York","Dutchess County",5,67,3803,1861,1942
050,36,027,"New York","Dutchess County",5,68,3650,1756,1894
050,36,027,"New York","Dutchess County",5,69,3480,1680,1800
050,36,027,"New York","Dutchess County",5,70,3321,1582,1739
050,36,027,"New York","Dutchess County",5,71,3110,1484,1626
050,36,027,"New York","Dutchess County",5,72,2938,1360,1578
050,36,027,"New York","Dutchess County",5,73,2730,1283,1447
050,36,027,"New York","Dutchess County",5,74,2622,1237,1385
050,36,027,"New York","Dutchess County",5,75,2653,1250,1403
050,36,027,"New York","Dutchess County",5,76,2758,1257,1501
050,36,027,"New York","Dutchess County",5,77,1969,893,1076
050,36,027,"New York","Dutchess County",5,78,1918,882,1036
050,36,027,"New York","Dutchess County",5,79,1832,788,1044
050,36,027,"New York","Dutchess County",5,80,1825,802,1023
050,36,027,"New York","Dutchess County",5,81,1491,659,832
050,36,027,"New York","Dutchess County",5,82,1351,580,771
050,36,027,"New York","Dutchess County",5,83,1221,526,695
050,36,027,"New York","Dutchess County",5,84,1109,450,659
050,36,027,"New York","Dutchess County",5,85,6583,2395,4188
050,36,029,"New York","Erie County",1,0,9947,5094,4853
050,36,029,"New York","Erie County",1,1,10149,5214,4935
050,36,029,"New York","Erie County",1,2,10296,5276,5020
050,36,029,"New York","Erie County",1,3,10334,5349,4985
050,36,029,"New York","Erie County",1,4,10744,5474,5270
050,36,029,"New York","Erie County",1,5,10965,5567,5398
050,36,029,"New York","Erie County",1,6,10777,5517,5260
050,36,029,"New York","Erie County",1,7,10867,5542,5325
050,36,029,"New York","Erie County",1,8,10614,5503,5111
050,36,029,"New York","Erie County",1,9,10596,5360,5236
050,36,029,"New York","Erie County",1,10,10965,5540,5425
050,36,029,"New York","Erie County",1,11,10956,5638,5318
050,36,029,"New York","Erie County",1,12,11242,5818,5424
050,36,029,"New York","Erie County",1,13,11286,5759,5527
050,36,029,"New York","Erie County",1,14,11011,5598,5413
050,36,029,"New York","Erie County",1,15,11170,5677,5493
050,36,029,"New York","Erie County",1,16,11650,5859,5791
050,36,029,"New York","Erie County",1,17,11709,5925,5784
050,36,029,"New York","Erie County",1,18,12703,6485,6218
050,36,029,"New York","Erie County",1,19,12144,6211,5933
050,36,029,"New York","Erie County",1,20,11915,6073,5842
050,36,029,"New York","Erie County",1,21,11794,5890,5904
050,36,029,"New York","Erie County",1,22,11828,5810,6018
050,36,029,"New York","Erie County",1,23,12158,5988,6170
050,36,029,"New York","Erie County",1,24,12630,6292,6338
050,36,029,"New York","Erie County",1,25,12779,6379,6400
050,36,029,"New York","Erie County",1,26,12976,6533,6443
050,36,029,"New York","Erie County",1,27,13087,6523,6564
050,36,029,"New York","Erie County",1,28,13270,6607,6663
050,36,029,"New York","Erie County",1,29,13953,7021,6932
050,36,029,"New York","Erie County",1,30,14218,7217,7001
050,36,029,"New York","Erie County",1,31,13792,6968,6824
050,36,029,"New York","Erie County",1,32,13718,6858,6860
050,36,029,"New York","Erie County",1,33,13383,6625,6758
050,36,029,"New York","Erie County",1,34,13192,6555,6637
050,36,029,"New York","Erie County",1,35,12790,6416,6374
050,36,029,"New York","Erie County",1,36,12166,6075,6091
050,36,029,"New York","Erie County",1,37,11920,5910,6010
050,36,029,"New York","Erie County",1,38,11699,5792,5907
050,36,029,"New York","Erie County",1,39,11572,5740,5832
050,36,029,"New York","Erie County",1,40,11265,5608,5657
050,36,029,"New York","Erie County",1,41,10660,5237,5423
050,36,029,"New York","Erie County",1,42,10449,5194,5255
050,36,029,"New York","Erie County",1,43,9903,4904,4999
050,36,029,"New York","Erie County",1,44,9781,4816,4965
050,36,029,"New York","Erie County",1,45,10095,4985,5110
050,36,029,"New York","Erie County",1,46,9754,4833,4921
050,36,029,"New York","Erie County",1,47,10082,5021,5061
050,36,029,"New York","Erie County",1,48,11136,5441,5695
050,36,029,"New York","Erie County",1,49,12438,6057,6381
050,36,029,"New York","Erie County",1,50,12276,6020,6256
050,36,029,"New York","Erie County",1,51,12173,5964,6209
050,36,029,"New York","Erie County",1,52,12098,5922,6176
050,36,029,"New York","Erie County",1,53,12533,6133,6400
050,36,029,"New York","Erie County",1,54,12874,6314,6560
050,36,029,"New York","Erie County",1,55,13341,6533,6808
050,36,029,"New York","Erie County",1,56,13430,6558,6872
050,36,029,"New York","Erie County",1,57,13575,6592,6983
050,36,029,"New York","Erie County",1,58,13955,6779,7176
050,36,029,"New York","Erie County",1,59,14114,6748,7366
050,36,029,"New York","Erie County",1,60,14273,6880,7393
050,36,029,"New York","Erie County",1,61,14302,6883,7419
050,36,029,"New York","Erie County",1,62,14167,6765,7402
050,36,029,"New York","Erie County",1,63,13478,6480,6998
050,36,029,"New York","Erie County",1,64,13057,6265,6792
050,36,029,"New York","Erie County",1,65,12717,6100,6617
050,36,029,"New York","Erie County",1,66,11957,5695,6262
050,36,029,"New York","Erie County",1,67,11395,5424,5971
050,36,029,"New York","Erie County",1,68,11060,5241,5819
050,36,029,"New York","Erie County",1,69,10224,4761,5463
050,36,029,"New York","Erie County",1,70,9701,4507,5194
050,36,029,"New York","Erie County",1,71,9460,4364,5096
050,36,029,"New York","Erie County",1,72,9331,4315,5016
050,36,029,"New York","Erie County",1,73,9321,4328,4993
050,36,029,"New York","Erie County",1,74,6512,2891,3621
050,36,029,"New York","Erie County",1,75,6380,2837,3543
050,36,029,"New York","Erie County",1,76,6518,2829,3689
050,36,029,"New York","Erie County",1,77,6695,2943,3752
050,36,029,"New York","Erie County",1,78,5673,2460,3213
050,36,029,"New York","Erie County",1,79,4967,2093,2874
050,36,029,"New York","Erie County",1,80,4446,1781,2665
050,36,029,"New York","Erie County",1,81,4327,1713,2614
050,36,029,"New York","Erie County",1,82,3950,1564,2386
050,36,029,"New York","Erie County",1,83,3570,1372,2198
050,36,029,"New York","Erie County",1,84,3451,1322,2129
050,36,029,"New York","Erie County",1,85,22402,7346,15056
050,36,029,"New York","Erie County",2,0,9894,5027,4867
050,36,029,"New York","Erie County",2,1,10105,5185,4920
050,36,029,"New York","Erie County",2,2,10286,5274,5012
050,36,029,"New York","Erie County",2,3,10311,5323,4988
050,36,029,"New York","Erie County",2,4,10682,5465,5217
050,36,029,"New York","Erie County",2,5,10936,5557,5379
050,36,029,"New York","Erie County",2,6,10850,5545,5305
050,36,029,"New York","Erie County",2,7,10834,5528,5306
050,36,029,"New York","Erie County",2,8,10635,5493,5142
050,36,029,"New York","Erie County",2,9,10591,5394,5197
050,36,029,"New York","Erie County",2,10,10864,5493,5371
050,36,029,"New York","Erie County",2,11,10915,5593,5322
050,36,029,"New York","Erie County",2,12,11215,5790,5425
050,36,029,"New York","Erie County",2,13,11250,5763,5487
050,36,029,"New York","Erie County",2,14,11079,5638,5441
050,36,029,"New York","Erie County",2,15,11146,5663,5483
050,36,029,"New York","Erie County",2,16,11537,5823,5714
050,36,029,"New York","Erie County",2,17,11691,5911,5780
050,36,029,"New York","Erie County",2,18,12572,6389,6183
050,36,029,"New York","Erie County",2,19,12085,6172,5913
050,36,029,"New York","Erie County",2,20,11987,6098,5889
050,36,029,"New York","Erie County",2,21,11762,5895,5867
050,36,029,"New York","Erie County",2,22,11804,5799,6005
050,36,029,"New York","Erie County",2,23,12120,5964,6156
050,36,029,"New York","Erie County",2,24,12484,6216,6268
050,36,029,"New York","Erie County",2,25,12758,6362,6396
050,36,029,"New York","Erie County",2,26,12923,6499,6424
050,36,029,"New York","Erie County",2,27,13025,6507,6518
050,36,029,"New York","Erie County",2,28,13196,6569,6627
050,36,029,"New York","Erie County",2,29,13755,6905,6850
050,36,029,"New York","Erie County",2,30,14194,7180,7014
050,36,029,"New York","Erie County",2,31,13831,6996,6835
050,36,029,"New York","Erie County",2,32,13691,6851,6840
050,36,029,"New York","Erie County",2,33,13425,6658,6767
050,36,029,"New York","Erie County",2,34,13221,6552,6669
050,36,029,"New York","Erie County",2,35,12951,6480,6471
050,36,029,"New York","Erie County",2,36,12214,6096,6118
050,36,029,"New York","Erie County",2,37,11997,5961,6036
050,36,029,"New York","Erie County",2,38,11780,5828,5952
050,36,029,"New York","Erie County",2,39,11556,5726,5830
050,36,029,"New York","Erie County",2,40,11401,5669,5732
050,36,029,"New York","Erie County",2,41,10785,5306,5479
050,36,029,"New York","Erie County",2,42,10434,5171,5263
050,36,029,"New York","Erie County",2,43,10086,4996,5090
050,36,029,"New York","Erie County",2,44,9716,4786,4930
050,36,029,"New York","Erie County",2,45,10069,4967,5102
050,36,029,"New York","Erie County",2,46,9779,4835,4944
050,36,029,"New York","Erie County",2,47,9953,4953,5000
050,36,029,"New York","Erie County",2,48,10873,5339,5534
050,36,029,"New York","Erie County",2,49,12156,5933,6223
050,36,029,"New York","Erie County",2,50,12301,6016,6285
050,36,029,"New York","Erie County",2,51,12126,5935,6191
050,36,029,"New York","Erie County",2,52,12062,5908,6154
050,36,029,"New York","Erie County",2,53,12382,6043,6339
050,36,029,"New York","Erie County",2,54,12742,6245,6497
050,36,029,"New York","Erie County",2,55,13198,6458,6740
050,36,029,"New York","Erie County",2,56,13417,6550,6867
050,36,029,"New York","Erie County",2,57,13538,6578,6960
050,36,029,"New York","Erie County",2,58,13826,6713,7113
050,36,029,"New York","Erie County",2,59,14097,6758,7339
050,36,029,"New York","Erie County",2,60,14168,6816,7352
050,36,029,"New York","Erie County",2,61,14199,6829,7370
050,36,029,"New York","Erie County",2,62,14124,6749,7375
050,36,029,"New York","Erie County",2,63,13685,6562,7123
050,36,029,"New York","Erie County",2,64,13033,6251,6782
050,36,029,"New York","Erie County",2,65,12721,6095,6626
050,36,029,"New York","Erie County",2,66,12107,5768,6339
050,36,029,"New York","Erie County",2,67,11433,5432,6001
050,36,029,"New York","Erie County",2,68,11006,5215,5791
050,36,029,"New York","Erie County",2,69,10412,4858,5554
050,36,029,"New York","Erie County",2,70,9724,4517,5207
050,36,029,"New York","Erie County",2,71,9454,4362,5092
050,36,029,"New York","Erie County",2,72,9147,4228,4919
050,36,029,"New York","Erie County",2,73,9693,4499,5194
050,36,029,"New York","Erie County",2,74,6691,3000,3691
050,36,029,"New York","Erie County",2,75,6361,2828,3533
050,36,029,"New York","Erie County",2,76,6355,2773,3582
050,36,029,"New York","Erie County",2,77,6714,2940,3774
050,36,029,"New York","Erie County",2,78,5722,2480,3242
050,36,029,"New York","Erie County",2,79,5053,2135,2918
050,36,029,"New York","Erie County",2,80,4503,1828,2675
050,36,029,"New York","Erie County",2,81,4237,1685,2552
050,36,029,"New York","Erie County",2,82,3975,1563,2412
050,36,029,"New York","Erie County",2,83,3527,1366,2161
050,36,029,"New York","Erie County",2,84,3363,1277,2086
050,36,029,"New York","Erie County",2,85,21842,7214,14628
050,36,029,"New York","Erie County",3,0,9336,4781,4555
050,36,029,"New York","Erie County",3,1,9943,5092,4851
050,36,029,"New York","Erie County",3,2,10247,5227,5020
050,36,029,"New York","Erie County",3,3,10356,5309,5047
050,36,029,"New York","Erie County",3,4,10349,5309,5040
050,36,029,"New York","Erie County",3,5,10738,5497,5241
050,36,029,"New York","Erie County",3,6,11010,5606,5404
050,36,029,"New York","Erie County",3,7,10879,5538,5341
050,36,029,"New York","Erie County",3,8,10839,5541,5298
050,36,029,"New York","Erie County",3,9,10630,5474,5156
050,36,029,"New York","Erie County",3,10,10683,5424,5259
050,36,029,"New York","Erie County",3,11,10857,5510,5347
050,36,029,"New York","Erie County",3,12,10837,5555,5282
050,36,029,"New York","Erie County",3,13,11187,5768,5419
050,36,029,"New York","Erie County",3,14,11214,5731,5483
050,36,029,"New York","Erie County",3,15,11060,5642,5418
050,36,029,"New York","Erie County",3,16,11108,5638,5470
050,36,029,"New York","Erie County",3,17,11516,5818,5698
050,36,029,"New York","Erie County",3,18,12959,6489,6470
050,36,029,"New York","Erie County",3,19,12486,6314,6172
050,36,029,"New York","Erie County",3,20,12292,6203,6089
050,36,029,"New York","Erie County",3,21,12267,6182,6085
050,36,029,"New York","Erie County",3,22,11927,5864,6063
050,36,029,"New York","Erie County",3,23,12169,5981,6188
050,36,029,"New York","Erie County",3,24,12376,6149,6227
050,36,029,"New York","Erie County",3,25,12560,6245,6315
050,36,029,"New York","Erie County",3,26,12766,6412,6354
050,36,029,"New York","Erie County",3,27,12870,6465,6405
050,36,029,"New York","Erie County",3,28,12934,6450,6484
050,36,029,"New York","Erie County",3,29,13182,6571,6611
050,36,029,"New York","Erie County",3,30,13745,6886,6859
050,36,029,"New York","Erie County",3,31,14106,7142,6964
050,36,029,"New York","Erie County",3,32,13883,7008,6875
050,36,029,"New York","Erie County",3,33,13673,6845,6828
050,36,029,"New York","Erie County",3,34,13383,6564,6819
050,36,029,"New York","Erie County",3,35,13231,6528,6703
050,36,029,"New York","Erie County",3,36,12953,6483,6470
050,36,029,"New York","Erie County",3,37,12262,6091,6171
050,36,029,"New York","Erie County",3,38,11982,5950,6032
050,36,029,"New York","Erie County",3,39,11818,5841,5977
050,36,029,"New York","Erie County",3,40,11560,5710,5850
050,36,029,"New York","Erie County",3,41,11441,5690,5751
050,36,029,"New York","Erie County",3,42,10813,5316,5497
050,36,029,"New York","Erie County",3,43,10415,5156,5259
050,36,029,"New York","Erie County",3,44,10064,4973,5091
050,36,029,"New York","Erie County",3,45,9740,4799,4941
050,36,029,"New York","Erie County",3,46,10020,4948,5072
050,36,029,"New York","Erie County",3,47,9695,4798,4897
050,36,029,"New York","Erie County",3,48,9912,4934,4978
050,36,029,"New York","Erie County",3,49,10821,5308,5513
050,36,029,"New York","Erie County",3,50,12047,5878,6169
050,36,029,"New York","Erie County",3,51,12200,5945,6255
050,36,029,"New York","Erie County",3,52,12023,5910,6113
050,36,029,"New York","Erie County",3,53,11913,5802,6111
050,36,029,"New York","Erie County",3,54,12300,6001,6299
050,36,029,"New York","Erie County",3,55,12606,6173,6433
050,36,029,"New York","Erie County",3,56,13055,6370,6685
050,36,029,"New York","Erie County",3,57,13256,6471,6785
050,36,029,"New York","Erie County",3,58,13421,6500,6921
050,36,029,"New York","Erie County",3,59,13678,6648,7030
050,36,029,"New York","Erie County",3,60,13925,6663,7262
050,36,029,"New York","Erie County",3,61,13946,6690,7256
050,36,029,"New York","Erie County",3,62,14006,6724,7282
050,36,029,"New York","Erie County",3,63,13928,6661,7267
050,36,029,"New York","Erie County",3,64,13468,6415,7053
050,36,029,"New York","Erie County",3,65,12826,6159,6667
050,36,029,"New York","Erie County",3,66,12473,5953,6520
050,36,029,"New York","Erie County",3,67,11856,5621,6235
050,36,029,"New York","Erie County",3,68,11177,5279,5898
050,36,029,"New York","Erie County",3,69,10752,5078,5674
050,36,029,"New York","Erie County",3,70,10173,4728,5445
050,36,029,"New York","Erie County",3,71,9498,4389,5109
050,36,029,"New York","Erie County",3,72,9204,4241,4963
050,36,029,"New York","Erie County",3,73,8875,4070,4805
050,36,029,"New York","Erie County",3,74,9426,4339,5087
050,36,029,"New York","Erie County",3,75,6436,2858,3578
050,36,029,"New York","Erie County",3,76,6112,2710,3402
050,36,029,"New York","Erie County",3,77,6111,2639,3472
050,36,029,"New York","Erie County",3,78,6359,2774,3585
050,36,029,"New York","Erie County",3,79,5512,2347,3165
050,36,029,"New York","Erie County",3,80,4802,2008,2794
050,36,029,"New York","Erie County",3,81,4258,1705,2553
050,36,029,"New York","Erie County",3,82,3989,1576,2413
050,36,029,"New York","Erie County",3,83,3691,1435,2256
050,36,029,"New York","Erie County",3,84,3250,1238,2012
050,36,029,"New York","Erie County",3,85,21266,7029,14237
050,36,029,"New York","Erie County",4,0,9503,4821,4682
050,36,029,"New York","Erie County",4,1,9308,4760,4548
050,36,029,"New York","Erie County",4,2,10030,5113,4917
050,36,029,"New York","Erie County",4,3,10304,5258,5046
050,36,029,"New York","Erie County",4,4,10435,5355,5080
050,36,029,"New York","Erie County",4,5,10395,5341,5054
050,36,029,"New York","Erie County",4,6,10708,5480,5228
050,36,029,"New York","Erie County",4,7,11028,5621,5407
050,36,029,"New York","Erie County",4,8,10898,5536,5362
050,36,029,"New York","Erie County",4,9,10791,5518,5273
050,36,029,"New York","Erie County",4,10,10632,5496,5136
050,36,029,"New York","Erie County",4,11,10701,5437,5264
050,36,029,"New York","Erie County",4,12,10861,5516,5345
050,36,029,"New York","Erie County",4,13,10806,5515,5291
050,36,029,"New York","Erie County",4,14,11212,5767,5445
050,36,029,"New York","Erie County",4,15,11151,5710,5441
050,36,029,"New York","Erie County",4,16,11015,5600,5415
050,36,029,"New York","Erie County",4,17,11064,5631,5433
050,36,029,"New York","Erie County",4,18,12636,6362,6274
050,36,029,"New York","Erie County",4,19,12045,6073,5972
050,36,029,"New York","Erie County",4,20,11913,5987,5926
050,36,029,"New York","Erie County",4,21,12018,6057,5961
050,36,029,"New York","Erie County",4,22,12052,6036,6016
050,36,029,"New York","Erie County",4,23,12055,5985,6070
050,36,029,"New York","Erie County",4,24,12229,6057,6172
050,36,029,"New York","Erie County",4,25,12246,6048,6198
050,36,029,"New York","Erie County",4,26,12412,6211,6201
050,36,029,"New York","Erie County",4,27,12620,6280,6340
050,36,029,"New York","Erie County",4,28,12632,6328,6304
050,36,029,"New York","Erie County",4,29,12843,6434,6409
050,36,029,"New York","Erie County",4,30,13047,6457,6590
050,36,029,"New York","Erie County",4,31,13568,6761,6807
050,36,029,"New York","Erie County",4,32,13946,7072,6874
050,36,029,"New York","Erie County",4,33,13735,6899,6836
050,36,029,"New York","Erie County",4,34,13477,6684,6793
050,36,029,"New York","Erie County",4,35,13237,6468,6769
050,36,029,"New York","Erie County",4,36,13165,6483,6682
050,36,029,"New York","Erie County",4,37,12921,6462,6459
050,36,029,"New York","Erie County",4,38,12206,6051,6155
050,36,029,"New York","Erie County",4,39,11941,5884,6057
050,36,029,"New York","Erie County",4,40,11743,5823,5920
050,36,029,"New York","Erie County",4,41,11498,5670,5828
050,36,029,"New York","Erie County",4,42,11373,5657,5716
050,36,029,"New York","Erie County",4,43,10782,5276,5506
050,36,029,"New York","Erie County",4,44,10309,5107,5202
050,36,029,"New York","Erie County",4,45,10031,4940,5091
050,36,029,"New York","Erie County",4,46,9648,4741,4907
050,36,029,"New York","Erie County",4,47,9928,4891,5037
050,36,029,"New York","Erie County",4,48,9682,4809,4873
050,36,029,"New York","Erie County",4,49,9827,4885,4942
050,36,029,"New York","Erie County",4,50,10688,5239,5449
050,36,029,"New York","Erie County",4,51,11988,5830,6158
050,36,029,"New York","Erie County",4,52,12123,5922,6201
050,36,029,"New York","Erie County",4,53,11827,5791,6036
050,36,029,"New York","Erie County",4,54,11827,5748,6079
050,36,029,"New York","Erie County",4,55,12201,5948,6253
050,36,029,"New York","Erie County",4,56,12430,6065,6365
050,36,029,"New York","Erie County",4,57,12897,6299,6598
050,36,029,"New York","Erie County",4,58,13132,6404,6728
050,36,029,"New York","Erie County",4,59,13264,6429,6835
050,36,029,"New York","Erie County",4,60,13525,6554,6971
050,36,029,"New York","Erie County",4,61,13728,6585,7143
050,36,029,"New York","Erie County",4,62,13785,6594,7191
050,36,029,"New York","Erie County",4,63,13780,6605,7175
050,36,029,"New York","Erie County",4,64,13735,6522,7213
050,36,029,"New York","Erie County",4,65,13259,6286,6973
050,36,029,"New York","Erie County",4,66,12589,6036,6553
050,36,029,"New York","Erie County",4,67,12201,5808,6393
050,36,029,"New York","Erie County",4,68,11583,5473,6110
050,36,029,"New York","Erie County",4,69,10923,5149,5774
050,36,029,"New York","Erie County",4,70,10530,4955,5575
050,36,029,"New York","Erie County",4,71,9941,4608,5333
050,36,029,"New York","Erie County",4,72,9275,4273,5002
050,36,029,"New York","Erie County",4,73,8968,4084,4884
050,36,029,"New York","Erie County",4,74,8665,3935,4730
050,36,029,"New York","Erie County",4,75,9108,4172,4936
050,36,029,"New York","Erie County",4,76,6236,2766,3470
050,36,029,"New York","Erie County",4,77,5868,2587,3281
050,36,029,"New York","Erie County",4,78,5834,2505,3329
050,36,029,"New York","Erie County",4,79,6128,2629,3499
050,36,029,"New York","Erie County",4,80,5265,2204,3061
050,36,029,"New York","Erie County",4,81,4548,1886,2662
050,36,029,"New York","Erie County",4,82,4018,1604,2414
050,36,029,"New York","Erie County",4,83,3728,1468,2260
050,36,029,"New York","Erie County",4,84,3413,1301,2112
050,36,029,"New York","Erie County",4,85,20806,6864,13942
050,36,029,"New York","Erie County",5,0,9503,4822,4681
050,36,029,"New York","Erie County",5,1,9560,4900,4660
050,36,029,"New York","Erie County",5,2,9345,4762,4583
050,36,029,"New York","Erie County",5,3,10097,5128,4969
050,36,029,"New York","Erie County",5,4,10381,5285,5096
050,36,029,"New York","Erie County",5,5,10488,5400,5088
050,36,029,"New York","Erie County",5,6,10486,5389,5097
050,36,029,"New York","Erie County",5,7,10730,5466,5264
050,36,029,"New York","Erie County",5,8,10971,5573,5398
050,36,029,"New York","Erie County",5,9,10895,5541,5354
050,36,029,"New York","Erie County",5,10,10802,5521,5281
050,36,029,"New York","Erie County",5,11,10673,5525,5148
050,36,029,"New York","Erie County",5,12,10664,5406,5258
050,36,029,"New York","Erie County",5,13,10818,5480,5338
050,36,029,"New York","Erie County",5,14,10816,5511,5305
050,36,029,"New York","Erie County",5,15,11143,5736,5407
050,36,029,"New York","Erie County",5,16,11064,5668,5396
050,36,029,"New York","Erie County",5,17,10994,5585,5409
050,36,029,"New York","Erie County",5,18,12198,6164,6034
050,36,029,"New York","Erie County",5,19,11966,6045,5921
050,36,029,"New York","Erie County",5,20,11721,5852,5869
050,36,029,"New York","Erie County",5,21,11665,5849,5816
050,36,029,"New York","Erie County",5,22,11872,5894,5978
050,36,029,"New York","Erie County",5,23,12129,6092,6037
050,36,029,"New York","Erie County",5,24,12077,5994,6083
050,36,029,"New York","Erie County",5,25,12109,5966,6143
050,36,029,"New York","Erie County",5,26,12101,6068,6033
050,36,029,"New York","Erie County",5,27,12321,6157,6164
050,36,029,"New York","Erie County",5,28,12353,6174,6179
050,36,029,"New York","Erie County",5,29,12524,6265,6259
050,36,029,"New York","Erie County",5,30,12806,6393,6413
050,36,029,"New York","Erie County",5,31,12903,6400,6503
050,36,029,"New York","Erie County",5,32,13535,6745,6790
050,36,029,"New York","Erie County",5,33,13920,7033,6887
050,36,029,"New York","Erie County",5,34,13654,6812,6842
050,36,029,"New York","Erie County",5,35,13416,6623,6793
050,36,029,"New York","Erie County",5,36,13183,6397,6786
050,36,029,"New York","Erie County",5,37,13096,6460,6636
050,36,029,"New York","Erie County",5,38,12895,6446,6449
050,36,029,"New York","Erie County",5,39,12237,6069,6168
050,36,029,"New York","Erie County",5,40,11870,5834,6036
050,36,029,"New York","Erie County",5,41,11755,5858,5897
050,36,029,"New York","Erie County",5,42,11513,5697,5816
050,36,029,"New York","Erie County",5,43,11334,5599,5735
050,36,029,"New York","Erie County",5,44,10791,5288,5503
050,36,029,"New York","Erie County",5,45,10282,5078,5204
050,36,029,"New York","Erie County",5,46,10004,4920,5084
050,36,029,"New York","Erie County",5,47,9541,4706,4835
050,36,029,"New York","Erie County",5,48,9922,4899,5023
050,36,029,"New York","Erie County",5,49,9634,4789,4845
050,36,029,"New York","Erie County",5,50,9744,4840,4904
050,36,029,"New York","Erie County",5,51,10654,5223,5431
050,36,029,"New York","Erie County",5,52,11952,5833,6119
050,36,029,"New York","Erie County",5,53,11996,5833,6163
050,36,029,"New York","Erie County",5,54,11749,5759,5990
050,36,029,"New York","Erie County",5,55,11761,5720,6041
050,36,029,"New York","Erie County",5,56,12041,5849,6192
050,36,029,"New York","Erie County",5,57,12284,6008,6276
050,36,029,"New York","Erie County",5,58,12792,6239,6553
050,36,029,"New York","Erie County",5,59,13006,6333,6673
050,36,029,"New York","Erie County",5,60,13123,6349,6774
050,36,029,"New York","Erie County",5,61,13321,6465,6856
050,36,029,"New York","Erie County",5,62,13544,6482,7062
050,36,029,"New York","Erie County",5,63,13537,6459,7078
050,36,029,"New York","Erie County",5,64,13595,6497,7098
050,36,029,"New York","Erie County",5,65,13534,6393,7141
050,36,029,"New York","Erie County",5,66,13036,6169,6867
050,36,029,"New York","Erie County",5,67,12340,5879,6461
050,36,029,"New York","Erie County",5,68,12019,5692,6327
050,36,029,"New York","Erie County",5,69,11360,5359,6001
050,36,029,"New York","Erie County",5,70,10726,5037,5689
050,36,029,"New York","Erie County",5,71,10334,4855,5479
050,36,029,"New York","Erie County",5,72,9718,4497,5221
050,36,029,"New York","Erie County",5,73,9029,4120,4909
050,36,029,"New York","Erie County",5,74,8779,3959,4820
050,36,029,"New York","Erie County",5,75,8390,3797,4593
050,36,029,"New York","Erie County",5,76,8823,4043,4780
050,36,029,"New York","Erie County",5,77,6004,2642,3362
050,36,029,"New York","Erie County",5,78,5585,2456,3129
050,36,029,"New York","Erie County",5,79,5616,2368,3248
050,36,029,"New York","Erie County",5,80,5854,2479,3375
050,36,029,"New York","Erie County",5,81,5000,2065,2935
050,36,029,"New York","Erie County",5,82,4300,1775,2525
050,36,029,"New York","Erie County",5,83,3750,1492,2258
050,36,029,"New York","Erie County",5,84,3472,1342,2130
050,36,029,"New York","Erie County",5,85,20622,6818,13804
050,36,031,"New York","Essex County",1,0,287,147,140
050,36,031,"New York","Essex County",1,1,306,150,156
050,36,031,"New York","Essex County",1,2,318,158,160
050,36,031,"New York","Essex County",1,3,300,160,140
050,36,031,"New York","Essex County",1,4,277,144,133
050,36,031,"New York","Essex County",1,5,299,147,152
050,36,031,"New York","Essex County",1,6,291,156,135
050,36,031,"New York","Essex County",1,7,312,149,163
050,36,031,"New York","Essex County",1,8,324,160,164
050,36,031,"New York","Essex County",1,9,306,153,153
050,36,031,"New York","Essex County",1,10,355,166,189
050,36,031,"New York","Essex County",1,11,354,182,172
050,36,031,"New York","Essex County",1,12,351,185,166
050,36,031,"New York","Essex County",1,13,356,184,172
050,36,031,"New York","Essex County",1,14,409,225,184
050,36,031,"New York","Essex County",1,15,446,266,180
050,36,031,"New York","Essex County",1,16,444,262,182
050,36,031,"New York","Essex County",1,17,403,228,175
050,36,031,"New York","Essex County",1,18,358,196,162
050,36,031,"New York","Essex County",1,19,293,160,133
050,36,031,"New York","Essex County",1,20,302,154,148
050,36,031,"New York","Essex County",1,21,323,177,146
050,36,031,"New York","Essex County",1,22,351,192,159
050,36,031,"New York","Essex County",1,23,386,214,172
050,36,031,"New York","Essex County",1,24,385,217,168
050,36,031,"New York","Essex County",1,25,401,220,181
050,36,031,"New York","Essex County",1,26,422,241,181
050,36,031,"New York","Essex County",1,27,411,238,173
050,36,031,"New York","Essex County",1,28,430,244,186
050,36,031,"New York","Essex County",1,29,409,225,184
050,36,031,"New York","Essex County",1,30,414,222,192
050,36,031,"New York","Essex County",1,31,451,251,200
050,36,031,"New York","Essex County",1,32,421,224,197
050,36,031,"New York","Essex County",1,33,419,229,190
050,36,031,"New York","Essex County",1,34,436,232,204
050,36,031,"New York","Essex County",1,35,427,247,180
050,36,031,"New York","Essex County",1,36,439,245,194
050,36,031,"New York","Essex County",1,37,425,238,187
050,36,031,"New York","Essex County",1,38,421,231,190
050,36,031,"New York","Essex County",1,39,425,225,200
050,36,031,"New York","Essex County",1,40,408,225,183
050,36,031,"New York","Essex County",1,41,402,209,193
050,36,031,"New York","Essex County",1,42,408,198,210
050,36,031,"New York","Essex County",1,43,421,210,211
050,36,031,"New York","Essex County",1,44,397,214,183
050,36,031,"New York","Essex County",1,45,403,199,204
050,36,031,"New York","Essex County",1,46,419,218,201
050,36,031,"New York","Essex County",1,47,438,231,207
050,36,031,"New York","Essex County",1,48,478,258,220
050,36,031,"New York","Essex County",1,49,498,266,232
050,36,031,"New York","Essex County",1,50,490,248,242
050,36,031,"New York","Essex County",1,51,514,258,256
050,36,031,"New York","Essex County",1,52,502,243,259
050,36,031,"New York","Essex County",1,53,513,264,249
050,36,031,"New York","Essex County",1,54,556,285,271
050,36,031,"New York","Essex County",1,55,605,295,310
050,36,031,"New York","Essex County",1,56,624,293,331
050,36,031,"New York","Essex County",1,57,625,305,320
050,36,031,"New York","Essex County",1,58,653,321,332
050,36,031,"New York","Essex County",1,59,619,314,305
050,36,031,"New York","Essex County",1,60,670,344,326
050,36,031,"New York","Essex County",1,61,645,337,308
050,36,031,"New York","Essex County",1,62,670,351,319
050,36,031,"New York","Essex County",1,63,671,357,314
050,36,031,"New York","Essex County",1,64,628,304,324
050,36,031,"New York","Essex County",1,65,630,310,320
050,36,031,"New York","Essex County",1,66,613,309,304
050,36,031,"New York","Essex County",1,67,626,317,309
050,36,031,"New York","Essex County",1,68,622,318,304
050,36,031,"New York","Essex County",1,69,572,304,268
050,36,031,"New York","Essex County",1,70,529,263,266
050,36,031,"New York","Essex County",1,71,486,237,249
050,36,031,"New York","Essex County",1,72,508,252,256
050,36,031,"New York","Essex County",1,73,505,253,252
050,36,031,"New York","Essex County",1,74,337,161,176
050,36,031,"New York","Essex County",1,75,364,175,189
050,36,031,"New York","Essex County",1,76,368,183,185
050,36,031,"New York","Essex County",1,77,347,184,163
050,36,031,"New York","Essex County",1,78,322,163,159
050,36,031,"New York","Essex County",1,79,266,120,146
050,36,031,"New York","Essex County",1,80,259,108,151
050,36,031,"New York","Essex County",1,81,244,118,126
050,36,031,"New York","Essex County",1,82,207,83,124
050,36,031,"New York","Essex County",1,83,188,82,106
050,36,031,"New York","Essex County",1,84,158,70,88
050,36,031,"New York","Essex County",1,85,1079,413,666
050,36,031,"New York","Essex County",2,0,286,140,146
050,36,031,"New York","Essex County",2,1,299,147,152
050,36,031,"New York","Essex County",2,2,314,156,158
050,36,031,"New York","Essex County",2,3,304,159,145
050,36,031,"New York","Essex County",2,4,285,147,138
050,36,031,"New York","Essex County",2,5,293,145,148
050,36,031,"New York","Essex County",2,6,290,151,139
050,36,031,"New York","Essex County",2,7,307,150,157
050,36,031,"New York","Essex County",2,8,317,156,161
050,36,031,"New York","Essex County",2,9,308,153,155
050,36,031,"New York","Essex County",2,10,342,161,181
050,36,031,"New York","Essex County",2,11,353,178,175
050,36,031,"New York","Essex County",2,12,353,184,169
050,36,031,"New York","Essex County",2,13,356,185,171
050,36,031,"New York","Essex County",2,14,405,225,180
050,36,031,"New York","Essex County",2,15,444,262,182
050,36,031,"New York","Essex County",2,16,449,267,182
050,36,031,"New York","Essex County",2,17,404,227,177
050,36,031,"New York","Essex County",2,18,349,191,158
050,36,031,"New York","Essex County",2,19,294,161,133
050,36,031,"New York","Essex County",2,20,300,155,145
050,36,031,"New York","Essex County",2,21,321,175,146
050,36,031,"New York","Essex County",2,22,351,190,161
050,36,031,"New York","Essex County",2,23,380,208,172
050,36,031,"New York","Essex County",2,24,385,216,169
050,36,031,"New York","Essex County",2,25,396,219,177
050,36,031,"New York","Essex County",2,26,416,235,181
050,36,031,"New York","Essex County",2,27,412,236,176
050,36,031,"New York","Essex County",2,28,424,240,184
050,36,031,"New York","Essex County",2,29,414,228,186
050,36,031,"New York","Essex County",2,30,417,222,195
050,36,031,"New York","Essex County",2,31,436,237,199
050,36,031,"New York","Essex County",2,32,421,225,196
050,36,031,"New York","Essex County",2,33,417,224,193
050,36,031,"New York","Essex County",2,34,430,229,201
050,36,031,"New York","Essex County",2,35,433,246,187
050,36,031,"New York","Essex County",2,36,432,242,190
050,36,031,"New York","Essex County",2,37,426,236,190
050,36,031,"New York","Essex County",2,38,420,229,191
050,36,031,"New York","Essex County",2,39,424,226,198
050,36,031,"New York","Essex County",2,40,412,223,189
050,36,031,"New York","Essex County",2,41,401,212,189
050,36,031,"New York","Essex County",2,42,404,198,206
050,36,031,"New York","Essex County",2,43,421,208,213
050,36,031,"New York","Essex County",2,44,395,207,188
050,36,031,"New York","Essex County",2,45,403,202,201
050,36,031,"New York","Essex County",2,46,414,213,201
050,36,031,"New York","Essex County",2,47,431,225,206
050,36,031,"New York","Essex County",2,48,465,249,216
050,36,031,"New York","Essex County",2,49,495,265,230
050,36,031,"New York","Essex County",2,50,489,251,238
050,36,031,"New York","Essex County",2,51,505,253,252
050,36,031,"New York","Essex County",2,52,503,246,257
050,36,031,"New York","Essex County",2,53,512,258,254
050,36,031,"New York","Essex County",2,54,543,280,263
050,36,031,"New York","Essex County",2,55,594,292,302
050,36,031,"New York","Essex County",2,56,623,296,327
050,36,031,"New York","Essex County",2,57,627,304,323
050,36,031,"New York","Essex County",2,58,645,317,328
050,36,031,"New York","Essex County",2,59,629,316,313
050,36,031,"New York","Essex County",2,60,656,337,319
050,36,031,"New York","Essex County",2,61,652,339,313
050,36,031,"New York","Essex County",2,62,669,349,320
050,36,031,"New York","Essex County",2,63,677,359,318
050,36,031,"New York","Essex County",2,64,634,315,319
050,36,031,"New York","Essex County",2,65,632,310,322
050,36,031,"New York","Essex County",2,66,617,308,309
050,36,031,"New York","Essex County",2,67,621,313,308
050,36,031,"New York","Essex County",2,68,612,314,298
050,36,031,"New York","Essex County",2,69,588,307,281
050,36,031,"New York","Essex County",2,70,537,271,266
050,36,031,"New York","Essex County",2,71,497,244,253
050,36,031,"New York","Essex County",2,72,491,241,250
050,36,031,"New York","Essex County",2,73,534,266,268
050,36,031,"New York","Essex County",2,74,350,170,180
050,36,031,"New York","Essex County",2,75,360,172,188
050,36,031,"New York","Essex County",2,76,355,174,181
050,36,031,"New York","Essex County",2,77,358,188,170
050,36,031,"New York","Essex County",2,78,316,162,154
050,36,031,"New York","Essex County",2,79,274,128,146
050,36,031,"New York","Essex County",2,80,260,109,151
050,36,031,"New York","Essex County",2,81,239,112,127
050,36,031,"New York","Essex County",2,82,217,92,125
050,36,031,"New York","Essex County",2,83,183,78,105
050,36,031,"New York","Essex County",2,84,160,72,88
050,36,031,"New York","Essex County",2,85,1068,406,662
050,36,031,"New York","Essex County",3,0,243,127,116
050,36,031,"New York","Essex County",3,1,289,139,150
050,36,031,"New York","Essex County",3,2,299,153,146
050,36,031,"New York","Essex County",3,3,307,150,157
050,36,031,"New York","Essex County",3,4,308,158,150
050,36,031,"New York","Essex County",3,5,307,158,149
050,36,031,"New York","Essex County",3,6,304,156,148
050,36,031,"New York","Essex County",3,7,291,157,134
050,36,031,"New York","Essex County",3,8,309,153,156
050,36,031,"New York","Essex County",3,9,318,159,159
050,36,031,"New York","Essex County",3,10,312,152,160
050,36,031,"New York","Essex County",3,11,351,166,185
050,36,031,"New York","Essex County",3,12,334,164,170
050,36,031,"New York","Essex County",3,13,341,178,163
050,36,031,"New York","Essex County",3,14,383,221,162
050,36,031,"New York","Essex County",3,15,426,238,188
050,36,031,"New York","Essex County",3,16,451,267,184
050,36,031,"New York","Essex County",3,17,409,224,185
050,36,031,"New York","Essex County",3,18,342,186,156
050,36,031,"New York","Essex County",3,19,276,155,121
050,36,031,"New York","Essex County",3,20,285,159,126
050,36,031,"New York","Essex County",3,21,326,167,159
050,36,031,"New York","Essex County",3,22,353,191,162
050,36,031,"New York","Essex County",3,23,363,203,160
050,36,031,"New York","Essex County",3,24,387,219,168
050,36,031,"New York","Essex County",3,25,384,212,172
050,36,031,"New York","Essex County",3,26,424,226,198
050,36,031,"New York","Essex County",3,27,426,240,186
050,36,031,"New York","Essex County",3,28,417,245,172
050,36,031,"New York","Essex County",3,29,436,248,188
050,36,031,"New York","Essex County",3,30,418,230,188
050,36,031,"New York","Essex County",3,31,427,236,191
050,36,031,"New York","Essex County",3,32,449,240,209
050,36,031,"New York","Essex County",3,33,425,221,204
050,36,031,"New York","Essex County",3,34,426,229,197
050,36,031,"New York","Essex County",3,35,456,241,215
050,36,031,"New York","Essex County",3,36,423,234,189
050,36,031,"New York","Essex County",3,37,430,248,182
050,36,031,"New York","Essex County",3,38,430,236,194
050,36,031,"New York","Essex County",3,39,443,239,204
050,36,031,"New York","Essex County",3,40,428,229,199
050,36,031,"New York","Essex County",3,41,418,225,193
050,36,031,"New York","Essex County",3,42,402,208,194
050,36,031,"New York","Essex County",3,43,429,216,213
050,36,031,"New York","Essex County",3,44,406,197,209
050,36,031,"New York","Essex County",3,45,394,203,191
050,36,031,"New York","Essex County",3,46,410,208,202
050,36,031,"New York","Essex County",3,47,418,213,205
050,36,031,"New York","Essex County",3,48,438,229,209
050,36,031,"New York","Essex County",3,49,470,261,209
050,36,031,"New York","Essex County",3,50,489,265,224
050,36,031,"New York","Essex County",3,51,500,255,245
050,36,031,"New York","Essex County",3,52,507,250,257
050,36,031,"New York","Essex County",3,53,501,253,248
050,36,031,"New York","Essex County",3,54,507,261,246
050,36,031,"New York","Essex County",3,55,539,272,267
050,36,031,"New York","Essex County",3,56,586,287,299
050,36,031,"New York","Essex County",3,57,619,294,325
050,36,031,"New York","Essex County",3,58,623,302,321
050,36,031,"New York","Essex County",3,59,628,305,323
050,36,031,"New York","Essex County",3,60,631,317,314
050,36,031,"New York","Essex County",3,61,649,333,316
050,36,031,"New York","Essex County",3,62,679,353,326
050,36,031,"New York","Essex County",3,63,674,352,322
050,36,031,"New York","Essex County",3,64,699,370,329
050,36,031,"New York","Essex County",3,65,639,320,319
050,36,031,"New York","Essex County",3,66,623,305,318
050,36,031,"New York","Essex County",3,67,604,300,304
050,36,031,"New York","Essex County",3,68,622,317,305
050,36,031,"New York","Essex County",3,69,600,305,295
050,36,031,"New York","Essex County",3,70,571,297,274
050,36,031,"New York","Essex County",3,71,517,263,254
050,36,031,"New York","Essex County",3,72,477,231,246
050,36,031,"New York","Essex County",3,73,490,239,251
050,36,031,"New York","Essex County",3,74,520,268,252
050,36,031,"New York","Essex County",3,75,336,160,176
050,36,031,"New York","Essex County",3,76,333,160,173
050,36,031,"New York","Essex County",3,77,338,165,173
050,36,031,"New York","Essex County",3,78,347,182,165
050,36,031,"New York","Essex County",3,79,299,152,147
050,36,031,"New York","Essex County",3,80,275,125,150
050,36,031,"New York","Essex County",3,81,242,107,135
050,36,031,"New York","Essex County",3,82,234,102,132
050,36,031,"New York","Essex County",3,83,191,86,105
050,36,031,"New York","Essex County",3,84,166,69,97
050,36,031,"New York","Essex County",3,85,1037,398,639
050,36,031,"New York","Essex County",4,0,262,151,111
050,36,031,"New York","Essex County",4,1,233,119,114
050,36,031,"New York","Essex County",4,2,271,128,143
050,36,031,"New York","Essex County",4,3,283,140,143
050,36,031,"New York","Essex County",4,4,304,146,158
050,36,031,"New York","Essex County",4,5,304,156,148
050,36,031,"New York","Essex County",4,6,311,160,151
050,36,031,"New York","Essex County",4,7,298,153,145
050,36,031,"New York","Essex County",4,8,284,151,133
050,36,031,"New York","Essex County",4,9,296,149,147
050,36,031,"New York","Essex County",4,10,317,159,158
050,36,031,"New York","Essex County",4,11,318,160,158
050,36,031,"New York","Essex County",4,12,333,157,176
050,36,031,"New York","Essex County",4,13,332,163,169
050,36,031,"New York","Essex County",4,14,372,219,153
050,36,031,"New York","Essex County",4,15,404,233,171
050,36,031,"New York","Essex County",4,16,437,247,190
050,36,031,"New York","Essex County",4,17,417,234,183
050,36,031,"New York","Essex County",4,18,345,186,159
050,36,031,"New York","Essex County",4,19,277,154,123
050,36,031,"New York","Essex County",4,20,266,145,121
050,36,031,"New York","Essex County",4,21,310,173,137
050,36,031,"New York","Essex County",4,22,349,172,177
050,36,031,"New York","Essex County",4,23,361,199,162
050,36,031,"New York","Essex County",4,24,351,201,150
050,36,031,"New York","Essex County",4,25,385,214,171
050,36,031,"New York","Essex County",4,26,372,200,172
050,36,031,"New York","Essex County",4,27,394,216,178
050,36,031,"New York","Essex County",4,28,412,235,177
050,36,031,"New York","Essex County",4,29,422,247,175
050,36,031,"New York","Essex County",4,30,423,234,189
050,36,031,"New York","Essex County",4,31,404,220,184
050,36,031,"New York","Essex County",4,32,430,235,195
050,36,031,"New York","Essex County",4,33,456,244,212
050,36,031,"New York","Essex County",4,34,429,219,210
050,36,031,"New York","Essex County",4,35,407,223,184
050,36,031,"New York","Essex County",4,36,447,228,219
050,36,031,"New York","Essex County",4,37,418,238,180
050,36,031,"New York","Essex County",4,38,411,227,184
050,36,031,"New York","Essex County",4,39,431,231,200
050,36,031,"New York","Essex County",4,40,436,236,200
050,36,031,"New York","Essex County",4,41,417,218,199
050,36,031,"New York","Essex County",4,42,407,212,195
050,36,031,"New York","Essex County",4,43,408,210,198
050,36,031,"New York","Essex County",4,44,406,201,205
050,36,031,"New York","Essex County",4,45,395,187,208
050,36,031,"New York","Essex County",4,46,389,201,188
050,36,031,"New York","Essex County",4,47,408,211,197
050,36,031,"New York","Essex County",4,48,416,206,210
050,36,031,"New York","Essex County",4,49,434,228,206
050,36,031,"New York","Essex County",4,50,461,254,207
050,36,031,"New York","Essex County",4,51,492,264,228
050,36,031,"New York","Essex County",4,52,501,255,246
050,36,031,"New York","Essex County",4,53,498,242,256
050,36,031,"New York","Essex County",4,54,503,254,249
050,36,031,"New York","Essex County",4,55,499,257,242
050,36,031,"New York","Essex County",4,56,547,282,265
050,36,031,"New York","Essex County",4,57,594,289,305
050,36,031,"New York","Essex County",4,58,621,303,318
050,36,031,"New York","Essex County",4,59,622,298,324
050,36,031,"New York","Essex County",4,60,626,307,319
050,36,031,"New York","Essex County",4,61,636,318,318
050,36,031,"New York","Essex County",4,62,669,339,330
050,36,031,"New York","Essex County",4,63,687,361,326
050,36,031,"New York","Essex County",4,64,668,344,324
050,36,031,"New York","Essex County",4,65,703,375,328
050,36,031,"New York","Essex County",4,66,614,298,316
050,36,031,"New York","Essex County",4,67,615,304,311
050,36,031,"New York","Essex County",4,68,594,300,294
050,36,031,"New York","Essex County",4,69,625,320,305
050,36,031,"New York","Essex County",4,70,585,299,286
050,36,031,"New York","Essex County",4,71,562,290,272
050,36,031,"New York","Essex County",4,72,499,259,240
050,36,031,"New York","Essex County",4,73,470,226,244
050,36,031,"New York","Essex County",4,74,479,239,240
050,36,031,"New York","Essex County",4,75,508,254,254
050,36,031,"New York","Essex County",4,76,309,146,163
050,36,031,"New York","Essex County",4,77,327,156,171
050,36,031,"New York","Essex County",4,78,333,163,170
050,36,031,"New York","Essex County",4,79,325,169,156
050,36,031,"New York","Essex County",4,80,297,147,150
050,36,031,"New York","Essex County",4,81,250,119,131
050,36,031,"New York","Essex County",4,82,229,98,131
050,36,031,"New York","Essex County",4,83,214,98,116
050,36,031,"New York","Essex County",4,84,166,68,98
050,36,031,"New York","Essex County",4,85,1043,385,658
050,36,031,"New York","Essex County",5,0,260,150,110
050,36,031,"New York","Essex County",5,1,280,159,121
050,36,031,"New York","Essex County",5,2,221,110,111
050,36,031,"New York","Essex County",5,3,267,128,139
050,36,031,"New York","Essex County",5,4,288,143,145
050,36,031,"New York","Essex County",5,5,309,146,163
050,36,031,"New York","Essex County",5,6,317,164,153
050,36,031,"New York","Essex County",5,7,298,156,142
050,36,031,"New York","Essex County",5,8,302,153,149
050,36,031,"New York","Essex County",5,9,277,145,132
050,36,031,"New York","Essex County",5,10,289,144,145
050,36,031,"New York","Essex County",5,11,317,160,157
050,36,031,"New York","Essex County",5,12,295,141,154
050,36,031,"New York","Essex County",5,13,341,163,178
050,36,031,"New York","Essex County",5,14,377,211,166
050,36,031,"New York","Essex County",5,15,403,240,163
050,36,031,"New York","Essex County",5,16,410,243,167
050,36,031,"New York","Essex County",5,17,401,207,194
050,36,031,"New York","Essex County",5,18,345,190,155
050,36,031,"New York","Essex County",5,19,269,150,119
050,36,031,"New York","Essex County",5,20,281,152,129
050,36,031,"New York","Essex County",5,21,289,155,134
050,36,031,"New York","Essex County",5,22,331,178,153
050,36,031,"New York","Essex County",5,23,365,183,182
050,36,031,"New York","Essex County",5,24,351,203,148
050,36,031,"New York","Essex County",5,25,362,201,161
050,36,031,"New York","Essex County",5,26,374,208,166
050,36,031,"New York","Essex County",5,27,365,192,173
050,36,031,"New York","Essex County",5,28,406,221,185
050,36,031,"New York","Essex County",5,29,425,240,185
050,36,031,"New York","Essex County",5,30,432,248,184
050,36,031,"New York","Essex County",5,31,435,249,186
050,36,031,"New York","Essex County",5,32,388,215,173
050,36,031,"New York","Essex County",5,33,431,228,203
050,36,031,"New York","Essex County",5,34,461,245,216
050,36,031,"New York","Essex County",5,35,439,227,212
050,36,031,"New York","Essex County",5,36,408,224,184
050,36,031,"New York","Essex County",5,37,452,230,222
050,36,031,"New York","Essex County",5,38,423,232,191
050,36,031,"New York","Essex County",5,39,411,230,181
050,36,031,"New York","Essex County",5,40,429,233,196
050,36,031,"New York","Essex County",5,41,434,229,205
050,36,031,"New York","Essex County",5,42,423,217,206
050,36,031,"New York","Essex County",5,43,421,220,201
050,36,031,"New York","Essex County",5,44,407,210,197
050,36,031,"New York","Essex County",5,45,418,206,212
050,36,031,"New York","Essex County",5,46,400,196,204
050,36,031,"New York","Essex County",5,47,385,200,185
050,36,031,"New York","Essex County",5,48,401,202,199
050,36,031,"New York","Essex County",5,49,418,213,205
050,36,031,"New York","Essex County",5,50,433,225,208
050,36,031,"New York","Essex County",5,51,465,252,213
050,36,031,"New York","Essex County",5,52,495,260,235
050,36,031,"New York","Essex County",5,53,511,261,250
050,36,031,"New York","Essex County",5,54,501,237,264
050,36,031,"New York","Essex County",5,55,504,254,250
050,36,031,"New York","Essex County",5,56,514,262,252
050,36,031,"New York","Essex County",5,57,541,283,258
050,36,031,"New York","Essex County",5,58,599,294,305
050,36,031,"New York","Essex County",5,59,624,305,319
050,36,031,"New York","Essex County",5,60,635,304,331
050,36,031,"New York","Essex County",5,61,623,309,314
050,36,031,"New York","Essex County",5,62,648,330,318
050,36,031,"New York","Essex County",5,63,672,341,331
050,36,031,"New York","Essex County",5,64,692,360,332
050,36,031,"New York","Essex County",5,65,686,357,329
050,36,031,"New York","Essex County",5,66,692,371,321
050,36,031,"New York","Essex County",5,67,610,295,315
050,36,031,"New York","Essex County",5,68,609,305,304
050,36,031,"New York","Essex County",5,69,589,292,297
050,36,031,"New York","Essex County",5,70,618,317,301
050,36,031,"New York","Essex County",5,71,568,288,280
050,36,031,"New York","Essex County",5,72,553,286,267
050,36,031,"New York","Essex County",5,73,508,262,246
050,36,031,"New York","Essex County",5,74,463,229,234
050,36,031,"New York","Essex County",5,75,474,231,243
050,36,031,"New York","Essex County",5,76,473,238,235
050,36,031,"New York","Essex County",5,77,297,140,157
050,36,031,"New York","Essex County",5,78,317,153,164
050,36,031,"New York","Essex County",5,79,318,154,164
050,36,031,"New York","Essex County",5,80,330,169,161
050,36,031,"New York","Essex County",5,81,275,141,134
050,36,031,"New York","Essex County",5,82,244,113,131
050,36,031,"New York","Essex County",5,83,208,93,115
050,36,031,"New York","Essex County",5,84,186,82,104
050,36,031,"New York","Essex County",5,85,1069,392,677
050,36,033,"New York","Franklin County",1,0,462,234,228
050,36,033,"New York","Franklin County",1,1,481,244,237
050,36,033,"New York","Franklin County",1,2,458,240,218
050,36,033,"New York","Franklin County",1,3,477,236,241
050,36,033,"New York","Franklin County",1,4,477,240,237
050,36,033,"New York","Franklin County",1,5,505,254,251
050,36,033,"New York","Franklin County",1,6,512,262,250
050,36,033,"New York","Franklin County",1,7,558,297,261
050,36,033,"New York","Franklin County",1,8,546,283,263
050,36,033,"New York","Franklin County",1,9,569,312,257
050,36,033,"New York","Franklin County",1,10,562,297,265
050,36,033,"New York","Franklin County",1,11,569,289,280
050,36,033,"New York","Franklin County",1,12,601,313,288
050,36,033,"New York","Franklin County",1,13,619,313,306
050,36,033,"New York","Franklin County",1,14,602,308,294
050,36,033,"New York","Franklin County",1,15,578,304,274
050,36,033,"New York","Franklin County",1,16,570,307,263
050,36,033,"New York","Franklin County",1,17,558,293,265
050,36,033,"New York","Franklin County",1,18,546,306,240
050,36,033,"New York","Franklin County",1,19,538,322,216
050,36,033,"New York","Franklin County",1,20,524,307,217
050,36,033,"New York","Franklin County",1,21,565,336,229
050,36,033,"New York","Franklin County",1,22,556,334,222
050,36,033,"New York","Franklin County",1,23,591,364,227
050,36,033,"New York","Franklin County",1,24,619,384,235
050,36,033,"New York","Franklin County",1,25,606,353,253
050,36,033,"New York","Franklin County",1,26,661,396,265
050,36,033,"New York","Franklin County",1,27,635,378,257
050,36,033,"New York","Franklin County",1,28,601,353,248
050,36,033,"New York","Franklin County",1,29,654,396,258
050,36,033,"New York","Franklin County",1,30,646,386,260
050,36,033,"New York","Franklin County",1,31,622,365,257
050,36,033,"New York","Franklin County",1,32,622,358,264
050,36,033,"New York","Franklin County",1,33,623,353,270
050,36,033,"New York","Franklin County",1,34,603,338,265
050,36,033,"New York","Franklin County",1,35,606,343,263
050,36,033,"New York","Franklin County",1,36,607,325,282
050,36,033,"New York","Franklin County",1,37,623,330,293
050,36,033,"New York","Franklin County",1,38,635,350,285
050,36,033,"New York","Franklin County",1,39,628,364,264
050,36,033,"New York","Franklin County",1,40,586,319,267
050,36,033,"New York","Franklin County",1,41,548,323,225
050,36,033,"New York","Franklin County",1,42,539,330,209
050,36,033,"New York","Franklin County",1,43,565,325,240
050,36,033,"New York","Franklin County",1,44,560,318,242
050,36,033,"New York","Franklin County",1,45,558,315,243
050,36,033,"New York","Franklin County",1,46,531,304,227
050,36,033,"New York","Franklin County",1,47,561,304,257
050,36,033,"New York","Franklin County",1,48,591,310,281
050,36,033,"New York","Franklin County",1,49,630,341,289
050,36,033,"New York","Franklin County",1,50,612,340,272
050,36,033,"New York","Franklin County",1,51,615,325,290
050,36,033,"New York","Franklin County",1,52,625,340,285
050,36,033,"New York","Franklin County",1,53,645,341,304
050,36,033,"New York","Franklin County",1,54,667,362,305
050,36,033,"New York","Franklin County",1,55,732,382,350
050,36,033,"New York","Franklin County",1,56,709,354,355
050,36,033,"New York","Franklin County",1,57,705,358,347
050,36,033,"New York","Franklin County",1,58,738,378,360
050,36,033,"New York","Franklin County",1,59,713,372,341
050,36,033,"New York","Franklin County",1,60,688,337,351
050,36,033,"New York","Franklin County",1,61,724,363,361
050,36,033,"New York","Franklin County",1,62,744,390,354
050,36,033,"New York","Franklin County",1,63,674,347,327
050,36,033,"New York","Franklin County",1,64,645,322,323
050,36,033,"New York","Franklin County",1,65,596,288,308
050,36,033,"New York","Franklin County",1,66,617,301,316
050,36,033,"New York","Franklin County",1,67,581,294,287
050,36,033,"New York","Franklin County",1,68,567,301,266
050,36,033,"New York","Franklin County",1,69,519,269,250
050,36,033,"New York","Franklin County",1,70,477,245,232
050,36,033,"New York","Franklin County",1,71,490,250,240
050,36,033,"New York","Franklin County",1,72,484,255,229
050,36,033,"New York","Franklin County",1,73,500,243,257
050,36,033,"New York","Franklin County",1,74,340,161,179
050,36,033,"New York","Franklin County",1,75,351,177,174
050,36,033,"New York","Franklin County",1,76,346,169,177
050,36,033,"New York","Franklin County",1,77,300,144,156
050,36,033,"New York","Franklin County",1,78,282,139,143
050,36,033,"New York","Franklin County",1,79,270,125,145
050,36,033,"New York","Franklin County",1,80,221,100,121
050,36,033,"New York","Franklin County",1,81,208,86,122
050,36,033,"New York","Franklin County",1,82,200,86,114
050,36,033,"New York","Franklin County",1,83,166,65,101
050,36,033,"New York","Franklin County",1,84,158,61,97
050,36,033,"New York","Franklin County",1,85,980,351,629
050,36,033,"New York","Franklin County",2,0,474,248,226
050,36,033,"New York","Franklin County",2,1,476,243,233
050,36,033,"New York","Franklin County",2,2,464,241,223
050,36,033,"New York","Franklin County",2,3,471,236,235
050,36,033,"New York","Franklin County",2,4,483,242,241
050,36,033,"New York","Franklin County",2,5,502,253,249
050,36,033,"New York","Franklin County",2,6,509,259,250
050,36,033,"New York","Franklin County",2,7,548,289,259
050,36,033,"New York","Franklin County",2,8,546,283,263
050,36,033,"New York","Franklin County",2,9,563,304,259
050,36,033,"New York","Franklin County",2,10,565,300,265
050,36,033,"New York","Franklin County",2,11,565,290,275
050,36,033,"New York","Franklin County",2,12,596,310,286
050,36,033,"New York","Franklin County",2,13,611,311,300
050,36,033,"New York","Franklin County",2,14,604,308,296
050,36,033,"New York","Franklin County",2,15,583,304,279
050,36,033,"New York","Franklin County",2,16,572,306,266
050,36,033,"New York","Franklin County",2,17,560,296,264
050,36,033,"New York","Franklin County",2,18,579,328,251
050,36,033,"New York","Franklin County",2,19,588,358,230
050,36,033,"New York","Franklin County",2,20,568,331,237
050,36,033,"New York","Franklin County",2,21,580,348,232
050,36,033,"New York","Franklin County",2,22,565,335,230
050,36,033,"New York","Franklin County",2,23,578,351,227
050,36,033,"New York","Franklin County",2,24,607,374,233
050,36,033,"New York","Franklin County",2,25,598,348,250
050,36,033,"New York","Franklin County",2,26,644,379,265
050,36,033,"New York","Franklin County",2,27,632,370,262
050,36,033,"New York","Franklin County",2,28,600,350,250
050,36,033,"New York","Franklin County",2,29,627,371,256
050,36,033,"New York","Franklin County",2,30,639,377,262
050,36,033,"New York","Franklin County",2,31,615,357,258
050,36,033,"New York","Franklin County",2,32,613,348,265
050,36,033,"New York","Franklin County",2,33,610,341,269
050,36,033,"New York","Franklin County",2,34,598,332,266
050,36,033,"New York","Franklin County",2,35,603,336,267
050,36,033,"New York","Franklin County",2,36,595,320,275
050,36,033,"New York","Franklin County",2,37,612,321,291
050,36,033,"New York","Franklin County",2,38,631,341,290
050,36,033,"New York","Franklin County",2,39,621,353,268
050,36,033,"New York","Franklin County",2,40,589,321,268
050,36,033,"New York","Franklin County",2,41,548,316,232
050,36,033,"New York","Franklin County",2,42,538,323,215
050,36,033,"New York","Franklin County",2,43,554,319,235
050,36,033,"New York","Franklin County",2,44,550,311,239
050,36,033,"New York","Franklin County",2,45,548,307,241
050,36,033,"New York","Franklin County",2,46,528,298,230
050,36,033,"New York","Franklin County",2,47,548,296,252
050,36,033,"New York","Franklin County",2,48,577,303,274
050,36,033,"New York","Franklin County",2,49,618,332,286
050,36,033,"New York","Franklin County",2,50,614,335,279
050,36,033,"New York","Franklin County",2,51,607,322,285
050,36,033,"New York","Franklin County",2,52,614,330,284
050,36,033,"New York","Franklin County",2,53,632,333,299
050,36,033,"New York","Franklin County",2,54,661,355,306
050,36,033,"New York","Franklin County",2,55,711,372,339
050,36,033,"New York","Franklin County",2,56,717,360,357
050,36,033,"New York","Franklin County",2,57,706,353,353
050,36,033,"New York","Franklin County",2,58,729,373,356
050,36,033,"New York","Franklin County",2,59,716,372,344
050,36,033,"New York","Franklin County",2,60,689,343,346
050,36,033,"New York","Franklin County",2,61,715,355,360
050,36,033,"New York","Franklin County",2,62,739,382,357
050,36,033,"New York","Franklin County",2,63,700,362,338
050,36,033,"New York","Franklin County",2,64,643,322,321
050,36,033,"New York","Franklin County",2,65,604,292,312
050,36,033,"New York","Franklin County",2,66,616,299,317
050,36,033,"New York","Franklin County",2,67,587,294,293
050,36,033,"New York","Franklin County",2,68,567,298,269
050,36,033,"New York","Franklin County",2,69,535,279,256
050,36,033,"New York","Franklin County",2,70,483,249,234
050,36,033,"New York","Franklin County",2,71,484,246,238
050,36,033,"New York","Franklin County",2,72,475,248,227
050,36,033,"New York","Franklin County",2,73,518,254,264
050,36,033,"New York","Franklin County",2,74,351,167,184
050,36,033,"New York","Franklin County",2,75,345,169,176
050,36,033,"New York","Franklin County",2,76,338,165,173
050,36,033,"New York","Franklin County",2,77,316,152,164
050,36,033,"New York","Franklin County",2,78,278,135,143
050,36,033,"New York","Franklin County",2,79,262,122,140
050,36,033,"New York","Franklin County",2,80,231,105,126
050,36,033,"New York","Franklin County",2,81,207,87,120
050,36,033,"New York","Franklin County",2,82,198,83,115
050,36,033,"New York","Franklin County",2,83,165,65,100
050,36,033,"New York","Franklin County",2,84,156,60,96
050,36,033,"New York","Franklin County",2,85,975,351,624
050,36,033,"New York","Franklin County",3,0,414,211,203
050,36,033,"New York","Franklin County",3,1,478,248,230
050,36,033,"New York","Franklin County",3,2,483,245,238
050,36,033,"New York","Franklin County",3,3,480,250,230
050,36,033,"New York","Franklin County",3,4,481,237,244
050,36,033,"New York","Franklin County",3,5,482,238,244
050,36,033,"New York","Franklin County",3,6,489,245,244
050,36,033,"New York","Franklin County",3,7,512,259,253
050,36,033,"New York","Franklin County",3,8,541,283,258
050,36,033,"New York","Franklin County",3,9,537,273,264
050,36,033,"New York","Franklin County",3,10,560,304,256
050,36,033,"New York","Franklin County",3,11,556,301,255
050,36,033,"New York","Franklin County",3,12,568,293,275
050,36,033,"New York","Franklin County",3,13,601,316,285
050,36,033,"New York","Franklin County",3,14,614,317,297
050,36,033,"New York","Franklin County",3,15,602,303,299
050,36,033,"New York","Franklin County",3,16,586,307,279
050,36,033,"New York","Franklin County",3,17,571,298,273
050,36,033,"New York","Franklin County",3,18,599,342,257
050,36,033,"New York","Franklin County",3,19,579,354,225
050,36,033,"New York","Franklin County",3,20,575,329,246
050,36,033,"New York","Franklin County",3,21,583,352,231
050,36,033,"New York","Franklin County",3,22,573,333,240
050,36,033,"New York","Franklin County",3,23,553,319,234
050,36,033,"New York","Franklin County",3,24,588,341,247
050,36,033,"New York","Franklin County",3,25,573,338,235
050,36,033,"New York","Franklin County",3,26,575,338,237
050,36,033,"New York","Franklin County",3,27,638,356,282
050,36,033,"New York","Franklin County",3,28,628,366,262
050,36,033,"New York","Franklin County",3,29,589,337,252
050,36,033,"New York","Franklin County",3,30,613,354,259
050,36,033,"New York","Franklin County",3,31,622,367,255
050,36,033,"New York","Franklin County",3,32,608,352,256
050,36,033,"New York","Franklin County",3,33,589,321,268
050,36,033,"New York","Franklin County",3,34,588,318,270
050,36,033,"New York","Franklin County",3,35,585,315,270
050,36,033,"New York","Franklin County",3,36,595,329,266
050,36,033,"New York","Franklin County",3,37,598,321,277
050,36,033,"New York","Franklin County",3,38,615,324,291
050,36,033,"New York","Franklin County",3,39,625,331,294
050,36,033,"New York","Franklin County",3,40,590,318,272
050,36,033,"New York","Franklin County",3,41,577,316,261
050,36,033,"New York","Franklin County",3,42,554,315,239
050,36,033,"New York","Franklin County",3,43,517,303,214
050,36,033,"New York","Franklin County",3,44,546,316,230
050,36,033,"New York","Franklin County",3,45,528,292,236
050,36,033,"New York","Franklin County",3,46,528,290,238
050,36,033,"New York","Franklin County",3,47,518,284,234
050,36,033,"New York","Franklin County",3,48,542,289,253
050,36,033,"New York","Franklin County",3,49,574,304,270
050,36,033,"New York","Franklin County",3,50,615,329,286
050,36,033,"New York","Franklin County",3,51,609,321,288
050,36,033,"New York","Franklin County",3,52,588,321,267
050,36,033,"New York","Franklin County",3,53,596,309,287
050,36,033,"New York","Franklin County",3,54,620,323,297
050,36,033,"New York","Franklin County",3,55,641,345,296
050,36,033,"New York","Franklin County",3,56,709,367,342
050,36,033,"New York","Franklin County",3,57,698,342,356
050,36,033,"New York","Franklin County",3,58,709,351,358
050,36,033,"New York","Franklin County",3,59,714,358,356
050,36,033,"New York","Franklin County",3,60,709,365,344
050,36,033,"New York","Franklin County",3,61,684,347,337
050,36,033,"New York","Franklin County",3,62,710,352,358
050,36,033,"New York","Franklin County",3,63,749,387,362
050,36,033,"New York","Franklin County",3,64,686,357,329
050,36,033,"New York","Franklin County",3,65,623,306,317
050,36,033,"New York","Franklin County",3,66,614,293,321
050,36,033,"New York","Franklin County",3,67,594,290,304
050,36,033,"New York","Franklin County",3,68,584,291,293
050,36,033,"New York","Franklin County",3,69,563,299,264
050,36,033,"New York","Franklin County",3,70,517,269,248
050,36,033,"New York","Franklin County",3,71,478,247,231
050,36,033,"New York","Franklin County",3,72,464,230,234
050,36,033,"New York","Franklin County",3,73,475,242,233
050,36,033,"New York","Franklin County",3,74,500,249,251
050,36,033,"New York","Franklin County",3,75,339,162,177
050,36,033,"New York","Franklin County",3,76,330,161,169
050,36,033,"New York","Franklin County",3,77,323,156,167
050,36,033,"New York","Franklin County",3,78,311,145,166
050,36,033,"New York","Franklin County",3,79,252,126,126
050,36,033,"New York","Franklin County",3,80,250,115,135
050,36,033,"New York","Franklin County",3,81,215,98,117
050,36,033,"New York","Franklin County",3,82,200,77,123
050,36,033,"New York","Franklin County",3,83,188,81,107
050,36,033,"New York","Franklin County",3,84,149,56,93
050,36,033,"New York","Franklin County",3,85,980,351,629
050,36,033,"New York","Franklin County",4,0,448,238,210
050,36,033,"New York","Franklin County",4,1,404,201,203
050,36,033,"New York","Franklin County",4,2,479,253,226
050,36,033,"New York","Franklin County",4,3,495,246,249
050,36,033,"New York","Franklin County",4,4,483,245,238
050,36,033,"New York","Franklin County",4,5,493,251,242
050,36,033,"New York","Franklin County",4,6,486,237,249
050,36,033,"New York","Franklin County",4,7,498,250,248
050,36,033,"New York","Franklin County",4,8,512,261,251
050,36,033,"New York","Franklin County",4,9,535,280,255
050,36,033,"New York","Franklin County",4,10,546,278,268
050,36,033,"New York","Franklin County",4,11,552,294,258
050,36,033,"New York","Franklin County",4,12,555,302,253
050,36,033,"New York","Franklin County",4,13,558,286,272
050,36,033,"New York","Franklin County",4,14,603,319,284
050,36,033,"New York","Franklin County",4,15,607,310,297
050,36,033,"New York","Franklin County",4,16,604,304,300
050,36,033,"New York","Franklin County",4,17,580,307,273
050,36,033,"New York","Franklin County",4,18,603,338,265
050,36,033,"New York","Franklin County",4,19,564,347,217
050,36,033,"New York","Franklin County",4,20,538,322,216
050,36,033,"New York","Franklin County",4,21,559,330,229
050,36,033,"New York","Franklin County",4,22,564,325,239
050,36,033,"New York","Franklin County",4,23,550,307,243
050,36,033,"New York","Franklin County",4,24,544,307,237
050,36,033,"New York","Franklin County",4,25,547,304,243
050,36,033,"New York","Franklin County",4,26,544,319,225
050,36,033,"New York","Franklin County",4,27,566,316,250
050,36,033,"New York","Franklin County",4,28,628,347,281
050,36,033,"New York","Franklin County",4,29,601,345,256
050,36,033,"New York","Franklin County",4,30,562,311,251
050,36,033,"New York","Franklin County",4,31,599,345,254
050,36,033,"New York","Franklin County",4,32,598,344,254
050,36,033,"New York","Franklin County",4,33,577,325,252
050,36,033,"New York","Franklin County",4,34,564,303,261
050,36,033,"New York","Franklin County",4,35,575,300,275
050,36,033,"New York","Franklin County",4,36,578,304,274
050,36,033,"New York","Franklin County",4,37,590,315,275
050,36,033,"New York","Franklin County",4,38,579,303,276
050,36,033,"New York","Franklin County",4,39,605,320,285
050,36,033,"New York","Franklin County",4,40,596,302,294
050,36,033,"New York","Franklin County",4,41,573,302,271
050,36,033,"New York","Franklin County",4,42,580,318,262
050,36,033,"New York","Franklin County",4,43,532,298,234
050,36,033,"New York","Franklin County",4,44,511,298,213
050,36,033,"New York","Franklin County",4,45,532,303,229
050,36,033,"New York","Franklin County",4,46,517,283,234
050,36,033,"New York","Franklin County",4,47,509,269,240
050,36,033,"New York","Franklin County",4,48,501,271,230
050,36,033,"New York","Franklin County",4,49,536,284,252
050,36,033,"New York","Franklin County",4,50,564,304,260
050,36,033,"New York","Franklin County",4,51,595,307,288
050,36,033,"New York","Franklin County",4,52,599,315,284
050,36,033,"New York","Franklin County",4,53,568,300,268
050,36,033,"New York","Franklin County",4,54,602,306,296
050,36,033,"New York","Franklin County",4,55,615,323,292
050,36,033,"New York","Franklin County",4,56,633,342,291
050,36,033,"New York","Franklin County",4,57,682,342,340
050,36,033,"New York","Franklin County",4,58,695,341,354
050,36,033,"New York","Franklin County",4,59,689,339,350
050,36,033,"New York","Franklin County",4,60,711,355,356
050,36,033,"New York","Franklin County",4,61,704,365,339
050,36,033,"New York","Franklin County",4,62,677,339,338
050,36,033,"New York","Franklin County",4,63,710,362,348
050,36,033,"New York","Franklin County",4,64,728,375,353
050,36,033,"New York","Franklin County",4,65,673,347,326
050,36,033,"New York","Franklin County",4,66,613,301,312
050,36,033,"New York","Franklin County",4,67,588,277,311
050,36,033,"New York","Franklin County",4,68,602,294,308
050,36,033,"New York","Franklin County",4,69,575,284,291
050,36,033,"New York","Franklin County",4,70,546,290,256
050,36,033,"New York","Franklin County",4,71,508,263,245
050,36,033,"New York","Franklin County",4,72,457,232,225
050,36,033,"New York","Franklin County",4,73,451,221,230
050,36,033,"New York","Franklin County",4,74,460,236,224
050,36,033,"New York","Franklin County",4,75,485,241,244
050,36,033,"New York","Franklin County",4,76,319,158,161
050,36,033,"New York","Franklin County",4,77,310,147,163
050,36,033,"New York","Franklin County",4,78,308,144,164
050,36,033,"New York","Franklin County",4,79,274,131,143
050,36,033,"New York","Franklin County",4,80,243,120,123
050,36,033,"New York","Franklin County",4,81,235,105,130
050,36,033,"New York","Franklin County",4,82,201,87,114
050,36,033,"New York","Franklin County",4,83,183,71,112
050,36,033,"New York","Franklin County",4,84,163,69,94
050,36,033,"New York","Franklin County",4,85,967,348,619
050,36,033,"New York","Franklin County",5,0,448,237,211
050,36,033,"New York","Franklin County",5,1,440,235,205
050,36,033,"New York","Franklin County",5,2,412,213,199
050,36,033,"New York","Franklin County",5,3,483,260,223
050,36,033,"New York","Franklin County",5,4,493,246,247
050,36,033,"New York","Franklin County",5,5,476,243,233
050,36,033,"New York","Franklin County",5,6,496,257,239
050,36,033,"New York","Franklin County",5,7,491,244,247
050,36,033,"New York","Franklin County",5,8,501,253,248
050,36,033,"New York","Franklin County",5,9,514,262,252
050,36,033,"New York","Franklin County",5,10,522,273,249
050,36,033,"New York","Franklin County",5,11,551,277,274
050,36,033,"New York","Franklin County",5,12,551,295,256
050,36,033,"New York","Franklin County",5,13,561,303,258
050,36,033,"New York","Franklin County",5,14,564,285,279
050,36,033,"New York","Franklin County",5,15,602,315,287
050,36,033,"New York","Franklin County",5,16,608,312,296
050,36,033,"New York","Franklin County",5,17,596,298,298
050,36,033,"New York","Franklin County",5,18,585,335,250
050,36,033,"New York","Franklin County",5,19,556,335,221
050,36,033,"New York","Franklin County",5,20,534,307,227
050,36,033,"New York","Franklin County",5,21,541,333,208
050,36,033,"New York","Franklin County",5,22,549,318,231
050,36,033,"New York","Franklin County",5,23,544,331,213
050,36,033,"New York","Franklin County",5,24,598,331,267
050,36,033,"New York","Franklin County",5,25,515,292,223
050,36,033,"New York","Franklin County",5,26,548,317,231
050,36,033,"New York","Franklin County",5,27,551,322,229
050,36,033,"New York","Franklin County",5,28,560,318,242
050,36,033,"New York","Franklin County",5,29,624,350,274
050,36,033,"New York","Franklin County",5,30,601,347,254
050,36,033,"New York","Franklin County",5,31,569,323,246
050,36,033,"New York","Franklin County",5,32,614,352,262
050,36,033,"New York","Franklin County",5,33,605,350,255
050,36,033,"New York","Franklin County",5,34,579,317,262
050,36,033,"New York","Franklin County",5,35,577,306,271
050,36,033,"New York","Franklin County",5,36,583,309,274
050,36,033,"New York","Franklin County",5,37,588,316,272
050,36,033,"New York","Franklin County",5,38,603,333,270
050,36,033,"New York","Franklin County",5,39,593,313,280
050,36,033,"New York","Franklin County",5,40,594,310,284
050,36,033,"New York","Franklin County",5,41,608,318,290
050,36,033,"New York","Franklin County",5,42,600,321,279
050,36,033,"New York","Franklin County",5,43,584,320,264
050,36,033,"New York","Franklin County",5,44,538,304,234
050,36,033,"New York","Franklin County",5,45,511,297,214
050,36,033,"New York","Franklin County",5,46,540,314,226
050,36,033,"New York","Franklin County",5,47,530,288,242
050,36,033,"New York","Franklin County",5,48,509,269,240
050,36,033,"New York","Franklin County",5,49,519,286,233
050,36,033,"New York","Franklin County",5,50,539,292,247
050,36,033,"New York","Franklin County",5,51,561,292,269
050,36,033,"New York","Franklin County",5,52,611,324,287
050,36,033,"New York","Franklin County",5,53,580,296,284
050,36,033,"New York","Franklin County",5,54,595,311,284
050,36,033,"New York","Franklin County",5,55,599,304,295
050,36,033,"New York","Franklin County",5,56,608,323,285
050,36,033,"New York","Franklin County",5,57,619,328,291
050,36,033,"New York","Franklin County",5,58,700,353,347
050,36,033,"New York","Franklin County",5,59,687,333,354
050,36,033,"New York","Franklin County",5,60,693,337,356
050,36,033,"New York","Franklin County",5,61,704,355,349
050,36,033,"New York","Franklin County",5,62,692,356,336
050,36,033,"New York","Franklin County",5,63,675,337,338
050,36,033,"New York","Franklin County",5,64,704,360,344
050,36,033,"New York","Franklin County",5,65,708,363,345
050,36,033,"New York","Franklin County",5,66,678,347,331
050,36,033,"New York","Franklin County",5,67,593,291,302
050,36,033,"New York","Franklin County",5,68,599,282,317
050,36,033,"New York","Franklin County",5,69,589,284,305
050,36,033,"New York","Franklin County",5,70,556,276,280
050,36,033,"New York","Franklin County",5,71,540,287,253
050,36,033,"New York","Franklin County",5,72,496,250,246
050,36,033,"New York","Franklin County",5,73,455,229,226
050,36,033,"New York","Franklin County",5,74,440,218,222
050,36,033,"New York","Franklin County",5,75,453,234,219
050,36,033,"New York","Franklin County",5,76,462,233,229
050,36,033,"New York","Franklin County",5,77,296,143,153
050,36,033,"New York","Franklin County",5,78,295,135,160
050,36,033,"New York","Franklin County",5,79,277,133,144
050,36,033,"New York","Franklin County",5,80,256,118,138
050,36,033,"New York","Franklin County",5,81,228,114,114
050,36,033,"New York","Franklin County",5,82,221,94,127
050,36,033,"New York","Franklin County",5,83,181,78,103
050,36,033,"New York","Franklin County",5,84,161,59,102
050,36,033,"New York","Franklin County",5,85,992,360,632
050,36,035,"New York","Fulton County",1,0,486,247,239
050,36,035,"New York","Fulton County",1,1,499,257,242
050,36,035,"New York","Fulton County",1,2,534,281,253
050,36,035,"New York","Fulton County",1,3,548,297,251
050,36,035,"New York","Fulton County",1,4,573,300,273
050,36,035,"New York","Fulton County",1,5,563,280,283
050,36,035,"New York","Fulton County",1,6,587,301,286
050,36,035,"New York","Fulton County",1,7,583,311,272
050,36,035,"New York","Fulton County",1,8,595,320,275
050,36,035,"New York","Fulton County",1,9,627,318,309
050,36,035,"New York","Fulton County",1,10,623,313,310
050,36,035,"New York","Fulton County",1,11,660,342,318
050,36,035,"New York","Fulton County",1,12,697,340,357
050,36,035,"New York","Fulton County",1,13,658,322,336
050,36,035,"New York","Fulton County",1,14,657,344,313
050,36,035,"New York","Fulton County",1,15,628,319,309
050,36,035,"New York","Fulton County",1,16,634,325,309
050,36,035,"New York","Fulton County",1,17,660,336,324
050,36,035,"New York","Fulton County",1,18,605,316,289
050,36,035,"New York","Fulton County",1,19,516,273,243
050,36,035,"New York","Fulton County",1,20,520,271,249
050,36,035,"New York","Fulton County",1,21,556,293,263
050,36,035,"New York","Fulton County",1,22,580,301,279
050,36,035,"New York","Fulton County",1,23,585,298,287
050,36,035,"New York","Fulton County",1,24,608,313,295
050,36,035,"New York","Fulton County",1,25,615,336,279
050,36,035,"New York","Fulton County",1,26,619,328,291
050,36,035,"New York","Fulton County",1,27,614,330,284
050,36,035,"New York","Fulton County",1,28,623,325,298
050,36,035,"New York","Fulton County",1,29,673,336,337
050,36,035,"New York","Fulton County",1,30,634,328,306
050,36,035,"New York","Fulton County",1,31,625,333,292
050,36,035,"New York","Fulton County",1,32,629,331,298
050,36,035,"New York","Fulton County",1,33,621,313,308
050,36,035,"New York","Fulton County",1,34,627,314,313
050,36,035,"New York","Fulton County",1,35,655,324,331
050,36,035,"New York","Fulton County",1,36,667,329,338
050,36,035,"New York","Fulton County",1,37,676,348,328
050,36,035,"New York","Fulton County",1,38,647,328,319
050,36,035,"New York","Fulton County",1,39,671,361,310
050,36,035,"New York","Fulton County",1,40,656,331,325
050,36,035,"New York","Fulton County",1,41,636,322,314
050,36,035,"New York","Fulton County",1,42,619,313,306
050,36,035,"New York","Fulton County",1,43,608,306,302
050,36,035,"New York","Fulton County",1,44,573,299,274
050,36,035,"New York","Fulton County",1,45,585,307,278
050,36,035,"New York","Fulton County",1,46,572,291,281
050,36,035,"New York","Fulton County",1,47,642,311,331
050,36,035,"New York","Fulton County",1,48,727,362,365
050,36,035,"New York","Fulton County",1,49,794,432,362
050,36,035,"New York","Fulton County",1,50,733,381,352
050,36,035,"New York","Fulton County",1,51,724,359,365
050,36,035,"New York","Fulton County",1,52,736,373,363
050,36,035,"New York","Fulton County",1,53,777,395,382
050,36,035,"New York","Fulton County",1,54,794,409,385
050,36,035,"New York","Fulton County",1,55,831,415,416
050,36,035,"New York","Fulton County",1,56,857,439,418
050,36,035,"New York","Fulton County",1,57,821,416,405
050,36,035,"New York","Fulton County",1,58,833,414,419
050,36,035,"New York","Fulton County",1,59,857,448,409
050,36,035,"New York","Fulton County",1,60,829,412,417
050,36,035,"New York","Fulton County",1,61,847,426,421
050,36,035,"New York","Fulton County",1,62,809,397,412
050,36,035,"New York","Fulton County",1,63,763,369,394
050,36,035,"New York","Fulton County",1,64,740,381,359
050,36,035,"New York","Fulton County",1,65,744,358,386
050,36,035,"New York","Fulton County",1,66,721,374,347
050,36,035,"New York","Fulton County",1,67,707,345,362
050,36,035,"New York","Fulton County",1,68,692,331,361
050,36,035,"New York","Fulton County",1,69,613,301,312
050,36,035,"New York","Fulton County",1,70,624,295,329
050,36,035,"New York","Fulton County",1,71,613,292,321
050,36,035,"New York","Fulton County",1,72,607,298,309
050,36,035,"New York","Fulton County",1,73,586,295,291
050,36,035,"New York","Fulton County",1,74,411,195,216
050,36,035,"New York","Fulton County",1,75,442,201,241
050,36,035,"New York","Fulton County",1,76,420,199,221
050,36,035,"New York","Fulton County",1,77,403,176,227
050,36,035,"New York","Fulton County",1,78,336,142,194
050,36,035,"New York","Fulton County",1,79,276,111,165
050,36,035,"New York","Fulton County",1,80,245,98,147
050,36,035,"New York","Fulton County",1,81,264,121,143
050,36,035,"New York","Fulton County",1,82,252,110,142
050,36,035,"New York","Fulton County",1,83,225,100,125
050,36,035,"New York","Fulton County",1,84,197,80,117
050,36,035,"New York","Fulton County",1,85,1214,389,825
050,36,035,"New York","Fulton County",2,0,482,245,237
050,36,035,"New York","Fulton County",2,1,497,257,240
050,36,035,"New York","Fulton County",2,2,526,277,249
050,36,035,"New York","Fulton County",2,3,542,293,249
050,36,035,"New York","Fulton County",2,4,565,298,267
050,36,035,"New York","Fulton County",2,5,566,286,280
050,36,035,"New York","Fulton County",2,6,579,293,286
050,36,035,"New York","Fulton County",2,7,584,310,274
050,36,035,"New York","Fulton County",2,8,590,316,274
050,36,035,"New York","Fulton County",2,9,617,317,300
050,36,035,"New York","Fulton County",2,10,625,315,310
050,36,035,"New York","Fulton County",2,11,645,332,313
050,36,035,"New York","Fulton County",2,12,689,341,348
050,36,035,"New York","Fulton County",2,13,667,327,340
050,36,035,"New York","Fulton County",2,14,656,335,321
050,36,035,"New York","Fulton County",2,15,635,322,313
050,36,035,"New York","Fulton County",2,16,636,324,312
050,36,035,"New York","Fulton County",2,17,653,331,322
050,36,035,"New York","Fulton County",2,18,596,310,286
050,36,035,"New York","Fulton County",2,19,517,272,245
050,36,035,"New York","Fulton County",2,20,532,278,254
050,36,035,"New York","Fulton County",2,21,552,292,260
050,36,035,"New York","Fulton County",2,22,577,298,279
050,36,035,"New York","Fulton County",2,23,585,299,286
050,36,035,"New York","Fulton County",2,24,598,307,291
050,36,035,"New York","Fulton County",2,25,605,326,279
050,36,035,"New York","Fulton County",2,26,616,329,287
050,36,035,"New York","Fulton County",2,27,610,325,285
050,36,035,"New York","Fulton County",2,28,619,324,295
050,36,035,"New York","Fulton County",2,29,654,325,329
050,36,035,"New York","Fulton County",2,30,644,328,316
050,36,035,"New York","Fulton County",2,31,623,328,295
050,36,035,"New York","Fulton County",2,32,624,329,295
050,36,035,"New York","Fulton County",2,33,619,314,305
050,36,035,"New York","Fulton County",2,34,625,315,310
050,36,035,"New York","Fulton County",2,35,650,321,329
050,36,035,"New York","Fulton County",2,36,652,319,333
050,36,035,"New York","Fulton County",2,37,673,340,333
050,36,035,"New York","Fulton County",2,38,652,330,322
050,36,035,"New York","Fulton County",2,39,660,350,310
050,36,035,"New York","Fulton County",2,40,657,335,322
050,36,035,"New York","Fulton County",2,41,634,320,314
050,36,035,"New York","Fulton County",2,42,621,313,308
050,36,035,"New York","Fulton County",2,43,617,312,305
050,36,035,"New York","Fulton County",2,44,576,298,278
050,36,035,"New York","Fulton County",2,45,582,305,277
050,36,035,"New York","Fulton County",2,46,567,290,277
050,36,035,"New York","Fulton County",2,47,621,305,316
050,36,035,"New York","Fulton County",2,48,702,346,356
050,36,035,"New York","Fulton County",2,49,779,417,362
050,36,035,"New York","Fulton County",2,50,747,393,354
050,36,035,"New York","Fulton County",2,51,723,364,359
050,36,035,"New York","Fulton County",2,52,731,368,363
050,36,035,"New York","Fulton County",2,53,763,388,375
050,36,035,"New York","Fulton County",2,54,785,403,382
050,36,035,"New York","Fulton County",2,55,820,414,406
050,36,035,"New York","Fulton County",2,56,849,433,416
050,36,035,"New York","Fulton County",2,57,828,418,410
050,36,035,"New York","Fulton County",2,58,829,414,415
050,36,035,"New York","Fulton County",2,59,851,440,411
050,36,035,"New York","Fulton County",2,60,831,417,414
050,36,035,"New York","Fulton County",2,61,833,419,414
050,36,035,"New York","Fulton County",2,62,813,402,411
050,36,035,"New York","Fulton County",2,63,778,379,399
050,36,035,"New York","Fulton County",2,64,739,374,365
050,36,035,"New York","Fulton County",2,65,742,362,380
050,36,035,"New York","Fulton County",2,66,724,368,356
050,36,035,"New York","Fulton County",2,67,705,348,357
050,36,035,"New York","Fulton County",2,68,685,329,356
050,36,035,"New York","Fulton County",2,69,633,307,326
050,36,035,"New York","Fulton County",2,70,618,294,324
050,36,035,"New York","Fulton County",2,71,613,290,323
050,36,035,"New York","Fulton County",2,72,594,289,305
050,36,035,"New York","Fulton County",2,73,619,309,310
050,36,035,"New York","Fulton County",2,74,420,203,217
050,36,035,"New York","Fulton County",2,75,433,199,234
050,36,035,"New York","Fulton County",2,76,415,195,220
050,36,035,"New York","Fulton County",2,77,414,186,228
050,36,035,"New York","Fulton County",2,78,339,146,193
050,36,035,"New York","Fulton County",2,79,286,117,169
050,36,035,"New York","Fulton County",2,80,242,98,144
050,36,035,"New York","Fulton County",2,81,251,112,139
050,36,035,"New York","Fulton County",2,82,247,106,141
050,36,035,"New York","Fulton County",2,83,222,96,126
050,36,035,"New York","Fulton County",2,84,197,84,113
050,36,035,"New York","Fulton County",2,85,1188,384,804
050,36,035,"New York","Fulton County",3,0,435,231,204
050,36,035,"New York","Fulton County",3,1,494,255,239
050,36,035,"New York","Fulton County",3,2,520,274,246
050,36,035,"New York","Fulton County",3,3,532,282,250
050,36,035,"New York","Fulton County",3,4,534,284,250
050,36,035,"New York","Fulton County",3,5,572,300,272
050,36,035,"New York","Fulton County",3,6,579,296,283
050,36,035,"New York","Fulton County",3,7,588,292,296
050,36,035,"New York","Fulton County",3,8,599,312,287
050,36,035,"New York","Fulton County",3,9,580,309,271
050,36,035,"New York","Fulton County",3,10,610,310,300
050,36,035,"New York","Fulton County",3,11,641,330,311
050,36,035,"New York","Fulton County",3,12,643,332,311
050,36,035,"New York","Fulton County",3,13,685,337,348
050,36,035,"New York","Fulton County",3,14,677,335,342
050,36,035,"New York","Fulton County",3,15,656,333,323
050,36,035,"New York","Fulton County",3,16,646,328,318
050,36,035,"New York","Fulton County",3,17,633,326,307
050,36,035,"New York","Fulton County",3,18,575,295,280
050,36,035,"New York","Fulton County",3,19,507,267,240
050,36,035,"New York","Fulton County",3,20,535,275,260
050,36,035,"New York","Fulton County",3,21,554,293,261
050,36,035,"New York","Fulton County",3,22,550,273,277
050,36,035,"New York","Fulton County",3,23,612,315,297
050,36,035,"New York","Fulton County",3,24,594,303,291
050,36,035,"New York","Fulton County",3,25,577,303,274
050,36,035,"New York","Fulton County",3,26,615,336,279
050,36,035,"New York","Fulton County",3,27,616,317,299
050,36,035,"New York","Fulton County",3,28,588,303,285
050,36,035,"New York","Fulton County",3,29,591,298,293
050,36,035,"New York","Fulton County",3,30,648,317,331
050,36,035,"New York","Fulton County",3,31,644,323,321
050,36,035,"New York","Fulton County",3,32,604,316,288
050,36,035,"New York","Fulton County",3,33,631,329,302
050,36,035,"New York","Fulton County",3,34,622,321,301
050,36,035,"New York","Fulton County",3,35,630,314,316
050,36,035,"New York","Fulton County",3,36,659,317,342
050,36,035,"New York","Fulton County",3,37,661,319,342
050,36,035,"New York","Fulton County",3,38,663,336,327
050,36,035,"New York","Fulton County",3,39,650,329,321
050,36,035,"New York","Fulton County",3,40,647,332,315
050,36,035,"New York","Fulton County",3,41,649,332,317
050,36,035,"New York","Fulton County",3,42,645,318,327
050,36,035,"New York","Fulton County",3,43,642,327,315
050,36,035,"New York","Fulton County",3,44,615,311,304
050,36,035,"New York","Fulton County",3,45,578,301,277
050,36,035,"New York","Fulton County",3,46,581,300,281
050,36,035,"New York","Fulton County",3,47,576,303,273
050,36,035,"New York","Fulton County",3,48,622,297,325
050,36,035,"New York","Fulton County",3,49,699,346,353
050,36,035,"New York","Fulton County",3,50,758,403,355
050,36,035,"New York","Fulton County",3,51,735,385,350
050,36,035,"New York","Fulton County",3,52,730,365,365
050,36,035,"New York","Fulton County",3,53,709,353,356
050,36,035,"New York","Fulton County",3,54,755,380,375
050,36,035,"New York","Fulton County",3,55,776,402,374
050,36,035,"New York","Fulton County",3,56,826,420,406
050,36,035,"New York","Fulton County",3,57,834,421,413
050,36,035,"New York","Fulton County",3,58,820,408,412
050,36,035,"New York","Fulton County",3,59,821,415,406
050,36,035,"New York","Fulton County",3,60,840,432,408
050,36,035,"New York","Fulton County",3,61,821,403,418
050,36,035,"New York","Fulton County",3,62,826,417,409
050,36,035,"New York","Fulton County",3,63,796,390,406
050,36,035,"New York","Fulton County",3,64,781,386,395
050,36,035,"New York","Fulton County",3,65,728,360,368
050,36,035,"New York","Fulton County",3,66,730,360,370
050,36,035,"New York","Fulton County",3,67,711,355,356
050,36,035,"New York","Fulton County",3,68,695,342,353
050,36,035,"New York","Fulton County",3,69,659,315,344
050,36,035,"New York","Fulton County",3,70,610,292,318
050,36,035,"New York","Fulton County",3,71,597,282,315
050,36,035,"New York","Fulton County",3,72,591,276,315
050,36,035,"New York","Fulton County",3,73,581,279,302
050,36,035,"New York","Fulton County",3,74,593,300,293
050,36,035,"New York","Fulton County",3,75,407,195,212
050,36,035,"New York","Fulton County",3,76,403,182,221
050,36,035,"New York","Fulton County",3,77,389,176,213
050,36,035,"New York","Fulton County",3,78,391,179,212
050,36,035,"New York","Fulton County",3,79,322,137,185
050,36,035,"New York","Fulton County",3,80,266,107,159
050,36,035,"New York","Fulton County",3,81,226,97,129
050,36,035,"New York","Fulton County",3,82,225,95,130
050,36,035,"New York","Fulton County",3,83,217,89,128
050,36,035,"New York","Fulton County",3,84,200,91,109
050,36,035,"New York","Fulton County",3,85,1174,386,788
050,36,035,"New York","Fulton County",4,0,480,259,221
050,36,035,"New York","Fulton County",4,1,467,254,213
050,36,035,"New York","Fulton County",4,2,506,263,243
050,36,035,"New York","Fulton County",4,3,529,273,256
050,36,035,"New York","Fulton County",4,4,532,279,253
050,36,035,"New York","Fulton County",4,5,537,279,258
050,36,035,"New York","Fulton County",4,6,555,284,271
050,36,035,"New York","Fulton County",4,7,575,290,285
050,36,035,"New York","Fulton County",4,8,605,303,302
050,36,035,"New York","Fulton County",4,9,592,311,281
050,36,035,"New York","Fulton County",4,10,558,297,261
050,36,035,"New York","Fulton County",4,11,605,305,300
050,36,035,"New York","Fulton County",4,12,621,311,310
050,36,035,"New York","Fulton County",4,13,639,326,313
050,36,035,"New York","Fulton County",4,14,702,338,364
050,36,035,"New York","Fulton County",4,15,668,327,341
050,36,035,"New York","Fulton County",4,16,660,342,318
050,36,035,"New York","Fulton County",4,17,638,329,309
050,36,035,"New York","Fulton County",4,18,536,288,248
050,36,035,"New York","Fulton County",4,19,475,243,232
050,36,035,"New York","Fulton County",4,20,522,263,259
050,36,035,"New York","Fulton County",4,21,564,290,274
050,36,035,"New York","Fulton County",4,22,562,295,267
050,36,035,"New York","Fulton County",4,23,551,275,276
050,36,035,"New York","Fulton County",4,24,615,316,299
050,36,035,"New York","Fulton County",4,25,576,295,281
050,36,035,"New York","Fulton County",4,26,572,305,267
050,36,035,"New York","Fulton County",4,27,607,321,286
050,36,035,"New York","Fulton County",4,28,582,291,291
050,36,035,"New York","Fulton County",4,29,586,293,293
050,36,035,"New York","Fulton County",4,30,593,296,297
050,36,035,"New York","Fulton County",4,31,660,315,345
050,36,035,"New York","Fulton County",4,32,610,309,301
050,36,035,"New York","Fulton County",4,33,583,299,284
050,36,035,"New York","Fulton County",4,34,639,329,310
050,36,035,"New York","Fulton County",4,35,618,311,307
050,36,035,"New York","Fulton County",4,36,641,316,325
050,36,035,"New York","Fulton County",4,37,660,316,344
050,36,035,"New York","Fulton County",4,38,642,307,335
050,36,035,"New York","Fulton County",4,39,668,341,327
050,36,035,"New York","Fulton County",4,40,643,322,321
050,36,035,"New York","Fulton County",4,41,631,323,308
050,36,035,"New York","Fulton County",4,42,650,329,321
050,36,035,"New York","Fulton County",4,43,644,320,324
050,36,035,"New York","Fulton County",4,44,636,326,310
050,36,035,"New York","Fulton County",4,45,611,308,303
050,36,035,"New York","Fulton County",4,46,564,286,278
050,36,035,"New York","Fulton County",4,47,589,309,280
050,36,035,"New York","Fulton County",4,48,576,300,276
050,36,035,"New York","Fulton County",4,49,614,295,319
050,36,035,"New York","Fulton County",4,50,689,348,341
050,36,035,"New York","Fulton County",4,51,764,403,361
050,36,035,"New York","Fulton County",4,52,746,386,360
050,36,035,"New York","Fulton County",4,53,713,358,355
050,36,035,"New York","Fulton County",4,54,714,353,361
050,36,035,"New York","Fulton County",4,55,752,370,382
050,36,035,"New York","Fulton County",4,56,772,401,371
050,36,035,"New York","Fulton County",4,57,821,415,406
050,36,035,"New York","Fulton County",4,58,853,427,426
050,36,035,"New York","Fulton County",4,59,803,406,397
050,36,035,"New York","Fulton County",4,60,817,414,403
050,36,035,"New York","Fulton County",4,61,825,424,401
050,36,035,"New York","Fulton County",4,62,812,394,418
050,36,035,"New York","Fulton County",4,63,807,410,397
050,36,035,"New York","Fulton County",4,64,785,387,398
050,36,035,"New York","Fulton County",4,65,769,382,387
050,36,035,"New York","Fulton County",4,66,711,355,356
050,36,035,"New York","Fulton County",4,67,720,352,368
050,36,035,"New York","Fulton County",4,68,688,345,343
050,36,035,"New York","Fulton County",4,69,661,325,336
050,36,035,"New York","Fulton County",4,70,646,307,339
050,36,035,"New York","Fulton County",4,71,604,283,321
050,36,035,"New York","Fulton County",4,72,581,268,313
050,36,035,"New York","Fulton County",4,73,579,266,313
050,36,035,"New York","Fulton County",4,74,558,260,298
050,36,035,"New York","Fulton County",4,75,563,279,284
050,36,035,"New York","Fulton County",4,76,377,178,199
050,36,035,"New York","Fulton County",4,77,385,171,214
050,36,035,"New York","Fulton County",4,78,364,166,198
050,36,035,"New York","Fulton County",4,79,374,168,206
050,36,035,"New York","Fulton County",4,80,299,127,172
050,36,035,"New York","Fulton County",4,81,248,102,146
050,36,035,"New York","Fulton County",4,82,210,82,128
050,36,035,"New York","Fulton County",4,83,193,80,113
050,36,035,"New York","Fulton County",4,84,201,81,120
050,36,035,"New York","Fulton County",4,85,1163,393,770
050,36,035,"New York","Fulton County",5,0,482,260,222
050,36,035,"New York","Fulton County",5,1,509,274,235
050,36,035,"New York","Fulton County",5,2,473,245,228
050,36,035,"New York","Fulton County",5,3,517,261,256
050,36,035,"New York","Fulton County",5,4,549,288,261
050,36,035,"New York","Fulton County",5,5,553,287,266
050,36,035,"New York","Fulton County",5,6,543,280,263
050,36,035,"New York","Fulton County",5,7,548,281,267
050,36,035,"New York","Fulton County",5,8,584,297,287
050,36,035,"New York","Fulton County",5,9,601,303,298
050,36,035,"New York","Fulton County",5,10,596,313,283
050,36,035,"New York","Fulton County",5,11,561,297,264
050,36,035,"New York","Fulton County",5,12,596,303,293
050,36,035,"New York","Fulton County",5,13,614,311,303
050,36,035,"New York","Fulton County",5,14,642,326,316
050,36,035,"New York","Fulton County",5,15,703,339,364
050,36,035,"New York","Fulton County",5,16,655,329,326
050,36,035,"New York","Fulton County",5,17,655,339,316
050,36,035,"New York","Fulton County",5,18,563,299,264
050,36,035,"New York","Fulton County",5,19,458,253,205
050,36,035,"New York","Fulton County",5,20,500,247,253
050,36,035,"New York","Fulton County",5,21,558,286,272
050,36,035,"New York","Fulton County",5,22,588,301,287
050,36,035,"New York","Fulton County",5,23,592,315,277
050,36,035,"New York","Fulton County",5,24,554,275,279
050,36,035,"New York","Fulton County",5,25,622,323,299
050,36,035,"New York","Fulton County",5,26,603,319,284
050,36,035,"New York","Fulton County",5,27,568,301,267
050,36,035,"New York","Fulton County",5,28,598,320,278
050,36,035,"New York","Fulton County",5,29,590,293,297
050,36,035,"New York","Fulton County",5,30,588,288,300
050,36,035,"New York","Fulton County",5,31,577,298,279
050,36,035,"New York","Fulton County",5,32,645,317,328
050,36,035,"New York","Fulton County",5,33,615,315,300
050,36,035,"New York","Fulton County",5,34,606,303,303
050,36,035,"New York","Fulton County",5,35,656,336,320
050,36,035,"New York","Fulton County",5,36,624,307,317
050,36,035,"New York","Fulton County",5,37,650,327,323
050,36,035,"New York","Fulton County",5,38,666,312,354
050,36,035,"New York","Fulton County",5,39,657,322,335
050,36,035,"New York","Fulton County",5,40,662,336,326
050,36,035,"New York","Fulton County",5,41,649,323,326
050,36,035,"New York","Fulton County",5,42,626,312,314
050,36,035,"New York","Fulton County",5,43,667,338,329
050,36,035,"New York","Fulton County",5,44,637,315,322
050,36,035,"New York","Fulton County",5,45,643,331,312
050,36,035,"New York","Fulton County",5,46,607,299,308
050,36,035,"New York","Fulton County",5,47,588,297,291
050,36,035,"New York","Fulton County",5,48,600,319,281
050,36,035,"New York","Fulton County",5,49,599,309,290
050,36,035,"New York","Fulton County",5,50,622,299,323
050,36,035,"New York","Fulton County",5,51,681,344,337
050,36,035,"New York","Fulton County",5,52,768,396,372
050,36,035,"New York","Fulton County",5,53,739,379,360
050,36,035,"New York","Fulton County",5,54,718,363,355
050,36,035,"New York","Fulton County",5,55,714,353,361
050,36,035,"New York","Fulton County",5,56,759,375,384
050,36,035,"New York","Fulton County",5,57,768,401,367
050,36,035,"New York","Fulton County",5,58,824,420,404
050,36,035,"New York","Fulton County",5,59,831,415,416
050,36,035,"New York","Fulton County",5,60,790,398,392
050,36,035,"New York","Fulton County",5,61,798,398,400
050,36,035,"New York","Fulton County",5,62,817,420,397
050,36,035,"New York","Fulton County",5,63,801,390,411
050,36,035,"New York","Fulton County",5,64,813,416,397
050,36,035,"New York","Fulton County",5,65,756,378,378
050,36,035,"New York","Fulton County",5,66,747,375,372
050,36,035,"New York","Fulton County",5,67,700,351,349
050,36,035,"New York","Fulton County",5,68,712,349,363
050,36,035,"New York","Fulton County",5,69,673,339,334
050,36,035,"New York","Fulton County",5,70,642,312,330
050,36,035,"New York","Fulton County",5,71,622,288,334
050,36,035,"New York","Fulton County",5,72,581,264,317
050,36,035,"New York","Fulton County",5,73,566,258,308
050,36,035,"New York","Fulton County",5,74,555,251,304
050,36,035,"New York","Fulton County",5,75,520,234,286
050,36,035,"New York","Fulton County",5,76,524,260,264
050,36,035,"New York","Fulton County",5,77,358,168,190
050,36,035,"New York","Fulton County",5,78,360,163,197
050,36,035,"New York","Fulton County",5,79,342,150,192
050,36,035,"New York","Fulton County",5,80,351,155,196
050,36,035,"New York","Fulton County",5,81,280,121,159
050,36,035,"New York","Fulton County",5,82,226,87,139
050,36,035,"New York","Fulton County",5,83,186,72,114
050,36,035,"New York","Fulton County",5,84,183,75,108
050,36,035,"New York","Fulton County",5,85,1170,400,770
050,36,037,"New York","Genesee County",1,0,586,300,286
050,36,037,"New York","Genesee County",1,1,613,307,306
050,36,037,"New York","Genesee County",1,2,623,323,300
050,36,037,"New York","Genesee County",1,3,599,301,298
050,36,037,"New York","Genesee County",1,4,622,304,318
050,36,037,"New York","Genesee County",1,5,670,333,337
050,36,037,"New York","Genesee County",1,6,640,318,322
050,36,037,"New York","Genesee County",1,7,659,311,348
050,36,037,"New York","Genesee County",1,8,676,325,351
050,36,037,"New York","Genesee County",1,9,686,328,358
050,36,037,"New York","Genesee County",1,10,684,344,340
050,36,037,"New York","Genesee County",1,11,725,369,356
050,36,037,"New York","Genesee County",1,12,738,382,356
050,36,037,"New York","Genesee County",1,13,744,369,375
050,36,037,"New York","Genesee County",1,14,731,391,340
050,36,037,"New York","Genesee County",1,15,744,379,365
050,36,037,"New York","Genesee County",1,16,713,369,344
050,36,037,"New York","Genesee County",1,17,715,391,324
050,36,037,"New York","Genesee County",1,18,732,366,366
050,36,037,"New York","Genesee County",1,19,597,304,293
050,36,037,"New York","Genesee County",1,20,585,298,287
050,36,037,"New York","Genesee County",1,21,642,335,307
050,36,037,"New York","Genesee County",1,22,624,318,306
050,36,037,"New York","Genesee County",1,23,640,319,321
050,36,037,"New York","Genesee County",1,24,702,360,342
050,36,037,"New York","Genesee County",1,25,727,370,357
050,36,037,"New York","Genesee County",1,26,748,400,348
050,36,037,"New York","Genesee County",1,27,745,416,329
050,36,037,"New York","Genesee County",1,28,713,383,330
050,36,037,"New York","Genesee County",1,29,745,399,346
050,36,037,"New York","Genesee County",1,30,725,358,367
050,36,037,"New York","Genesee County",1,31,658,369,289
050,36,037,"New York","Genesee County",1,32,660,339,321
050,36,037,"New York","Genesee County",1,33,710,364,346
050,36,037,"New York","Genesee County",1,34,718,384,334
050,36,037,"New York","Genesee County",1,35,707,377,330
050,36,037,"New York","Genesee County",1,36,712,371,341
050,36,037,"New York","Genesee County",1,37,737,377,360
050,36,037,"New York","Genesee County",1,38,699,355,344
050,36,037,"New York","Genesee County",1,39,683,327,356
050,36,037,"New York","Genesee County",1,40,685,348,337
050,36,037,"New York","Genesee County",1,41,635,340,295
050,36,037,"New York","Genesee County",1,42,607,310,297
050,36,037,"New York","Genesee County",1,43,626,319,307
050,36,037,"New York","Genesee County",1,44,597,295,302
050,36,037,"New York","Genesee County",1,45,626,332,294
050,36,037,"New York","Genesee County",1,46,629,310,319
050,36,037,"New York","Genesee County",1,47,673,338,335
050,36,037,"New York","Genesee County",1,48,710,354,356
050,36,037,"New York","Genesee County",1,49,832,426,406
050,36,037,"New York","Genesee County",1,50,856,441,415
050,36,037,"New York","Genesee County",1,51,801,387,414
050,36,037,"New York","Genesee County",1,52,794,406,388
050,36,037,"New York","Genesee County",1,53,832,426,406
050,36,037,"New York","Genesee County",1,54,847,422,425
050,36,037,"New York","Genesee County",1,55,902,440,462
050,36,037,"New York","Genesee County",1,56,924,476,448
050,36,037,"New York","Genesee County",1,57,873,442,431
050,36,037,"New York","Genesee County",1,58,950,482,468
050,36,037,"New York","Genesee County",1,59,950,479,471
050,36,037,"New York","Genesee County",1,60,931,464,467
050,36,037,"New York","Genesee County",1,61,938,476,462
050,36,037,"New York","Genesee County",1,62,960,482,478
050,36,037,"New York","Genesee County",1,63,883,441,442
050,36,037,"New York","Genesee County",1,64,826,410,416
050,36,037,"New York","Genesee County",1,65,802,410,392
050,36,037,"New York","Genesee County",1,66,772,406,366
050,36,037,"New York","Genesee County",1,67,692,341,351
050,36,037,"New York","Genesee County",1,68,666,323,343
050,36,037,"New York","Genesee County",1,69,628,290,338
050,36,037,"New York","Genesee County",1,70,623,299,324
050,36,037,"New York","Genesee County",1,71,547,264,283
050,36,037,"New York","Genesee County",1,72,547,255,292
050,36,037,"New York","Genesee County",1,73,607,304,303
050,36,037,"New York","Genesee County",1,74,443,217,226
050,36,037,"New York","Genesee County",1,75,404,190,214
050,36,037,"New York","Genesee County",1,76,397,192,205
050,36,037,"New York","Genesee County",1,77,418,210,208
050,36,037,"New York","Genesee County",1,78,405,177,228
050,36,037,"New York","Genesee County",1,79,340,157,183
050,36,037,"New York","Genesee County",1,80,294,124,170
050,36,037,"New York","Genesee County",1,81,304,133,171
050,36,037,"New York","Genesee County",1,82,269,104,165
050,36,037,"New York","Genesee County",1,83,248,113,135
050,36,037,"New York","Genesee County",1,84,234,102,132
050,36,037,"New York","Genesee County",1,85,1479,497,982
050,36,037,"New York","Genesee County",2,0,601,310,291
050,36,037,"New York","Genesee County",2,1,607,306,301
050,36,037,"New York","Genesee County",2,2,619,316,303
050,36,037,"New York","Genesee County",2,3,602,304,298
050,36,037,"New York","Genesee County",2,4,618,302,316
050,36,037,"New York","Genesee County",2,5,660,326,334
050,36,037,"New York","Genesee County",2,6,649,322,327
050,36,037,"New York","Genesee County",2,7,654,311,343
050,36,037,"New York","Genesee County",2,8,669,319,350
050,36,037,"New York","Genesee County",2,9,678,325,353
050,36,037,"New York","Genesee County",2,10,683,339,344
050,36,037,"New York","Genesee County",2,11,708,359,349
050,36,037,"New York","Genesee County",2,12,742,384,358
050,36,037,"New York","Genesee County",2,13,737,370,367
050,36,037,"New York","Genesee County",2,14,734,384,350
050,36,037,"New York","Genesee County",2,15,740,380,360
050,36,037,"New York","Genesee County",2,16,721,372,349
050,36,037,"New York","Genesee County",2,17,717,388,329
050,36,037,"New York","Genesee County",2,18,728,367,361
050,36,037,"New York","Genesee County",2,19,598,309,289
050,36,037,"New York","Genesee County",2,20,596,306,290
050,36,037,"New York","Genesee County",2,21,633,331,302
050,36,037,"New York","Genesee County",2,22,627,320,307
050,36,037,"New York","Genesee County",2,23,639,322,317
050,36,037,"New York","Genesee County",2,24,690,353,337
050,36,037,"New York","Genesee County",2,25,724,367,357
050,36,037,"New York","Genesee County",2,26,741,393,348
050,36,037,"New York","Genesee County",2,27,745,410,335
050,36,037,"New York","Genesee County",2,28,715,387,328
050,36,037,"New York","Genesee County",2,29,740,398,342
050,36,037,"New York","Genesee County",2,30,730,369,361
050,36,037,"New York","Genesee County",2,31,676,369,307
050,36,037,"New York","Genesee County",2,32,659,343,316
050,36,037,"New York","Genesee County",2,33,694,356,338
050,36,037,"New York","Genesee County",2,34,718,382,336
050,36,037,"New York","Genesee County",2,35,717,382,335
050,36,037,"New York","Genesee County",2,36,708,372,336
050,36,037,"New York","Genesee County",2,37,729,373,356
050,36,037,"New York","Genesee County",2,38,712,363,349
050,36,037,"New York","Genesee County",2,39,681,328,353
050,36,037,"New York","Genesee County",2,40,693,348,345
050,36,037,"New York","Genesee County",2,41,640,342,298
050,36,037,"New York","Genesee County",2,42,610,314,296
050,36,037,"New York","Genesee County",2,43,626,318,308
050,36,037,"New York","Genesee County",2,44,595,298,297
050,36,037,"New York","Genesee County",2,45,622,327,295
050,36,037,"New York","Genesee County",2,46,624,313,311
050,36,037,"New York","Genesee County",2,47,662,328,334
050,36,037,"New York","Genesee County",2,48,700,351,349
050,36,037,"New York","Genesee County",2,49,800,405,395
050,36,037,"New York","Genesee County",2,50,852,441,411
050,36,037,"New York","Genesee County",2,51,802,390,412
050,36,037,"New York","Genesee County",2,52,793,404,389
050,36,037,"New York","Genesee County",2,53,828,422,406
050,36,037,"New York","Genesee County",2,54,835,421,414
050,36,037,"New York","Genesee County",2,55,886,434,452
050,36,037,"New York","Genesee County",2,56,920,469,451
050,36,037,"New York","Genesee County",2,57,887,449,438
050,36,037,"New York","Genesee County",2,58,931,472,459
050,36,037,"New York","Genesee County",2,59,950,479,471
050,36,037,"New York","Genesee County",2,60,933,465,468
050,36,037,"New York","Genesee County",2,61,934,473,461
050,36,037,"New York","Genesee County",2,62,946,477,469
050,36,037,"New York","Genesee County",2,63,902,448,454
050,36,037,"New York","Genesee County",2,64,829,413,416
050,36,037,"New York","Genesee County",2,65,807,410,397
050,36,037,"New York","Genesee County",2,66,777,402,375
050,36,037,"New York","Genesee County",2,67,704,354,350
050,36,037,"New York","Genesee County",2,68,663,321,342
050,36,037,"New York","Genesee County",2,69,640,298,342
050,36,037,"New York","Genesee County",2,70,619,297,322
050,36,037,"New York","Genesee County",2,71,558,269,289
050,36,037,"New York","Genesee County",2,72,531,250,281
050,36,037,"New York","Genesee County",2,73,617,306,311
050,36,037,"New York","Genesee County",2,74,449,219,230
050,36,037,"New York","Genesee County",2,75,410,194,216
050,36,037,"New York","Genesee County",2,76,394,190,204
050,36,037,"New York","Genesee County",2,77,418,207,211
050,36,037,"New York","Genesee County",2,78,402,181,221
050,36,037,"New York","Genesee County",2,79,346,158,188
050,36,037,"New York","Genesee County",2,80,299,130,169
050,36,037,"New York","Genesee County",2,81,297,130,167
050,36,037,"New York","Genesee County",2,82,273,107,166
050,36,037,"New York","Genesee County",2,83,250,112,138
050,36,037,"New York","Genesee County",2,84,232,100,132
050,36,037,"New York","Genesee County",2,85,1477,494,983
050,36,037,"New York","Genesee County",3,0,505,271,234
050,36,037,"New York","Genesee County",3,1,607,291,316
050,36,037,"New York","Genesee County",3,2,621,320,301
050,36,037,"New York","Genesee County",3,3,599,308,291
050,36,037,"New York","Genesee County",3,4,601,304,297
050,36,037,"New York","Genesee County",3,5,607,299,308
050,36,037,"New York","Genesee County",3,6,655,317,338
050,36,037,"New York","Genesee County",3,7,659,326,333
050,36,037,"New York","Genesee County",3,8,646,313,333
050,36,037,"New York","Genesee County",3,9,671,329,342
050,36,037,"New York","Genesee County",3,10,664,321,343
050,36,037,"New York","Genesee County",3,11,697,338,359
050,36,037,"New York","Genesee County",3,12,704,358,346
050,36,037,"New York","Genesee County",3,13,726,370,356
050,36,037,"New York","Genesee County",3,14,736,370,366
050,36,037,"New York","Genesee County",3,15,748,388,360
050,36,037,"New York","Genesee County",3,16,737,379,358
050,36,037,"New York","Genesee County",3,17,714,376,338
050,36,037,"New York","Genesee County",3,18,738,381,357
050,36,037,"New York","Genesee County",3,19,596,320,276
050,36,037,"New York","Genesee County",3,20,599,321,278
050,36,037,"New York","Genesee County",3,21,609,321,288
050,36,037,"New York","Genesee County",3,22,630,322,308
050,36,037,"New York","Genesee County",3,23,643,345,298
050,36,037,"New York","Genesee County",3,24,643,334,309
050,36,037,"New York","Genesee County",3,25,665,339,326
050,36,037,"New York","Genesee County",3,26,695,353,342
050,36,037,"New York","Genesee County",3,27,711,368,343
050,36,037,"New York","Genesee County",3,28,719,407,312
050,36,037,"New York","Genesee County",3,29,731,407,324
050,36,037,"New York","Genesee County",3,30,749,395,354
050,36,037,"New York","Genesee County",3,31,743,368,375
050,36,037,"New York","Genesee County",3,32,688,372,316
050,36,037,"New York","Genesee County",3,33,674,349,325
050,36,037,"New York","Genesee County",3,34,705,365,340
050,36,037,"New York","Genesee County",3,35,730,383,347
050,36,037,"New York","Genesee County",3,36,720,380,340
050,36,037,"New York","Genesee County",3,37,693,364,329
050,36,037,"New York","Genesee County",3,38,732,382,350
050,36,037,"New York","Genesee County",3,39,697,347,350
050,36,037,"New York","Genesee County",3,40,705,338,367
050,36,037,"New York","Genesee County",3,41,696,358,338
050,36,037,"New York","Genesee County",3,42,638,330,308
050,36,037,"New York","Genesee County",3,43,627,321,306
050,36,037,"New York","Genesee County",3,44,621,322,299
050,36,037,"New York","Genesee County",3,45,592,303,289
050,36,037,"New York","Genesee County",3,46,618,318,300
050,36,037,"New York","Genesee County",3,47,625,310,315
050,36,037,"New York","Genesee County",3,48,673,342,331
050,36,037,"New York","Genesee County",3,49,690,345,345
050,36,037,"New York","Genesee County",3,50,820,420,400
050,36,037,"New York","Genesee County",3,51,814,408,406
050,36,037,"New York","Genesee County",3,52,817,403,414
050,36,037,"New York","Genesee County",3,53,808,403,405
050,36,037,"New York","Genesee County",3,54,819,423,396
050,36,037,"New York","Genesee County",3,55,836,426,410
050,36,037,"New York","Genesee County",3,56,869,424,445
050,36,037,"New York","Genesee County",3,57,912,462,450
050,36,037,"New York","Genesee County",3,58,909,464,445
050,36,037,"New York","Genesee County",3,59,906,458,448
050,36,037,"New York","Genesee County",3,60,946,472,474
050,36,037,"New York","Genesee County",3,61,926,462,464
050,36,037,"New York","Genesee County",3,62,920,474,446
050,36,037,"New York","Genesee County",3,63,934,460,474
050,36,037,"New York","Genesee County",3,64,876,439,437
050,36,037,"New York","Genesee County",3,65,828,413,415
050,36,037,"New York","Genesee County",3,66,785,388,397
050,36,037,"New York","Genesee County",3,67,758,391,367
050,36,037,"New York","Genesee County",3,68,684,350,334
050,36,037,"New York","Genesee County",3,69,653,314,339
050,36,037,"New York","Genesee County",3,70,620,293,327
050,36,037,"New York","Genesee County",3,71,595,285,310
050,36,037,"New York","Genesee County",3,72,533,257,276
050,36,037,"New York","Genesee County",3,73,503,234,269
050,36,037,"New York","Genesee County",3,74,593,293,300
050,36,037,"New York","Genesee County",3,75,423,205,218
050,36,037,"New York","Genesee County",3,76,383,179,204
050,36,037,"New York","Genesee County",3,77,376,183,193
050,36,037,"New York","Genesee County",3,78,405,195,210
050,36,037,"New York","Genesee County",3,79,380,174,206
050,36,037,"New York","Genesee County",3,80,313,140,173
050,36,037,"New York","Genesee County",3,81,288,127,161
050,36,037,"New York","Genesee County",3,82,259,104,155
050,36,037,"New York","Genesee County",3,83,254,100,154
050,36,037,"New York","Genesee County",3,84,228,95,133
050,36,037,"New York","Genesee County",3,85,1424,482,942
050,36,037,"New York","Genesee County",4,0,539,286,253
050,36,037,"New York","Genesee County",4,1,534,284,250
050,36,037,"New York","Genesee County",4,2,622,299,323
050,36,037,"New York","Genesee County",4,3,617,315,302
050,36,037,"New York","Genesee County",4,4,615,310,305
050,36,037,"New York","Genesee County",4,5,595,311,284
050,36,037,"New York","Genesee County",4,6,605,301,304
050,36,037,"New York","Genesee County",4,7,670,327,343
050,36,037,"New York","Genesee County",4,8,643,317,326
050,36,037,"New York","Genesee County",4,9,628,307,321
050,36,037,"New York","Genesee County",4,10,671,330,341
050,36,037,"New York","Genesee County",4,11,662,317,345
050,36,037,"New York","Genesee County",4,12,685,340,345
050,36,037,"New York","Genesee County",4,13,704,351,353
050,36,037,"New York","Genesee County",4,14,710,366,344
050,36,037,"New York","Genesee County",4,15,747,377,370
050,36,037,"New York","Genesee County",4,16,734,386,348
050,36,037,"New York","Genesee County",4,17,728,373,355
050,36,037,"New York","Genesee County",4,18,713,353,360
050,36,037,"New York","Genesee County",4,19,577,299,278
050,36,037,"New York","Genesee County",4,20,587,328,259
050,36,037,"New York","Genesee County",4,21,614,333,281
050,36,037,"New York","Genesee County",4,22,601,300,301
050,36,037,"New York","Genesee County",4,23,618,318,300
050,36,037,"New York","Genesee County",4,24,655,359,296
050,36,037,"New York","Genesee County",4,25,633,315,318
050,36,037,"New York","Genesee County",4,26,640,327,313
050,36,037,"New York","Genesee County",4,27,663,335,328
050,36,037,"New York","Genesee County",4,28,677,353,324
050,36,037,"New York","Genesee County",4,29,743,425,318
050,36,037,"New York","Genesee County",4,30,712,389,323
050,36,037,"New York","Genesee County",4,31,741,393,348
050,36,037,"New York","Genesee County",4,32,745,360,385
050,36,037,"New York","Genesee County",4,33,680,376,304
050,36,037,"New York","Genesee County",4,34,711,380,331
050,36,037,"New York","Genesee County",4,35,701,363,338
050,36,037,"New York","Genesee County",4,36,739,390,349
050,36,037,"New York","Genesee County",4,37,712,364,348
050,36,037,"New York","Genesee County",4,38,696,368,328
050,36,037,"New York","Genesee County",4,39,730,370,360
050,36,037,"New York","Genesee County",4,40,723,359,364
050,36,037,"New York","Genesee County",4,41,704,351,353
050,36,037,"New York","Genesee County",4,42,690,344,346
050,36,037,"New York","Genesee County",4,43,655,341,314
050,36,037,"New York","Genesee County",4,44,613,316,297
050,36,037,"New York","Genesee County",4,45,597,324,273
050,36,037,"New York","Genesee County",4,46,575,286,289
050,36,037,"New York","Genesee County",4,47,625,315,310
050,36,037,"New York","Genesee County",4,48,637,320,317
050,36,037,"New York","Genesee County",4,49,679,346,333
050,36,037,"New York","Genesee County",4,50,694,361,333
050,36,037,"New York","Genesee County",4,51,768,379,389
050,36,037,"New York","Genesee County",4,52,813,416,397
050,36,037,"New York","Genesee County",4,53,813,399,414
050,36,037,"New York","Genesee County",4,54,790,401,389
050,36,037,"New York","Genesee County",4,55,802,408,394
050,36,037,"New York","Genesee County",4,56,821,420,401
050,36,037,"New York","Genesee County",4,57,871,421,450
050,36,037,"New York","Genesee County",4,58,926,459,467
050,36,037,"New York","Genesee County",4,59,888,447,441
050,36,037,"New York","Genesee County",4,60,886,444,442
050,36,037,"New York","Genesee County",4,61,944,467,477
050,36,037,"New York","Genesee County",4,62,903,458,445
050,36,037,"New York","Genesee County",4,63,897,450,447
050,36,037,"New York","Genesee County",4,64,895,440,455
050,36,037,"New York","Genesee County",4,65,866,437,429
050,36,037,"New York","Genesee County",4,66,810,394,416
050,36,037,"New York","Genesee County",4,67,769,380,389
050,36,037,"New York","Genesee County",4,68,743,386,357
050,36,037,"New York","Genesee County",4,69,670,342,328
050,36,037,"New York","Genesee County",4,70,635,306,329
050,36,037,"New York","Genesee County",4,71,605,286,319
050,36,037,"New York","Genesee County",4,72,583,275,308
050,36,037,"New York","Genesee County",4,73,514,249,265
050,36,037,"New York","Genesee County",4,74,481,218,263
050,36,037,"New York","Genesee County",4,75,563,276,287
050,36,037,"New York","Genesee County",4,76,398,195,203
050,36,037,"New York","Genesee County",4,77,374,174,200
050,36,037,"New York","Genesee County",4,78,374,178,196
050,36,037,"New York","Genesee County",4,79,394,192,202
050,36,037,"New York","Genesee County",4,80,358,166,192
050,36,037,"New York","Genesee County",4,81,302,137,165
050,36,037,"New York","Genesee County",4,82,260,104,156
050,36,037,"New York","Genesee County",4,83,249,104,145
050,36,037,"New York","Genesee County",4,84,232,89,143
050,36,037,"New York","Genesee County",4,85,1412,495,917
050,36,037,"New York","Genesee County",5,0,539,286,253
050,36,037,"New York","Genesee County",5,1,569,281,288
050,36,037,"New York","Genesee County",5,2,544,280,264
050,36,037,"New York","Genesee County",5,3,649,317,332
050,36,037,"New York","Genesee County",5,4,612,303,309
050,36,037,"New York","Genesee County",5,5,633,319,314
050,36,037,"New York","Genesee County",5,6,600,324,276
050,36,037,"New York","Genesee County",5,7,620,313,307
050,36,037,"New York","Genesee County",5,8,672,333,339
050,36,037,"New York","Genesee County",5,9,651,325,326
050,36,037,"New York","Genesee County",5,10,646,311,335
050,36,037,"New York","Genesee County",5,11,674,333,341
050,36,037,"New York","Genesee County",5,12,680,336,344
050,36,037,"New York","Genesee County",5,13,690,341,349
050,36,037,"New York","Genesee County",5,14,704,352,352
050,36,037,"New York","Genesee County",5,15,707,364,343
050,36,037,"New York","Genesee County",5,16,754,386,368
050,36,037,"New York","Genesee County",5,17,734,388,346
050,36,037,"New York","Genesee County",5,18,742,363,379
050,36,037,"New York","Genesee County",5,19,581,297,284
050,36,037,"New York","Genesee County",5,20,581,315,266
050,36,037,"New York","Genesee County",5,21,613,344,269
050,36,037,"New York","Genesee County",5,22,612,312,300
050,36,037,"New York","Genesee County",5,23,637,324,313
050,36,037,"New York","Genesee County",5,24,646,338,308
050,36,037,"New York","Genesee County",5,25,661,357,304
050,36,037,"New York","Genesee County",5,26,630,313,317
050,36,037,"New York","Genesee County",5,27,646,332,314
050,36,037,"New York","Genesee County",5,28,674,336,338
050,36,037,"New York","Genesee County",5,29,720,387,333
050,36,037,"New York","Genesee County",5,30,755,426,329
050,36,037,"New York","Genesee County",5,31,729,401,328
050,36,037,"New York","Genesee County",5,32,740,383,357
050,36,037,"New York","Genesee County",5,33,766,377,389
050,36,037,"New York","Genesee County",5,34,695,384,311
050,36,037,"New York","Genesee County",5,35,726,393,333
050,36,037,"New York","Genesee County",5,36,720,380,340
050,36,037,"New York","Genesee County",5,37,733,379,354
050,36,037,"New York","Genesee County",5,38,726,374,352
050,36,037,"New York","Genesee County",5,39,686,354,332
050,36,037,"New York","Genesee County",5,40,745,375,370
050,36,037,"New York","Genesee County",5,41,706,364,342
050,36,037,"New York","Genesee County",5,42,705,345,360
050,36,037,"New York","Genesee County",5,43,702,353,349
050,36,037,"New York","Genesee County",5,44,645,344,301
050,36,037,"New York","Genesee County",5,45,600,313,287
050,36,037,"New York","Genesee County",5,46,606,328,278
050,36,037,"New York","Genesee County",5,47,581,284,297
050,36,037,"New York","Genesee County",5,48,632,325,307
050,36,037,"New York","Genesee County",5,49,650,324,326
050,36,037,"New York","Genesee County",5,50,689,364,325
050,36,037,"New York","Genesee County",5,51,665,329,336
050,36,037,"New York","Genesee County",5,52,755,381,374
050,36,037,"New York","Genesee County",5,53,820,411,409
050,36,037,"New York","Genesee County",5,54,799,392,407
050,36,037,"New York","Genesee County",5,55,776,390,386
050,36,037,"New York","Genesee County",5,56,789,399,390
050,36,037,"New York","Genesee County",5,57,826,418,408
050,36,037,"New York","Genesee County",5,58,883,423,460
050,36,037,"New York","Genesee County",5,59,904,448,456
050,36,037,"New York","Genesee County",5,60,879,430,449
050,36,037,"New York","Genesee County",5,61,888,443,445
050,36,037,"New York","Genesee County",5,62,938,475,463
050,36,037,"New York","Genesee County",5,63,874,431,443
050,36,037,"New York","Genesee County",5,64,870,439,431
050,36,037,"New York","Genesee County",5,65,887,438,449
050,36,037,"New York","Genesee County",5,66,846,420,426
050,36,037,"New York","Genesee County",5,67,799,390,409
050,36,037,"New York","Genesee County",5,68,742,365,377
050,36,037,"New York","Genesee County",5,69,734,382,352
050,36,037,"New York","Genesee County",5,70,652,341,311
050,36,037,"New York","Genesee County",5,71,613,294,319
050,36,037,"New York","Genesee County",5,72,590,281,309
050,36,037,"New York","Genesee County",5,73,563,269,294
050,36,037,"New York","Genesee County",5,74,497,237,260
050,36,037,"New York","Genesee County",5,75,453,208,245
050,36,037,"New York","Genesee County",5,76,541,270,271
050,36,037,"New York","Genesee County",5,77,387,188,199
050,36,037,"New York","Genesee County",5,78,367,164,203
050,36,037,"New York","Genesee County",5,79,369,178,191
050,36,037,"New York","Genesee County",5,80,363,182,181
050,36,037,"New York","Genesee County",5,81,347,159,188
050,36,037,"New York","Genesee County",5,82,278,118,160
050,36,037,"New York","Genesee County",5,83,248,106,142
050,36,037,"New York","Genesee County",5,84,230,92,138
050,36,037,"New York","Genesee County",5,85,1399,496,903
050,36,039,"New York","Greene County",1,0,439,228,211
050,36,039,"New York","Greene County",1,1,427,223,204
050,36,039,"New York","Greene County",1,2,419,211,208
050,36,039,"New York","Greene County",1,3,404,197,207
050,36,039,"New York","Greene County",1,4,402,215,187
050,36,039,"New York","Greene County",1,5,403,207,196
050,36,039,"New York","Greene County",1,6,414,202,212
050,36,039,"New York","Greene County",1,7,416,223,193
050,36,039,"New York","Greene County",1,8,445,231,214
050,36,039,"New York","Greene County",1,9,452,230,222
050,36,039,"New York","Greene County",1,10,453,222,231
050,36,039,"New York","Greene County",1,11,460,228,232
050,36,039,"New York","Greene County",1,12,448,226,222
050,36,039,"New York","Greene County",1,13,466,248,218
050,36,039,"New York","Greene County",1,14,444,231,213
050,36,039,"New York","Greene County",1,15,449,249,200
050,36,039,"New York","Greene County",1,16,474,253,221
050,36,039,"New York","Greene County",1,17,527,300,227
050,36,039,"New York","Greene County",1,18,542,342,200
050,36,039,"New York","Greene County",1,19,559,393,166
050,36,039,"New York","Greene County",1,20,648,447,201
050,36,039,"New York","Greene County",1,21,619,419,200
050,36,039,"New York","Greene County",1,22,517,309,208
050,36,039,"New York","Greene County",1,23,550,313,237
050,36,039,"New York","Greene County",1,24,533,291,242
050,36,039,"New York","Greene County",1,25,541,298,243
050,36,039,"New York","Greene County",1,26,546,291,255
050,36,039,"New York","Greene County",1,27,559,290,269
050,36,039,"New York","Greene County",1,28,572,312,260
050,36,039,"New York","Greene County",1,29,599,327,272
050,36,039,"New York","Greene County",1,30,558,286,272
050,36,039,"New York","Greene County",1,31,579,315,264
050,36,039,"New York","Greene County",1,32,563,298,265
050,36,039,"New York","Greene County",1,33,579,318,261
050,36,039,"New York","Greene County",1,34,576,307,269
050,36,039,"New York","Greene County",1,35,557,300,257
050,36,039,"New York","Greene County",1,36,534,297,237
050,36,039,"New York","Greene County",1,37,543,287,256
050,36,039,"New York","Greene County",1,38,516,265,251
050,36,039,"New York","Greene County",1,39,505,259,246
050,36,039,"New York","Greene County",1,40,529,298,231
050,36,039,"New York","Greene County",1,41,501,272,229
050,36,039,"New York","Greene County",1,42,519,252,267
050,36,039,"New York","Greene County",1,43,520,270,250
050,36,039,"New York","Greene County",1,44,534,278,256
050,36,039,"New York","Greene County",1,45,550,282,268
050,36,039,"New York","Greene County",1,46,558,286,272
050,36,039,"New York","Greene County",1,47,569,297,272
050,36,039,"New York","Greene County",1,48,620,308,312
050,36,039,"New York","Greene County",1,49,640,317,323
050,36,039,"New York","Greene County",1,50,646,323,323
050,36,039,"New York","Greene County",1,51,637,333,304
050,36,039,"New York","Greene County",1,52,677,372,305
050,36,039,"New York","Greene County",1,53,693,378,315
050,36,039,"New York","Greene County",1,54,700,351,349
050,36,039,"New York","Greene County",1,55,735,369,366
050,36,039,"New York","Greene County",1,56,809,407,402
050,36,039,"New York","Greene County",1,57,841,430,411
050,36,039,"New York","Greene County",1,58,785,399,386
050,36,039,"New York","Greene County",1,59,815,417,398
050,36,039,"New York","Greene County",1,60,817,405,412
050,36,039,"New York","Greene County",1,61,802,397,405
050,36,039,"New York","Greene County",1,62,791,399,392
050,36,039,"New York","Greene County",1,63,767,400,367
050,36,039,"New York","Greene County",1,64,743,375,368
050,36,039,"New York","Greene County",1,65,685,347,338
050,36,039,"New York","Greene County",1,66,682,334,348
050,36,039,"New York","Greene County",1,67,661,309,352
050,36,039,"New York","Greene County",1,68,711,339,372
050,36,039,"New York","Greene County",1,69,661,341,320
050,36,039,"New York","Greene County",1,70,645,308,337
050,36,039,"New York","Greene County",1,71,587,271,316
050,36,039,"New York","Greene County",1,72,635,314,321
050,36,039,"New York","Greene County",1,73,652,343,309
050,36,039,"New York","Greene County",1,74,462,216,246
050,36,039,"New York","Greene County",1,75,459,222,237
050,36,039,"New York","Greene County",1,76,482,223,259
050,36,039,"New York","Greene County",1,77,456,226,230
050,36,039,"New York","Greene County",1,78,370,187,183
050,36,039,"New York","Greene County",1,79,311,146,165
050,36,039,"New York","Greene County",1,80,293,140,153
050,36,039,"New York","Greene County",1,81,262,127,135
050,36,039,"New York","Greene County",1,82,233,114,119
050,36,039,"New York","Greene County",1,83,225,103,122
050,36,039,"New York","Greene County",1,84,210,90,120
050,36,039,"New York","Greene County",1,85,1215,480,735
050,36,039,"New York","Greene County",2,0,441,222,219
050,36,039,"New York","Greene County",2,1,427,222,205
050,36,039,"New York","Greene County",2,2,421,214,207
050,36,039,"New York","Greene County",2,3,405,200,205
050,36,039,"New York","Greene County",2,4,403,211,192
050,36,039,"New York","Greene County",2,5,402,209,193
050,36,039,"New York","Greene County",2,6,413,204,209
050,36,039,"New York","Greene County",2,7,413,217,196
050,36,039,"New York","Greene County",2,8,435,228,207
050,36,039,"New York","Greene County",2,9,454,234,220
050,36,039,"New York","Greene County",2,10,451,223,228
050,36,039,"New York","Greene County",2,11,459,227,232
050,36,039,"New York","Greene County",2,12,454,229,225
050,36,039,"New York","Greene County",2,13,458,242,216
050,36,039,"New York","Greene County",2,14,449,234,215
050,36,039,"New York","Greene County",2,15,447,244,203
050,36,039,"New York","Greene County",2,16,470,253,217
050,36,039,"New York","Greene County",2,17,521,299,222
050,36,039,"New York","Greene County",2,18,524,327,197
050,36,039,"New York","Greene County",2,19,548,381,167
050,36,039,"New York","Greene County",2,20,628,425,203
050,36,039,"New York","Greene County",2,21,601,398,203
050,36,039,"New York","Greene County",2,22,515,303,212
050,36,039,"New York","Greene County",2,23,541,307,234
050,36,039,"New York","Greene County",2,24,531,291,240
050,36,039,"New York","Greene County",2,25,533,292,241
050,36,039,"New York","Greene County",2,26,539,285,254
050,36,039,"New York","Greene County",2,27,553,288,265
050,36,039,"New York","Greene County",2,28,569,304,265
050,36,039,"New York","Greene County",2,29,594,324,270
050,36,039,"New York","Greene County",2,30,570,293,277
050,36,039,"New York","Greene County",2,31,569,308,261
050,36,039,"New York","Greene County",2,32,565,300,265
050,36,039,"New York","Greene County",2,33,575,311,264
050,36,039,"New York","Greene County",2,34,575,307,268
050,36,039,"New York","Greene County",2,35,563,303,260
050,36,039,"New York","Greene County",2,36,532,291,241
050,36,039,"New York","Greene County",2,37,540,287,253
050,36,039,"New York","Greene County",2,38,523,268,255
050,36,039,"New York","Greene County",2,39,505,257,248
050,36,039,"New York","Greene County",2,40,524,288,236
050,36,039,"New York","Greene County",2,41,506,276,230
050,36,039,"New York","Greene County",2,42,511,253,258
050,36,039,"New York","Greene County",2,43,526,269,257
050,36,039,"New York","Greene County",2,44,522,271,251
050,36,039,"New York","Greene County",2,45,546,280,266
050,36,039,"New York","Greene County",2,46,553,284,269
050,36,039,"New York","Greene County",2,47,566,293,273
050,36,039,"New York","Greene County",2,48,608,301,307
050,36,039,"New York","Greene County",2,49,632,311,321
050,36,039,"New York","Greene County",2,50,638,316,322
050,36,039,"New York","Greene County",2,51,637,328,309
050,36,039,"New York","Greene County",2,52,665,362,303
050,36,039,"New York","Greene County",2,53,689,375,314
050,36,039,"New York","Greene County",2,54,696,356,340
050,36,039,"New York","Greene County",2,55,724,364,360
050,36,039,"New York","Greene County",2,56,793,400,393
050,36,039,"New York","Greene County",2,57,836,426,410
050,36,039,"New York","Greene County",2,58,802,409,393
050,36,039,"New York","Greene County",2,59,810,413,397
050,36,039,"New York","Greene County",2,60,814,409,405
050,36,039,"New York","Greene County",2,61,801,396,405
050,36,039,"New York","Greene County",2,62,790,396,394
050,36,039,"New York","Greene County",2,63,780,403,377
050,36,039,"New York","Greene County",2,64,744,377,367
050,36,039,"New York","Greene County",2,65,696,352,344
050,36,039,"New York","Greene County",2,66,684,338,346
050,36,039,"New York","Greene County",2,67,665,315,350
050,36,039,"New York","Greene County",2,68,695,328,367
050,36,039,"New York","Greene County",2,69,678,343,335
050,36,039,"New York","Greene County",2,70,645,315,330
050,36,039,"New York","Greene County",2,71,593,278,315
050,36,039,"New York","Greene County",2,72,608,297,311
050,36,039,"New York","Greene County",2,73,679,354,325
050,36,039,"New York","Greene County",2,74,470,228,242
050,36,039,"New York","Greene County",2,75,457,216,241
050,36,039,"New York","Greene County",2,76,466,218,248
050,36,039,"New York","Greene County",2,77,464,226,238
050,36,039,"New York","Greene County",2,78,375,188,187
050,36,039,"New York","Greene County",2,79,319,153,166
050,36,039,"New York","Greene County",2,80,292,139,153
050,36,039,"New York","Greene County",2,81,266,130,136
050,36,039,"New York","Greene County",2,82,235,114,121
050,36,039,"New York","Greene County",2,83,222,101,121
050,36,039,"New York","Greene County",2,84,206,91,115
050,36,039,"New York","Greene County",2,85,1208,477,731
050,36,039,"New York","Greene County",3,0,391,207,184
050,36,039,"New York","Greene County",3,1,442,218,224
050,36,039,"New York","Greene County",3,2,448,235,213
050,36,039,"New York","Greene County",3,3,429,227,202
050,36,039,"New York","Greene County",3,4,409,201,208
050,36,039,"New York","Greene County",3,5,401,212,189
050,36,039,"New York","Greene County",3,6,394,204,190
050,36,039,"New York","Greene County",3,7,414,199,215
050,36,039,"New York","Greene County",3,8,421,226,195
050,36,039,"New York","Greene County",3,9,443,229,214
050,36,039,"New York","Greene County",3,10,456,239,217
050,36,039,"New York","Greene County",3,11,446,217,229
050,36,039,"New York","Greene County",3,12,445,221,224
050,36,039,"New York","Greene County",3,13,446,226,220
050,36,039,"New York","Greene County",3,14,454,234,220
050,36,039,"New York","Greene County",3,15,445,238,207
050,36,039,"New York","Greene County",3,16,464,252,212
050,36,039,"New York","Greene County",3,17,487,273,214
050,36,039,"New York","Greene County",3,18,482,290,192
050,36,039,"New York","Greene County",3,19,492,330,162
050,36,039,"New York","Greene County",3,20,547,357,190
050,36,039,"New York","Greene County",3,21,563,353,210
050,36,039,"New York","Greene County",3,22,501,277,224
050,36,039,"New York","Greene County",3,23,516,294,222
050,36,039,"New York","Greene County",3,24,533,298,235
050,36,039,"New York","Greene County",3,25,539,296,243
050,36,039,"New York","Greene County",3,26,529,279,250
050,36,039,"New York","Greene County",3,27,562,292,270
050,36,039,"New York","Greene County",3,28,540,284,256
050,36,039,"New York","Greene County",3,29,591,306,285
050,36,039,"New York","Greene County",3,30,597,325,272
050,36,039,"New York","Greene County",3,31,600,319,281
050,36,039,"New York","Greene County",3,32,593,313,280
050,36,039,"New York","Greene County",3,33,569,300,269
050,36,039,"New York","Greene County",3,34,613,329,284
050,36,039,"New York","Greene County",3,35,622,330,292
050,36,039,"New York","Greene County",3,36,578,298,280
050,36,039,"New York","Greene County",3,37,558,301,257
050,36,039,"New York","Greene County",3,38,571,289,282
050,36,039,"New York","Greene County",3,39,544,278,266
050,36,039,"New York","Greene County",3,40,531,271,260
050,36,039,"New York","Greene County",3,41,543,300,243
050,36,039,"New York","Greene County",3,42,526,285,241
050,36,039,"New York","Greene County",3,43,516,260,256
050,36,039,"New York","Greene County",3,44,534,265,269
050,36,039,"New York","Greene County",3,45,520,267,253
050,36,039,"New York","Greene County",3,46,577,305,272
050,36,039,"New York","Greene County",3,47,567,287,280
050,36,039,"New York","Greene County",3,48,593,299,294
050,36,039,"New York","Greene County",3,49,593,289,304
050,36,039,"New York","Greene County",3,50,635,311,324
050,36,039,"New York","Greene County",3,51,641,317,324
050,36,039,"New York","Greene County",3,52,650,339,311
050,36,039,"New York","Greene County",3,53,659,355,304
050,36,039,"New York","Greene County",3,54,679,355,324
050,36,039,"New York","Greene County",3,55,693,355,338
050,36,039,"New York","Greene County",3,56,722,363,359
050,36,039,"New York","Greene County",3,57,819,406,413
050,36,039,"New York","Greene County",3,58,822,416,406
050,36,039,"New York","Greene County",3,59,803,418,385
050,36,039,"New York","Greene County",3,60,817,404,413
050,36,039,"New York","Greene County",3,61,799,399,400
050,36,039,"New York","Greene County",3,62,810,406,404
050,36,039,"New York","Greene County",3,63,795,398,397
050,36,039,"New York","Greene County",3,64,781,404,377
050,36,039,"New York","Greene County",3,65,738,374,364
050,36,039,"New York","Greene County",3,66,689,341,348
050,36,039,"New York","Greene County",3,67,672,333,339
050,36,039,"New York","Greene County",3,68,666,317,349
050,36,039,"New York","Greene County",3,69,682,318,364
050,36,039,"New York","Greene County",3,70,668,334,334
050,36,039,"New York","Greene County",3,71,630,308,322
050,36,039,"New York","Greene County",3,72,580,271,309
050,36,039,"New York","Greene County",3,73,592,293,299
050,36,039,"New York","Greene County",3,74,656,341,315
050,36,039,"New York","Greene County",3,75,459,221,238
050,36,039,"New York","Greene County",3,76,440,206,234
050,36,039,"New York","Greene County",3,77,446,210,236
050,36,039,"New York","Greene County",3,78,443,209,234
050,36,039,"New York","Greene County",3,79,357,179,178
050,36,039,"New York","Greene County",3,80,300,149,151
050,36,039,"New York","Greene County",3,81,283,135,148
050,36,039,"New York","Greene County",3,82,244,121,123
050,36,039,"New York","Greene County",3,83,213,87,126
050,36,039,"New York","Greene County",3,84,203,91,112
050,36,039,"New York","Greene County",3,85,1223,496,727
050,36,039,"New York","Greene County",4,0,395,197,198
050,36,039,"New York","Greene County",4,1,403,206,197
050,36,039,"New York","Greene County",4,2,422,210,212
050,36,039,"New York","Greene County",4,3,421,225,196
050,36,039,"New York","Greene County",4,4,432,227,205
050,36,039,"New York","Greene County",4,5,410,201,209
050,36,039,"New York","Greene County",4,6,406,210,196
050,36,039,"New York","Greene County",4,7,398,200,198
050,36,039,"New York","Greene County",4,8,406,193,213
050,36,039,"New York","Greene County",4,9,430,241,189
050,36,039,"New York","Greene County",4,10,425,225,200
050,36,039,"New York","Greene County",4,11,447,233,214
050,36,039,"New York","Greene County",4,12,452,219,233
050,36,039,"New York","Greene County",4,13,421,208,213
050,36,039,"New York","Greene County",4,14,445,229,216
050,36,039,"New York","Greene County",4,15,440,229,211
050,36,039,"New York","Greene County",4,16,432,225,207
050,36,039,"New York","Greene County",4,17,469,273,196
050,36,039,"New York","Greene County",4,18,459,275,184
050,36,039,"New York","Greene County",4,19,459,313,146
050,36,039,"New York","Greene County",4,20,524,346,178
050,36,039,"New York","Greene County",4,21,499,321,178
050,36,039,"New York","Greene County",4,22,464,254,210
050,36,039,"New York","Greene County",4,23,500,271,229
050,36,039,"New York","Greene County",4,24,488,273,215
050,36,039,"New York","Greene County",4,25,500,276,224
050,36,039,"New York","Greene County",4,26,528,282,246
050,36,039,"New York","Greene County",4,27,529,270,259
050,36,039,"New York","Greene County",4,28,537,276,261
050,36,039,"New York","Greene County",4,29,524,271,253
050,36,039,"New York","Greene County",4,30,591,289,302
050,36,039,"New York","Greene County",4,31,623,348,275
050,36,039,"New York","Greene County",4,32,623,326,297
050,36,039,"New York","Greene County",4,33,594,307,287
050,36,039,"New York","Greene County",4,34,575,296,279
050,36,039,"New York","Greene County",4,35,622,334,288
050,36,039,"New York","Greene County",4,36,604,310,294
050,36,039,"New York","Greene County",4,37,585,308,277
050,36,039,"New York","Greene County",4,38,551,306,245
050,36,039,"New York","Greene County",4,39,585,305,280
050,36,039,"New York","Greene County",4,40,565,284,281
050,36,039,"New York","Greene County",4,41,546,283,263
050,36,039,"New York","Greene County",4,42,545,301,244
050,36,039,"New York","Greene County",4,43,549,301,248
050,36,039,"New York","Greene County",4,44,503,252,251
050,36,039,"New York","Greene County",4,45,533,260,273
050,36,039,"New York","Greene County",4,46,527,271,256
050,36,039,"New York","Greene County",4,47,563,298,265
050,36,039,"New York","Greene County",4,48,581,299,282
050,36,039,"New York","Greene County",4,49,559,283,276
050,36,039,"New York","Greene County",4,50,565,273,292
050,36,039,"New York","Greene County",4,51,626,304,322
050,36,039,"New York","Greene County",4,52,631,311,320
050,36,039,"New York","Greene County",4,53,621,318,303
050,36,039,"New York","Greene County",4,54,658,349,309
050,36,039,"New York","Greene County",4,55,673,349,324
050,36,039,"New York","Greene County",4,56,681,346,335
050,36,039,"New York","Greene County",4,57,712,348,364
050,36,039,"New York","Greene County",4,58,827,405,422
050,36,039,"New York","Greene County",4,59,821,414,407
050,36,039,"New York","Greene County",4,60,801,418,383
050,36,039,"New York","Greene County",4,61,818,393,425
050,36,039,"New York","Greene County",4,62,786,391,395
050,36,039,"New York","Greene County",4,63,787,394,393
050,36,039,"New York","Greene County",4,64,776,384,392
050,36,039,"New York","Greene County",4,65,781,409,372
050,36,039,"New York","Greene County",4,66,706,355,351
050,36,039,"New York","Greene County",4,67,680,338,342
050,36,039,"New York","Greene County",4,68,685,339,346
050,36,039,"New York","Greene County",4,69,661,313,348
050,36,039,"New York","Greene County",4,70,683,318,365
050,36,039,"New York","Greene County",4,71,650,327,323
050,36,039,"New York","Greene County",4,72,621,307,314
050,36,039,"New York","Greene County",4,73,568,262,306
050,36,039,"New York","Greene County",4,74,568,280,288
050,36,039,"New York","Greene County",4,75,636,326,310
050,36,039,"New York","Greene County",4,76,445,216,229
050,36,039,"New York","Greene County",4,77,430,198,232
050,36,039,"New York","Greene County",4,78,433,200,233
050,36,039,"New York","Greene County",4,79,421,193,228
050,36,039,"New York","Greene County",4,80,335,169,166
050,36,039,"New York","Greene County",4,81,280,137,143
050,36,039,"New York","Greene County",4,82,258,128,130
050,36,039,"New York","Greene County",4,83,211,94,117
050,36,039,"New York","Greene County",4,84,192,76,116
050,36,039,"New York","Greene County",4,85,1229,494,735
050,36,039,"New York","Greene County",5,0,395,196,199
050,36,039,"New York","Greene County",5,1,418,212,206
050,36,039,"New York","Greene County",5,2,414,213,201
050,36,039,"New York","Greene County",5,3,417,214,203
050,36,039,"New York","Greene County",5,4,410,212,198
050,36,039,"New York","Greene County",5,5,431,227,204
050,36,039,"New York","Greene County",5,6,398,197,201
050,36,039,"New York","Greene County",5,7,400,207,193
050,36,039,"New York","Greene County",5,8,391,197,194
050,36,039,"New York","Greene County",5,9,404,201,203
050,36,039,"New York","Greene County",5,10,403,226,177
050,36,039,"New York","Greene County",5,11,423,224,199
050,36,039,"New York","Greene County",5,12,443,239,204
050,36,039,"New York","Greene County",5,13,441,212,229
050,36,039,"New York","Greene County",5,14,405,204,201
050,36,039,"New York","Greene County",5,15,443,227,216
050,36,039,"New York","Greene County",5,16,437,230,207
050,36,039,"New York","Greene County",5,17,446,250,196
050,36,039,"New York","Greene County",5,18,453,282,171
050,36,039,"New York","Greene County",5,19,453,310,143
050,36,039,"New York","Greene County",5,20,521,352,169
050,36,039,"New York","Greene County",5,21,524,334,190
050,36,039,"New York","Greene County",5,22,454,257,197
050,36,039,"New York","Greene County",5,23,482,262,220
050,36,039,"New York","Greene County",5,24,491,261,230
050,36,039,"New York","Greene County",5,25,497,284,213
050,36,039,"New York","Greene County",5,26,482,257,225
050,36,039,"New York","Greene County",5,27,531,286,245
050,36,039,"New York","Greene County",5,28,509,254,255
050,36,039,"New York","Greene County",5,29,572,299,273
050,36,039,"New York","Greene County",5,30,518,259,259
050,36,039,"New York","Greene County",5,31,602,328,274
050,36,039,"New York","Greene County",5,32,627,346,281
050,36,039,"New York","Greene County",5,33,636,323,313
050,36,039,"New York","Greene County",5,34,605,313,292
050,36,039,"New York","Greene County",5,35,585,306,279
050,36,039,"New York","Greene County",5,36,628,326,302
050,36,039,"New York","Greene County",5,37,596,302,294
050,36,039,"New York","Greene County",5,38,585,314,271
050,36,039,"New York","Greene County",5,39,559,316,243
050,36,039,"New York","Greene County",5,40,588,311,277
050,36,039,"New York","Greene County",5,41,576,303,273
050,36,039,"New York","Greene County",5,42,544,272,272
050,36,039,"New York","Greene County",5,43,550,321,229
050,36,039,"New York","Greene County",5,44,540,285,255
050,36,039,"New York","Greene County",5,45,507,260,247
050,36,039,"New York","Greene County",5,46,537,266,271
050,36,039,"New York","Greene County",5,47,524,270,254
050,36,039,"New York","Greene County",5,48,571,299,272
050,36,039,"New York","Greene County",5,49,568,288,280
050,36,039,"New York","Greene County",5,50,545,270,275
050,36,039,"New York","Greene County",5,51,583,280,303
050,36,039,"New York","Greene County",5,52,625,314,311
050,36,039,"New York","Greene County",5,53,616,299,317
050,36,039,"New York","Greene County",5,54,607,304,303
050,36,039,"New York","Greene County",5,55,640,343,297
050,36,039,"New York","Greene County",5,56,662,341,321
050,36,039,"New York","Greene County",5,57,680,341,339
050,36,039,"New York","Greene County",5,58,711,348,363
050,36,039,"New York","Greene County",5,59,802,395,407
050,36,039,"New York","Greene County",5,60,823,416,407
050,36,039,"New York","Greene County",5,61,780,398,382
050,36,039,"New York","Greene County",5,62,800,382,418
050,36,039,"New York","Greene County",5,63,779,394,385
050,36,039,"New York","Greene County",5,64,774,385,389
050,36,039,"New York","Greene County",5,65,762,379,383
050,36,039,"New York","Greene County",5,66,770,399,371
050,36,039,"New York","Greene County",5,67,698,353,345
050,36,039,"New York","Greene County",5,68,657,329,328
050,36,039,"New York","Greene County",5,69,665,325,340
050,36,039,"New York","Greene County",5,70,655,307,348
050,36,039,"New York","Greene County",5,71,653,303,350
050,36,039,"New York","Greene County",5,72,633,319,314
050,36,039,"New York","Greene County",5,73,607,302,305
050,36,039,"New York","Greene County",5,74,551,252,299
050,36,039,"New York","Greene County",5,75,552,274,278
050,36,039,"New York","Greene County",5,76,610,317,293
050,36,039,"New York","Greene County",5,77,424,204,220
050,36,039,"New York","Greene County",5,78,414,184,230
050,36,039,"New York","Greene County",5,79,419,190,229
050,36,039,"New York","Greene County",5,80,385,178,207
050,36,039,"New York","Greene County",5,81,319,163,156
050,36,039,"New York","Greene County",5,82,256,126,130
050,36,039,"New York","Greene County",5,83,240,110,130
050,36,039,"New York","Greene County",5,84,187,83,104
050,36,039,"New York","Greene County",5,85,1244,482,762
050,36,041,"New York","Hamilton County",1,0,20,10,10
050,36,041,"New York","Hamilton County",1,1,20,9,11
050,36,041,"New York","Hamilton County",1,2,32,15,17
050,36,041,"New York","Hamilton County",1,3,30,14,16
050,36,041,"New York","Hamilton County",1,4,37,18,19
050,36,041,"New York","Hamilton County",1,5,38,21,17
050,36,041,"New York","Hamilton County",1,6,28,13,15
050,36,041,"New York","Hamilton County",1,7,36,21,15
050,36,041,"New York","Hamilton County",1,8,38,18,20
050,36,041,"New York","Hamilton County",1,9,36,15,21
050,36,041,"New York","Hamilton County",1,10,35,19,16
050,36,041,"New York","Hamilton County",1,11,35,19,16
050,36,041,"New York","Hamilton County",1,12,34,21,13
050,36,041,"New York","Hamilton County",1,13,45,25,20
050,36,041,"New York","Hamilton County",1,14,47,25,22
050,36,041,"New York","Hamilton County",1,15,53,28,25
050,36,041,"New York","Hamilton County",1,16,55,31,24
050,36,041,"New York","Hamilton County",1,17,51,22,29
050,36,041,"New York","Hamilton County",1,18,49,25,24
050,36,041,"New York","Hamilton County",1,19,36,19,17
050,36,041,"New York","Hamilton County",1,20,33,18,15
050,36,041,"New York","Hamilton County",1,21,56,32,24
050,36,041,"New York","Hamilton County",1,22,46,23,23
050,36,041,"New York","Hamilton County",1,23,38,22,16
050,36,041,"New York","Hamilton County",1,24,33,17,16
050,36,041,"New York","Hamilton County",1,25,36,15,21
050,36,041,"New York","Hamilton County",1,26,40,19,21
050,36,041,"New York","Hamilton County",1,27,39,15,24
050,36,041,"New York","Hamilton County",1,28,40,20,20
050,36,041,"New York","Hamilton County",1,29,43,25,18
050,36,041,"New York","Hamilton County",1,30,37,16,21
050,36,041,"New York","Hamilton County",1,31,31,15,16
050,36,041,"New York","Hamilton County",1,32,40,19,21
050,36,041,"New York","Hamilton County",1,33,29,16,13
050,36,041,"New York","Hamilton County",1,34,34,18,16
050,36,041,"New York","Hamilton County",1,35,40,20,20
050,36,041,"New York","Hamilton County",1,36,40,21,19
050,36,041,"New York","Hamilton County",1,37,45,20,25
050,36,041,"New York","Hamilton County",1,38,49,24,25
050,36,041,"New York","Hamilton County",1,39,52,25,27
050,36,041,"New York","Hamilton County",1,40,48,25,23
050,36,041,"New York","Hamilton County",1,41,54,27,27
050,36,041,"New York","Hamilton County",1,42,45,25,20
050,36,041,"New York","Hamilton County",1,43,30,16,14
050,36,041,"New York","Hamilton County",1,44,41,20,21
050,36,041,"New York","Hamilton County",1,45,48,24,24
050,36,041,"New York","Hamilton County",1,46,47,27,20
050,36,041,"New York","Hamilton County",1,47,57,33,24
050,36,041,"New York","Hamilton County",1,48,77,37,40
050,36,041,"New York","Hamilton County",1,49,55,25,30
050,36,041,"New York","Hamilton County",1,50,58,31,27
050,36,041,"New York","Hamilton County",1,51,58,28,30
050,36,041,"New York","Hamilton County",1,52,61,29,32
050,36,041,"New York","Hamilton County",1,53,69,35,34
050,36,041,"New York","Hamilton County",1,54,86,48,38
050,36,041,"New York","Hamilton County",1,55,95,48,47
050,36,041,"New York","Hamilton County",1,56,94,51,43
050,36,041,"New York","Hamilton County",1,57,100,53,47
050,36,041,"New York","Hamilton County",1,58,108,58,50
050,36,041,"New York","Hamilton County",1,59,100,49,51
050,36,041,"New York","Hamilton County",1,60,91,43,48
050,36,041,"New York","Hamilton County",1,61,119,61,58
050,36,041,"New York","Hamilton County",1,62,126,63,63
050,36,041,"New York","Hamilton County",1,63,121,53,68
050,36,041,"New York","Hamilton County",1,64,112,59,53
050,36,041,"New York","Hamilton County",1,65,117,62,55
050,36,041,"New York","Hamilton County",1,66,120,55,65
050,36,041,"New York","Hamilton County",1,67,119,60,59
050,36,041,"New York","Hamilton County",1,68,116,64,52
050,36,041,"New York","Hamilton County",1,69,115,59,56
050,36,041,"New York","Hamilton County",1,70,102,50,52
050,36,041,"New York","Hamilton County",1,71,112,61,51
050,36,041,"New York","Hamilton County",1,72,93,49,44
050,36,041,"New York","Hamilton County",1,73,99,54,45
050,36,041,"New York","Hamilton County",1,74,75,39,36
050,36,041,"New York","Hamilton County",1,75,67,34,33
050,36,041,"New York","Hamilton County",1,76,56,24,32
050,36,041,"New York","Hamilton County",1,77,60,29,31
050,36,041,"New York","Hamilton County",1,78,65,37,28
050,36,041,"New York","Hamilton County",1,79,46,29,17
050,36,041,"New York","Hamilton County",1,80,34,19,15
050,36,041,"New York","Hamilton County",1,81,33,16,17
050,36,041,"New York","Hamilton County",1,82,26,13,13
050,36,041,"New York","Hamilton County",1,83,29,14,15
050,36,041,"New York","Hamilton County",1,84,23,12,11
050,36,041,"New York","Hamilton County",1,85,142,60,82
050,36,041,"New York","Hamilton County",2,0,25,11,14
050,36,041,"New York","Hamilton County",2,1,20,9,11
050,36,041,"New York","Hamilton County",2,2,29,13,16
050,36,041,"New York","Hamilton County",2,3,30,14,16
050,36,041,"New York","Hamilton County",2,4,35,17,18
050,36,041,"New York","Hamilton County",2,5,39,21,18
050,36,041,"New York","Hamilton County",2,6,31,16,15
050,36,041,"New York","Hamilton County",2,7,35,20,15
050,36,041,"New York","Hamilton County",2,8,37,18,19
050,36,041,"New York","Hamilton County",2,9,36,16,20
050,36,041,"New York","Hamilton County",2,10,34,18,16
050,36,041,"New York","Hamilton County",2,11,36,20,16
050,36,041,"New York","Hamilton County",2,12,33,20,13
050,36,041,"New York","Hamilton County",2,13,42,24,18
050,36,041,"New York","Hamilton County",2,14,47,25,22
050,36,041,"New York","Hamilton County",2,15,51,26,25
050,36,041,"New York","Hamilton County",2,16,55,31,24
050,36,041,"New York","Hamilton County",2,17,51,24,27
050,36,041,"New York","Hamilton County",2,18,47,23,24
050,36,041,"New York","Hamilton County",2,19,38,19,19
050,36,041,"New York","Hamilton County",2,20,34,19,15
050,36,041,"New York","Hamilton County",2,21,56,32,24
050,36,041,"New York","Hamilton County",2,22,44,23,21
050,36,041,"New York","Hamilton County",2,23,38,22,16
050,36,041,"New York","Hamilton County",2,24,33,17,16
050,36,041,"New York","Hamilton County",2,25,34,15,19
050,36,041,"New York","Hamilton County",2,26,36,16,20
050,36,041,"New York","Hamilton County",2,27,39,15,24
050,36,041,"New York","Hamilton County",2,28,39,18,21
050,36,041,"New York","Hamilton County",2,29,42,24,18
050,36,041,"New York","Hamilton County",2,30,37,17,20
050,36,041,"New York","Hamilton County",2,31,32,15,17
050,36,041,"New York","Hamilton County",2,32,37,18,19
050,36,041,"New York","Hamilton County",2,33,31,17,14
050,36,041,"New York","Hamilton County",2,34,34,18,16
050,36,041,"New York","Hamilton County",2,35,39,20,19
050,36,041,"New York","Hamilton County",2,36,40,21,19
050,36,041,"New York","Hamilton County",2,37,44,20,24
050,36,041,"New York","Hamilton County",2,38,48,23,25
050,36,041,"New York","Hamilton County",2,39,53,26,27
050,36,041,"New York","Hamilton County",2,40,49,25,24
050,36,041,"New York","Hamilton County",2,41,53,26,27
050,36,041,"New York","Hamilton County",2,42,44,23,21
050,36,041,"New York","Hamilton County",2,43,35,19,16
050,36,041,"New York","Hamilton County",2,44,40,20,20
050,36,041,"New York","Hamilton County",2,45,45,22,23
050,36,041,"New York","Hamilton County",2,46,47,27,20
050,36,041,"New York","Hamilton County",2,47,55,32,23
050,36,041,"New York","Hamilton County",2,48,72,36,36
050,36,041,"New York","Hamilton County",2,49,61,29,32
050,36,041,"New York","Hamilton County",2,50,57,30,27
050,36,041,"New York","Hamilton County",2,51,58,28,30
050,36,041,"New York","Hamilton County",2,52,60,29,31
050,36,041,"New York","Hamilton County",2,53,69,34,35
050,36,041,"New York","Hamilton County",2,54,82,45,37
050,36,041,"New York","Hamilton County",2,55,93,48,45
050,36,041,"New York","Hamilton County",2,56,93,50,43
050,36,041,"New York","Hamilton County",2,57,99,53,46
050,36,041,"New York","Hamilton County",2,58,107,58,49
050,36,041,"New York","Hamilton County",2,59,103,51,52
050,36,041,"New York","Hamilton County",2,60,95,45,50
050,36,041,"New York","Hamilton County",2,61,114,58,56
050,36,041,"New York","Hamilton County",2,62,123,62,61
050,36,041,"New York","Hamilton County",2,63,122,55,67
050,36,041,"New York","Hamilton County",2,64,113,57,56
050,36,041,"New York","Hamilton County",2,65,114,60,54
050,36,041,"New York","Hamilton County",2,66,120,57,63
050,36,041,"New York","Hamilton County",2,67,119,59,60
050,36,041,"New York","Hamilton County",2,68,114,63,51
050,36,041,"New York","Hamilton County",2,69,116,60,56
050,36,041,"New York","Hamilton County",2,70,107,53,54
050,36,041,"New York","Hamilton County",2,71,109,58,51
050,36,041,"New York","Hamilton County",2,72,96,51,45
050,36,041,"New York","Hamilton County",2,73,99,54,45
050,36,041,"New York","Hamilton County",2,74,75,39,36
050,36,041,"New York","Hamilton County",2,75,68,35,33
050,36,041,"New York","Hamilton County",2,76,57,26,31
050,36,041,"New York","Hamilton County",2,77,61,29,32
050,36,041,"New York","Hamilton County",2,78,59,32,27
050,36,041,"New York","Hamilton County",2,79,47,29,18
050,36,041,"New York","Hamilton County",2,80,38,22,16
050,36,041,"New York","Hamilton County",2,81,31,15,16
050,36,041,"New York","Hamilton County",2,82,26,12,14
050,36,041,"New York","Hamilton County",2,83,26,13,13
050,36,041,"New York","Hamilton County",2,84,24,12,12
050,36,041,"New York","Hamilton County",2,85,143,60,83
050,36,041,"New York","Hamilton County",3,0,23,8,15
050,36,041,"New York","Hamilton County",3,1,29,8,21
050,36,041,"New York","Hamilton County",3,2,23,11,12
050,36,041,"New York","Hamilton County",3,3,31,13,18
050,36,041,"New York","Hamilton County",3,4,35,14,21
050,36,041,"New York","Hamilton County",3,5,35,17,18
050,36,041,"New York","Hamilton County",3,6,37,20,17
050,36,041,"New York","Hamilton County",3,7,35,19,16
050,36,041,"New York","Hamilton County",3,8,39,20,19
050,36,041,"New York","Hamilton County",3,9,44,23,21
050,36,041,"New York","Hamilton County",3,10,36,16,20
050,36,041,"New York","Hamilton County",3,11,35,20,15
050,36,041,"New York","Hamilton County",3,12,35,20,15
050,36,041,"New York","Hamilton County",3,13,35,22,13
050,36,041,"New York","Hamilton County",3,14,41,24,17
050,36,041,"New York","Hamilton County",3,15,48,26,22
050,36,041,"New York","Hamilton County",3,16,52,27,25
050,36,041,"New York","Hamilton County",3,17,55,29,26
050,36,041,"New York","Hamilton County",3,18,43,21,22
050,36,041,"New York","Hamilton County",3,19,40,19,21
050,36,041,"New York","Hamilton County",3,20,40,21,19
050,36,041,"New York","Hamilton County",3,21,56,34,22
050,36,041,"New York","Hamilton County",3,22,38,21,17
050,36,041,"New York","Hamilton County",3,23,45,21,24
050,36,041,"New York","Hamilton County",3,24,30,20,10
050,36,041,"New York","Hamilton County",3,25,38,16,22
050,36,041,"New York","Hamilton County",3,26,34,15,19
050,36,041,"New York","Hamilton County",3,27,36,17,19
050,36,041,"New York","Hamilton County",3,28,40,15,25
050,36,041,"New York","Hamilton County",3,29,44,22,22
050,36,041,"New York","Hamilton County",3,30,39,21,18
050,36,041,"New York","Hamilton County",3,31,41,20,21
050,36,041,"New York","Hamilton County",3,32,36,18,18
050,36,041,"New York","Hamilton County",3,33,39,19,20
050,36,041,"New York","Hamilton County",3,34,31,17,14
050,36,041,"New York","Hamilton County",3,35,40,19,21
050,36,041,"New York","Hamilton County",3,36,36,19,17
050,36,041,"New York","Hamilton County",3,37,40,21,19
050,36,041,"New York","Hamilton County",3,38,45,21,24
050,36,041,"New York","Hamilton County",3,39,53,28,25
050,36,041,"New York","Hamilton County",3,40,56,28,28
050,36,041,"New York","Hamilton County",3,41,51,25,26
050,36,041,"New York","Hamilton County",3,42,50,23,27
050,36,041,"New York","Hamilton County",3,43,43,22,21
050,36,041,"New York","Hamilton County",3,44,48,28,20
050,36,041,"New York","Hamilton County",3,45,39,18,21
050,36,041,"New York","Hamilton County",3,46,47,24,23
050,36,041,"New York","Hamilton County",3,47,50,28,22
050,36,041,"New York","Hamilton County",3,48,51,30,21
050,36,041,"New York","Hamilton County",3,49,76,34,42
050,36,041,"New York","Hamilton County",3,50,60,30,30
050,36,041,"New York","Hamilton County",3,51,58,27,31
050,36,041,"New York","Hamilton County",3,52,60,30,30
050,36,041,"New York","Hamilton County",3,53,62,32,30
050,36,041,"New York","Hamilton County",3,54,78,41,37
050,36,041,"New York","Hamilton County",3,55,83,45,38
050,36,041,"New York","Hamilton County",3,56,98,50,48
050,36,041,"New York","Hamilton County",3,57,96,47,49
050,36,041,"New York","Hamilton County",3,58,91,52,39
050,36,041,"New York","Hamilton County",3,59,106,56,50
050,36,041,"New York","Hamilton County",3,60,109,51,58
050,36,041,"New York","Hamilton County",3,61,92,47,45
050,36,041,"New York","Hamilton County",3,62,121,63,58
050,36,041,"New York","Hamilton County",3,63,127,63,64
050,36,041,"New York","Hamilton County",3,64,126,55,71
050,36,041,"New York","Hamilton County",3,65,118,62,56
050,36,041,"New York","Hamilton County",3,66,117,63,54
050,36,041,"New York","Hamilton County",3,67,123,58,65
050,36,041,"New York","Hamilton County",3,68,115,57,58
050,36,041,"New York","Hamilton County",3,69,110,58,52
050,36,041,"New York","Hamilton County",3,70,111,58,53
050,36,041,"New York","Hamilton County",3,71,105,53,52
050,36,041,"New York","Hamilton County",3,72,107,58,49
050,36,041,"New York","Hamilton County",3,73,92,51,41
050,36,041,"New York","Hamilton County",3,74,90,48,42
050,36,041,"New York","Hamilton County",3,75,74,38,36
050,36,041,"New York","Hamilton County",3,76,65,34,31
050,36,041,"New York","Hamilton County",3,77,56,28,28
050,36,041,"New York","Hamilton County",3,78,59,27,32
050,36,041,"New York","Hamilton County",3,79,56,31,25
050,36,041,"New York","Hamilton County",3,80,43,24,19
050,36,041,"New York","Hamilton County",3,81,38,21,17
050,36,041,"New York","Hamilton County",3,82,28,14,14
050,36,041,"New York","Hamilton County",3,83,24,10,14
050,36,041,"New York","Hamilton County",3,84,19,10,9
050,36,041,"New York","Hamilton County",3,85,142,60,82
050,36,041,"New York","Hamilton County",4,0,27,12,15
050,36,041,"New York","Hamilton County",4,1,19,4,15
050,36,041,"New York","Hamilton County",4,2,39,13,26
050,36,041,"New York","Hamilton County",4,3,22,9,13
050,36,041,"New York","Hamilton County",4,4,29,12,17
050,36,041,"New York","Hamilton County",4,5,36,17,19
050,36,041,"New York","Hamilton County",4,6,36,16,20
050,36,041,"New York","Hamilton County",4,7,36,21,15
050,36,041,"New York","Hamilton County",4,8,35,20,15
050,36,041,"New York","Hamilton County",4,9,38,19,19
050,36,041,"New York","Hamilton County",4,10,46,23,23
050,36,041,"New York","Hamilton County",4,11,39,17,22
050,36,041,"New York","Hamilton County",4,12,35,20,15
050,36,041,"New York","Hamilton County",4,13,35,20,15
050,36,041,"New York","Hamilton County",4,14,35,22,13
050,36,041,"New York","Hamilton County",4,15,41,24,17
050,36,041,"New York","Hamilton County",4,16,42,25,17
050,36,041,"New York","Hamilton County",4,17,53,25,28
050,36,041,"New York","Hamilton County",4,18,49,27,22
050,36,041,"New York","Hamilton County",4,19,36,15,21
050,36,041,"New York","Hamilton County",4,20,37,16,21
050,36,041,"New York","Hamilton County",4,21,59,32,27
050,36,041,"New York","Hamilton County",4,22,35,17,18
050,36,041,"New York","Hamilton County",4,23,30,18,12
050,36,041,"New York","Hamilton County",4,24,49,23,26
050,36,041,"New York","Hamilton County",4,25,31,18,13
050,36,041,"New York","Hamilton County",4,26,40,18,22
050,36,041,"New York","Hamilton County",4,27,34,16,18
050,36,041,"New York","Hamilton County",4,28,39,18,21
050,36,041,"New York","Hamilton County",4,29,43,17,26
050,36,041,"New York","Hamilton County",4,30,43,22,21
050,36,041,"New York","Hamilton County",4,31,40,24,16
050,36,041,"New York","Hamilton County",4,32,40,19,21
050,36,041,"New York","Hamilton County",4,33,41,21,20
050,36,041,"New York","Hamilton County",4,34,36,17,19
050,36,041,"New York","Hamilton County",4,35,37,21,16
050,36,041,"New York","Hamilton County",4,36,42,19,23
050,36,041,"New York","Hamilton County",4,37,37,21,16
050,36,041,"New York","Hamilton County",4,38,44,22,22
050,36,041,"New York","Hamilton County",4,39,48,20,28
050,36,041,"New York","Hamilton County",4,40,53,30,23
050,36,041,"New York","Hamilton County",4,41,51,26,25
050,36,041,"New York","Hamilton County",4,42,47,19,28
050,36,041,"New York","Hamilton County",4,43,50,22,28
050,36,041,"New York","Hamilton County",4,44,53,30,23
050,36,041,"New York","Hamilton County",4,45,42,23,19
050,36,041,"New York","Hamilton County",4,46,39,18,21
050,36,041,"New York","Hamilton County",4,47,54,29,25
050,36,041,"New York","Hamilton County",4,48,49,28,21
050,36,041,"New York","Hamilton County",4,49,54,27,27
050,36,041,"New York","Hamilton County",4,50,78,34,44
050,36,041,"New York","Hamilton County",4,51,62,31,31
050,36,041,"New York","Hamilton County",4,52,58,27,31
050,36,041,"New York","Hamilton County",4,53,73,35,38
050,36,041,"New York","Hamilton County",4,54,69,34,35
050,36,041,"New York","Hamilton County",4,55,90,48,42
050,36,041,"New York","Hamilton County",4,56,77,41,36
050,36,041,"New York","Hamilton County",4,57,106,53,53
050,36,041,"New York","Hamilton County",4,58,94,50,44
050,36,041,"New York","Hamilton County",4,59,101,55,46
050,36,041,"New York","Hamilton County",4,60,108,55,53
050,36,041,"New York","Hamilton County",4,61,110,51,59
050,36,041,"New York","Hamilton County",4,62,98,52,46
050,36,041,"New York","Hamilton County",4,63,118,65,53
050,36,041,"New York","Hamilton County",4,64,125,60,65
050,36,041,"New York","Hamilton County",4,65,125,55,70
050,36,041,"New York","Hamilton County",4,66,117,61,56
050,36,041,"New York","Hamilton County",4,67,121,66,55
050,36,041,"New York","Hamilton County",4,68,118,57,61
050,36,041,"New York","Hamilton County",4,69,113,53,60
050,36,041,"New York","Hamilton County",4,70,105,57,48
050,36,041,"New York","Hamilton County",4,71,103,55,48
050,36,041,"New York","Hamilton County",4,72,104,52,52
050,36,041,"New York","Hamilton County",4,73,105,58,47
050,36,041,"New York","Hamilton County",4,74,87,46,41
050,36,041,"New York","Hamilton County",4,75,88,48,40
050,36,041,"New York","Hamilton County",4,76,71,37,34
050,36,041,"New York","Hamilton County",4,77,64,34,30
050,36,041,"New York","Hamilton County",4,78,48,24,24
050,36,041,"New York","Hamilton County",4,79,53,25,28
050,36,041,"New York","Hamilton County",4,80,53,28,25
050,36,041,"New York","Hamilton County",4,81,42,24,18
050,36,041,"New York","Hamilton County",4,82,35,20,15
050,36,041,"New York","Hamilton County",4,83,25,13,12
050,36,041,"New York","Hamilton County",4,84,19,9,10
050,36,041,"New York","Hamilton County",4,85,133,60,73
050,36,041,"New York","Hamilton County",5,0,27,12,15
050,36,041,"New York","Hamilton County",5,1,29,12,17
050,36,041,"New York","Hamilton County",5,2,19,5,14
050,36,041,"New York","Hamilton County",5,3,39,14,25
050,36,041,"New York","Hamilton County",5,4,24,10,14
050,36,041,"New York","Hamilton County",5,5,30,14,16
050,36,041,"New York","Hamilton County",5,6,35,16,19
050,36,041,"New York","Hamilton County",5,7,37,18,19
050,36,041,"New York","Hamilton County",5,8,35,19,16
050,36,041,"New York","Hamilton County",5,9,39,22,17
050,36,041,"New York","Hamilton County",5,10,36,19,17
050,36,041,"New York","Hamilton County",5,11,45,22,23
050,36,041,"New York","Hamilton County",5,12,42,19,23
050,36,041,"New York","Hamilton County",5,13,33,17,16
050,36,041,"New York","Hamilton County",5,14,38,21,17
050,36,041,"New York","Hamilton County",5,15,38,23,15
050,36,041,"New York","Hamilton County",5,16,37,20,17
050,36,041,"New York","Hamilton County",5,17,44,26,18
050,36,041,"New York","Hamilton County",5,18,45,21,24
050,36,041,"New York","Hamilton County",5,19,39,21,18
050,36,041,"New York","Hamilton County",5,20,39,16,23
050,36,041,"New York","Hamilton County",5,21,55,26,29
050,36,041,"New York","Hamilton County",5,22,39,18,21
050,36,041,"New York","Hamilton County",5,23,39,23,16
050,36,041,"New York","Hamilton County",5,24,34,21,13
050,36,041,"New York","Hamilton County",5,25,47,25,22
050,36,041,"New York","Hamilton County",5,26,28,16,12
050,36,041,"New York","Hamilton County",5,27,37,17,20
050,36,041,"New York","Hamilton County",5,28,33,15,18
050,36,041,"New York","Hamilton County",5,29,41,21,20
050,36,041,"New York","Hamilton County",5,30,42,17,25
050,36,041,"New York","Hamilton County",5,31,47,26,21
050,36,041,"New York","Hamilton County",5,32,42,23,19
050,36,041,"New York","Hamilton County",5,33,44,22,22
050,36,041,"New York","Hamilton County",5,34,39,21,18
050,36,041,"New York","Hamilton County",5,35,36,17,19
050,36,041,"New York","Hamilton County",5,36,40,23,17
050,36,041,"New York","Hamilton County",5,37,41,19,22
050,36,041,"New York","Hamilton County",5,38,42,26,16
050,36,041,"New York","Hamilton County",5,39,45,23,22
050,36,041,"New York","Hamilton County",5,40,54,26,28
050,36,041,"New York","Hamilton County",5,41,54,31,23
050,36,041,"New York","Hamilton County",5,42,46,23,23
050,36,041,"New York","Hamilton County",5,43,45,18,27
050,36,041,"New York","Hamilton County",5,44,57,28,29
050,36,041,"New York","Hamilton County",5,45,47,25,22
050,36,041,"New York","Hamilton County",5,46,45,24,21
050,36,041,"New York","Hamilton County",5,47,43,21,22
050,36,041,"New York","Hamilton County",5,48,53,29,24
050,36,041,"New York","Hamilton County",5,49,54,27,27
050,36,041,"New York","Hamilton County",5,50,55,26,29
050,36,041,"New York","Hamilton County",5,51,73,29,44
050,36,041,"New York","Hamilton County",5,52,66,35,31
050,36,041,"New York","Hamilton County",5,53,60,27,33
050,36,041,"New York","Hamilton County",5,54,76,39,37
050,36,041,"New York","Hamilton County",5,55,72,35,37
050,36,041,"New York","Hamilton County",5,56,85,49,36
050,36,041,"New York","Hamilton County",5,57,78,40,38
050,36,041,"New York","Hamilton County",5,58,104,57,47
050,36,041,"New York","Hamilton County",5,59,98,47,51
050,36,041,"New York","Hamilton County",5,60,95,49,46
050,36,041,"New York","Hamilton County",5,61,115,58,57
050,36,041,"New York","Hamilton County",5,62,112,53,59
050,36,041,"New York","Hamilton County",5,63,94,52,42
050,36,041,"New York","Hamilton County",5,64,113,61,52
050,36,041,"New York","Hamilton County",5,65,122,58,64
050,36,041,"New York","Hamilton County",5,66,125,55,70
050,36,041,"New York","Hamilton County",5,67,120,61,59
050,36,041,"New York","Hamilton County",5,68,115,65,50
050,36,041,"New York","Hamilton County",5,69,118,57,61
050,36,041,"New York","Hamilton County",5,70,108,51,57
050,36,041,"New York","Hamilton County",5,71,103,54,49
050,36,041,"New York","Hamilton County",5,72,104,54,50
050,36,041,"New York","Hamilton County",5,73,104,53,51
050,36,041,"New York","Hamilton County",5,74,104,57,47
050,36,041,"New York","Hamilton County",5,75,81,45,36
050,36,041,"New York","Hamilton County",5,76,78,44,34
050,36,041,"New York","Hamilton County",5,77,73,38,35
050,36,041,"New York","Hamilton County",5,78,56,30,26
050,36,041,"New York","Hamilton County",5,79,43,23,20
050,36,041,"New York","Hamilton County",5,80,48,23,25
050,36,041,"New York","Hamilton County",5,81,51,27,24
050,36,041,"New York","Hamilton County",5,82,36,22,14
050,36,041,"New York","Hamilton County",5,83,30,15,15
050,36,041,"New York","Hamilton County",5,84,20,12,8
050,36,041,"New York","Hamilton County",5,85,128,60,68
050,36,043,"New York","Herkimer County",1,0,547,279,268
050,36,043,"New York","Herkimer County",1,1,575,298,277
050,36,043,"New York","Herkimer County",1,2,625,329,296
050,36,043,"New York","Herkimer County",1,3,628,325,303
050,36,043,"New York","Herkimer County",1,4,630,325,305
050,36,043,"New York","Herkimer County",1,5,660,338,322
050,36,043,"New York","Herkimer County",1,6,652,338,314
050,36,043,"New York","Herkimer County",1,7,657,335,322
050,36,043,"New York","Herkimer County",1,8,688,333,355
050,36,043,"New York","Herkimer County",1,9,700,353,347
050,36,043,"New York","Herkimer County",1,10,737,387,350
050,36,043,"New York","Herkimer County",1,11,732,372,360
050,36,043,"New York","Herkimer County",1,12,776,393,383
050,36,043,"New York","Herkimer County",1,13,777,384,393
050,36,043,"New York","Herkimer County",1,14,751,383,368
050,36,043,"New York","Herkimer County",1,15,761,383,378
050,36,043,"New York","Herkimer County",1,16,795,384,411
050,36,043,"New York","Herkimer County",1,17,792,418,374
050,36,043,"New York","Herkimer County",1,18,754,394,360
050,36,043,"New York","Herkimer County",1,19,684,366,318
050,36,043,"New York","Herkimer County",1,20,644,342,302
050,36,043,"New York","Herkimer County",1,21,634,330,304
050,36,043,"New York","Herkimer County",1,22,647,335,312
050,36,043,"New York","Herkimer County",1,23,637,326,311
050,36,043,"New York","Herkimer County",1,24,652,328,324
050,36,043,"New York","Herkimer County",1,25,643,306,337
050,36,043,"New York","Herkimer County",1,26,668,325,343
050,36,043,"New York","Herkimer County",1,27,675,357,318
050,36,043,"New York","Herkimer County",1,28,736,383,353
050,36,043,"New York","Herkimer County",1,29,760,390,370
050,36,043,"New York","Herkimer County",1,30,673,342,331
050,36,043,"New York","Herkimer County",1,31,661,339,322
050,36,043,"New York","Herkimer County",1,32,646,334,312
050,36,043,"New York","Herkimer County",1,33,673,341,332
050,36,043,"New York","Herkimer County",1,34,709,357,352
050,36,043,"New York","Herkimer County",1,35,665,315,350
050,36,043,"New York","Herkimer County",1,36,634,322,312
050,36,043,"New York","Herkimer County",1,37,704,376,328
050,36,043,"New York","Herkimer County",1,38,696,361,335
050,36,043,"New York","Herkimer County",1,39,697,355,342
050,36,043,"New York","Herkimer County",1,40,697,371,326
050,36,043,"New York","Herkimer County",1,41,647,329,318
050,36,043,"New York","Herkimer County",1,42,620,299,321
050,36,043,"New York","Herkimer County",1,43,627,320,307
050,36,043,"New York","Herkimer County",1,44,610,299,311
050,36,043,"New York","Herkimer County",1,45,653,332,321
050,36,043,"New York","Herkimer County",1,46,667,350,317
050,36,043,"New York","Herkimer County",1,47,704,346,358
050,36,043,"New York","Herkimer County",1,48,736,377,359
050,36,043,"New York","Herkimer County",1,49,803,396,407
050,36,043,"New York","Herkimer County",1,50,752,364,388
050,36,043,"New York","Herkimer County",1,51,746,366,380
050,36,043,"New York","Herkimer County",1,52,769,383,386
050,36,043,"New York","Herkimer County",1,53,787,401,386
050,36,043,"New York","Herkimer County",1,54,833,436,397
050,36,043,"New York","Herkimer County",1,55,909,465,444
050,36,043,"New York","Herkimer County",1,56,974,484,490
050,36,043,"New York","Herkimer County",1,57,963,477,486
050,36,043,"New York","Herkimer County",1,58,982,500,482
050,36,043,"New York","Herkimer County",1,59,950,462,488
050,36,043,"New York","Herkimer County",1,60,950,478,472
050,36,043,"New York","Herkimer County",1,61,964,491,473
050,36,043,"New York","Herkimer County",1,62,955,487,468
050,36,043,"New York","Herkimer County",1,63,917,456,461
050,36,043,"New York","Herkimer County",1,64,856,426,430
050,36,043,"New York","Herkimer County",1,65,845,416,429
050,36,043,"New York","Herkimer County",1,66,833,416,417
050,36,043,"New York","Herkimer County",1,67,849,421,428
050,36,043,"New York","Herkimer County",1,68,835,420,415
050,36,043,"New York","Herkimer County",1,69,766,371,395
050,36,043,"New York","Herkimer County",1,70,731,354,377
050,36,043,"New York","Herkimer County",1,71,748,373,375
050,36,043,"New York","Herkimer County",1,72,740,366,374
050,36,043,"New York","Herkimer County",1,73,686,350,336
050,36,043,"New York","Herkimer County",1,74,482,239,243
050,36,043,"New York","Herkimer County",1,75,478,234,244
050,36,043,"New York","Herkimer County",1,76,478,239,239
050,36,043,"New York","Herkimer County",1,77,494,229,265
050,36,043,"New York","Herkimer County",1,78,420,186,234
050,36,043,"New York","Herkimer County",1,79,361,162,199
050,36,043,"New York","Herkimer County",1,80,310,130,180
050,36,043,"New York","Herkimer County",1,81,308,135,173
050,36,043,"New York","Herkimer County",1,82,268,116,152
050,36,043,"New York","Herkimer County",1,83,278,112,166
050,36,043,"New York","Herkimer County",1,84,275,121,154
050,36,043,"New York","Herkimer County",1,85,1513,528,985
050,36,043,"New York","Herkimer County",2,0,557,286,271
050,36,043,"New York","Herkimer County",2,1,570,295,275
050,36,043,"New York","Herkimer County",2,2,616,324,292
050,36,043,"New York","Herkimer County",2,3,629,327,302
050,36,043,"New York","Herkimer County",2,4,636,327,309
050,36,043,"New York","Herkimer County",2,5,655,334,321
050,36,043,"New York","Herkimer County",2,6,652,337,315
050,36,043,"New York","Herkimer County",2,7,655,334,321
050,36,043,"New York","Herkimer County",2,8,677,331,346
050,36,043,"New York","Herkimer County",2,9,700,350,350
050,36,043,"New York","Herkimer County",2,10,728,376,352
050,36,043,"New York","Herkimer County",2,11,730,376,354
050,36,043,"New York","Herkimer County",2,12,767,389,378
050,36,043,"New York","Herkimer County",2,13,773,383,390
050,36,043,"New York","Herkimer County",2,14,754,383,371
050,36,043,"New York","Herkimer County",2,15,755,382,373
050,36,043,"New York","Herkimer County",2,16,786,384,402
050,36,043,"New York","Herkimer County",2,17,795,410,385
050,36,043,"New York","Herkimer County",2,18,758,395,363
050,36,043,"New York","Herkimer County",2,19,679,364,315
050,36,043,"New York","Herkimer County",2,20,651,345,306
050,36,043,"New York","Herkimer County",2,21,633,330,303
050,36,043,"New York","Herkimer County",2,22,644,335,309
050,36,043,"New York","Herkimer County",2,23,646,331,315
050,36,043,"New York","Herkimer County",2,24,644,324,320
050,36,043,"New York","Herkimer County",2,25,642,313,329
050,36,043,"New York","Herkimer County",2,26,663,324,339
050,36,043,"New York","Herkimer County",2,27,672,349,323
050,36,043,"New York","Herkimer County",2,28,725,378,347
050,36,043,"New York","Herkimer County",2,29,748,384,364
050,36,043,"New York","Herkimer County",2,30,695,354,341
050,36,043,"New York","Herkimer County",2,31,664,341,323
050,36,043,"New York","Herkimer County",2,32,650,335,315
050,36,043,"New York","Herkimer County",2,33,666,342,324
050,36,043,"New York","Herkimer County",2,34,699,352,347
050,36,043,"New York","Herkimer County",2,35,682,328,354
050,36,043,"New York","Herkimer County",2,36,636,318,318
050,36,043,"New York","Herkimer County",2,37,688,365,323
050,36,043,"New York","Herkimer County",2,38,700,365,335
050,36,043,"New York","Herkimer County",2,39,696,355,341
050,36,043,"New York","Herkimer County",2,40,696,370,326
050,36,043,"New York","Herkimer County",2,41,657,337,320
050,36,043,"New York","Herkimer County",2,42,622,303,319
050,36,043,"New York","Herkimer County",2,43,628,315,313
050,36,043,"New York","Herkimer County",2,44,606,300,306
050,36,043,"New York","Herkimer County",2,45,645,326,319
050,36,043,"New York","Herkimer County",2,46,660,342,318
050,36,043,"New York","Herkimer County",2,47,695,346,349
050,36,043,"New York","Herkimer County",2,48,724,368,356
050,36,043,"New York","Herkimer County",2,49,791,393,398
050,36,043,"New York","Herkimer County",2,50,762,372,390
050,36,043,"New York","Herkimer County",2,51,743,363,380
050,36,043,"New York","Herkimer County",2,52,759,375,384
050,36,043,"New York","Herkimer County",2,53,784,398,386
050,36,043,"New York","Herkimer County",2,54,822,427,395
050,36,043,"New York","Herkimer County",2,55,890,457,433
050,36,043,"New York","Herkimer County",2,56,957,478,479
050,36,043,"New York","Herkimer County",2,57,967,480,487
050,36,043,"New York","Herkimer County",2,58,977,495,482
050,36,043,"New York","Herkimer County",2,59,958,471,487
050,36,043,"New York","Herkimer County",2,60,947,473,474
050,36,043,"New York","Herkimer County",2,61,954,484,470
050,36,043,"New York","Herkimer County",2,62,954,485,469
050,36,043,"New York","Herkimer County",2,63,929,465,464
050,36,043,"New York","Herkimer County",2,64,863,431,432
050,36,043,"New York","Herkimer County",2,65,843,414,429
050,36,043,"New York","Herkimer County",2,66,837,415,422
050,36,043,"New York","Herkimer County",2,67,837,413,424
050,36,043,"New York","Herkimer County",2,68,829,417,412
050,36,043,"New York","Herkimer County",2,69,786,385,401
050,36,043,"New York","Herkimer County",2,70,734,355,379
050,36,043,"New York","Herkimer County",2,71,744,368,376
050,36,043,"New York","Herkimer County",2,72,724,358,366
050,36,043,"New York","Herkimer County",2,73,728,368,360
050,36,043,"New York","Herkimer County",2,74,495,246,249
050,36,043,"New York","Herkimer County",2,75,478,235,243
050,36,043,"New York","Herkimer County",2,76,469,236,233
050,36,043,"New York","Herkimer County",2,77,500,235,265
050,36,043,"New York","Herkimer County",2,78,423,189,234
050,36,043,"New York","Herkimer County",2,79,363,164,199
050,36,043,"New York","Herkimer County",2,80,315,134,181
050,36,043,"New York","Herkimer County",2,81,304,131,173
050,36,043,"New York","Herkimer County",2,82,275,120,155
050,36,043,"New York","Herkimer County",2,83,268,106,162
050,36,043,"New York","Herkimer County",2,84,270,118,152
050,36,043,"New York","Herkimer County",2,85,1509,530,979
050,36,043,"New York","Herkimer County",3,0,624,338,286
050,36,043,"New York","Herkimer County",3,1,557,290,267
050,36,043,"New York","Herkimer County",3,2,582,296,286
050,36,043,"New York","Herkimer County",3,3,641,334,307
050,36,043,"New York","Herkimer County",3,4,629,327,302
050,36,043,"New York","Herkimer County",3,5,645,331,314
050,36,043,"New York","Herkimer County",3,6,653,332,321
050,36,043,"New York","Herkimer County",3,7,665,350,315
050,36,043,"New York","Herkimer County",3,8,633,328,305
050,36,043,"New York","Herkimer County",3,9,695,348,347
050,36,043,"New York","Herkimer County",3,10,720,355,365
050,36,043,"New York","Herkimer County",3,11,725,375,350
050,36,043,"New York","Herkimer County",3,12,743,382,361
050,36,043,"New York","Herkimer County",3,13,761,386,375
050,36,043,"New York","Herkimer County",3,14,784,384,400
050,36,043,"New York","Herkimer County",3,15,759,388,371
050,36,043,"New York","Herkimer County",3,16,743,374,369
050,36,043,"New York","Herkimer County",3,17,791,382,409
050,36,043,"New York","Herkimer County",3,18,777,400,377
050,36,043,"New York","Herkimer County",3,19,664,357,307
050,36,043,"New York","Herkimer County",3,20,667,356,311
050,36,043,"New York","Herkimer County",3,21,652,341,311
050,36,043,"New York","Herkimer County",3,22,656,334,322
050,36,043,"New York","Herkimer County",3,23,658,328,330
050,36,043,"New York","Herkimer County",3,24,639,331,308
050,36,043,"New York","Herkimer County",3,25,653,330,323
050,36,043,"New York","Herkimer County",3,26,641,315,326
050,36,043,"New York","Herkimer County",3,27,701,344,357
050,36,043,"New York","Herkimer County",3,28,680,361,319
050,36,043,"New York","Herkimer County",3,29,712,366,346
050,36,043,"New York","Herkimer County",3,30,745,389,356
050,36,043,"New York","Herkimer County",3,31,694,356,338
050,36,043,"New York","Herkimer County",3,32,685,351,334
050,36,043,"New York","Herkimer County",3,33,659,334,325
050,36,043,"New York","Herkimer County",3,34,675,354,321
050,36,043,"New York","Herkimer County",3,35,702,349,353
050,36,043,"New York","Herkimer County",3,36,680,327,353
050,36,043,"New York","Herkimer County",3,37,632,319,313
050,36,043,"New York","Herkimer County",3,38,686,364,322
050,36,043,"New York","Herkimer County",3,39,704,368,336
050,36,043,"New York","Herkimer County",3,40,706,360,346
050,36,043,"New York","Herkimer County",3,41,703,373,330
050,36,043,"New York","Herkimer County",3,42,668,327,341
050,36,043,"New York","Herkimer County",3,43,630,309,321
050,36,043,"New York","Herkimer County",3,44,616,305,311
050,36,043,"New York","Herkimer County",3,45,635,316,319
050,36,043,"New York","Herkimer County",3,46,644,326,318
050,36,043,"New York","Herkimer County",3,47,666,348,318
050,36,043,"New York","Herkimer County",3,48,691,346,345
050,36,043,"New York","Herkimer County",3,49,739,376,363
050,36,043,"New York","Herkimer County",3,50,785,398,387
050,36,043,"New York","Herkimer County",3,51,756,374,382
050,36,043,"New York","Herkimer County",3,52,728,353,375
050,36,043,"New York","Herkimer County",3,53,766,378,388
050,36,043,"New York","Herkimer County",3,54,795,409,386
050,36,043,"New York","Herkimer County",3,55,818,421,397
050,36,043,"New York","Herkimer County",3,56,894,460,434
050,36,043,"New York","Herkimer County",3,57,946,472,474
050,36,043,"New York","Herkimer County",3,58,963,473,490
050,36,043,"New York","Herkimer County",3,59,960,493,467
050,36,043,"New York","Herkimer County",3,60,954,471,483
050,36,043,"New York","Herkimer County",3,61,936,469,467
050,36,043,"New York","Herkimer County",3,62,950,480,470
050,36,043,"New York","Herkimer County",3,63,923,470,453
050,36,043,"New York","Herkimer County",3,64,918,455,463
050,36,043,"New York","Herkimer County",3,65,834,415,419
050,36,043,"New York","Herkimer County",3,66,830,406,424
050,36,043,"New York","Herkimer County",3,67,816,400,416
050,36,043,"New York","Herkimer County",3,68,826,408,418
050,36,043,"New York","Herkimer County",3,69,816,409,407
050,36,043,"New York","Herkimer County",3,70,766,372,394
050,36,043,"New York","Herkimer County",3,71,716,348,368
050,36,043,"New York","Herkimer County",3,72,721,357,364
050,36,043,"New York","Herkimer County",3,73,715,361,354
050,36,043,"New York","Herkimer County",3,74,709,355,354
050,36,043,"New York","Herkimer County",3,75,469,229,240
050,36,043,"New York","Herkimer County",3,76,465,229,236
050,36,043,"New York","Herkimer County",3,77,460,228,232
050,36,043,"New York","Herkimer County",3,78,465,214,251
050,36,043,"New York","Herkimer County",3,79,404,183,221
050,36,043,"New York","Herkimer County",3,80,325,145,180
050,36,043,"New York","Herkimer County",3,81,297,125,172
050,36,043,"New York","Herkimer County",3,82,270,114,156
050,36,043,"New York","Herkimer County",3,83,263,109,154
050,36,043,"New York","Herkimer County",3,84,244,105,139
050,36,043,"New York","Herkimer County",3,85,1510,545,965
050,36,043,"New York","Herkimer County",4,0,556,306,250
050,36,043,"New York","Herkimer County",4,1,633,341,292
050,36,043,"New York","Herkimer County",4,2,571,292,279
050,36,043,"New York","Herkimer County",4,3,576,291,285
050,36,043,"New York","Herkimer County",4,4,628,328,300
050,36,043,"New York","Herkimer County",4,5,639,332,307
050,36,043,"New York","Herkimer County",4,6,660,345,315
050,36,043,"New York","Herkimer County",4,7,669,348,321
050,36,043,"New York","Herkimer County",4,8,674,362,312
050,36,043,"New York","Herkimer County",4,9,649,334,315
050,36,043,"New York","Herkimer County",4,10,697,353,344
050,36,043,"New York","Herkimer County",4,11,723,362,361
050,36,043,"New York","Herkimer County",4,12,700,365,335
050,36,043,"New York","Herkimer County",4,13,733,381,352
050,36,043,"New York","Herkimer County",4,14,781,393,388
050,36,043,"New York","Herkimer County",4,15,785,387,398
050,36,043,"New York","Herkimer County",4,16,774,395,379
050,36,043,"New York","Herkimer County",4,17,761,383,378
050,36,043,"New York","Herkimer County",4,18,769,372,397
050,36,043,"New York","Herkimer County",4,19,674,367,307
050,36,043,"New York","Herkimer County",4,20,616,335,281
050,36,043,"New York","Herkimer County",4,21,645,339,306
050,36,043,"New York","Herkimer County",4,22,655,344,311
050,36,043,"New York","Herkimer County",4,23,656,339,317
050,36,043,"New York","Herkimer County",4,24,662,335,327
050,36,043,"New York","Herkimer County",4,25,604,317,287
050,36,043,"New York","Herkimer County",4,26,629,312,317
050,36,043,"New York","Herkimer County",4,27,636,312,324
050,36,043,"New York","Herkimer County",4,28,689,337,352
050,36,043,"New York","Herkimer County",4,29,660,352,308
050,36,043,"New York","Herkimer County",4,30,699,361,338
050,36,043,"New York","Herkimer County",4,31,724,370,354
050,36,043,"New York","Herkimer County",4,32,686,353,333
050,36,043,"New York","Herkimer County",4,33,690,351,339
050,36,043,"New York","Herkimer County",4,34,660,333,327
050,36,043,"New York","Herkimer County",4,35,671,346,325
050,36,043,"New York","Herkimer County",4,36,714,353,361
050,36,043,"New York","Herkimer County",4,37,685,333,352
050,36,043,"New York","Herkimer County",4,38,639,327,312
050,36,043,"New York","Herkimer County",4,39,699,366,333
050,36,043,"New York","Herkimer County",4,40,699,364,335
050,36,043,"New York","Herkimer County",4,41,721,368,353
050,36,043,"New York","Herkimer County",4,42,710,371,339
050,36,043,"New York","Herkimer County",4,43,700,341,359
050,36,043,"New York","Herkimer County",4,44,629,311,318
050,36,043,"New York","Herkimer County",4,45,628,311,317
050,36,043,"New York","Herkimer County",4,46,633,316,317
050,36,043,"New York","Herkimer County",4,47,654,328,326
050,36,043,"New York","Herkimer County",4,48,664,349,315
050,36,043,"New York","Herkimer County",4,49,689,343,346
050,36,043,"New York","Herkimer County",4,50,743,380,363
050,36,043,"New York","Herkimer County",4,51,775,391,384
050,36,043,"New York","Herkimer County",4,52,738,363,375
050,36,043,"New York","Herkimer County",4,53,722,352,370
050,36,043,"New York","Herkimer County",4,54,775,387,388
050,36,043,"New York","Herkimer County",4,55,788,406,382
050,36,043,"New York","Herkimer County",4,56,810,419,391
050,36,043,"New York","Herkimer County",4,57,881,449,432
050,36,043,"New York","Herkimer County",4,58,947,470,477
050,36,043,"New York","Herkimer County",4,59,946,466,480
050,36,043,"New York","Herkimer County",4,60,949,493,456
050,36,043,"New York","Herkimer County",4,61,945,465,480
050,36,043,"New York","Herkimer County",4,62,921,460,461
050,36,043,"New York","Herkimer County",4,63,927,471,456
050,36,043,"New York","Herkimer County",4,64,907,462,445
050,36,043,"New York","Herkimer County",4,65,896,442,454
050,36,043,"New York","Herkimer County",4,66,819,406,413
050,36,043,"New York","Herkimer County",4,67,796,387,409
050,36,043,"New York","Herkimer County",4,68,793,390,403
050,36,043,"New York","Herkimer County",4,69,800,392,408
050,36,043,"New York","Herkimer County",4,70,794,391,403
050,36,043,"New York","Herkimer County",4,71,748,361,387
050,36,043,"New York","Herkimer County",4,72,696,338,358
050,36,043,"New York","Herkimer County",4,73,700,349,351
050,36,043,"New York","Herkimer County",4,74,695,350,345
050,36,043,"New York","Herkimer County",4,75,665,327,338
050,36,043,"New York","Herkimer County",4,76,452,218,234
050,36,043,"New York","Herkimer County",4,77,461,218,243
050,36,043,"New York","Herkimer County",4,78,428,213,215
050,36,043,"New York","Herkimer County",4,79,434,197,237
050,36,043,"New York","Herkimer County",4,80,368,166,202
050,36,043,"New York","Herkimer County",4,81,305,129,176
050,36,043,"New York","Herkimer County",4,82,266,110,156
050,36,043,"New York","Herkimer County",4,83,261,98,163
050,36,043,"New York","Herkimer County",4,84,253,114,139
050,36,043,"New York","Herkimer County",4,85,1482,527,955
050,36,043,"New York","Herkimer County",5,0,556,306,250
050,36,043,"New York","Herkimer County",5,1,568,297,271
050,36,043,"New York","Herkimer County",5,2,648,349,299
050,36,043,"New York","Herkimer County",5,3,593,308,285
050,36,043,"New York","Herkimer County",5,4,575,295,280
050,36,043,"New York","Herkimer County",5,5,649,349,300
050,36,043,"New York","Herkimer County",5,6,621,325,296
050,36,043,"New York","Herkimer County",5,7,672,351,321
050,36,043,"New York","Herkimer County",5,8,669,344,325
050,36,043,"New York","Herkimer County",5,9,690,367,323
050,36,043,"New York","Herkimer County",5,10,649,337,312
050,36,043,"New York","Herkimer County",5,11,701,358,343
050,36,043,"New York","Herkimer County",5,12,723,361,362
050,36,043,"New York","Herkimer County",5,13,693,365,328
050,36,043,"New York","Herkimer County",5,14,731,374,357
050,36,043,"New York","Herkimer County",5,15,781,393,388
050,36,043,"New York","Herkimer County",5,16,779,389,390
050,36,043,"New York","Herkimer County",5,17,780,399,381
050,36,043,"New York","Herkimer County",5,18,742,369,373
050,36,043,"New York","Herkimer County",5,19,662,341,321
050,36,043,"New York","Herkimer County",5,20,657,361,296
050,36,043,"New York","Herkimer County",5,21,610,326,284
050,36,043,"New York","Herkimer County",5,22,650,330,320
050,36,043,"New York","Herkimer County",5,23,672,348,324
050,36,043,"New York","Herkimer County",5,24,674,354,320
050,36,043,"New York","Herkimer County",5,25,671,350,321
050,36,043,"New York","Herkimer County",5,26,595,311,284
050,36,043,"New York","Herkimer County",5,27,630,315,315
050,36,043,"New York","Herkimer County",5,28,647,316,331
050,36,043,"New York","Herkimer County",5,29,681,338,343
050,36,043,"New York","Herkimer County",5,30,651,335,316
050,36,043,"New York","Herkimer County",5,31,720,372,348
050,36,043,"New York","Herkimer County",5,32,737,367,370
050,36,043,"New York","Herkimer County",5,33,704,366,338
050,36,043,"New York","Herkimer County",5,34,697,356,341
050,36,043,"New York","Herkimer County",5,35,672,337,335
050,36,043,"New York","Herkimer County",5,36,680,354,326
050,36,043,"New York","Herkimer County",5,37,722,360,362
050,36,043,"New York","Herkimer County",5,38,700,346,354
050,36,043,"New York","Herkimer County",5,39,637,317,320
050,36,043,"New York","Herkimer County",5,40,676,345,331
050,36,043,"New York","Herkimer County",5,41,730,385,345
050,36,043,"New York","Herkimer County",5,42,730,365,365
050,36,043,"New York","Herkimer County",5,43,711,368,343
050,36,043,"New York","Herkimer County",5,44,682,332,350
050,36,043,"New York","Herkimer County",5,45,635,320,315
050,36,043,"New York","Herkimer County",5,46,620,312,308
050,36,043,"New York","Herkimer County",5,47,632,310,322
050,36,043,"New York","Herkimer County",5,48,641,326,315
050,36,043,"New York","Herkimer County",5,49,687,357,330
050,36,043,"New York","Herkimer County",5,50,702,354,348
050,36,043,"New York","Herkimer County",5,51,726,378,348
050,36,043,"New York","Herkimer County",5,52,777,387,390
050,36,043,"New York","Herkimer County",5,53,739,363,376
050,36,043,"New York","Herkimer County",5,54,717,352,365
050,36,043,"New York","Herkimer County",5,55,776,389,387
050,36,043,"New York","Herkimer County",5,56,783,404,379
050,36,043,"New York","Herkimer County",5,57,805,407,398
050,36,043,"New York","Herkimer County",5,58,884,448,436
050,36,043,"New York","Herkimer County",5,59,941,467,474
050,36,043,"New York","Herkimer County",5,60,947,463,484
050,36,043,"New York","Herkimer County",5,61,927,479,448
050,36,043,"New York","Herkimer County",5,62,937,456,481
050,36,043,"New York","Herkimer County",5,63,909,455,454
050,36,043,"New York","Herkimer County",5,64,922,475,447
050,36,043,"New York","Herkimer County",5,65,881,449,432
050,36,043,"New York","Herkimer County",5,66,889,432,457
050,36,043,"New York","Herkimer County",5,67,797,396,401
050,36,043,"New York","Herkimer County",5,68,786,384,402
050,36,043,"New York","Herkimer County",5,69,776,381,395
050,36,043,"New York","Herkimer County",5,70,779,381,398
050,36,043,"New York","Herkimer County",5,71,775,385,390
050,36,043,"New York","Herkimer County",5,72,732,350,382
050,36,043,"New York","Herkimer County",5,73,686,336,350
050,36,043,"New York","Herkimer County",5,74,686,344,342
050,36,043,"New York","Herkimer County",5,75,662,330,332
050,36,043,"New York","Herkimer County",5,76,634,310,324
050,36,043,"New York","Herkimer County",5,77,441,202,239
050,36,043,"New York","Herkimer County",5,78,434,205,229
050,36,043,"New York","Herkimer County",5,79,401,198,203
050,36,043,"New York","Herkimer County",5,80,403,180,223
050,36,043,"New York","Herkimer County",5,81,351,157,194
050,36,043,"New York","Herkimer County",5,82,274,119,155
050,36,043,"New York","Herkimer County",5,83,248,92,156
050,36,043,"New York","Herkimer County",5,84,245,101,144
050,36,043,"New York","Herkimer County",5,85,1479,530,949
050,36,045,"New York","Jefferson County",1,0,1825,937,888
050,36,045,"New York","Jefferson County",1,1,1695,862,833
050,36,045,"New York","Jefferson County",1,2,1700,873,827
050,36,045,"New York","Jefferson County",1,3,1771,955,816
050,36,045,"New York","Jefferson County",1,4,1705,870,835
050,36,045,"New York","Jefferson County",1,5,1612,817,795
050,36,045,"New York","Jefferson County",1,6,1577,780,797
050,36,045,"New York","Jefferson County",1,7,1569,825,744
050,36,045,"New York","Jefferson County",1,8,1548,785,763
050,36,045,"New York","Jefferson County",1,9,1520,769,751
050,36,045,"New York","Jefferson County",1,10,1591,804,787
050,36,045,"New York","Jefferson County",1,11,1541,778,763
050,36,045,"New York","Jefferson County",1,12,1508,787,721
050,36,045,"New York","Jefferson County",1,13,1458,751,707
050,36,045,"New York","Jefferson County",1,14,1394,721,673
050,36,045,"New York","Jefferson County",1,15,1327,665,662
050,36,045,"New York","Jefferson County",1,16,1353,669,684
050,36,045,"New York","Jefferson County",1,17,1307,641,666
050,36,045,"New York","Jefferson County",1,18,1327,744,583
050,36,045,"New York","Jefferson County",1,19,1494,937,557
050,36,045,"New York","Jefferson County",1,20,1983,1264,719
050,36,045,"New York","Jefferson County",1,21,2359,1547,812
050,36,045,"New York","Jefferson County",1,22,2362,1504,858
050,36,045,"New York","Jefferson County",1,23,2362,1469,893
050,36,045,"New York","Jefferson County",1,24,2370,1477,893
050,36,045,"New York","Jefferson County",1,25,2243,1372,871
050,36,045,"New York","Jefferson County",1,26,2161,1276,885
050,36,045,"New York","Jefferson County",1,27,2050,1182,868
050,36,045,"New York","Jefferson County",1,28,1959,1147,812
050,36,045,"New York","Jefferson County",1,29,1980,1130,850
050,36,045,"New York","Jefferson County",1,30,1828,995,833
050,36,045,"New York","Jefferson County",1,31,1709,935,774
050,36,045,"New York","Jefferson County",1,32,1660,920,740
050,36,045,"New York","Jefferson County",1,33,1659,905,754
050,36,045,"New York","Jefferson County",1,34,1676,899,777
050,36,045,"New York","Jefferson County",1,35,1619,853,766
050,36,045,"New York","Jefferson County",1,36,1601,842,759
050,36,045,"New York","Jefferson County",1,37,1577,832,745
050,36,045,"New York","Jefferson County",1,38,1525,833,692
050,36,045,"New York","Jefferson County",1,39,1485,806,679
050,36,045,"New York","Jefferson County",1,40,1377,748,629
050,36,045,"New York","Jefferson County",1,41,1310,683,627
050,36,045,"New York","Jefferson County",1,42,1206,641,565
050,36,045,"New York","Jefferson County",1,43,1131,590,541
050,36,045,"New York","Jefferson County",1,44,1094,573,521
050,36,045,"New York","Jefferson County",1,45,1085,572,513
050,36,045,"New York","Jefferson County",1,46,1060,537,523
050,36,045,"New York","Jefferson County",1,47,1079,521,558
050,36,045,"New York","Jefferson County",1,48,1136,581,555
050,36,045,"New York","Jefferson County",1,49,1264,647,617
050,36,045,"New York","Jefferson County",1,50,1212,609,603
050,36,045,"New York","Jefferson County",1,51,1197,600,597
050,36,045,"New York","Jefferson County",1,52,1200,612,588
050,36,045,"New York","Jefferson County",1,53,1241,616,625
050,36,045,"New York","Jefferson County",1,54,1265,641,624
050,36,045,"New York","Jefferson County",1,55,1339,674,665
050,36,045,"New York","Jefferson County",1,56,1322,639,683
050,36,045,"New York","Jefferson County",1,57,1381,680,701
050,36,045,"New York","Jefferson County",1,58,1374,670,704
050,36,045,"New York","Jefferson County",1,59,1371,673,698
050,36,045,"New York","Jefferson County",1,60,1312,647,665
050,36,045,"New York","Jefferson County",1,61,1323,659,664
050,36,045,"New York","Jefferson County",1,62,1309,628,681
050,36,045,"New York","Jefferson County",1,63,1292,627,665
050,36,045,"New York","Jefferson County",1,64,1213,598,615
050,36,045,"New York","Jefferson County",1,65,1144,549,595
050,36,045,"New York","Jefferson County",1,66,1111,536,575
050,36,045,"New York","Jefferson County",1,67,1083,507,576
050,36,045,"New York","Jefferson County",1,68,1062,509,553
050,36,045,"New York","Jefferson County",1,69,992,505,487
050,36,045,"New York","Jefferson County",1,70,985,485,500
050,36,045,"New York","Jefferson County",1,71,973,474,499
050,36,045,"New York","Jefferson County",1,72,955,451,504
050,36,045,"New York","Jefferson County",1,73,969,456,513
050,36,045,"New York","Jefferson County",1,74,672,335,337
050,36,045,"New York","Jefferson County",1,75,678,334,344
050,36,045,"New York","Jefferson County",1,76,669,313,356
050,36,045,"New York","Jefferson County",1,77,657,312,345
050,36,045,"New York","Jefferson County",1,78,582,270,312
050,36,045,"New York","Jefferson County",1,79,455,216,239
050,36,045,"New York","Jefferson County",1,80,392,183,209
050,36,045,"New York","Jefferson County",1,81,373,170,203
050,36,045,"New York","Jefferson County",1,82,374,149,225
050,36,045,"New York","Jefferson County",1,83,330,133,197
050,36,045,"New York","Jefferson County",1,84,315,137,178
050,36,045,"New York","Jefferson County",1,85,1857,628,1229
050,36,045,"New York","Jefferson County",2,0,1829,938,891
050,36,045,"New York","Jefferson County",2,1,1687,859,828
050,36,045,"New York","Jefferson County",2,2,1678,866,812
050,36,045,"New York","Jefferson County",2,3,1729,919,810
050,36,045,"New York","Jefferson County",2,4,1696,877,819
050,36,045,"New York","Jefferson County",2,5,1610,813,797
050,36,045,"New York","Jefferson County",2,6,1576,785,791
050,36,045,"New York","Jefferson County",2,7,1562,809,753
050,36,045,"New York","Jefferson County",2,8,1538,787,751
050,36,045,"New York","Jefferson County",2,9,1522,769,753
050,36,045,"New York","Jefferson County",2,10,1565,790,775
050,36,045,"New York","Jefferson County",2,11,1539,779,760
050,36,045,"New York","Jefferson County",2,12,1503,778,725
050,36,045,"New York","Jefferson County",2,13,1456,754,702
050,36,045,"New York","Jefferson County",2,14,1395,719,676
050,36,045,"New York","Jefferson County",2,15,1336,675,661
050,36,045,"New York","Jefferson County",2,16,1340,663,677
050,36,045,"New York","Jefferson County",2,17,1321,650,671
050,36,045,"New York","Jefferson County",2,18,1343,749,594
050,36,045,"New York","Jefferson County",2,19,1515,948,567
050,36,045,"New York","Jefferson County",2,20,1961,1257,704
050,36,045,"New York","Jefferson County",2,21,2302,1507,795
050,36,045,"New York","Jefferson County",2,22,2330,1481,849
050,36,045,"New York","Jefferson County",2,23,2354,1467,887
050,36,045,"New York","Jefferson County",2,24,2328,1448,880
050,36,045,"New York","Jefferson County",2,25,2213,1350,863
050,36,045,"New York","Jefferson County",2,26,2129,1256,873
050,36,045,"New York","Jefferson County",2,27,2026,1168,858
050,36,045,"New York","Jefferson County",2,28,1949,1125,824
050,36,045,"New York","Jefferson County",2,29,1945,1114,831
050,36,045,"New York","Jefferson County",2,30,1833,1003,830
050,36,045,"New York","Jefferson County",2,31,1699,926,773
050,36,045,"New York","Jefferson County",2,32,1628,897,731
050,36,045,"New York","Jefferson County",2,33,1633,888,745
050,36,045,"New York","Jefferson County",2,34,1652,890,762
050,36,045,"New York","Jefferson County",2,35,1621,854,767
050,36,045,"New York","Jefferson County",2,36,1575,829,746
050,36,045,"New York","Jefferson County",2,37,1557,817,740
050,36,045,"New York","Jefferson County",2,38,1527,822,705
050,36,045,"New York","Jefferson County",2,39,1468,796,672
050,36,045,"New York","Jefferson County",2,40,1383,745,638
050,36,045,"New York","Jefferson County",2,41,1299,682,617
050,36,045,"New York","Jefferson County",2,42,1198,628,570
050,36,045,"New York","Jefferson County",2,43,1140,595,545
050,36,045,"New York","Jefferson County",2,44,1083,566,517
050,36,045,"New York","Jefferson County",2,45,1073,562,511
050,36,045,"New York","Jefferson County",2,46,1054,541,513
050,36,045,"New York","Jefferson County",2,47,1055,507,548
050,36,045,"New York","Jefferson County",2,48,1110,560,550
050,36,045,"New York","Jefferson County",2,49,1232,630,602
050,36,045,"New York","Jefferson County",2,50,1216,611,605
050,36,045,"New York","Jefferson County",2,51,1193,596,597
050,36,045,"New York","Jefferson County",2,52,1183,598,585
050,36,045,"New York","Jefferson County",2,53,1221,609,612
050,36,045,"New York","Jefferson County",2,54,1243,629,614
050,36,045,"New York","Jefferson County",2,55,1315,663,652
050,36,045,"New York","Jefferson County",2,56,1325,647,678
050,36,045,"New York","Jefferson County",2,57,1362,669,693
050,36,045,"New York","Jefferson County",2,58,1362,665,697
050,36,045,"New York","Jefferson County",2,59,1367,671,696
050,36,045,"New York","Jefferson County",2,60,1322,650,672
050,36,045,"New York","Jefferson County",2,61,1313,655,658
050,36,045,"New York","Jefferson County",2,62,1302,630,672
050,36,045,"New York","Jefferson County",2,63,1301,629,672
050,36,045,"New York","Jefferson County",2,64,1211,596,615
050,36,045,"New York","Jefferson County",2,65,1158,558,600
050,36,045,"New York","Jefferson County",2,66,1115,539,576
050,36,045,"New York","Jefferson County",2,67,1089,510,579
050,36,045,"New York","Jefferson County",2,68,1053,502,551
050,36,045,"New York","Jefferson County",2,69,1010,506,504
050,36,045,"New York","Jefferson County",2,70,980,486,494
050,36,045,"New York","Jefferson County",2,71,971,470,501
050,36,045,"New York","Jefferson County",2,72,940,446,494
050,36,045,"New York","Jefferson County",2,73,1011,479,532
050,36,045,"New York","Jefferson County",2,74,697,341,356
050,36,045,"New York","Jefferson County",2,75,669,330,339
050,36,045,"New York","Jefferson County",2,76,659,315,344
050,36,045,"New York","Jefferson County",2,77,674,316,358
050,36,045,"New York","Jefferson County",2,78,581,268,313
050,36,045,"New York","Jefferson County",2,79,478,226,252
050,36,045,"New York","Jefferson County",2,80,401,189,212
050,36,045,"New York","Jefferson County",2,81,372,173,199
050,36,045,"New York","Jefferson County",2,82,372,149,223
050,36,045,"New York","Jefferson County",2,83,328,131,197
050,36,045,"New York","Jefferson County",2,84,308,132,176
050,36,045,"New York","Jefferson County",2,85,1870,643,1227
050,36,045,"New York","Jefferson County",3,0,1722,897,825
050,36,045,"New York","Jefferson County",3,1,1792,916,876
050,36,045,"New York","Jefferson County",3,2,1649,825,824
050,36,045,"New York","Jefferson County",3,3,1660,867,793
050,36,045,"New York","Jefferson County",3,4,1704,889,815
050,36,045,"New York","Jefferson County",3,5,1703,898,805
050,36,045,"New York","Jefferson County",3,6,1554,789,765
050,36,045,"New York","Jefferson County",3,7,1576,794,782
050,36,045,"New York","Jefferson County",3,8,1514,786,728
050,36,045,"New York","Jefferson County",3,9,1507,783,724
050,36,045,"New York","Jefferson County",3,10,1521,767,754
050,36,045,"New York","Jefferson County",3,11,1530,761,769
050,36,045,"New York","Jefferson County",3,12,1516,750,766
050,36,045,"New York","Jefferson County",3,13,1469,760,709
050,36,045,"New York","Jefferson County",3,14,1442,755,687
050,36,045,"New York","Jefferson County",3,15,1375,722,653
050,36,045,"New York","Jefferson County",3,16,1311,665,646
050,36,045,"New York","Jefferson County",3,17,1343,671,672
050,36,045,"New York","Jefferson County",3,18,1341,733,608
050,36,045,"New York","Jefferson County",3,19,1555,982,573
050,36,045,"New York","Jefferson County",3,20,2125,1401,724
050,36,045,"New York","Jefferson County",3,21,2424,1593,831
050,36,045,"New York","Jefferson County",3,22,2358,1510,848
050,36,045,"New York","Jefferson County",3,23,2448,1530,918
050,36,045,"New York","Jefferson County",3,24,2426,1532,894
050,36,045,"New York","Jefferson County",3,25,2223,1352,871
050,36,045,"New York","Jefferson County",3,26,2121,1291,830
050,36,045,"New York","Jefferson County",3,27,2110,1233,877
050,36,045,"New York","Jefferson County",3,28,2018,1138,880
050,36,045,"New York","Jefferson County",3,29,1879,1075,804
050,36,045,"New York","Jefferson County",3,30,1832,1018,814
050,36,045,"New York","Jefferson County",3,31,1792,981,811
050,36,045,"New York","Jefferson County",3,32,1676,904,772
050,36,045,"New York","Jefferson County",3,33,1606,868,738
050,36,045,"New York","Jefferson County",3,34,1635,893,742
050,36,045,"New York","Jefferson County",3,35,1648,886,762
050,36,045,"New York","Jefferson County",3,36,1622,856,766
050,36,045,"New York","Jefferson County",3,37,1538,794,744
050,36,045,"New York","Jefferson County",3,38,1529,797,732
050,36,045,"New York","Jefferson County",3,39,1495,809,686
050,36,045,"New York","Jefferson County",3,40,1405,754,651
050,36,045,"New York","Jefferson County",3,41,1358,727,631
050,36,045,"New York","Jefferson County",3,42,1242,648,594
050,36,045,"New York","Jefferson County",3,43,1158,607,551
050,36,045,"New York","Jefferson County",3,44,1148,604,544
050,36,045,"New York","Jefferson County",3,45,1045,529,516
050,36,045,"New York","Jefferson County",3,46,1066,565,501
050,36,045,"New York","Jefferson County",3,47,999,499,500
050,36,045,"New York","Jefferson County",3,48,1029,497,532
050,36,045,"New York","Jefferson County",3,49,1106,553,553
050,36,045,"New York","Jefferson County",3,50,1193,605,588
050,36,045,"New York","Jefferson County",3,51,1195,588,607
050,36,045,"New York","Jefferson County",3,52,1166,583,583
050,36,045,"New York","Jefferson County",3,53,1160,583,577
050,36,045,"New York","Jefferson County",3,54,1205,590,615
050,36,045,"New York","Jefferson County",3,55,1231,616,615
050,36,045,"New York","Jefferson County",3,56,1292,653,639
050,36,045,"New York","Jefferson County",3,57,1321,643,678
050,36,045,"New York","Jefferson County",3,58,1336,660,676
050,36,045,"New York","Jefferson County",3,59,1337,650,687
050,36,045,"New York","Jefferson County",3,60,1362,643,719
050,36,045,"New York","Jefferson County",3,61,1330,668,662
050,36,045,"New York","Jefferson County",3,62,1265,625,640
050,36,045,"New York","Jefferson County",3,63,1294,619,675
050,36,045,"New York","Jefferson County",3,64,1255,602,653
050,36,045,"New York","Jefferson County",3,65,1202,586,616
050,36,045,"New York","Jefferson County",3,66,1143,551,592
050,36,045,"New York","Jefferson County",3,67,1112,524,588
050,36,045,"New York","Jefferson County",3,68,1064,499,565
050,36,045,"New York","Jefferson County",3,69,1026,491,535
050,36,045,"New York","Jefferson County",3,70,981,492,489
050,36,045,"New York","Jefferson County",3,71,949,475,474
050,36,045,"New York","Jefferson County",3,72,940,458,482
050,36,045,"New York","Jefferson County",3,73,909,434,475
050,36,045,"New York","Jefferson County",3,74,975,463,512
050,36,045,"New York","Jefferson County",3,75,671,328,343
050,36,045,"New York","Jefferson County",3,76,646,318,328
050,36,045,"New York","Jefferson County",3,77,641,306,335
050,36,045,"New York","Jefferson County",3,78,636,292,344
050,36,045,"New York","Jefferson County",3,79,544,242,302
050,36,045,"New York","Jefferson County",3,80,472,223,249
050,36,045,"New York","Jefferson County",3,81,371,178,193
050,36,045,"New York","Jefferson County",3,82,358,154,204
050,36,045,"New York","Jefferson County",3,83,346,136,210
050,36,045,"New York","Jefferson County",3,84,298,124,174
050,36,045,"New York","Jefferson County",3,85,1831,638,1193
050,36,045,"New York","Jefferson County",4,0,1840,987,853
050,36,045,"New York","Jefferson County",4,1,1658,895,763
050,36,045,"New York","Jefferson County",4,2,1704,869,835
050,36,045,"New York","Jefferson County",4,3,1603,827,776
050,36,045,"New York","Jefferson County",4,4,1614,824,790
050,36,045,"New York","Jefferson County",4,5,1645,868,777
050,36,045,"New York","Jefferson County",4,6,1655,882,773
050,36,045,"New York","Jefferson County",4,7,1551,787,764
050,36,045,"New York","Jefferson County",4,8,1510,768,742
050,36,045,"New York","Jefferson County",4,9,1466,775,691
050,36,045,"New York","Jefferson County",4,10,1471,757,714
050,36,045,"New York","Jefferson County",4,11,1477,758,719
050,36,045,"New York","Jefferson County",4,12,1502,743,759
050,36,045,"New York","Jefferson County",4,13,1451,730,721
050,36,045,"New York","Jefferson County",4,14,1441,733,708
050,36,045,"New York","Jefferson County",4,15,1377,717,660
050,36,045,"New York","Jefferson County",4,16,1343,721,622
050,36,045,"New York","Jefferson County",4,17,1279,651,628
050,36,045,"New York","Jefferson County",4,18,1336,729,607
050,36,045,"New York","Jefferson County",4,19,1464,906,558
050,36,045,"New York","Jefferson County",4,20,1947,1273,674
050,36,045,"New York","Jefferson County",4,21,2362,1544,818
050,36,045,"New York","Jefferson County",4,22,2286,1411,875
050,36,045,"New York","Jefferson County",4,23,2246,1376,870
050,36,045,"New York","Jefferson County",4,24,2263,1394,869
050,36,045,"New York","Jefferson County",4,25,2134,1295,839
050,36,045,"New York","Jefferson County",4,26,2080,1218,862
050,36,045,"New York","Jefferson County",4,27,2019,1180,839
050,36,045,"New York","Jefferson County",4,28,1979,1141,838
050,36,045,"New York","Jefferson County",4,29,1966,1107,859
050,36,045,"New York","Jefferson County",4,30,1806,1034,772
050,36,045,"New York","Jefferson County",4,31,1831,1024,807
050,36,045,"New York","Jefferson County",4,32,1723,926,797
050,36,045,"New York","Jefferson County",4,33,1609,838,771
050,36,045,"New York","Jefferson County",4,34,1577,841,736
050,36,045,"New York","Jefferson County",4,35,1635,896,739
050,36,045,"New York","Jefferson County",4,36,1571,843,728
050,36,045,"New York","Jefferson County",4,37,1542,795,747
050,36,045,"New York","Jefferson County",4,38,1516,781,735
050,36,045,"New York","Jefferson County",4,39,1465,760,705
050,36,045,"New York","Jefferson County",4,40,1426,764,662
050,36,045,"New York","Jefferson County",4,41,1358,714,644
050,36,045,"New York","Jefferson County",4,42,1301,692,609
050,36,045,"New York","Jefferson County",4,43,1191,634,557
050,36,045,"New York","Jefferson County",4,44,1153,610,543
050,36,045,"New York","Jefferson County",4,45,1075,547,528
050,36,045,"New York","Jefferson County",4,46,1041,531,510
050,36,045,"New York","Jefferson County",4,47,1032,523,509
050,36,045,"New York","Jefferson County",4,48,979,504,475
050,36,045,"New York","Jefferson County",4,49,1010,483,527
050,36,045,"New York","Jefferson County",4,50,1071,534,537
050,36,045,"New York","Jefferson County",4,51,1182,588,594
050,36,045,"New York","Jefferson County",4,52,1168,580,588
050,36,045,"New York","Jefferson County",4,53,1126,570,556
050,36,045,"New York","Jefferson County",4,54,1133,571,562
050,36,045,"New York","Jefferson County",4,55,1186,579,607
050,36,045,"New York","Jefferson County",4,56,1200,604,596
050,36,045,"New York","Jefferson County",4,57,1282,641,641
050,36,045,"New York","Jefferson County",4,58,1279,622,657
050,36,045,"New York","Jefferson County",4,59,1303,640,663
050,36,045,"New York","Jefferson County",4,60,1330,640,690
050,36,045,"New York","Jefferson County",4,61,1327,637,690
050,36,045,"New York","Jefferson County",4,62,1294,648,646
050,36,045,"New York","Jefferson County",4,63,1253,626,627
050,36,045,"New York","Jefferson County",4,64,1266,608,658
050,36,045,"New York","Jefferson County",4,65,1239,588,651
050,36,045,"New York","Jefferson County",4,66,1202,577,625
050,36,045,"New York","Jefferson County",4,67,1145,542,603
050,36,045,"New York","Jefferson County",4,68,1095,516,579
050,36,045,"New York","Jefferson County",4,69,1039,491,548
050,36,045,"New York","Jefferson County",4,70,1004,474,530
050,36,045,"New York","Jefferson County",4,71,945,475,470
050,36,045,"New York","Jefferson County",4,72,931,463,468
050,36,045,"New York","Jefferson County",4,73,917,450,467
050,36,045,"New York","Jefferson County",4,74,877,417,460
050,36,045,"New York","Jefferson County",4,75,935,447,488
050,36,045,"New York","Jefferson County",4,76,658,326,332
050,36,045,"New York","Jefferson County",4,77,632,305,327
050,36,045,"New York","Jefferson County",4,78,618,292,326
050,36,045,"New York","Jefferson County",4,79,596,260,336
050,36,045,"New York","Jefferson County",4,80,523,231,292
050,36,045,"New York","Jefferson County",4,81,439,216,223
050,36,045,"New York","Jefferson County",4,82,354,160,194
050,36,045,"New York","Jefferson County",4,83,330,148,182
050,36,045,"New York","Jefferson County",4,84,304,128,176
050,36,045,"New York","Jefferson County",4,85,1768,617,1151
050,36,045,"New York","Jefferson County",5,0,1850,992,858
050,36,045,"New York","Jefferson County",5,1,1708,876,832
050,36,045,"New York","Jefferson County",5,2,1636,883,753
050,36,045,"New York","Jefferson County",5,3,1648,830,818
050,36,045,"New York","Jefferson County",5,4,1524,775,749
050,36,045,"New York","Jefferson County",5,5,1553,783,770
050,36,045,"New York","Jefferson County",5,6,1607,850,757
050,36,045,"New York","Jefferson County",5,7,1615,874,741
050,36,045,"New York","Jefferson County",5,8,1535,777,758
050,36,045,"New York","Jefferson County",5,9,1478,745,733
050,36,045,"New York","Jefferson County",5,10,1457,773,684
050,36,045,"New York","Jefferson County",5,11,1411,721,690
050,36,045,"New York","Jefferson County",5,12,1465,751,714
050,36,045,"New York","Jefferson County",5,13,1474,732,742
050,36,045,"New York","Jefferson County",5,14,1414,699,715
050,36,045,"New York","Jefferson County",5,15,1411,733,678
050,36,045,"New York","Jefferson County",5,16,1378,714,664
050,36,045,"New York","Jefferson County",5,17,1343,720,623
050,36,045,"New York","Jefferson County",5,18,1316,745,571
050,36,045,"New York","Jefferson County",5,19,1398,865,533
050,36,045,"New York","Jefferson County",5,20,1850,1197,653
050,36,045,"New York","Jefferson County",5,21,2250,1471,779
050,36,045,"New York","Jefferson County",5,22,2277,1461,816
050,36,045,"New York","Jefferson County",5,23,2199,1334,865
050,36,045,"New York","Jefferson County",5,24,2240,1366,874
050,36,045,"New York","Jefferson County",5,25,2105,1256,849
050,36,045,"New York","Jefferson County",5,26,1985,1168,817
050,36,045,"New York","Jefferson County",5,27,1989,1159,830
050,36,045,"New York","Jefferson County",5,28,1893,1074,819
050,36,045,"New York","Jefferson County",5,29,1883,1074,809
050,36,045,"New York","Jefferson County",5,30,1875,1045,830
050,36,045,"New York","Jefferson County",5,31,1813,1044,769
050,36,045,"New York","Jefferson County",5,32,1805,989,816
050,36,045,"New York","Jefferson County",5,33,1728,918,810
050,36,045,"New York","Jefferson County",5,34,1583,819,764
050,36,045,"New York","Jefferson County",5,35,1557,832,725
050,36,045,"New York","Jefferson County",5,36,1599,873,726
050,36,045,"New York","Jefferson County",5,37,1502,795,707
050,36,045,"New York","Jefferson County",5,38,1513,779,734
050,36,045,"New York","Jefferson County",5,39,1463,771,692
050,36,045,"New York","Jefferson County",5,40,1422,738,684
050,36,045,"New York","Jefferson County",5,41,1374,742,632
050,36,045,"New York","Jefferson County",5,42,1311,683,628
050,36,045,"New York","Jefferson County",5,43,1264,681,583
050,36,045,"New York","Jefferson County",5,44,1164,623,541
050,36,045,"New York","Jefferson County",5,45,1099,575,524
050,36,045,"New York","Jefferson County",5,46,1061,542,519
050,36,045,"New York","Jefferson County",5,47,987,485,502
050,36,045,"New York","Jefferson County",5,48,1000,520,480
050,36,045,"New York","Jefferson County",5,49,964,499,465
050,36,045,"New York","Jefferson County",5,50,988,470,518
050,36,045,"New York","Jefferson County",5,51,1073,531,542
050,36,045,"New York","Jefferson County",5,52,1127,562,565
050,36,045,"New York","Jefferson County",5,53,1152,577,575
050,36,045,"New York","Jefferson County",5,54,1109,552,557
050,36,045,"New York","Jefferson County",5,55,1124,565,559
050,36,045,"New York","Jefferson County",5,56,1170,574,596
050,36,045,"New York","Jefferson County",5,57,1197,602,595
050,36,045,"New York","Jefferson County",5,58,1270,637,633
050,36,045,"New York","Jefferson County",5,59,1261,615,646
050,36,045,"New York","Jefferson County",5,60,1274,615,659
050,36,045,"New York","Jefferson County",5,61,1317,643,674
050,36,045,"New York","Jefferson County",5,62,1303,629,674
050,36,045,"New York","Jefferson County",5,63,1271,641,630
050,36,045,"New York","Jefferson County",5,64,1232,614,618
050,36,045,"New York","Jefferson County",5,65,1256,592,664
050,36,045,"New York","Jefferson County",5,66,1230,588,642
050,36,045,"New York","Jefferson County",5,67,1184,563,621
050,36,045,"New York","Jefferson County",5,68,1116,525,591
050,36,045,"New York","Jefferson County",5,69,1065,506,559
050,36,045,"New York","Jefferson County",5,70,1009,475,534
050,36,045,"New York","Jefferson County",5,71,963,450,513
050,36,045,"New York","Jefferson County",5,72,911,455,456
050,36,045,"New York","Jefferson County",5,73,918,457,461
050,36,045,"New York","Jefferson County",5,74,891,432,459
050,36,045,"New York","Jefferson County",5,75,842,396,446
050,36,045,"New York","Jefferson County",5,76,905,432,473
050,36,045,"New York","Jefferson County",5,77,642,314,328
050,36,045,"New York","Jefferson County",5,78,595,287,308
050,36,045,"New York","Jefferson County",5,79,572,257,315
050,36,045,"New York","Jefferson County",5,80,571,246,325
050,36,045,"New York","Jefferson County",5,81,495,220,275
050,36,045,"New York","Jefferson County",5,82,414,194,220
050,36,045,"New York","Jefferson County",5,83,329,149,180
050,36,045,"New York","Jefferson County",5,84,291,138,153
050,36,045,"New York","Jefferson County",5,85,1744,612,1132
050,36,047,"New York","Kings County",1,0,40319,20552,19767
050,36,047,"New York","Kings County",1,1,38780,19564,19216
050,36,047,"New York","Kings County",1,2,38203,19576,18627
050,36,047,"New York","Kings County",1,3,37820,19369,18451
050,36,047,"New York","Kings County",1,4,37209,19129,18080
050,36,047,"New York","Kings County",1,5,36416,18842,17574
050,36,047,"New York","Kings County",1,6,35395,18066,17329
050,36,047,"New York","Kings County",1,7,35269,18047,17222
050,36,047,"New York","Kings County",1,8,34893,17887,17006
050,36,047,"New York","Kings County",1,9,34236,17752,16484
050,36,047,"New York","Kings County",1,10,32665,17012,15653
050,36,047,"New York","Kings County",1,11,32814,16832,15982
050,36,047,"New York","Kings County",1,12,33219,17000,16219
050,36,047,"New York","Kings County",1,13,32659,16769,15890
050,36,047,"New York","Kings County",1,14,31990,16215,15775
050,36,047,"New York","Kings County",1,15,31422,16039,15383
050,36,047,"New York","Kings County",1,16,31436,16086,15350
050,36,047,"New York","Kings County",1,17,30971,15638,15333
050,36,047,"New York","Kings County",1,18,27216,13915,13301
050,36,047,"New York","Kings County",1,19,24938,12597,12341
050,36,047,"New York","Kings County",1,20,26048,13097,12951
050,36,047,"New York","Kings County",1,21,27473,13487,13986
050,36,047,"New York","Kings County",1,22,30285,14452,15833
050,36,047,"New York","Kings County",1,23,35275,16500,18775
050,36,047,"New York","Kings County",1,24,40120,18553,21567
050,36,047,"New York","Kings County",1,25,43468,20190,23278
050,36,047,"New York","Kings County",1,26,46247,21729,24518
050,36,047,"New York","Kings County",1,27,48490,23006,25484
050,36,047,"New York","Kings County",1,28,50781,24147,26634
050,36,047,"New York","Kings County",1,29,53267,25823,27444
050,36,047,"New York","Kings County",1,30,53718,26272,27446
050,36,047,"New York","Kings County",1,31,52376,25768,26608
050,36,047,"New York","Kings County",1,32,50560,24740,25820
050,36,047,"New York","Kings County",1,33,48587,23734,24853
050,36,047,"New York","Kings County",1,34,47304,23359,23945
050,36,047,"New York","Kings County",1,35,45388,22217,23171
050,36,047,"New York","Kings County",1,36,43398,21246,22152
050,36,047,"New York","Kings County",1,37,42627,20853,21774
050,36,047,"New York","Kings County",1,38,40913,19954,20959
050,36,047,"New York","Kings County",1,39,39440,19210,20230
050,36,047,"New York","Kings County",1,40,38514,18929,19585
050,36,047,"New York","Kings County",1,41,36292,17592,18700
050,36,047,"New York","Kings County",1,42,35088,16877,18211
050,36,047,"New York","Kings County",1,43,33826,16239,17587
050,36,047,"New York","Kings County",1,44,33433,15887,17546
050,36,047,"New York","Kings County",1,45,33200,15762,17438
050,36,047,"New York","Kings County",1,46,31506,14899,16607
050,36,047,"New York","Kings County",1,47,31655,14992,16663
050,36,047,"New York","Kings County",1,48,32181,15218,16963
050,36,047,"New York","Kings County",1,49,33591,15898,17693
050,36,047,"New York","Kings County",1,50,32702,15570,17132
050,36,047,"New York","Kings County",1,51,31178,14691,16487
050,36,047,"New York","Kings County",1,52,30371,14197,16174
050,36,047,"New York","Kings County",1,53,30142,14015,16127
050,36,047,"New York","Kings County",1,54,30838,14375,16463
050,36,047,"New York","Kings County",1,55,32154,15098,17056
050,36,047,"New York","Kings County",1,56,31927,14880,17047
050,36,047,"New York","Kings County",1,57,31579,14684,16895
050,36,047,"New York","Kings County",1,58,31004,14364,16640
050,36,047,"New York","Kings County",1,59,31030,14221,16809
050,36,047,"New York","Kings County",1,60,31320,14424,16896
050,36,047,"New York","Kings County",1,61,30580,14087,16493
050,36,047,"New York","Kings County",1,62,30159,13906,16253
050,36,047,"New York","Kings County",1,63,29071,13190,15881
050,36,047,"New York","Kings County",1,64,28431,12890,15541
050,36,047,"New York","Kings County",1,65,27854,12494,15360
050,36,047,"New York","Kings County",1,66,25993,11609,14384
050,36,047,"New York","Kings County",1,67,25022,11138,13884
050,36,047,"New York","Kings County",1,68,24456,10897,13559
050,36,047,"New York","Kings County",1,69,23330,10328,13002
050,36,047,"New York","Kings County",1,70,23340,10337,13003
050,36,047,"New York","Kings County",1,71,22021,9714,12307
050,36,047,"New York","Kings County",1,72,21457,9389,12068
050,36,047,"New York","Kings County",1,73,20619,8950,11669
050,36,047,"New York","Kings County",1,74,15510,6477,9033
050,36,047,"New York","Kings County",1,75,14886,6205,8681
050,36,047,"New York","Kings County",1,76,13447,5662,7785
050,36,047,"New York","Kings County",1,77,12813,5184,7629
050,36,047,"New York","Kings County",1,78,11891,4723,7168
050,36,047,"New York","Kings County",1,79,11126,4377,6749
050,36,047,"New York","Kings County",1,80,10906,4257,6649
050,36,047,"New York","Kings County",1,81,10368,4067,6301
050,36,047,"New York","Kings County",1,82,9669,3776,5893
050,36,047,"New York","Kings County",1,83,8539,3346,5193
050,36,047,"New York","Kings County",1,84,7924,2988,4936
050,36,047,"New York","Kings County",1,85,49541,16770,32771
050,36,047,"New York","Kings County",2,0,38390,19505,18885
050,36,047,"New York","Kings County",2,1,38557,19484,19073
050,36,047,"New York","Kings County",2,2,37950,19360,18590
050,36,047,"New York","Kings County",2,3,37424,19146,18278
050,36,047,"New York","Kings County",2,4,37021,19001,18020
050,36,047,"New York","Kings County",2,5,36330,18779,17551
050,36,047,"New York","Kings County",2,6,35428,18158,17270
050,36,047,"New York","Kings County",2,7,34998,17907,17091
050,36,047,"New York","Kings County",2,8,34630,17745,16885
050,36,047,"New York","Kings County",2,9,34130,17656,16474
050,36,047,"New York","Kings County",2,10,32834,17094,15740
050,36,047,"New York","Kings County",2,11,32462,16712,15750
050,36,047,"New York","Kings County",2,12,33079,16931,16148
050,36,047,"New York","Kings County",2,13,32583,16735,15848
050,36,047,"New York","Kings County",2,14,31955,16236,15719
050,36,047,"New York","Kings County",2,15,31416,16014,15402
050,36,047,"New York","Kings County",2,16,31332,16011,15321
050,36,047,"New York","Kings County",2,17,30876,15618,15258
050,36,047,"New York","Kings County",2,18,26904,13791,13113
050,36,047,"New York","Kings County",2,19,24423,12395,12028
050,36,047,"New York","Kings County",2,20,26029,13092,12937
050,36,047,"New York","Kings County",2,21,27174,13362,13812
050,36,047,"New York","Kings County",2,22,30271,14416,15855
050,36,047,"New York","Kings County",2,23,34850,16303,18547
050,36,047,"New York","Kings County",2,24,39360,18221,21139
050,36,047,"New York","Kings County",2,25,43016,19966,23050
050,36,047,"New York","Kings County",2,26,45866,21505,24361
050,36,047,"New York","Kings County",2,27,47970,22727,25243
050,36,047,"New York","Kings County",2,28,50234,23909,26325
050,36,047,"New York","Kings County",2,29,52476,25330,27146
050,36,047,"New York","Kings County",2,30,53569,26167,27402
050,36,047,"New York","Kings County",2,31,52155,25625,26530
050,36,047,"New York","Kings County",2,32,50493,24732,25761
050,36,047,"New York","Kings County",2,33,48607,23747,24860
050,36,047,"New York","Kings County",2,34,47149,23220,23929
050,36,047,"New York","Kings County",2,35,45622,22372,23250
050,36,047,"New York","Kings County",2,36,43241,21161,22080
050,36,047,"New York","Kings County",2,37,42445,20741,21704
050,36,047,"New York","Kings County",2,38,41123,20037,21086
050,36,047,"New York","Kings County",2,39,39267,19120,20147
050,36,047,"New York","Kings County",2,40,38630,18929,19701
050,36,047,"New York","Kings County",2,41,36443,17682,18761
050,36,047,"New York","Kings County",2,42,34920,16818,18102
050,36,047,"New York","Kings County",2,43,34065,16346,17719
050,36,047,"New York","Kings County",2,44,33041,15725,17316
050,36,047,"New York","Kings County",2,45,33140,15701,17439
050,36,047,"New York","Kings County",2,46,31628,14970,16658
050,36,047,"New York","Kings County",2,47,31355,14833,16522
050,36,047,"New York","Kings County",2,48,31896,15081,16815
050,36,047,"New York","Kings County",2,49,33105,15635,17470
050,36,047,"New York","Kings County",2,50,32745,15554,17191
050,36,047,"New York","Kings County",2,51,31148,14687,16461
050,36,047,"New York","Kings County",2,52,30398,14214,16184
050,36,047,"New York","Kings County",2,53,29862,13880,15982
050,36,047,"New York","Kings County",2,54,30460,14180,16280
050,36,047,"New York","Kings County",2,55,31629,14804,16825
050,36,047,"New York","Kings County",2,56,31831,14836,16995
050,36,047,"New York","Kings County",2,57,31446,14609,16837
050,36,047,"New York","Kings County",2,58,30898,14315,16583
050,36,047,"New York","Kings County",2,59,30727,14076,16651
050,36,047,"New York","Kings County",2,60,31072,14272,16800
050,36,047,"New York","Kings County",2,61,30429,13986,16443
050,36,047,"New York","Kings County",2,62,29892,13773,16119
050,36,047,"New York","Kings County",2,63,29166,13246,15920
050,36,047,"New York","Kings County",2,64,28176,12746,15430
050,36,047,"New York","Kings County",2,65,27621,12396,15225
050,36,047,"New York","Kings County",2,66,26199,11681,14518
050,36,047,"New York","Kings County",2,67,24812,11015,13797
050,36,047,"New York","Kings County",2,68,24104,10715,13389
050,36,047,"New York","Kings County",2,69,23341,10293,13048
050,36,047,"New York","Kings County",2,70,23022,10176,12846
050,36,047,"New York","Kings County",2,71,21940,9636,12304
050,36,047,"New York","Kings County",2,72,21063,9185,11878
050,36,047,"New York","Kings County",2,73,21101,9131,11970
050,36,047,"New York","Kings County",2,74,15729,6590,9139
050,36,047,"New York","Kings County",2,75,14793,6148,8645
050,36,047,"New York","Kings County",2,76,13410,5580,7830
050,36,047,"New York","Kings County",2,77,12813,5191,7622
050,36,047,"New York","Kings County",2,78,11700,4644,7056
050,36,047,"New York","Kings County",2,79,10939,4273,6666
050,36,047,"New York","Kings County",2,80,10654,4120,6534
050,36,047,"New York","Kings County",2,81,10110,3944,6166
050,36,047,"New York","Kings County",2,82,9521,3667,5854
050,36,047,"New York","Kings County",2,83,8466,3289,5177
050,36,047,"New York","Kings County",2,84,7717,2887,4830
050,36,047,"New York","Kings County",2,85,47651,16070,31581
050,36,047,"New York","Kings County",3,0,33732,17313,16419
050,36,047,"New York","Kings County",3,1,35010,17754,17256
050,36,047,"New York","Kings County",3,2,35570,18016,17554
050,36,047,"New York","Kings County",3,3,35355,17986,17369
050,36,047,"New York","Kings County",3,4,35191,18048,17143
050,36,047,"New York","Kings County",3,5,34896,17994,16902
050,36,047,"New York","Kings County",3,6,34593,17825,16768
050,36,047,"New York","Kings County",3,7,33576,17187,16389
050,36,047,"New York","Kings County",3,8,33496,17102,16394
050,36,047,"New York","Kings County",3,9,33166,16943,16223
050,36,047,"New York","Kings County",3,10,32848,16988,15860
050,36,047,"New York","Kings County",3,11,31708,16472,15236
050,36,047,"New York","Kings County",3,12,31493,16236,15257
050,36,047,"New York","Kings County",3,13,32021,16374,15647
050,36,047,"New York","Kings County",3,14,31692,16285,15407
050,36,047,"New York","Kings County",3,15,31076,15802,15274
050,36,047,"New York","Kings County",3,16,30678,15579,15099
050,36,047,"New York","Kings County",3,17,30542,15565,14977
050,36,047,"New York","Kings County",3,18,26692,13710,12982
050,36,047,"New York","Kings County",3,19,23575,11969,11606
050,36,047,"New York","Kings County",3,20,25534,12858,12676
050,36,047,"New York","Kings County",3,21,26750,13341,13409
050,36,047,"New York","Kings County",3,22,28413,13719,14694
050,36,047,"New York","Kings County",3,23,31840,14996,16844
050,36,047,"New York","Kings County",3,24,35748,16773,18975
050,36,047,"New York","Kings County",3,25,39008,18173,20835
050,36,047,"New York","Kings County",3,26,42437,19762,22675
050,36,047,"New York","Kings County",3,27,44355,20851,23504
050,36,047,"New York","Kings County",3,28,45874,21882,23992
050,36,047,"New York","Kings County",3,29,47694,22943,24751
050,36,047,"New York","Kings County",3,30,49480,24007,25473
050,36,047,"New York","Kings County",3,31,50170,24576,25594
050,36,047,"New York","Kings County",3,32,48629,23985,24644
050,36,047,"New York","Kings County",3,33,47160,23080,24080
050,36,047,"New York","Kings County",3,34,45061,22084,22977
050,36,047,"New York","Kings County",3,35,43770,21575,22195
050,36,047,"New York","Kings County",3,36,42322,20744,21578
050,36,047,"New York","Kings County",3,37,40138,19578,20560
050,36,047,"New York","Kings County",3,38,39590,19281,20309
050,36,047,"New York","Kings County",3,39,38424,18671,19753
050,36,047,"New York","Kings County",3,40,36845,17888,18957
050,36,047,"New York","Kings County",3,41,36290,17721,18569
050,36,047,"New York","Kings County",3,42,34698,16741,17957
050,36,047,"New York","Kings County",3,43,33188,15928,17260
050,36,047,"New York","Kings County",3,44,32655,15586,17069
050,36,047,"New York","Kings County",3,45,31529,14885,16644
050,36,047,"New York","Kings County",3,46,31790,15007,16783
050,36,047,"New York","Kings County",3,47,30549,14432,16117
050,36,047,"New York","Kings County",3,48,30173,14239,15934
050,36,047,"New York","Kings County",3,49,30959,14540,16419
050,36,047,"New York","Kings County",3,50,32169,15163,17006
050,36,047,"New York","Kings County",3,51,31881,15070,16811
050,36,047,"New York","Kings County",3,52,30288,14243,16045
050,36,047,"New York","Kings County",3,53,29578,13765,15813
050,36,047,"New York","Kings County",3,54,29203,13567,15636
050,36,047,"New York","Kings County",3,55,29710,13818,15892
050,36,047,"New York","Kings County",3,56,30840,14420,16420
050,36,047,"New York","Kings County",3,57,31084,14458,16626
050,36,047,"New York","Kings County",3,58,30758,14241,16517
050,36,047,"New York","Kings County",3,59,30173,13930,16243
050,36,047,"New York","Kings County",3,60,29933,13713,16220
050,36,047,"New York","Kings County",3,61,30344,13848,16496
050,36,047,"New York","Kings County",3,62,29669,13626,16043
050,36,047,"New York","Kings County",3,63,28946,13306,15640
050,36,047,"New York","Kings County",3,64,28345,12834,15511
050,36,047,"New York","Kings County",3,65,27286,12330,14956
050,36,047,"New York","Kings County",3,66,26935,12073,14862
050,36,047,"New York","Kings County",3,67,25463,11286,14177
050,36,047,"New York","Kings County",3,68,24135,10712,13423
050,36,047,"New York","Kings County",3,69,23471,10400,13071
050,36,047,"New York","Kings County",3,70,22700,10010,12690
050,36,047,"New York","Kings County",3,71,22403,9845,12558
050,36,047,"New York","Kings County",3,72,21324,9296,12028
050,36,047,"New York","Kings County",3,73,20391,8904,11487
050,36,047,"New York","Kings County",3,74,20415,8781,11634
050,36,047,"New York","Kings County",3,75,15202,6366,8836
050,36,047,"New York","Kings County",3,76,14366,5943,8423
050,36,047,"New York","Kings County",3,77,12922,5310,7612
050,36,047,"New York","Kings County",3,78,12305,4945,7360
050,36,047,"New York","Kings County",3,79,11191,4392,6799
050,36,047,"New York","Kings County",3,80,10442,4056,6386
050,36,047,"New York","Kings County",3,81,10161,3878,6283
050,36,047,"New York","Kings County",3,82,9578,3690,5888
050,36,047,"New York","Kings County",3,83,8964,3384,5580
050,36,047,"New York","Kings County",3,84,7951,3077,4874
050,36,047,"New York","Kings County",3,85,49013,16658,32355
050,36,047,"New York","Kings County",4,0,33196,16995,16201
050,36,047,"New York","Kings County",4,1,31531,16174,15357
050,36,047,"New York","Kings County",4,2,32770,16635,16135
050,36,047,"New York","Kings County",4,3,33647,17006,16641
050,36,047,"New York","Kings County",4,4,33556,17089,16467
050,36,047,"New York","Kings County",4,5,33314,17109,16205
050,36,047,"New York","Kings County",4,6,33164,17127,16037
050,36,047,"New York","Kings County",4,7,32883,16968,15915
050,36,047,"New York","Kings County",4,8,32055,16332,15723
050,36,047,"New York","Kings County",4,9,32086,16352,15734
050,36,047,"New York","Kings County",4,10,31731,16206,15525
050,36,047,"New York","Kings County",4,11,31675,16337,15338
050,36,047,"New York","Kings County",4,12,30744,15929,14815
050,36,047,"New York","Kings County",4,13,30533,15741,14792
050,36,047,"New York","Kings County",4,14,31071,15906,15165
050,36,047,"New York","Kings County",4,15,30843,15833,15010
050,36,047,"New York","Kings County",4,16,30218,15317,14901
050,36,047,"New York","Kings County",4,17,29993,15139,14854
050,36,047,"New York","Kings County",4,18,26510,13659,12851
050,36,047,"New York","Kings County",4,19,23244,11822,11422
050,36,047,"New York","Kings County",4,20,24664,12405,12259
050,36,047,"New York","Kings County",4,21,26575,13177,13398
050,36,047,"New York","Kings County",4,22,28450,13870,14580
050,36,047,"New York","Kings County",4,23,31429,14890,16539
050,36,047,"New York","Kings County",4,24,34725,16228,18497
050,36,047,"New York","Kings County",4,25,37884,17740,20144
050,36,047,"New York","Kings County",4,26,40735,19019,21716
050,36,047,"New York","Kings County",4,27,43195,20279,22916
050,36,047,"New York","Kings County",4,28,44696,21139,23557
050,36,047,"New York","Kings County",4,29,45739,21853,23886
050,36,047,"New York","Kings County",4,30,47048,22756,24292
050,36,047,"New York","Kings County",4,31,48211,23525,24686
050,36,047,"New York","Kings County",4,32,48655,23962,24693
050,36,047,"New York","Kings County",4,33,46546,22993,23553
050,36,047,"New York","Kings County",4,34,45037,22097,22940
050,36,047,"New York","Kings County",4,35,42845,20986,21859
050,36,047,"New York","Kings County",4,36,41622,20628,20994
050,36,047,"New York","Kings County",4,37,40273,19686,20587
050,36,047,"New York","Kings County",4,38,38093,18635,19458
050,36,047,"New York","Kings County",4,39,37548,18318,19230
050,36,047,"New York","Kings County",4,40,36571,17763,18808
050,36,047,"New York","Kings County",4,41,35055,16975,18080
050,36,047,"New York","Kings County",4,42,34526,16794,17732
050,36,047,"New York","Kings County",4,43,33124,15933,17191
050,36,047,"New York","Kings County",4,44,31879,15285,16594
050,36,047,"New York","Kings County",4,45,31442,14893,16549
050,36,047,"New York","Kings County",4,46,30278,14272,16006
050,36,047,"New York","Kings County",4,47,30809,14505,16304
050,36,047,"New York","Kings County",4,48,29504,13842,15662
050,36,047,"New York","Kings County",4,49,29352,13769,15583
050,36,047,"New York","Kings County",4,50,30217,14195,16022
050,36,047,"New York","Kings County",4,51,31315,14798,16517
050,36,047,"New York","Kings County",4,52,30975,14614,16361
050,36,047,"New York","Kings County",4,53,29371,13786,15585
050,36,047,"New York","Kings County",4,54,28887,13396,15491
050,36,047,"New York","Kings County",4,55,28639,13262,15377
050,36,047,"New York","Kings County",4,56,28895,13418,15477
050,36,047,"New York","Kings County",4,57,30006,14016,15990
050,36,047,"New York","Kings County",4,58,30387,14061,16326
050,36,047,"New York","Kings County",4,59,30019,13807,16212
050,36,047,"New York","Kings County",4,60,29376,13556,15820
050,36,047,"New York","Kings County",4,61,29232,13362,15870
050,36,047,"New York","Kings County",4,62,29634,13557,16077
050,36,047,"New York","Kings County",4,63,28750,13103,15647
050,36,047,"New York","Kings County",4,64,28096,12897,15199
050,36,047,"New York","Kings County",4,65,27385,12399,14986
050,36,047,"New York","Kings County",4,66,26421,11915,14506
050,36,047,"New York","Kings County",4,67,26102,11645,14457
050,36,047,"New York","Kings County",4,68,24670,10945,13725
050,36,047,"New York","Kings County",4,69,23416,10356,13060
050,36,047,"New York","Kings County",4,70,22660,9978,12682
050,36,047,"New York","Kings County",4,71,21972,9615,12357
050,36,047,"New York","Kings County",4,72,21715,9507,12208
050,36,047,"New York","Kings County",4,73,20544,8917,11627
050,36,047,"New York","Kings County",4,74,19704,8562,11142
050,36,047,"New York","Kings County",4,75,19602,8433,11169
050,36,047,"New York","Kings County",4,76,14704,6095,8609
050,36,047,"New York","Kings County",4,77,13793,5664,8129
050,36,047,"New York","Kings County",4,78,12400,5056,7344
050,36,047,"New York","Kings County",4,79,11685,4649,7036
050,36,047,"New York","Kings County",4,80,10718,4190,6528
050,36,047,"New York","Kings County",4,81,9905,3807,6098
050,36,047,"New York","Kings County",4,82,9550,3617,5933
050,36,047,"New York","Kings County",4,83,8945,3383,5562
050,36,047,"New York","Kings County",4,84,8359,3135,5224
050,36,047,"New York","Kings County",4,85,50208,17322,32886
050,36,047,"New York","Kings County",5,0,31763,16231,15532
050,36,047,"New York","Kings County",5,1,31126,15807,15319
050,36,047,"New York","Kings County",5,2,29829,15308,14521
050,36,047,"New York","Kings County",5,3,31374,15874,15500
050,36,047,"New York","Kings County",5,4,32192,16247,15945
050,36,047,"New York","Kings County",5,5,32026,16315,15711
050,36,047,"New York","Kings County",5,6,31836,16356,15480
050,36,047,"New York","Kings County",5,7,31977,16598,15379
050,36,047,"New York","Kings County",5,8,31516,16214,15302
050,36,047,"New York","Kings County",5,9,30996,15800,15196
050,36,047,"New York","Kings County",5,10,31054,15855,15199
050,36,047,"New York","Kings County",5,11,30795,15753,15042
050,36,047,"New York","Kings County",5,12,30866,15887,14979
050,36,047,"New York","Kings County",5,13,29925,15583,14342
050,36,047,"New York","Kings County",5,14,29761,15364,14397
050,36,047,"New York","Kings County",5,15,30369,15487,14882
050,36,047,"New York","Kings County",5,16,30198,15447,14751
050,36,047,"New York","Kings County",5,17,29685,14985,14700
050,36,047,"New York","Kings County",5,18,26056,13343,12713
050,36,047,"New York","Kings County",5,19,23267,11904,11363
050,36,047,"New York","Kings County",5,20,24509,12370,12139
050,36,047,"New York","Kings County",5,21,25742,12758,12984
050,36,047,"New York","Kings County",5,22,28442,13835,14607
050,36,047,"New York","Kings County",5,23,31835,15191,16644
050,36,047,"New York","Kings County",5,24,34714,16186,18528
050,36,047,"New York","Kings County",5,25,37502,17428,20074
050,36,047,"New York","Kings County",5,26,40280,18802,21478
050,36,047,"New York","Kings County",5,27,42616,19999,22617
050,36,047,"New York","Kings County",5,28,44204,20859,23345
050,36,047,"New York","Kings County",5,29,45062,21445,23617
050,36,047,"New York","Kings County",5,30,45858,22095,23763
050,36,047,"New York","Kings County",5,31,46353,22524,23829
050,36,047,"New York","Kings County",5,32,47228,23254,23974
050,36,047,"New York","Kings County",5,33,47096,23178,23918
050,36,047,"New York","Kings County",5,34,44803,22198,22605
050,36,047,"New York","Kings County",5,35,43392,21312,22080
050,36,047,"New York","Kings County",5,36,41181,20293,20888
050,36,047,"New York","Kings County",5,37,39894,19705,20189
050,36,047,"New York","Kings County",5,38,38538,18856,19682
050,36,047,"New York","Kings County",5,39,36656,17941,18715
050,36,047,"New York","Kings County",5,40,36080,17590,18490
050,36,047,"New York","Kings County",5,41,35121,17071,18050
050,36,047,"New York","Kings County",5,42,33842,16399,17443
050,36,047,"New York","Kings County",5,43,33317,16166,17151
050,36,047,"New York","Kings County",5,44,32204,15444,16760
050,36,047,"New York","Kings County",5,45,30888,14764,16124
050,36,047,"New York","Kings County",5,46,30387,14377,16010
050,36,047,"New York","Kings County",5,47,29450,13837,15613
050,36,047,"New York","Kings County",5,48,29850,13984,15866
050,36,047,"New York","Kings County",5,49,28775,13433,15342
050,36,047,"New York","Kings County",5,50,28662,13494,15168
050,36,047,"New York","Kings County",5,51,29581,13853,15728
050,36,047,"New York","Kings County",5,52,30572,14421,16151
050,36,047,"New York","Kings County",5,53,30249,14235,16014
050,36,047,"New York","Kings County",5,54,28832,13493,15339
050,36,047,"New York","Kings County",5,55,28278,13077,15201
050,36,047,"New York","Kings County",5,56,27911,12896,15015
050,36,047,"New York","Kings County",5,57,28356,13118,15238
050,36,047,"New York","Kings County",5,58,29358,13650,15708
050,36,047,"New York","Kings County",5,59,29672,13628,16044
050,36,047,"New York","Kings County",5,60,29352,13467,15885
050,36,047,"New York","Kings County",5,61,28766,13203,15563
050,36,047,"New York","Kings County",5,62,28515,13000,15515
050,36,047,"New York","Kings County",5,63,28783,13100,15683
050,36,047,"New York","Kings County",5,64,28014,12733,15281
050,36,047,"New York","Kings County",5,65,27261,12493,14768
050,36,047,"New York","Kings County",5,66,26709,12057,14652
050,36,047,"New York","Kings County",5,67,25738,11588,14150
050,36,047,"New York","Kings County",5,68,25437,11360,14077
050,36,047,"New York","Kings County",5,69,24005,10609,13396
050,36,047,"New York","Kings County",5,70,22708,10000,12708
050,36,047,"New York","Kings County",5,71,22030,9650,12380
050,36,047,"New York","Kings County",5,72,21432,9329,12103
050,36,047,"New York","Kings County",5,73,21027,9191,11836
050,36,047,"New York","Kings County",5,74,19932,8633,11299
050,36,047,"New York","Kings County",5,75,19113,8296,10817
050,36,047,"New York","Kings County",5,76,19036,8153,10883
050,36,047,"New York","Kings County",5,77,14195,5837,8358
050,36,047,"New York","Kings County",5,78,13316,5447,7869
050,36,047,"New York","Kings County",5,79,11885,4800,7085
050,36,047,"New York","Kings County",5,80,11170,4411,6759
050,36,047,"New York","Kings County",5,81,10176,3948,6228
050,36,047,"New York","Kings County",5,82,9351,3563,5788
050,36,047,"New York","Kings County",5,83,8982,3345,5637
050,36,047,"New York","Kings County",5,84,8378,3146,5232
050,36,047,"New York","Kings County",5,85,52013,18142,33871
050,36,049,"New York","Lewis County",1,0,319,162,157
050,36,049,"New York","Lewis County",1,1,326,169,157
050,36,049,"New York","Lewis County",1,2,310,180,130
050,36,049,"New York","Lewis County",1,3,340,167,173
050,36,049,"New York","Lewis County",1,4,348,175,173
050,36,049,"New York","Lewis County",1,5,333,165,168
050,36,049,"New York","Lewis County",1,6,339,170,169
050,36,049,"New York","Lewis County",1,7,346,179,167
050,36,049,"New York","Lewis County",1,8,340,188,152
050,36,049,"New York","Lewis County",1,9,321,163,158
050,36,049,"New York","Lewis County",1,10,379,178,201
050,36,049,"New York","Lewis County",1,11,339,169,170
050,36,049,"New York","Lewis County",1,12,336,187,149
050,36,049,"New York","Lewis County",1,13,351,178,173
050,36,049,"New York","Lewis County",1,14,367,192,175
050,36,049,"New York","Lewis County",1,15,347,175,172
050,36,049,"New York","Lewis County",1,16,351,181,170
050,36,049,"New York","Lewis County",1,17,344,183,161
050,36,049,"New York","Lewis County",1,18,305,156,149
050,36,049,"New York","Lewis County",1,19,241,123,118
050,36,049,"New York","Lewis County",1,20,249,130,119
050,36,049,"New York","Lewis County",1,21,278,141,137
050,36,049,"New York","Lewis County",1,22,279,139,140
050,36,049,"New York","Lewis County",1,23,294,149,145
050,36,049,"New York","Lewis County",1,24,295,154,141
050,36,049,"New York","Lewis County",1,25,300,154,146
050,36,049,"New York","Lewis County",1,26,292,143,149
050,36,049,"New York","Lewis County",1,27,297,154,143
050,36,049,"New York","Lewis County",1,28,306,150,156
050,36,049,"New York","Lewis County",1,29,320,168,152
050,36,049,"New York","Lewis County",1,30,300,163,137
050,36,049,"New York","Lewis County",1,31,285,153,132
050,36,049,"New York","Lewis County",1,32,293,161,132
050,36,049,"New York","Lewis County",1,33,310,162,148
050,36,049,"New York","Lewis County",1,34,314,161,153
050,36,049,"New York","Lewis County",1,35,324,165,159
050,36,049,"New York","Lewis County",1,36,314,158,156
050,36,049,"New York","Lewis County",1,37,297,150,147
050,36,049,"New York","Lewis County",1,38,310,162,148
050,36,049,"New York","Lewis County",1,39,321,160,161
050,36,049,"New York","Lewis County",1,40,315,164,151
050,36,049,"New York","Lewis County",1,41,296,154,142
050,36,049,"New York","Lewis County",1,42,288,140,148
050,36,049,"New York","Lewis County",1,43,276,131,145
050,36,049,"New York","Lewis County",1,44,277,140,137
050,36,049,"New York","Lewis County",1,45,281,149,132
050,36,049,"New York","Lewis County",1,46,279,145,134
050,36,049,"New York","Lewis County",1,47,313,161,152
050,36,049,"New York","Lewis County",1,48,324,174,150
050,36,049,"New York","Lewis County",1,49,345,186,159
050,36,049,"New York","Lewis County",1,50,347,178,169
050,36,049,"New York","Lewis County",1,51,330,183,147
050,36,049,"New York","Lewis County",1,52,308,164,144
050,36,049,"New York","Lewis County",1,53,320,174,146
050,36,049,"New York","Lewis County",1,54,361,184,177
050,36,049,"New York","Lewis County",1,55,414,208,206
050,36,049,"New York","Lewis County",1,56,416,208,208
050,36,049,"New York","Lewis County",1,57,422,216,206
050,36,049,"New York","Lewis County",1,58,434,230,204
050,36,049,"New York","Lewis County",1,59,451,248,203
050,36,049,"New York","Lewis County",1,60,442,220,222
050,36,049,"New York","Lewis County",1,61,400,195,205
050,36,049,"New York","Lewis County",1,62,425,218,207
050,36,049,"New York","Lewis County",1,63,416,214,202
050,36,049,"New York","Lewis County",1,64,406,215,191
050,36,049,"New York","Lewis County",1,65,388,208,180
050,36,049,"New York","Lewis County",1,66,382,184,198
050,36,049,"New York","Lewis County",1,67,388,196,192
050,36,049,"New York","Lewis County",1,68,322,158,164
050,36,049,"New York","Lewis County",1,69,284,147,137
050,36,049,"New York","Lewis County",1,70,288,147,141
050,36,049,"New York","Lewis County",1,71,266,147,119
050,36,049,"New York","Lewis County",1,72,253,133,120
050,36,049,"New York","Lewis County",1,73,243,120,123
050,36,049,"New York","Lewis County",1,74,186,79,107
050,36,049,"New York","Lewis County",1,75,189,90,99
050,36,049,"New York","Lewis County",1,76,182,87,95
050,36,049,"New York","Lewis County",1,77,175,79,96
050,36,049,"New York","Lewis County",1,78,167,87,80
050,36,049,"New York","Lewis County",1,79,151,77,74
050,36,049,"New York","Lewis County",1,80,135,66,69
050,36,049,"New York","Lewis County",1,81,134,62,72
050,36,049,"New York","Lewis County",1,82,126,55,71
050,36,049,"New York","Lewis County",1,83,104,47,57
050,36,049,"New York","Lewis County",1,84,98,49,49
050,36,049,"New York","Lewis County",1,85,580,237,343
050,36,049,"New York","Lewis County",2,0,310,148,162
050,36,049,"New York","Lewis County",2,1,321,167,154
050,36,049,"New York","Lewis County",2,2,317,178,139
050,36,049,"New York","Lewis County",2,3,332,171,161
050,36,049,"New York","Lewis County",2,4,347,172,175
050,36,049,"New York","Lewis County",2,5,337,167,170
050,36,049,"New York","Lewis County",2,6,340,170,170
050,36,049,"New York","Lewis County",2,7,343,176,167
050,36,049,"New York","Lewis County",2,8,341,185,156
050,36,049,"New York","Lewis County",2,9,327,169,158
050,36,049,"New York","Lewis County",2,10,363,173,190
050,36,049,"New York","Lewis County",2,11,344,169,175
050,36,049,"New York","Lewis County",2,12,336,180,156
050,36,049,"New York","Lewis County",2,13,346,180,166
050,36,049,"New York","Lewis County",2,14,361,187,174
050,36,049,"New York","Lewis County",2,15,355,180,175
050,36,049,"New York","Lewis County",2,16,350,179,171
050,36,049,"New York","Lewis County",2,17,345,182,163
050,36,049,"New York","Lewis County",2,18,297,155,142
050,36,049,"New York","Lewis County",2,19,243,124,119
050,36,049,"New York","Lewis County",2,20,255,132,123
050,36,049,"New York","Lewis County",2,21,268,136,132
050,36,049,"New York","Lewis County",2,22,281,140,141
050,36,049,"New York","Lewis County",2,23,293,149,144
050,36,049,"New York","Lewis County",2,24,297,155,142
050,36,049,"New York","Lewis County",2,25,295,151,144
050,36,049,"New York","Lewis County",2,26,296,147,149
050,36,049,"New York","Lewis County",2,27,297,152,145
050,36,049,"New York","Lewis County",2,28,306,152,154
050,36,049,"New York","Lewis County",2,29,318,163,155
050,36,049,"New York","Lewis County",2,30,306,164,142
050,36,049,"New York","Lewis County",2,31,287,154,133
050,36,049,"New York","Lewis County",2,32,288,158,130
050,36,049,"New York","Lewis County",2,33,306,160,146
050,36,049,"New York","Lewis County",2,34,313,162,151
050,36,049,"New York","Lewis County",2,35,323,164,159
050,36,049,"New York","Lewis County",2,36,314,157,157
050,36,049,"New York","Lewis County",2,37,302,154,148
050,36,049,"New York","Lewis County",2,38,306,159,147
050,36,049,"New York","Lewis County",2,39,317,159,158
050,36,049,"New York","Lewis County",2,40,319,164,155
050,36,049,"New York","Lewis County",2,41,300,156,144
050,36,049,"New York","Lewis County",2,42,288,142,146
050,36,049,"New York","Lewis County",2,43,280,133,147
050,36,049,"New York","Lewis County",2,44,274,137,137
050,36,049,"New York","Lewis County",2,45,279,145,134
050,36,049,"New York","Lewis County",2,46,279,144,135
050,36,049,"New York","Lewis County",2,47,304,158,146
050,36,049,"New York","Lewis County",2,48,322,172,150
050,36,049,"New York","Lewis County",2,49,342,184,158
050,36,049,"New York","Lewis County",2,50,349,181,168
050,36,049,"New York","Lewis County",2,51,333,180,153
050,36,049,"New York","Lewis County",2,52,311,168,143
050,36,049,"New York","Lewis County",2,53,316,172,144
050,36,049,"New York","Lewis County",2,54,347,180,167
050,36,049,"New York","Lewis County",2,55,402,203,199
050,36,049,"New York","Lewis County",2,56,417,210,207
050,36,049,"New York","Lewis County",2,57,422,215,207
050,36,049,"New York","Lewis County",2,58,430,227,203
050,36,049,"New York","Lewis County",2,59,448,243,205
050,36,049,"New York","Lewis County",2,60,440,225,215
050,36,049,"New York","Lewis County",2,61,406,198,208
050,36,049,"New York","Lewis County",2,62,419,212,207
050,36,049,"New York","Lewis County",2,63,420,215,205
050,36,049,"New York","Lewis County",2,64,403,212,191
050,36,049,"New York","Lewis County",2,65,392,209,183
050,36,049,"New York","Lewis County",2,66,383,190,193
050,36,049,"New York","Lewis County",2,67,383,191,192
050,36,049,"New York","Lewis County",2,68,334,164,170
050,36,049,"New York","Lewis County",2,69,294,151,143
050,36,049,"New York","Lewis County",2,70,284,145,139
050,36,049,"New York","Lewis County",2,71,270,146,124
050,36,049,"New York","Lewis County",2,72,252,134,118
050,36,049,"New York","Lewis County",2,73,260,130,130
050,36,049,"New York","Lewis County",2,74,186,83,103
050,36,049,"New York","Lewis County",2,75,187,87,100
050,36,049,"New York","Lewis County",2,76,179,85,94
050,36,049,"New York","Lewis County",2,77,179,82,97
050,36,049,"New York","Lewis County",2,78,166,83,83
050,36,049,"New York","Lewis County",2,79,153,78,75
050,36,049,"New York","Lewis County",2,80,137,68,69
050,36,049,"New York","Lewis County",2,81,135,63,72
050,36,049,"New York","Lewis County",2,82,126,57,69
050,36,049,"New York","Lewis County",2,83,107,48,59
050,36,049,"New York","Lewis County",2,84,99,48,51
050,36,049,"New York","Lewis County",2,85,581,239,342
050,36,049,"New York","Lewis County",3,0,300,154,146
050,36,049,"New York","Lewis County",3,1,305,141,164
050,36,049,"New York","Lewis County",3,2,336,177,159
050,36,049,"New York","Lewis County",3,3,322,179,143
050,36,049,"New York","Lewis County",3,4,337,183,154
050,36,049,"New York","Lewis County",3,5,359,180,179
050,36,049,"New York","Lewis County",3,6,340,168,172
050,36,049,"New York","Lewis County",3,7,336,166,170
050,36,049,"New York","Lewis County",3,8,357,188,169
050,36,049,"New York","Lewis County",3,9,339,180,159
050,36,049,"New York","Lewis County",3,10,327,165,162
050,36,049,"New York","Lewis County",3,11,362,174,188
050,36,049,"New York","Lewis County",3,12,351,170,181
050,36,049,"New York","Lewis County",3,13,341,182,159
050,36,049,"New York","Lewis County",3,14,350,184,166
050,36,049,"New York","Lewis County",3,15,360,186,174
050,36,049,"New York","Lewis County",3,16,353,187,166
050,36,049,"New York","Lewis County",3,17,349,178,171
050,36,049,"New York","Lewis County",3,18,295,158,137
050,36,049,"New York","Lewis County",3,19,252,132,120
050,36,049,"New York","Lewis County",3,20,272,138,134
050,36,049,"New York","Lewis County",3,21,269,137,132
050,36,049,"New York","Lewis County",3,22,281,139,142
050,36,049,"New York","Lewis County",3,23,297,156,141
050,36,049,"New York","Lewis County",3,24,289,148,141
050,36,049,"New York","Lewis County",3,25,292,152,140
050,36,049,"New York","Lewis County",3,26,310,162,148
050,36,049,"New York","Lewis County",3,27,301,150,151
050,36,049,"New York","Lewis County",3,28,303,145,158
050,36,049,"New York","Lewis County",3,29,307,154,153
050,36,049,"New York","Lewis County",3,30,316,161,155
050,36,049,"New York","Lewis County",3,31,302,161,141
050,36,049,"New York","Lewis County",3,32,302,160,142
050,36,049,"New York","Lewis County",3,33,296,153,143
050,36,049,"New York","Lewis County",3,34,315,166,149
050,36,049,"New York","Lewis County",3,35,319,166,153
050,36,049,"New York","Lewis County",3,36,327,167,160
050,36,049,"New York","Lewis County",3,37,319,160,159
050,36,049,"New York","Lewis County",3,38,296,154,142
050,36,049,"New York","Lewis County",3,39,303,155,148
050,36,049,"New York","Lewis County",3,40,310,149,161
050,36,049,"New York","Lewis County",3,41,326,168,158
050,36,049,"New York","Lewis County",3,42,295,152,143
050,36,049,"New York","Lewis County",3,43,285,144,141
050,36,049,"New York","Lewis County",3,44,288,139,149
050,36,049,"New York","Lewis County",3,45,270,134,136
050,36,049,"New York","Lewis County",3,46,276,142,134
050,36,049,"New York","Lewis County",3,47,286,149,137
050,36,049,"New York","Lewis County",3,48,302,155,147
050,36,049,"New York","Lewis County",3,49,327,174,153
050,36,049,"New York","Lewis County",3,50,340,181,159
050,36,049,"New York","Lewis County",3,51,348,183,165
050,36,049,"New York","Lewis County",3,52,339,183,156
050,36,049,"New York","Lewis County",3,53,308,166,142
050,36,049,"New York","Lewis County",3,54,319,171,148
050,36,049,"New York","Lewis County",3,55,341,177,164
050,36,049,"New York","Lewis County",3,56,406,201,205
050,36,049,"New York","Lewis County",3,57,419,210,209
050,36,049,"New York","Lewis County",3,58,420,215,205
050,36,049,"New York","Lewis County",3,59,430,228,202
050,36,049,"New York","Lewis County",3,60,456,253,203
050,36,049,"New York","Lewis County",3,61,428,218,210
050,36,049,"New York","Lewis County",3,62,412,202,210
050,36,049,"New York","Lewis County",3,63,414,208,206
050,36,049,"New York","Lewis County",3,64,422,221,201
050,36,049,"New York","Lewis County",3,65,414,214,200
050,36,049,"New York","Lewis County",3,66,383,206,177
050,36,049,"New York","Lewis County",3,67,376,189,187
050,36,049,"New York","Lewis County",3,68,378,187,191
050,36,049,"New York","Lewis County",3,69,320,157,163
050,36,049,"New York","Lewis County",3,70,295,151,144
050,36,049,"New York","Lewis County",3,71,272,136,136
050,36,049,"New York","Lewis County",3,72,262,140,122
050,36,049,"New York","Lewis County",3,73,245,130,115
050,36,049,"New York","Lewis County",3,74,255,125,130
050,36,049,"New York","Lewis County",3,75,176,79,97
050,36,049,"New York","Lewis County",3,76,183,80,103
050,36,049,"New York","Lewis County",3,77,172,81,91
050,36,049,"New York","Lewis County",3,78,183,78,105
050,36,049,"New York","Lewis County",3,79,147,70,77
050,36,049,"New York","Lewis County",3,80,142,74,68
050,36,049,"New York","Lewis County",3,81,133,61,72
050,36,049,"New York","Lewis County",3,82,134,64,70
050,36,049,"New York","Lewis County",3,83,121,54,67
050,36,049,"New York","Lewis County",3,84,98,42,56
050,36,049,"New York","Lewis County",3,85,579,236,343
050,36,049,"New York","Lewis County",4,0,284,141,143
050,36,049,"New York","Lewis County",4,1,287,152,135
050,36,049,"New York","Lewis County",4,2,291,136,155
050,36,049,"New York","Lewis County",4,3,349,185,164
050,36,049,"New York","Lewis County",4,4,323,177,146
050,36,049,"New York","Lewis County",4,5,340,188,152
050,36,049,"New York","Lewis County",4,6,359,182,177
050,36,049,"New York","Lewis County",4,7,348,174,174
050,36,049,"New York","Lewis County",4,8,336,169,167
050,36,049,"New York","Lewis County",4,9,362,190,172
050,36,049,"New York","Lewis County",4,10,328,172,156
050,36,049,"New York","Lewis County",4,11,330,175,155
050,36,049,"New York","Lewis County",4,12,371,179,192
050,36,049,"New York","Lewis County",4,13,341,165,176
050,36,049,"New York","Lewis County",4,14,338,176,162
050,36,049,"New York","Lewis County",4,15,346,184,162
050,36,049,"New York","Lewis County",4,16,363,183,180
050,36,049,"New York","Lewis County",4,17,346,186,160
050,36,049,"New York","Lewis County",4,18,287,155,132
050,36,049,"New York","Lewis County",4,19,216,119,97
050,36,049,"New York","Lewis County",4,20,260,142,118
050,36,049,"New York","Lewis County",4,21,285,144,141
050,36,049,"New York","Lewis County",4,22,281,139,142
050,36,049,"New York","Lewis County",4,23,285,147,138
050,36,049,"New York","Lewis County",4,24,290,151,139
050,36,049,"New York","Lewis County",4,25,280,146,134
050,36,049,"New York","Lewis County",4,26,274,137,137
050,36,049,"New York","Lewis County",4,27,304,163,141
050,36,049,"New York","Lewis County",4,28,300,151,149
050,36,049,"New York","Lewis County",4,29,294,142,152
050,36,049,"New York","Lewis County",4,30,313,156,157
050,36,049,"New York","Lewis County",4,31,308,155,153
050,36,049,"New York","Lewis County",4,32,314,161,153
050,36,049,"New York","Lewis County",4,33,307,156,151
050,36,049,"New York","Lewis County",4,34,307,163,144
050,36,049,"New York","Lewis County",4,35,311,160,151
050,36,049,"New York","Lewis County",4,36,333,175,158
050,36,049,"New York","Lewis County",4,37,351,180,171
050,36,049,"New York","Lewis County",4,38,306,154,152
050,36,049,"New York","Lewis County",4,39,287,145,142
050,36,049,"New York","Lewis County",4,40,306,162,144
050,36,049,"New York","Lewis County",4,41,322,161,161
050,36,049,"New York","Lewis County",4,42,322,165,157
050,36,049,"New York","Lewis County",4,43,293,150,143
050,36,049,"New York","Lewis County",4,44,282,146,136
050,36,049,"New York","Lewis County",4,45,284,138,146
050,36,049,"New York","Lewis County",4,46,273,141,132
050,36,049,"New York","Lewis County",4,47,279,141,138
050,36,049,"New York","Lewis County",4,48,290,152,138
050,36,049,"New York","Lewis County",4,49,297,153,144
050,36,049,"New York","Lewis County",4,50,327,175,152
050,36,049,"New York","Lewis County",4,51,336,179,157
050,36,049,"New York","Lewis County",4,52,337,177,160
050,36,049,"New York","Lewis County",4,53,334,180,154
050,36,049,"New York","Lewis County",4,54,306,163,143
050,36,049,"New York","Lewis County",4,55,311,168,143
050,36,049,"New York","Lewis County",4,56,345,183,162
050,36,049,"New York","Lewis County",4,57,405,202,203
050,36,049,"New York","Lewis County",4,58,404,205,199
050,36,049,"New York","Lewis County",4,59,427,216,211
050,36,049,"New York","Lewis County",4,60,429,229,200
050,36,049,"New York","Lewis County",4,61,451,252,199
050,36,049,"New York","Lewis County",4,62,436,221,215
050,36,049,"New York","Lewis County",4,63,408,199,209
050,36,049,"New York","Lewis County",4,64,412,203,209
050,36,049,"New York","Lewis County",4,65,426,222,204
050,36,049,"New York","Lewis County",4,66,403,207,196
050,36,049,"New York","Lewis County",4,67,374,199,175
050,36,049,"New York","Lewis County",4,68,374,187,187
050,36,049,"New York","Lewis County",4,69,364,179,185
050,36,049,"New York","Lewis County",4,70,315,154,161
050,36,049,"New York","Lewis County",4,71,283,146,137
050,36,049,"New York","Lewis County",4,72,265,131,134
050,36,049,"New York","Lewis County",4,73,263,137,126
050,36,049,"New York","Lewis County",4,74,241,125,116
050,36,049,"New York","Lewis County",4,75,244,124,120
050,36,049,"New York","Lewis County",4,76,168,68,100
050,36,049,"New York","Lewis County",4,77,176,77,99
050,36,049,"New York","Lewis County",4,78,173,78,95
050,36,049,"New York","Lewis County",4,79,166,70,96
050,36,049,"New York","Lewis County",4,80,135,68,67
050,36,049,"New York","Lewis County",4,81,138,69,69
050,36,049,"New York","Lewis County",4,82,125,59,66
050,36,049,"New York","Lewis County",4,83,126,58,68
050,36,049,"New York","Lewis County",4,84,111,48,63
050,36,049,"New York","Lewis County",4,85,574,226,348
050,36,049,"New York","Lewis County",5,0,286,143,143
050,36,049,"New York","Lewis County",5,1,289,142,147
050,36,049,"New York","Lewis County",5,2,290,156,134
050,36,049,"New York","Lewis County",5,3,310,146,164
050,36,049,"New York","Lewis County",5,4,346,183,163
050,36,049,"New York","Lewis County",5,5,322,177,145
050,36,049,"New York","Lewis County",5,6,339,183,156
050,36,049,"New York","Lewis County",5,7,363,180,183
050,36,049,"New York","Lewis County",5,8,353,177,176
050,36,049,"New York","Lewis County",5,9,344,171,173
050,36,049,"New York","Lewis County",5,10,355,181,174
050,36,049,"New York","Lewis County",5,11,336,178,158
050,36,049,"New York","Lewis County",5,12,332,179,153
050,36,049,"New York","Lewis County",5,13,375,180,195
050,36,049,"New York","Lewis County",5,14,343,168,175
050,36,049,"New York","Lewis County",5,15,334,177,157
050,36,049,"New York","Lewis County",5,16,339,183,156
050,36,049,"New York","Lewis County",5,17,364,185,179
050,36,049,"New York","Lewis County",5,18,289,164,125
050,36,049,"New York","Lewis County",5,19,216,118,98
050,36,049,"New York","Lewis County",5,20,236,121,115
050,36,049,"New York","Lewis County",5,21,266,144,122
050,36,049,"New York","Lewis County",5,22,294,141,153
050,36,049,"New York","Lewis County",5,23,291,142,149
050,36,049,"New York","Lewis County",5,24,286,154,132
050,36,049,"New York","Lewis County",5,25,273,140,133
050,36,049,"New York","Lewis County",5,26,277,153,124
050,36,049,"New York","Lewis County",5,27,271,139,132
050,36,049,"New York","Lewis County",5,28,298,160,138
050,36,049,"New York","Lewis County",5,29,304,151,153
050,36,049,"New York","Lewis County",5,30,302,144,158
050,36,049,"New York","Lewis County",5,31,324,159,165
050,36,049,"New York","Lewis County",5,32,310,160,150
050,36,049,"New York","Lewis County",5,33,312,158,154
050,36,049,"New York","Lewis County",5,34,298,153,145
050,36,049,"New York","Lewis County",5,35,305,161,144
050,36,049,"New York","Lewis County",5,36,327,173,154
050,36,049,"New York","Lewis County",5,37,327,170,157
050,36,049,"New York","Lewis County",5,38,348,182,166
050,36,049,"New York","Lewis County",5,39,306,153,153
050,36,049,"New York","Lewis County",5,40,287,147,140
050,36,049,"New York","Lewis County",5,41,303,162,141
050,36,049,"New York","Lewis County",5,42,324,157,167
050,36,049,"New York","Lewis County",5,43,313,164,149
050,36,049,"New York","Lewis County",5,44,293,148,145
050,36,049,"New York","Lewis County",5,45,276,145,131
050,36,049,"New York","Lewis County",5,46,277,131,146
050,36,049,"New York","Lewis County",5,47,274,138,136
050,36,049,"New York","Lewis County",5,48,273,138,135
050,36,049,"New York","Lewis County",5,49,290,150,140
050,36,049,"New York","Lewis County",5,50,303,158,145
050,36,049,"New York","Lewis County",5,51,323,171,152
050,36,049,"New York","Lewis County",5,52,342,184,158
050,36,049,"New York","Lewis County",5,53,337,178,159
050,36,049,"New York","Lewis County",5,54,331,172,159
050,36,049,"New York","Lewis County",5,55,304,159,145
050,36,049,"New York","Lewis County",5,56,309,170,139
050,36,049,"New York","Lewis County",5,57,343,181,162
050,36,049,"New York","Lewis County",5,58,391,197,194
050,36,049,"New York","Lewis County",5,59,397,202,195
050,36,049,"New York","Lewis County",5,60,438,224,214
050,36,049,"New York","Lewis County",5,61,424,227,197
050,36,049,"New York","Lewis County",5,62,452,251,201
050,36,049,"New York","Lewis County",5,63,433,215,218
050,36,049,"New York","Lewis County",5,64,411,200,211
050,36,049,"New York","Lewis County",5,65,416,203,213
050,36,049,"New York","Lewis County",5,66,416,215,201
050,36,049,"New York","Lewis County",5,67,393,202,191
050,36,049,"New York","Lewis County",5,68,371,194,177
050,36,049,"New York","Lewis County",5,69,365,184,181
050,36,049,"New York","Lewis County",5,70,356,174,182
050,36,049,"New York","Lewis County",5,71,311,152,159
050,36,049,"New York","Lewis County",5,72,275,144,131
050,36,049,"New York","Lewis County",5,73,267,130,137
050,36,049,"New York","Lewis County",5,74,259,131,128
050,36,049,"New York","Lewis County",5,75,233,125,108
050,36,049,"New York","Lewis County",5,76,235,115,120
050,36,049,"New York","Lewis County",5,77,162,67,95
050,36,049,"New York","Lewis County",5,78,176,77,99
050,36,049,"New York","Lewis County",5,79,161,71,90
050,36,049,"New York","Lewis County",5,80,147,64,83
050,36,049,"New York","Lewis County",5,81,130,63,67
050,36,049,"New York","Lewis County",5,82,131,65,66
050,36,049,"New York","Lewis County",5,83,118,54,64
050,36,049,"New York","Lewis County",5,84,120,53,67
050,36,049,"New York","Lewis County",5,85,578,225,353
050,36,051,"New York","Livingston County",1,0,499,254,245
050,36,051,"New York","Livingston County",1,1,505,249,256
050,36,051,"New York","Livingston County",1,2,538,269,269
050,36,051,"New York","Livingston County",1,3,559,293,266
050,36,051,"New York","Livingston County",1,4,572,288,284
050,36,051,"New York","Livingston County",1,5,560,291,269
050,36,051,"New York","Livingston County",1,6,565,300,265
050,36,051,"New York","Livingston County",1,7,604,316,288
050,36,051,"New York","Livingston County",1,8,621,321,300
050,36,051,"New York","Livingston County",1,9,632,312,320
050,36,051,"New York","Livingston County",1,10,669,354,315
050,36,051,"New York","Livingston County",1,11,667,349,318
050,36,051,"New York","Livingston County",1,12,697,351,346
050,36,051,"New York","Livingston County",1,13,699,349,350
050,36,051,"New York","Livingston County",1,14,706,361,345
050,36,051,"New York","Livingston County",1,15,717,371,346
050,36,051,"New York","Livingston County",1,16,712,358,354
050,36,051,"New York","Livingston County",1,17,727,364,363
050,36,051,"New York","Livingston County",1,18,1200,551,649
050,36,051,"New York","Livingston County",1,19,1661,785,876
050,36,051,"New York","Livingston County",1,20,1679,746,933
050,36,051,"New York","Livingston County",1,21,1670,739,931
050,36,051,"New York","Livingston County",1,22,1196,606,590
050,36,051,"New York","Livingston County",1,23,789,403,386
050,36,051,"New York","Livingston County",1,24,701,376,325
050,36,051,"New York","Livingston County",1,25,663,368,295
050,36,051,"New York","Livingston County",1,26,632,341,291
050,36,051,"New York","Livingston County",1,27,646,351,295
050,36,051,"New York","Livingston County",1,28,625,349,276
050,36,051,"New York","Livingston County",1,29,592,343,249
050,36,051,"New York","Livingston County",1,30,651,366,285
050,36,051,"New York","Livingston County",1,31,613,337,276
050,36,051,"New York","Livingston County",1,32,632,328,304
050,36,051,"New York","Livingston County",1,33,644,331,313
050,36,051,"New York","Livingston County",1,34,685,372,313
050,36,051,"New York","Livingston County",1,35,674,342,332
050,36,051,"New York","Livingston County",1,36,678,360,318
050,36,051,"New York","Livingston County",1,37,743,384,359
050,36,051,"New York","Livingston County",1,38,711,356,355
050,36,051,"New York","Livingston County",1,39,703,356,347
050,36,051,"New York","Livingston County",1,40,657,337,320
050,36,051,"New York","Livingston County",1,41,669,366,303
050,36,051,"New York","Livingston County",1,42,641,352,289
050,36,051,"New York","Livingston County",1,43,618,335,283
050,36,051,"New York","Livingston County",1,44,629,331,298
050,36,051,"New York","Livingston County",1,45,577,301,276
050,36,051,"New York","Livingston County",1,46,579,298,281
050,36,051,"New York","Livingston County",1,47,653,348,305
050,36,051,"New York","Livingston County",1,48,738,370,368
050,36,051,"New York","Livingston County",1,49,801,422,379
050,36,051,"New York","Livingston County",1,50,807,414,393
050,36,051,"New York","Livingston County",1,51,788,382,406
050,36,051,"New York","Livingston County",1,52,764,378,386
050,36,051,"New York","Livingston County",1,53,798,379,419
050,36,051,"New York","Livingston County",1,54,880,434,446
050,36,051,"New York","Livingston County",1,55,932,469,463
050,36,051,"New York","Livingston County",1,56,958,497,461
050,36,051,"New York","Livingston County",1,57,962,477,485
050,36,051,"New York","Livingston County",1,58,998,493,505
050,36,051,"New York","Livingston County",1,59,974,488,486
050,36,051,"New York","Livingston County",1,60,981,478,503
050,36,051,"New York","Livingston County",1,61,997,496,501
050,36,051,"New York","Livingston County",1,62,947,474,473
050,36,051,"New York","Livingston County",1,63,915,447,468
050,36,051,"New York","Livingston County",1,64,885,449,436
050,36,051,"New York","Livingston County",1,65,854,437,417
050,36,051,"New York","Livingston County",1,66,829,407,422
050,36,051,"New York","Livingston County",1,67,786,383,403
050,36,051,"New York","Livingston County",1,68,749,378,371
050,36,051,"New York","Livingston County",1,69,670,328,342
050,36,051,"New York","Livingston County",1,70,681,337,344
050,36,051,"New York","Livingston County",1,71,671,337,334
050,36,051,"New York","Livingston County",1,72,657,333,324
050,36,051,"New York","Livingston County",1,73,659,318,341
050,36,051,"New York","Livingston County",1,74,450,195,255
050,36,051,"New York","Livingston County",1,75,453,206,247
050,36,051,"New York","Livingston County",1,76,439,206,233
050,36,051,"New York","Livingston County",1,77,436,205,231
050,36,051,"New York","Livingston County",1,78,391,186,205
050,36,051,"New York","Livingston County",1,79,302,130,172
050,36,051,"New York","Livingston County",1,80,280,125,155
050,36,051,"New York","Livingston County",1,81,258,114,144
050,36,051,"New York","Livingston County",1,82,283,122,161
050,36,051,"New York","Livingston County",1,83,234,116,118
050,36,051,"New York","Livingston County",1,84,218,105,113
050,36,051,"New York","Livingston County",1,85,1355,484,871
050,36,051,"New York","Livingston County",2,0,521,274,247
050,36,051,"New York","Livingston County",2,1,501,249,252
050,36,051,"New York","Livingston County",2,2,526,262,264
050,36,051,"New York","Livingston County",2,3,550,285,265
050,36,051,"New York","Livingston County",2,4,569,289,280
050,36,051,"New York","Livingston County",2,5,562,290,272
050,36,051,"New York","Livingston County",2,6,567,301,266
050,36,051,"New York","Livingston County",2,7,597,314,283
050,36,051,"New York","Livingston County",2,8,617,320,297
050,36,051,"New York","Livingston County",2,9,630,315,315
050,36,051,"New York","Livingston County",2,10,657,342,315
050,36,051,"New York","Livingston County",2,11,664,348,316
050,36,051,"New York","Livingston County",2,12,696,351,345
050,36,051,"New York","Livingston County",2,13,698,349,349
050,36,051,"New York","Livingston County",2,14,704,358,346
050,36,051,"New York","Livingston County",2,15,716,369,347
050,36,051,"New York","Livingston County",2,16,712,360,352
050,36,051,"New York","Livingston County",2,17,723,361,362
050,36,051,"New York","Livingston County",2,18,1197,545,652
050,36,051,"New York","Livingston County",2,19,1649,775,874
050,36,051,"New York","Livingston County",2,20,1687,746,941
050,36,051,"New York","Livingston County",2,21,1659,732,927
050,36,051,"New York","Livingston County",2,22,1187,601,586
050,36,051,"New York","Livingston County",2,23,786,403,383
050,36,051,"New York","Livingston County",2,24,697,371,326
050,36,051,"New York","Livingston County",2,25,657,359,298
050,36,051,"New York","Livingston County",2,26,624,335,289
050,36,051,"New York","Livingston County",2,27,626,341,285
050,36,051,"New York","Livingston County",2,28,625,346,279
050,36,051,"New York","Livingston County",2,29,597,340,257
050,36,051,"New York","Livingston County",2,30,633,355,278
050,36,051,"New York","Livingston County",2,31,616,340,276
050,36,051,"New York","Livingston County",2,32,625,326,299
050,36,051,"New York","Livingston County",2,33,638,327,311
050,36,051,"New York","Livingston County",2,34,668,357,311
050,36,051,"New York","Livingston County",2,35,674,347,327
050,36,051,"New York","Livingston County",2,36,673,353,320
050,36,051,"New York","Livingston County",2,37,728,377,351
050,36,051,"New York","Livingston County",2,38,719,361,358
050,36,051,"New York","Livingston County",2,39,705,356,349
050,36,051,"New York","Livingston County",2,40,673,343,330
050,36,051,"New York","Livingston County",2,41,659,353,306
050,36,051,"New York","Livingston County",2,42,637,349,288
050,36,051,"New York","Livingston County",2,43,625,338,287
050,36,051,"New York","Livingston County",2,44,616,324,292
050,36,051,"New York","Livingston County",2,45,588,306,282
050,36,051,"New York","Livingston County",2,46,574,295,279
050,36,051,"New York","Livingston County",2,47,630,331,299
050,36,051,"New York","Livingston County",2,48,708,356,352
050,36,051,"New York","Livingston County",2,49,783,406,377
050,36,051,"New York","Livingston County",2,50,799,412,387
050,36,051,"New York","Livingston County",2,51,787,384,403
050,36,051,"New York","Livingston County",2,52,763,375,388
050,36,051,"New York","Livingston County",2,53,786,374,412
050,36,051,"New York","Livingston County",2,54,853,417,436
050,36,051,"New York","Livingston County",2,55,917,459,458
050,36,051,"New York","Livingston County",2,56,954,490,464
050,36,051,"New York","Livingston County",2,57,951,476,475
050,36,051,"New York","Livingston County",2,58,981,484,497
050,36,051,"New York","Livingston County",2,59,982,492,490
050,36,051,"New York","Livingston County",2,60,975,475,500
050,36,051,"New York","Livingston County",2,61,989,488,501
050,36,051,"New York","Livingston County",2,62,954,477,477
050,36,051,"New York","Livingston County",2,63,929,457,472
050,36,051,"New York","Livingston County",2,64,885,445,440
050,36,051,"New York","Livingston County",2,65,859,437,422
050,36,051,"New York","Livingston County",2,66,835,414,421
050,36,051,"New York","Livingston County",2,67,794,387,407
050,36,051,"New York","Livingston County",2,68,749,376,373
050,36,051,"New York","Livingston County",2,69,692,341,351
050,36,051,"New York","Livingston County",2,70,677,333,344
050,36,051,"New York","Livingston County",2,71,673,337,336
050,36,051,"New York","Livingston County",2,72,647,327,320
050,36,051,"New York","Livingston County",2,73,691,336,355
050,36,051,"New York","Livingston County",2,74,464,209,255
050,36,051,"New York","Livingston County",2,75,452,204,248
050,36,051,"New York","Livingston County",2,76,431,201,230
050,36,051,"New York","Livingston County",2,77,444,210,234
050,36,051,"New York","Livingston County",2,78,388,187,201
050,36,051,"New York","Livingston County",2,79,318,141,177
050,36,051,"New York","Livingston County",2,80,273,122,151
050,36,051,"New York","Livingston County",2,81,255,111,144
050,36,051,"New York","Livingston County",2,82,280,120,160
050,36,051,"New York","Livingston County",2,83,235,115,120
050,36,051,"New York","Livingston County",2,84,209,99,110
050,36,051,"New York","Livingston County",2,85,1346,487,859
050,36,051,"New York","Livingston County",3,0,487,242,245
050,36,051,"New York","Livingston County",3,1,544,301,243
050,36,051,"New York","Livingston County",3,2,513,257,256
050,36,051,"New York","Livingston County",3,3,527,261,266
050,36,051,"New York","Livingston County",3,4,558,290,268
050,36,051,"New York","Livingston County",3,5,592,302,290
050,36,051,"New York","Livingston County",3,6,565,290,275
050,36,051,"New York","Livingston County",3,7,583,308,275
050,36,051,"New York","Livingston County",3,8,608,326,282
050,36,051,"New York","Livingston County",3,9,616,313,303
050,36,051,"New York","Livingston County",3,10,644,327,317
050,36,051,"New York","Livingston County",3,11,661,343,318
050,36,051,"New York","Livingston County",3,12,656,348,308
050,36,051,"New York","Livingston County",3,13,712,365,347
050,36,051,"New York","Livingston County",3,14,695,346,349
050,36,051,"New York","Livingston County",3,15,703,364,339
050,36,051,"New York","Livingston County",3,16,719,368,351
050,36,051,"New York","Livingston County",3,17,717,360,357
050,36,051,"New York","Livingston County",3,18,1246,568,678
050,36,051,"New York","Livingston County",3,19,1674,783,891
050,36,051,"New York","Livingston County",3,20,1675,733,942
050,36,051,"New York","Livingston County",3,21,1681,747,934
050,36,051,"New York","Livingston County",3,22,1215,619,596
050,36,051,"New York","Livingston County",3,23,806,439,367
050,36,051,"New York","Livingston County",3,24,715,367,348
050,36,051,"New York","Livingston County",3,25,673,361,312
050,36,051,"New York","Livingston County",3,26,629,343,286
050,36,051,"New York","Livingston County",3,27,618,332,286
050,36,051,"New York","Livingston County",3,28,637,348,289
050,36,051,"New York","Livingston County",3,29,623,346,277
050,36,051,"New York","Livingston County",3,30,577,332,245
050,36,051,"New York","Livingston County",3,31,640,368,272
050,36,051,"New York","Livingston County",3,32,606,342,264
050,36,051,"New York","Livingston County",3,33,643,333,310
050,36,051,"New York","Livingston County",3,34,637,329,308
050,36,051,"New York","Livingston County",3,35,687,372,315
050,36,051,"New York","Livingston County",3,36,693,365,328
050,36,051,"New York","Livingston County",3,37,694,365,329
050,36,051,"New York","Livingston County",3,38,715,360,355
050,36,051,"New York","Livingston County",3,39,737,382,355
050,36,051,"New York","Livingston County",3,40,728,372,356
050,36,051,"New York","Livingston County",3,41,687,352,335
050,36,051,"New York","Livingston County",3,42,663,354,309
050,36,051,"New York","Livingston County",3,43,646,345,301
050,36,051,"New York","Livingston County",3,44,632,340,292
050,36,051,"New York","Livingston County",3,45,621,328,293
050,36,051,"New York","Livingston County",3,46,607,316,291
050,36,051,"New York","Livingston County",3,47,574,297,277
050,36,051,"New York","Livingston County",3,48,623,321,302
050,36,051,"New York","Livingston County",3,49,691,357,334
050,36,051,"New York","Livingston County",3,50,785,419,366
050,36,051,"New York","Livingston County",3,51,802,411,391
050,36,051,"New York","Livingston County",3,52,780,383,397
050,36,051,"New York","Livingston County",3,53,763,384,379
050,36,051,"New York","Livingston County",3,54,786,376,410
050,36,051,"New York","Livingston County",3,55,833,397,436
050,36,051,"New York","Livingston County",3,56,919,472,447
050,36,051,"New York","Livingston County",3,57,943,481,462
050,36,051,"New York","Livingston County",3,58,938,464,474
050,36,051,"New York","Livingston County",3,59,967,474,493
050,36,051,"New York","Livingston County",3,60,961,476,485
050,36,051,"New York","Livingston County",3,61,975,481,494
050,36,051,"New York","Livingston County",3,62,970,476,494
050,36,051,"New York","Livingston County",3,63,931,460,471
050,36,051,"New York","Livingston County",3,64,913,446,467
050,36,051,"New York","Livingston County",3,65,869,436,433
050,36,051,"New York","Livingston County",3,66,856,436,420
050,36,051,"New York","Livingston County",3,67,829,408,421
050,36,051,"New York","Livingston County",3,68,785,382,403
050,36,051,"New York","Livingston County",3,69,727,367,360
050,36,051,"New York","Livingston County",3,70,687,336,351
050,36,051,"New York","Livingston County",3,71,671,334,337
050,36,051,"New York","Livingston County",3,72,654,318,336
050,36,051,"New York","Livingston County",3,73,632,317,315
050,36,051,"New York","Livingston County",3,74,657,315,342
050,36,051,"New York","Livingston County",3,75,460,208,252
050,36,051,"New York","Livingston County",3,76,422,189,233
050,36,051,"New York","Livingston County",3,77,419,198,221
050,36,051,"New York","Livingston County",3,78,425,198,227
050,36,051,"New York","Livingston County",3,79,371,177,194
050,36,051,"New York","Livingston County",3,80,294,131,163
050,36,051,"New York","Livingston County",3,81,259,120,139
050,36,051,"New York","Livingston County",3,82,250,102,148
050,36,051,"New York","Livingston County",3,83,251,114,137
050,36,051,"New York","Livingston County",3,84,208,94,114
050,36,051,"New York","Livingston County",3,85,1306,485,821
050,36,051,"New York","Livingston County",4,0,511,248,263
050,36,051,"New York","Livingston County",4,1,513,263,250
050,36,051,"New York","Livingston County",4,2,574,312,262
050,36,051,"New York","Livingston County",4,3,535,274,261
050,36,051,"New York","Livingston County",4,4,552,272,280
050,36,051,"New York","Livingston County",4,5,582,297,285
050,36,051,"New York","Livingston County",4,6,593,303,290
050,36,051,"New York","Livingston County",4,7,566,280,286
050,36,051,"New York","Livingston County",4,8,579,309,270
050,36,051,"New York","Livingston County",4,9,612,328,284
050,36,051,"New York","Livingston County",4,10,607,318,289
050,36,051,"New York","Livingston County",4,11,643,327,316
050,36,051,"New York","Livingston County",4,12,654,343,311
050,36,051,"New York","Livingston County",4,13,644,336,308
050,36,051,"New York","Livingston County",4,14,695,358,337
050,36,051,"New York","Livingston County",4,15,692,339,353
050,36,051,"New York","Livingston County",4,16,679,350,329
050,36,051,"New York","Livingston County",4,17,716,359,357
050,36,051,"New York","Livingston County",4,18,1229,557,672
050,36,051,"New York","Livingston County",4,19,1664,776,888
050,36,051,"New York","Livingston County",4,20,1657,729,928
050,36,051,"New York","Livingston County",4,21,1645,706,939
050,36,051,"New York","Livingston County",4,22,1220,628,592
050,36,051,"New York","Livingston County",4,23,808,430,378
050,36,051,"New York","Livingston County",4,24,715,391,324
050,36,051,"New York","Livingston County",4,25,695,359,336
050,36,051,"New York","Livingston County",4,26,616,331,285
050,36,051,"New York","Livingston County",4,27,584,331,253
050,36,051,"New York","Livingston County",4,28,603,305,298
050,36,051,"New York","Livingston County",4,29,649,351,298
050,36,051,"New York","Livingston County",4,30,612,326,286
050,36,051,"New York","Livingston County",4,31,590,339,251
050,36,051,"New York","Livingston County",4,32,649,362,287
050,36,051,"New York","Livingston County",4,33,617,336,281
050,36,051,"New York","Livingston County",4,34,642,329,313
050,36,051,"New York","Livingston County",4,35,655,338,317
050,36,051,"New York","Livingston County",4,36,687,376,311
050,36,051,"New York","Livingston County",4,37,694,361,333
050,36,051,"New York","Livingston County",4,38,682,354,328
050,36,051,"New York","Livingston County",4,39,728,371,357
050,36,051,"New York","Livingston County",4,40,736,385,351
050,36,051,"New York","Livingston County",4,41,722,360,362
050,36,051,"New York","Livingston County",4,42,689,350,339
050,36,051,"New York","Livingston County",4,43,658,348,310
050,36,051,"New York","Livingston County",4,44,639,339,300
050,36,051,"New York","Livingston County",4,45,632,343,289
050,36,051,"New York","Livingston County",4,46,626,324,302
050,36,051,"New York","Livingston County",4,47,608,319,289
050,36,051,"New York","Livingston County",4,48,560,285,275
050,36,051,"New York","Livingston County",4,49,601,309,292
050,36,051,"New York","Livingston County",4,50,685,358,327
050,36,051,"New York","Livingston County",4,51,792,420,372
050,36,051,"New York","Livingston County",4,52,793,408,385
050,36,051,"New York","Livingston County",4,53,781,379,402
050,36,051,"New York","Livingston County",4,54,764,385,379
050,36,051,"New York","Livingston County",4,55,778,370,408
050,36,051,"New York","Livingston County",4,56,837,405,432
050,36,051,"New York","Livingston County",4,57,899,450,449
050,36,051,"New York","Livingston County",4,58,925,471,454
050,36,051,"New York","Livingston County",4,59,931,461,470
050,36,051,"New York","Livingston County",4,60,948,457,491
050,36,051,"New York","Livingston County",4,61,959,473,486
050,36,051,"New York","Livingston County",4,62,961,469,492
050,36,051,"New York","Livingston County",4,63,951,468,483
050,36,051,"New York","Livingston County",4,64,924,462,462
050,36,051,"New York","Livingston County",4,65,901,433,468
050,36,051,"New York","Livingston County",4,66,847,423,424
050,36,051,"New York","Livingston County",4,67,838,424,414
050,36,051,"New York","Livingston County",4,68,805,392,413
050,36,051,"New York","Livingston County",4,69,760,366,394
050,36,051,"New York","Livingston County",4,70,721,357,364
050,36,051,"New York","Livingston County",4,71,665,331,334
050,36,051,"New York","Livingston County",4,72,653,322,331
050,36,051,"New York","Livingston County",4,73,642,311,331
050,36,051,"New York","Livingston County",4,74,591,293,298
050,36,051,"New York","Livingston County",4,75,640,303,337
050,36,051,"New York","Livingston County",4,76,428,189,239
050,36,051,"New York","Livingston County",4,77,409,188,221
050,36,051,"New York","Livingston County",4,78,406,190,216
050,36,051,"New York","Livingston County",4,79,403,192,211
050,36,051,"New York","Livingston County",4,80,346,165,181
050,36,051,"New York","Livingston County",4,81,283,128,155
050,36,051,"New York","Livingston County",4,82,249,109,140
050,36,051,"New York","Livingston County",4,83,232,101,131
050,36,051,"New York","Livingston County",4,84,231,100,131
050,36,051,"New York","Livingston County",4,85,1303,484,819
050,36,051,"New York","Livingston County",5,0,511,248,263
050,36,051,"New York","Livingston County",5,1,534,266,268
050,36,051,"New York","Livingston County",5,2,525,271,254
050,36,051,"New York","Livingston County",5,3,562,313,249
050,36,051,"New York","Livingston County",5,4,546,282,264
050,36,051,"New York","Livingston County",5,5,555,273,282
050,36,051,"New York","Livingston County",5,6,577,292,285
050,36,051,"New York","Livingston County",5,7,596,301,295
050,36,051,"New York","Livingston County",5,8,568,282,286
050,36,051,"New York","Livingston County",5,9,575,310,265
050,36,051,"New York","Livingston County",5,10,617,330,287
050,36,051,"New York","Livingston County",5,11,598,305,293
050,36,051,"New York","Livingston County",5,12,636,334,302
050,36,051,"New York","Livingston County",5,13,642,339,303
050,36,051,"New York","Livingston County",5,14,650,343,307
050,36,051,"New York","Livingston County",5,15,705,369,336
050,36,051,"New York","Livingston County",5,16,683,333,350
050,36,051,"New York","Livingston County",5,17,693,358,335
050,36,051,"New York","Livingston County",5,18,1226,554,672
050,36,051,"New York","Livingston County",5,19,1655,770,885
050,36,051,"New York","Livingston County",5,20,1661,732,929
050,36,051,"New York","Livingston County",5,21,1610,700,910
050,36,051,"New York","Livingston County",5,22,1172,589,583
050,36,051,"New York","Livingston County",5,23,814,442,372
050,36,051,"New York","Livingston County",5,24,719,389,330
050,36,051,"New York","Livingston County",5,25,701,383,318
050,36,051,"New York","Livingston County",5,26,630,327,303
050,36,051,"New York","Livingston County",5,27,584,324,260
050,36,051,"New York","Livingston County",5,28,587,326,261
050,36,051,"New York","Livingston County",5,29,601,315,286
050,36,051,"New York","Livingston County",5,30,650,344,306
050,36,051,"New York","Livingston County",5,31,612,327,285
050,36,051,"New York","Livingston County",5,32,605,342,263
050,36,051,"New York","Livingston County",5,33,655,361,294
050,36,051,"New York","Livingston County",5,34,624,335,289
050,36,051,"New York","Livingston County",5,35,628,318,310
050,36,051,"New York","Livingston County",5,36,675,344,331
050,36,051,"New York","Livingston County",5,37,716,390,326
050,36,051,"New York","Livingston County",5,38,677,343,334
050,36,051,"New York","Livingston County",5,39,698,369,329
050,36,051,"New York","Livingston County",5,40,728,375,353
050,36,051,"New York","Livingston County",5,41,730,374,356
050,36,051,"New York","Livingston County",5,42,706,354,352
050,36,051,"New York","Livingston County",5,43,681,336,345
050,36,051,"New York","Livingston County",5,44,664,355,309
050,36,051,"New York","Livingston County",5,45,642,336,306
050,36,051,"New York","Livingston County",5,46,645,350,295
050,36,051,"New York","Livingston County",5,47,624,326,298
050,36,051,"New York","Livingston County",5,48,599,306,293
050,36,051,"New York","Livingston County",5,49,549,282,267
050,36,051,"New York","Livingston County",5,50,596,306,290
050,36,051,"New York","Livingston County",5,51,687,353,334
050,36,051,"New York","Livingston County",5,52,790,420,370
050,36,051,"New York","Livingston County",5,53,775,404,371
050,36,051,"New York","Livingston County",5,54,787,386,401
050,36,051,"New York","Livingston County",5,55,739,368,371
050,36,051,"New York","Livingston County",5,56,793,376,417
050,36,051,"New York","Livingston County",5,57,815,388,427
050,36,051,"New York","Livingston County",5,58,901,442,459
050,36,051,"New York","Livingston County",5,59,936,478,458
050,36,051,"New York","Livingston County",5,60,919,445,474
050,36,051,"New York","Livingston County",5,61,937,460,477
050,36,051,"New York","Livingston County",5,62,945,465,480
050,36,051,"New York","Livingston County",5,63,948,466,482
050,36,051,"New York","Livingston County",5,64,958,476,482
050,36,051,"New York","Livingston County",5,65,915,451,464
050,36,051,"New York","Livingston County",5,66,890,426,464
050,36,051,"New York","Livingston County",5,67,836,419,417
050,36,051,"New York","Livingston County",5,68,820,409,411
050,36,051,"New York","Livingston County",5,69,778,376,402
050,36,051,"New York","Livingston County",5,70,753,357,396
050,36,051,"New York","Livingston County",5,71,708,359,349
050,36,051,"New York","Livingston County",5,72,655,325,330
050,36,051,"New York","Livingston County",5,73,641,314,327
050,36,051,"New York","Livingston County",5,74,618,298,320
050,36,051,"New York","Livingston County",5,75,584,291,293
050,36,051,"New York","Livingston County",5,76,608,284,324
050,36,051,"New York","Livingston County",5,77,417,187,230
050,36,051,"New York","Livingston County",5,78,402,185,217
050,36,051,"New York","Livingston County",5,79,391,181,210
050,36,051,"New York","Livingston County",5,80,370,173,197
050,36,051,"New York","Livingston County",5,81,333,165,168
050,36,051,"New York","Livingston County",5,82,278,121,157
050,36,051,"New York","Livingston County",5,83,228,106,122
050,36,051,"New York","Livingston County",5,84,213,90,123
050,36,051,"New York","Livingston County",5,85,1353,484,869
050,36,053,"New York","Madison County",1,0,609,310,299
050,36,053,"New York","Madison County",1,1,650,330,320
050,36,053,"New York","Madison County",1,2,667,351,316
050,36,053,"New York","Madison County",1,3,665,353,312
050,36,053,"New York","Madison County",1,4,664,367,297
050,36,053,"New York","Madison County",1,5,639,346,293
050,36,053,"New York","Madison County",1,6,676,378,298
050,36,053,"New York","Madison County",1,7,704,361,343
050,36,053,"New York","Madison County",1,8,709,371,338
050,36,053,"New York","Madison County",1,9,686,362,324
050,36,053,"New York","Madison County",1,10,721,364,357
050,36,053,"New York","Madison County",1,11,751,392,359
050,36,053,"New York","Madison County",1,12,814,405,409
050,36,053,"New York","Madison County",1,13,782,391,391
050,36,053,"New York","Madison County",1,14,785,397,388
050,36,053,"New York","Madison County",1,15,783,417,366
050,36,053,"New York","Madison County",1,16,803,403,400
050,36,053,"New York","Madison County",1,17,827,393,434
050,36,053,"New York","Madison County",1,18,1535,718,817
050,36,053,"New York","Madison County",1,19,1946,894,1052
050,36,053,"New York","Madison County",1,20,1584,787,797
050,36,053,"New York","Madison County",1,21,1412,661,751
050,36,053,"New York","Madison County",1,22,1001,499,502
050,36,053,"New York","Madison County",1,23,783,429,354
050,36,053,"New York","Madison County",1,24,723,377,346
050,36,053,"New York","Madison County",1,25,697,349,348
050,36,053,"New York","Madison County",1,26,681,339,342
050,36,053,"New York","Madison County",1,27,658,328,330
050,36,053,"New York","Madison County",1,28,679,346,333
050,36,053,"New York","Madison County",1,29,679,336,343
050,36,053,"New York","Madison County",1,30,724,364,360
050,36,053,"New York","Madison County",1,31,701,356,345
050,36,053,"New York","Madison County",1,32,710,357,353
050,36,053,"New York","Madison County",1,33,711,341,370
050,36,053,"New York","Madison County",1,34,724,363,361
050,36,053,"New York","Madison County",1,35,738,387,351
050,36,053,"New York","Madison County",1,36,761,402,359
050,36,053,"New York","Madison County",1,37,749,377,372
050,36,053,"New York","Madison County",1,38,742,379,363
050,36,053,"New York","Madison County",1,39,748,380,368
050,36,053,"New York","Madison County",1,40,775,406,369
050,36,053,"New York","Madison County",1,41,717,376,341
050,36,053,"New York","Madison County",1,42,677,338,339
050,36,053,"New York","Madison County",1,43,664,332,332
050,36,053,"New York","Madison County",1,44,701,337,364
050,36,053,"New York","Madison County",1,45,693,346,347
050,36,053,"New York","Madison County",1,46,672,347,325
050,36,053,"New York","Madison County",1,47,711,360,351
050,36,053,"New York","Madison County",1,48,828,409,419
050,36,053,"New York","Madison County",1,49,880,429,451
050,36,053,"New York","Madison County",1,50,869,427,442
050,36,053,"New York","Madison County",1,51,846,420,426
050,36,053,"New York","Madison County",1,52,859,423,436
050,36,053,"New York","Madison County",1,53,994,523,471
050,36,053,"New York","Madison County",1,54,1009,510,499
050,36,053,"New York","Madison County",1,55,1037,533,504
050,36,053,"New York","Madison County",1,56,1097,533,564
050,36,053,"New York","Madison County",1,57,1068,510,558
050,36,053,"New York","Madison County",1,58,1080,535,545
050,36,053,"New York","Madison County",1,59,1086,552,534
050,36,053,"New York","Madison County",1,60,1082,551,531
050,36,053,"New York","Madison County",1,61,1096,575,521
050,36,053,"New York","Madison County",1,62,1095,556,539
050,36,053,"New York","Madison County",1,63,1073,531,542
050,36,053,"New York","Madison County",1,64,1028,513,515
050,36,053,"New York","Madison County",1,65,951,465,486
050,36,053,"New York","Madison County",1,66,886,440,446
050,36,053,"New York","Madison County",1,67,870,434,436
050,36,053,"New York","Madison County",1,68,857,442,415
050,36,053,"New York","Madison County",1,69,800,399,401
050,36,053,"New York","Madison County",1,70,714,360,354
050,36,053,"New York","Madison County",1,71,697,340,357
050,36,053,"New York","Madison County",1,72,713,342,371
050,36,053,"New York","Madison County",1,73,720,348,372
050,36,053,"New York","Madison County",1,74,480,229,251
050,36,053,"New York","Madison County",1,75,490,238,252
050,36,053,"New York","Madison County",1,76,493,247,246
050,36,053,"New York","Madison County",1,77,507,238,269
050,36,053,"New York","Madison County",1,78,440,205,235
050,36,053,"New York","Madison County",1,79,391,158,233
050,36,053,"New York","Madison County",1,80,328,140,188
050,36,053,"New York","Madison County",1,81,311,137,174
050,36,053,"New York","Madison County",1,82,305,132,173
050,36,053,"New York","Madison County",1,83,268,126,142
050,36,053,"New York","Madison County",1,84,227,102,125
050,36,053,"New York","Madison County",1,85,1311,479,832
050,36,053,"New York","Madison County",2,0,611,295,316
050,36,053,"New York","Madison County",2,1,640,326,314
050,36,053,"New York","Madison County",2,2,662,347,315
050,36,053,"New York","Madison County",2,3,664,356,308
050,36,053,"New York","Madison County",2,4,668,366,302
050,36,053,"New York","Madison County",2,5,647,353,294
050,36,053,"New York","Madison County",2,6,670,371,299
050,36,053,"New York","Madison County",2,7,698,367,331
050,36,053,"New York","Madison County",2,8,704,368,336
050,36,053,"New York","Madison County",2,9,694,367,327
050,36,053,"New York","Madison County",2,10,709,362,347
050,36,053,"New York","Madison County",2,11,742,385,357
050,36,053,"New York","Madison County",2,12,804,406,398
050,36,053,"New York","Madison County",2,13,790,395,395
050,36,053,"New York","Madison County",2,14,782,395,387
050,36,053,"New York","Madison County",2,15,784,413,371
050,36,053,"New York","Madison County",2,16,799,406,393
050,36,053,"New York","Madison County",2,17,820,395,425
050,36,053,"New York","Madison County",2,18,1527,709,818
050,36,053,"New York","Madison County",2,19,1936,884,1052
050,36,053,"New York","Madison County",2,20,1586,785,801
050,36,053,"New York","Madison County",2,21,1415,669,746
050,36,053,"New York","Madison County",2,22,1002,496,506
050,36,053,"New York","Madison County",2,23,783,425,358
050,36,053,"New York","Madison County",2,24,726,380,346
050,36,053,"New York","Madison County",2,25,695,349,346
050,36,053,"New York","Madison County",2,26,680,337,343
050,36,053,"New York","Madison County",2,27,661,328,333
050,36,053,"New York","Madison County",2,28,673,342,331
050,36,053,"New York","Madison County",2,29,686,342,344
050,36,053,"New York","Madison County",2,30,716,358,358
050,36,053,"New York","Madison County",2,31,704,358,346
050,36,053,"New York","Madison County",2,32,711,358,353
050,36,053,"New York","Madison County",2,33,713,346,367
050,36,053,"New York","Madison County",2,34,722,359,363
050,36,053,"New York","Madison County",2,35,745,387,358
050,36,053,"New York","Madison County",2,36,750,395,355
050,36,053,"New York","Madison County",2,37,755,385,370
050,36,053,"New York","Madison County",2,38,740,376,364
050,36,053,"New York","Madison County",2,39,750,384,366
050,36,053,"New York","Madison County",2,40,769,402,367
050,36,053,"New York","Madison County",2,41,728,382,346
050,36,053,"New York","Madison County",2,42,682,345,337
050,36,053,"New York","Madison County",2,43,671,334,337
050,36,053,"New York","Madison County",2,44,679,329,350
050,36,053,"New York","Madison County",2,45,697,345,352
050,36,053,"New York","Madison County",2,46,673,344,329
050,36,053,"New York","Madison County",2,47,699,355,344
050,36,053,"New York","Madison County",2,48,798,396,402
050,36,053,"New York","Madison County",2,49,870,428,442
050,36,053,"New York","Madison County",2,50,870,426,444
050,36,053,"New York","Madison County",2,51,847,419,428
050,36,053,"New York","Madison County",2,52,848,418,430
050,36,053,"New York","Madison County",2,53,960,497,463
050,36,053,"New York","Madison County",2,54,1004,513,491
050,36,053,"New York","Madison County",2,55,1024,522,502
050,36,053,"New York","Madison County",2,56,1083,533,550
050,36,053,"New York","Madison County",2,57,1078,518,560
050,36,053,"New York","Madison County",2,58,1075,528,547
050,36,053,"New York","Madison County",2,59,1088,549,539
050,36,053,"New York","Madison County",2,60,1079,549,530
050,36,053,"New York","Madison County",2,61,1085,565,520
050,36,053,"New York","Madison County",2,62,1089,557,532
050,36,053,"New York","Madison County",2,63,1088,543,545
050,36,053,"New York","Madison County",2,64,1030,514,516
050,36,053,"New York","Madison County",2,65,964,473,491
050,36,053,"New York","Madison County",2,66,902,446,456
050,36,053,"New York","Madison County",2,67,868,434,434
050,36,053,"New York","Madison County",2,68,848,435,413
050,36,053,"New York","Madison County",2,69,818,413,405
050,36,053,"New York","Madison County",2,70,726,364,362
050,36,053,"New York","Madison County",2,71,703,345,358
050,36,053,"New York","Madison County",2,72,695,335,360
050,36,053,"New York","Madison County",2,73,748,359,389
050,36,053,"New York","Madison County",2,74,502,240,262
050,36,053,"New York","Madison County",2,75,491,238,253
050,36,053,"New York","Madison County",2,76,486,244,242
050,36,053,"New York","Madison County",2,77,509,243,266
050,36,053,"New York","Madison County",2,78,446,208,238
050,36,053,"New York","Madison County",2,79,399,166,233
050,36,053,"New York","Madison County",2,80,340,145,195
050,36,053,"New York","Madison County",2,81,304,133,171
050,36,053,"New York","Madison County",2,82,303,129,174
050,36,053,"New York","Madison County",2,83,270,124,146
050,36,053,"New York","Madison County",2,84,232,104,128
050,36,053,"New York","Madison County",2,85,1303,480,823
050,36,053,"New York","Madison County",3,0,545,275,270
050,36,053,"New York","Madison County",3,1,635,304,331
050,36,053,"New York","Madison County",3,2,632,326,306
050,36,053,"New York","Madison County",3,3,645,343,302
050,36,053,"New York","Madison County",3,4,687,363,324
050,36,053,"New York","Madison County",3,5,645,357,288
050,36,053,"New York","Madison County",3,6,654,359,295
050,36,053,"New York","Madison County",3,7,693,385,308
050,36,053,"New York","Madison County",3,8,686,363,323
050,36,053,"New York","Madison County",3,9,708,366,342
050,36,053,"New York","Madison County",3,10,701,367,334
050,36,053,"New York","Madison County",3,11,694,357,337
050,36,053,"New York","Madison County",3,12,721,377,344
050,36,053,"New York","Madison County",3,13,804,405,399
050,36,053,"New York","Madison County",3,14,778,385,393
050,36,053,"New York","Madison County",3,15,774,392,382
050,36,053,"New York","Madison County",3,16,772,404,368
050,36,053,"New York","Madison County",3,17,791,395,396
050,36,053,"New York","Madison County",3,18,1466,673,793
050,36,053,"New York","Madison County",3,19,1812,816,996
050,36,053,"New York","Madison County",3,20,1495,729,766
050,36,053,"New York","Madison County",3,21,1360,671,689
050,36,053,"New York","Madison County",3,22,1004,502,502
050,36,053,"New York","Madison County",3,23,737,385,352
050,36,053,"New York","Madison County",3,24,715,384,331
050,36,053,"New York","Madison County",3,25,712,378,334
050,36,053,"New York","Madison County",3,26,663,332,331
050,36,053,"New York","Madison County",3,27,682,338,344
050,36,053,"New York","Madison County",3,28,695,355,340
050,36,053,"New York","Madison County",3,29,668,334,334
050,36,053,"New York","Madison County",3,30,710,355,355
050,36,053,"New York","Madison County",3,31,731,368,363
050,36,053,"New York","Madison County",3,32,724,373,351
050,36,053,"New York","Madison County",3,33,735,370,365
050,36,053,"New York","Madison County",3,34,727,350,377
050,36,053,"New York","Madison County",3,35,716,350,366
050,36,053,"New York","Madison County",3,36,753,386,367
050,36,053,"New York","Madison County",3,37,750,399,351
050,36,053,"New York","Madison County",3,38,774,389,385
050,36,053,"New York","Madison County",3,39,754,385,369
050,36,053,"New York","Madison County",3,40,748,387,361
050,36,053,"New York","Madison County",3,41,796,416,380
050,36,053,"New York","Madison County",3,42,732,386,346
050,36,053,"New York","Madison County",3,43,679,345,334
050,36,053,"New York","Madison County",3,44,673,337,336
050,36,053,"New York","Madison County",3,45,678,331,347
050,36,053,"New York","Madison County",3,46,688,335,353
050,36,053,"New York","Madison County",3,47,665,348,317
050,36,053,"New York","Madison County",3,48,689,344,345
050,36,053,"New York","Madison County",3,49,799,401,398
050,36,053,"New York","Madison County",3,50,864,417,447
050,36,053,"New York","Madison County",3,51,883,437,446
050,36,053,"New York","Madison County",3,52,842,407,435
050,36,053,"New York","Madison County",3,53,851,413,438
050,36,053,"New York","Madison County",3,54,968,497,471
050,36,053,"New York","Madison County",3,55,991,499,492
050,36,053,"New York","Madison County",3,56,1038,528,510
050,36,053,"New York","Madison County",3,57,1075,526,549
050,36,053,"New York","Madison County",3,58,1083,519,564
050,36,053,"New York","Madison County",3,59,1078,534,544
050,36,053,"New York","Madison County",3,60,1094,555,539
050,36,053,"New York","Madison County",3,61,1059,542,517
050,36,053,"New York","Madison County",3,62,1059,549,510
050,36,053,"New York","Madison County",3,63,1083,549,534
050,36,053,"New York","Madison County",3,64,1067,539,528
050,36,053,"New York","Madison County",3,65,1006,506,500
050,36,053,"New York","Madison County",3,66,946,466,480
050,36,053,"New York","Madison County",3,67,877,430,447
050,36,053,"New York","Madison County",3,68,861,430,431
050,36,053,"New York","Madison County",3,69,838,428,410
050,36,053,"New York","Madison County",3,70,798,405,393
050,36,053,"New York","Madison County",3,71,713,357,356
050,36,053,"New York","Madison County",3,72,688,337,351
050,36,053,"New York","Madison County",3,73,672,316,356
050,36,053,"New York","Madison County",3,74,744,352,392
050,36,053,"New York","Madison County",3,75,479,230,249
050,36,053,"New York","Madison County",3,76,473,224,249
050,36,053,"New York","Madison County",3,77,462,227,235
050,36,053,"New York","Madison County",3,78,492,236,256
050,36,053,"New York","Madison County",3,79,418,187,231
050,36,053,"New York","Madison County",3,80,377,162,215
050,36,053,"New York","Madison County",3,81,307,126,181
050,36,053,"New York","Madison County",3,82,270,114,156
050,36,053,"New York","Madison County",3,83,274,123,151
050,36,053,"New York","Madison County",3,84,248,110,138
050,36,053,"New York","Madison County",3,85,1309,498,811
050,36,053,"New York","Madison County",4,0,545,273,272
050,36,053,"New York","Madison County",4,1,561,292,269
050,36,053,"New York","Madison County",4,2,664,326,338
050,36,053,"New York","Madison County",4,3,633,326,307
050,36,053,"New York","Madison County",4,4,657,342,315
050,36,053,"New York","Madison County",4,5,701,361,340
050,36,053,"New York","Madison County",4,6,649,354,295
050,36,053,"New York","Madison County",4,7,666,355,311
050,36,053,"New York","Madison County",4,8,696,388,308
050,36,053,"New York","Madison County",4,9,687,364,323
050,36,053,"New York","Madison County",4,10,703,369,334
050,36,053,"New York","Madison County",4,11,702,370,332
050,36,053,"New York","Madison County",4,12,695,359,336
050,36,053,"New York","Madison County",4,13,725,376,349
050,36,053,"New York","Madison County",4,14,804,402,402
050,36,053,"New York","Madison County",4,15,788,389,399
050,36,053,"New York","Madison County",4,16,782,388,394
050,36,053,"New York","Madison County",4,17,784,405,379
050,36,053,"New York","Madison County",4,18,1460,694,766
050,36,053,"New York","Madison County",4,19,1770,791,979
050,36,053,"New York","Madison County",4,20,1462,699,763
050,36,053,"New York","Madison County",4,21,1350,645,705
050,36,053,"New York","Madison County",4,22,980,503,477
050,36,053,"New York","Madison County",4,23,782,400,382
050,36,053,"New York","Madison County",4,24,677,351,326
050,36,053,"New York","Madison County",4,25,690,373,317
050,36,053,"New York","Madison County",4,26,669,359,310
050,36,053,"New York","Madison County",4,27,638,329,309
050,36,053,"New York","Madison County",4,28,677,337,340
050,36,053,"New York","Madison County",4,29,699,350,349
050,36,053,"New York","Madison County",4,30,653,331,322
050,36,053,"New York","Madison County",4,31,725,356,369
050,36,053,"New York","Madison County",4,32,708,355,353
050,36,053,"New York","Madison County",4,33,723,376,347
050,36,053,"New York","Madison County",4,34,724,372,352
050,36,053,"New York","Madison County",4,35,750,359,391
050,36,053,"New York","Madison County",4,36,721,342,379
050,36,053,"New York","Madison County",4,37,739,372,367
050,36,053,"New York","Madison County",4,38,758,400,358
050,36,053,"New York","Madison County",4,39,785,389,396
050,36,053,"New York","Madison County",4,40,757,389,368
050,36,053,"New York","Madison County",4,41,743,384,359
050,36,053,"New York","Madison County",4,42,807,423,384
050,36,053,"New York","Madison County",4,43,743,394,349
050,36,053,"New York","Madison County",4,44,692,351,341
050,36,053,"New York","Madison County",4,45,675,343,332
050,36,053,"New York","Madison County",4,46,663,319,344
050,36,053,"New York","Madison County",4,47,687,339,348
050,36,053,"New York","Madison County",4,48,664,339,325
050,36,053,"New York","Madison County",4,49,676,340,336
050,36,053,"New York","Madison County",4,50,788,388,400
050,36,053,"New York","Madison County",4,51,846,410,436
050,36,053,"New York","Madison County",4,52,869,423,446
050,36,053,"New York","Madison County",4,53,854,409,445
050,36,053,"New York","Madison County",4,54,848,415,433
050,36,053,"New York","Madison County",4,55,945,487,458
050,36,053,"New York","Madison County",4,56,988,502,486
050,36,053,"New York","Madison County",4,57,1020,516,504
050,36,053,"New York","Madison County",4,58,1078,529,549
050,36,053,"New York","Madison County",4,59,1063,502,561
050,36,053,"New York","Madison County",4,60,1068,529,539
050,36,053,"New York","Madison County",4,61,1076,547,529
050,36,053,"New York","Madison County",4,62,1054,533,521
050,36,053,"New York","Madison County",4,63,1050,551,499
050,36,053,"New York","Madison County",4,64,1066,541,525
050,36,053,"New York","Madison County",4,65,1049,518,531
050,36,053,"New York","Madison County",4,66,1000,505,495
050,36,053,"New York","Madison County",4,67,950,465,485
050,36,053,"New York","Madison County",4,68,859,419,440
050,36,053,"New York","Madison County",4,69,844,420,424
050,36,053,"New York","Madison County",4,70,812,413,399
050,36,053,"New York","Madison County",4,71,786,395,391
050,36,053,"New York","Madison County",4,72,703,351,352
050,36,053,"New York","Madison County",4,73,667,321,346
050,36,053,"New York","Madison County",4,74,654,309,345
050,36,053,"New York","Madison County",4,75,712,338,374
050,36,053,"New York","Madison County",4,76,458,219,239
050,36,053,"New York","Madison County",4,77,451,211,240
050,36,053,"New York","Madison County",4,78,440,212,228
050,36,053,"New York","Madison County",4,79,479,224,255
050,36,053,"New York","Madison County",4,80,405,178,227
050,36,053,"New York","Madison County",4,81,358,151,207
050,36,053,"New York","Madison County",4,82,282,106,176
050,36,053,"New York","Madison County",4,83,251,108,143
050,36,053,"New York","Madison County",4,84,248,106,142
050,36,053,"New York","Madison County",4,85,1344,519,825
050,36,053,"New York","Madison County",5,0,544,272,272
050,36,053,"New York","Madison County",5,1,548,268,280
050,36,053,"New York","Madison County",5,2,564,282,282
050,36,053,"New York","Madison County",5,3,659,321,338
050,36,053,"New York","Madison County",5,4,641,327,314
050,36,053,"New York","Madison County",5,5,684,356,328
050,36,053,"New York","Madison County",5,6,697,368,329
050,36,053,"New York","Madison County",5,7,652,355,297
050,36,053,"New York","Madison County",5,8,667,353,314
050,36,053,"New York","Madison County",5,9,711,398,313
050,36,053,"New York","Madison County",5,10,694,371,323
050,36,053,"New York","Madison County",5,11,703,364,339
050,36,053,"New York","Madison County",5,12,689,359,330
050,36,053,"New York","Madison County",5,13,700,362,338
050,36,053,"New York","Madison County",5,14,724,374,350
050,36,053,"New York","Madison County",5,15,800,400,400
050,36,053,"New York","Madison County",5,16,803,404,399
050,36,053,"New York","Madison County",5,17,801,400,401
050,36,053,"New York","Madison County",5,18,1429,686,743
050,36,053,"New York","Madison County",5,19,1797,823,974
050,36,053,"New York","Madison County",5,20,1419,680,739
050,36,053,"New York","Madison County",5,21,1304,616,688
050,36,053,"New York","Madison County",5,22,985,497,488
050,36,053,"New York","Madison County",5,23,767,413,354
050,36,053,"New York","Madison County",5,24,714,357,357
050,36,053,"New York","Madison County",5,25,681,348,333
050,36,053,"New York","Madison County",5,26,656,348,308
050,36,053,"New York","Madison County",5,27,638,337,301
050,36,053,"New York","Madison County",5,28,642,331,311
050,36,053,"New York","Madison County",5,29,664,325,339
050,36,053,"New York","Madison County",5,30,671,338,333
050,36,053,"New York","Madison County",5,31,693,351,342
050,36,053,"New York","Madison County",5,32,756,370,386
050,36,053,"New York","Madison County",5,33,715,363,352
050,36,053,"New York","Madison County",5,34,727,380,347
050,36,053,"New York","Madison County",5,35,753,385,368
050,36,053,"New York","Madison County",5,36,741,359,382
050,36,053,"New York","Madison County",5,37,731,339,392
050,36,053,"New York","Madison County",5,38,736,369,367
050,36,053,"New York","Madison County",5,39,754,390,364
050,36,053,"New York","Madison County",5,40,813,403,410
050,36,053,"New York","Madison County",5,41,765,394,371
050,36,053,"New York","Madison County",5,42,748,386,362
050,36,053,"New York","Madison County",5,43,806,425,381
050,36,053,"New York","Madison County",5,44,741,392,349
050,36,053,"New York","Madison County",5,45,685,346,339
050,36,053,"New York","Madison County",5,46,655,333,322
050,36,053,"New York","Madison County",5,47,660,323,337
050,36,053,"New York","Madison County",5,48,683,334,349
050,36,053,"New York","Madison County",5,49,655,338,317
050,36,053,"New York","Madison County",5,50,668,331,337
050,36,053,"New York","Madison County",5,51,794,396,398
050,36,053,"New York","Madison County",5,52,841,408,433
050,36,053,"New York","Madison County",5,53,860,424,436
050,36,053,"New York","Madison County",5,54,846,405,441
050,36,053,"New York","Madison County",5,55,852,422,430
050,36,053,"New York","Madison County",5,56,954,501,453
050,36,053,"New York","Madison County",5,57,988,502,486
050,36,053,"New York","Madison County",5,58,1008,503,505
050,36,053,"New York","Madison County",5,59,1063,517,546
050,36,053,"New York","Madison County",5,60,1061,499,562
050,36,053,"New York","Madison County",5,61,1069,530,539
050,36,053,"New York","Madison County",5,62,1055,536,519
050,36,053,"New York","Madison County",5,63,1043,530,513
050,36,053,"New York","Madison County",5,64,1032,542,490
050,36,053,"New York","Madison County",5,65,1054,532,522
050,36,053,"New York","Madison County",5,66,1044,512,532
050,36,053,"New York","Madison County",5,67,1002,501,501
050,36,053,"New York","Madison County",5,68,939,453,486
050,36,053,"New York","Madison County",5,69,859,416,443
050,36,053,"New York","Madison County",5,70,835,412,423
050,36,053,"New York","Madison County",5,71,789,404,385
050,36,053,"New York","Madison County",5,72,775,391,384
050,36,053,"New York","Madison County",5,73,684,340,344
050,36,053,"New York","Madison County",5,74,652,316,336
050,36,053,"New York","Madison County",5,75,628,300,328
050,36,053,"New York","Madison County",5,76,689,323,366
050,36,053,"New York","Madison County",5,77,431,203,228
050,36,053,"New York","Madison County",5,78,434,201,233
050,36,053,"New York","Madison County",5,79,428,199,229
050,36,053,"New York","Madison County",5,80,464,216,248
050,36,053,"New York","Madison County",5,81,379,167,212
050,36,053,"New York","Madison County",5,82,334,136,198
050,36,053,"New York","Madison County",5,83,253,95,158
050,36,053,"New York","Madison County",5,84,234,94,140
050,36,053,"New York","Madison County",5,85,1415,544,871
050,36,055,"New York","Monroe County",1,0,7726,3929,3797
050,36,055,"New York","Monroe County",1,1,7893,4011,3882
050,36,055,"New York","Monroe County",1,2,8204,4172,4032
050,36,055,"New York","Monroe County",1,3,8306,4174,4132
050,36,055,"New York","Monroe County",1,4,8459,4297,4162
050,36,055,"New York","Monroe County",1,5,8684,4465,4219
050,36,055,"New York","Monroe County",1,6,8523,4353,4170
050,36,055,"New York","Monroe County",1,7,8650,4373,4277
050,36,055,"New York","Monroe County",1,8,8647,4359,4288
050,36,055,"New York","Monroe County",1,9,8889,4490,4399
050,36,055,"New York","Monroe County",1,10,8966,4599,4367
050,36,055,"New York","Monroe County",1,11,9039,4667,4372
050,36,055,"New York","Monroe County",1,12,9391,4880,4511
050,36,055,"New York","Monroe County",1,13,9411,4805,4606
050,36,055,"New York","Monroe County",1,14,9126,4599,4527
050,36,055,"New York","Monroe County",1,15,9095,4653,4442
050,36,055,"New York","Monroe County",1,16,9376,4844,4532
050,36,055,"New York","Monroe County",1,17,9479,4889,4590
050,36,055,"New York","Monroe County",1,18,11667,5928,5739
050,36,055,"New York","Monroe County",1,19,11854,6150,5704
050,36,055,"New York","Monroe County",1,20,10844,5458,5386
050,36,055,"New York","Monroe County",1,21,10280,5100,5180
050,36,055,"New York","Monroe County",1,22,9774,4873,4901
050,36,055,"New York","Monroe County",1,23,9502,4703,4799
050,36,055,"New York","Monroe County",1,24,9724,4727,4997
050,36,055,"New York","Monroe County",1,25,9960,4917,5043
050,36,055,"New York","Monroe County",1,26,10415,5190,5225
050,36,055,"New York","Monroe County",1,27,10663,5278,5385
050,36,055,"New York","Monroe County",1,28,10626,5260,5366
050,36,055,"New York","Monroe County",1,29,10845,5323,5522
050,36,055,"New York","Monroe County",1,30,11104,5507,5597
050,36,055,"New York","Monroe County",1,31,10993,5580,5413
050,36,055,"New York","Monroe County",1,32,10693,5265,5428
050,36,055,"New York","Monroe County",1,33,10497,5104,5393
050,36,055,"New York","Monroe County",1,34,10390,5068,5322
050,36,055,"New York","Monroe County",1,35,10173,4969,5204
050,36,055,"New York","Monroe County",1,36,9599,4763,4836
050,36,055,"New York","Monroe County",1,37,9513,4676,4837
050,36,055,"New York","Monroe County",1,38,9426,4661,4765
050,36,055,"New York","Monroe County",1,39,9331,4580,4751
050,36,055,"New York","Monroe County",1,40,9159,4419,4740
050,36,055,"New York","Monroe County",1,41,8456,4072,4384
050,36,055,"New York","Monroe County",1,42,8216,3987,4229
050,36,055,"New York","Monroe County",1,43,8033,3829,4204
050,36,055,"New York","Monroe County",1,44,8042,3832,4210
050,36,055,"New York","Monroe County",1,45,8176,3962,4214
050,36,055,"New York","Monroe County",1,46,7764,3753,4011
050,36,055,"New York","Monroe County",1,47,8059,3845,4214
050,36,055,"New York","Monroe County",1,48,8774,4156,4618
050,36,055,"New York","Monroe County",1,49,9920,4779,5141
050,36,055,"New York","Monroe County",1,50,9956,4884,5072
050,36,055,"New York","Monroe County",1,51,9720,4734,4986
050,36,055,"New York","Monroe County",1,52,9397,4539,4858
050,36,055,"New York","Monroe County",1,53,9719,4725,4994
050,36,055,"New York","Monroe County",1,54,10038,4836,5202
050,36,055,"New York","Monroe County",1,55,10659,5179,5480
050,36,055,"New York","Monroe County",1,56,10683,5188,5495
050,36,055,"New York","Monroe County",1,57,10681,5153,5528
050,36,055,"New York","Monroe County",1,58,10867,5199,5668
050,36,055,"New York","Monroe County",1,59,10991,5269,5722
050,36,055,"New York","Monroe County",1,60,10913,5315,5598
050,36,055,"New York","Monroe County",1,61,10711,5188,5523
050,36,055,"New York","Monroe County",1,62,10484,5154,5330
050,36,055,"New York","Monroe County",1,63,9971,4857,5114
050,36,055,"New York","Monroe County",1,64,9687,4663,5024
050,36,055,"New York","Monroe County",1,65,9460,4536,4924
050,36,055,"New York","Monroe County",1,66,9049,4308,4741
050,36,055,"New York","Monroe County",1,67,8735,4141,4594
050,36,055,"New York","Monroe County",1,68,8417,3970,4447
050,36,055,"New York","Monroe County",1,69,7880,3686,4194
050,36,055,"New York","Monroe County",1,70,7585,3529,4056
050,36,055,"New York","Monroe County",1,71,7324,3307,4017
050,36,055,"New York","Monroe County",1,72,7436,3380,4056
050,36,055,"New York","Monroe County",1,73,7554,3524,4030
050,36,055,"New York","Monroe County",1,74,5336,2404,2932
050,36,055,"New York","Monroe County",1,75,5209,2290,2919
050,36,055,"New York","Monroe County",1,76,5132,2251,2881
050,36,055,"New York","Monroe County",1,77,5217,2299,2918
050,36,055,"New York","Monroe County",1,78,4380,1947,2433
050,36,055,"New York","Monroe County",1,79,3687,1597,2090
050,36,055,"New York","Monroe County",1,80,3363,1412,1951
050,36,055,"New York","Monroe County",1,81,3362,1400,1962
050,36,055,"New York","Monroe County",1,82,3086,1309,1777
050,36,055,"New York","Monroe County",1,83,2675,1074,1601
050,36,055,"New York","Monroe County",1,84,2575,1049,1526
050,36,055,"New York","Monroe County",1,85,17155,5771,11384
050,36,055,"New York","Monroe County",2,0,7750,3937,3813
050,36,055,"New York","Monroe County",2,1,7857,3995,3862
050,36,055,"New York","Monroe County",2,2,8159,4149,4010
050,36,055,"New York","Monroe County",2,3,8267,4168,4099
050,36,055,"New York","Monroe County",2,4,8434,4275,4159
050,36,055,"New York","Monroe County",2,5,8630,4426,4204
050,36,055,"New York","Monroe County",2,6,8574,4388,4186
050,36,055,"New York","Monroe County",2,7,8605,4361,4244
050,36,055,"New York","Monroe County",2,8,8614,4339,4275
050,36,055,"New York","Monroe County",2,9,8815,4452,4363
050,36,055,"New York","Monroe County",2,10,8926,4559,4367
050,36,055,"New York","Monroe County",2,11,8979,4626,4353
050,36,055,"New York","Monroe County",2,12,9342,4847,4495
050,36,055,"New York","Monroe County",2,13,9378,4809,4569
050,36,055,"New York","Monroe County",2,14,9185,4644,4541
050,36,055,"New York","Monroe County",2,15,9093,4633,4460
050,36,055,"New York","Monroe County",2,16,9311,4803,4508
050,36,055,"New York","Monroe County",2,17,9452,4867,4585
050,36,055,"New York","Monroe County",2,18,11405,5814,5591
050,36,055,"New York","Monroe County",2,19,11616,6018,5598
050,36,055,"New York","Monroe County",2,20,10749,5403,5346
050,36,055,"New York","Monroe County",2,21,10159,5041,5118
050,36,055,"New York","Monroe County",2,22,9723,4844,4879
050,36,055,"New York","Monroe County",2,23,9488,4685,4803
050,36,055,"New York","Monroe County",2,24,9631,4704,4927
050,36,055,"New York","Monroe County",2,25,9900,4880,5020
050,36,055,"New York","Monroe County",2,26,10320,5133,5187
050,36,055,"New York","Monroe County",2,27,10590,5243,5347
050,36,055,"New York","Monroe County",2,28,10629,5257,5372
050,36,055,"New York","Monroe County",2,29,10780,5298,5482
050,36,055,"New York","Monroe County",2,30,11079,5477,5602
050,36,055,"New York","Monroe County",2,31,10977,5541,5436
050,36,055,"New York","Monroe County",2,32,10725,5312,5413
050,36,055,"New York","Monroe County",2,33,10514,5128,5386
050,36,055,"New York","Monroe County",2,34,10402,5070,5332
050,36,055,"New York","Monroe County",2,35,10271,5017,5254
050,36,055,"New York","Monroe County",2,36,9682,4784,4898
050,36,055,"New York","Monroe County",2,37,9551,4704,4847
050,36,055,"New York","Monroe County",2,38,9474,4678,4796
050,36,055,"New York","Monroe County",2,39,9303,4569,4734
050,36,055,"New York","Monroe County",2,40,9240,4477,4763
050,36,055,"New York","Monroe County",2,41,8607,4146,4461
050,36,055,"New York","Monroe County",2,42,8226,3990,4236
050,36,055,"New York","Monroe County",2,43,8118,3883,4235
050,36,055,"New York","Monroe County",2,44,7956,3794,4162
050,36,055,"New York","Monroe County",2,45,8170,3937,4233
050,36,055,"New York","Monroe County",2,46,7829,3789,4040
050,36,055,"New York","Monroe County",2,47,7946,3803,4143
050,36,055,"New York","Monroe County",2,48,8593,4077,4516
050,36,055,"New York","Monroe County",2,49,9650,4631,5019
050,36,055,"New York","Monroe County",2,50,9939,4856,5083
050,36,055,"New York","Monroe County",2,51,9715,4742,4973
050,36,055,"New York","Monroe County",2,52,9435,4567,4868
050,36,055,"New York","Monroe County",2,53,9623,4665,4958
050,36,055,"New York","Monroe County",2,54,9901,4775,5126
050,36,055,"New York","Monroe County",2,55,10485,5082,5403
050,36,055,"New York","Monroe County",2,56,10678,5185,5493
050,36,055,"New York","Monroe County",2,57,10651,5143,5508
050,36,055,"New York","Monroe County",2,58,10797,5178,5619
050,36,055,"New York","Monroe County",2,59,10971,5256,5715
050,36,055,"New York","Monroe County",2,60,10874,5277,5597
050,36,055,"New York","Monroe County",2,61,10693,5184,5509
050,36,055,"New York","Monroe County",2,62,10484,5134,5350
050,36,055,"New York","Monroe County",2,63,10135,4944,5191
050,36,055,"New York","Monroe County",2,64,9649,4654,4995
050,36,055,"New York","Monroe County",2,65,9445,4530,4915
050,36,055,"New York","Monroe County",2,66,9128,4354,4774
050,36,055,"New York","Monroe County",2,67,8744,4143,4601
050,36,055,"New York","Monroe County",2,68,8386,3963,4423
050,36,055,"New York","Monroe County",2,69,8025,3756,4269
050,36,055,"New York","Monroe County",2,70,7585,3528,4057
050,36,055,"New York","Monroe County",2,71,7350,3342,4008
050,36,055,"New York","Monroe County",2,72,7257,3298,3959
050,36,055,"New York","Monroe County",2,73,7831,3628,4203
050,36,055,"New York","Monroe County",2,74,5488,2491,2997
050,36,055,"New York","Monroe County",2,75,5224,2304,2920
050,36,055,"New York","Monroe County",2,76,5050,2212,2838
050,36,055,"New York","Monroe County",2,77,5255,2309,2946
050,36,055,"New York","Monroe County",2,78,4451,1979,2472
050,36,055,"New York","Monroe County",2,79,3786,1647,2139
050,36,055,"New York","Monroe County",2,80,3396,1432,1964
050,36,055,"New York","Monroe County",2,81,3290,1376,1914
050,36,055,"New York","Monroe County",2,82,3102,1300,1802
050,36,055,"New York","Monroe County",2,83,2705,1099,1606
050,36,055,"New York","Monroe County",2,84,2540,1032,1508
050,36,055,"New York","Monroe County",2,85,16809,5690,11119
050,36,055,"New York","Monroe County",3,0,7539,3923,3616
050,36,055,"New York","Monroe County",3,1,7779,3935,3844
050,36,055,"New York","Monroe County",3,2,7875,4010,3865
050,36,055,"New York","Monroe County",3,3,8177,4159,4018
050,36,055,"New York","Monroe County",3,4,8231,4149,4082
050,36,055,"New York","Monroe County",3,5,8405,4259,4146
050,36,055,"New York","Monroe County",3,6,8665,4423,4242
050,36,055,"New York","Monroe County",3,7,8569,4403,4166
050,36,055,"New York","Monroe County",3,8,8559,4316,4243
050,36,055,"New York","Monroe County",3,9,8614,4337,4277
050,36,055,"New York","Monroe County",3,10,8780,4427,4353
050,36,055,"New York","Monroe County",3,11,8892,4543,4349
050,36,055,"New York","Monroe County",3,12,8903,4578,4325
050,36,055,"New York","Monroe County",3,13,9259,4798,4461
050,36,055,"New York","Monroe County",3,14,9304,4772,4532
050,36,055,"New York","Monroe County",3,15,9130,4624,4506
050,36,055,"New York","Monroe County",3,16,9029,4620,4409
050,36,055,"New York","Monroe County",3,17,9299,4764,4535
050,36,055,"New York","Monroe County",3,18,11605,5947,5658
050,36,055,"New York","Monroe County",3,19,11852,6151,5701
050,36,055,"New York","Monroe County",3,20,10853,5433,5420
050,36,055,"New York","Monroe County",3,21,10336,5135,5201
050,36,055,"New York","Monroe County",3,22,9724,4842,4882
050,36,055,"New York","Monroe County",3,23,9588,4752,4836
050,36,055,"New York","Monroe County",3,24,9600,4769,4831
050,36,055,"New York","Monroe County",3,25,9764,4827,4937
050,36,055,"New York","Monroe County",3,26,9991,4946,5045
050,36,055,"New York","Monroe County",3,27,10314,5141,5173
050,36,055,"New York","Monroe County",3,28,10560,5225,5335
050,36,055,"New York","Monroe County",3,29,10642,5274,5368
050,36,055,"New York","Monroe County",3,30,10718,5258,5460
050,36,055,"New York","Monroe County",3,31,11077,5494,5583
050,36,055,"New York","Monroe County",3,32,10953,5512,5441
050,36,055,"New York","Monroe County",3,33,10671,5259,5412
050,36,055,"New York","Monroe County",3,34,10534,5170,5364
050,36,055,"New York","Monroe County",3,35,10411,5054,5357
050,36,055,"New York","Monroe County",3,36,10272,5025,5247
050,36,055,"New York","Monroe County",3,37,9599,4714,4885
050,36,055,"New York","Monroe County",3,38,9549,4717,4832
050,36,055,"New York","Monroe County",3,39,9352,4591,4761
050,36,055,"New York","Monroe County",3,40,9322,4586,4736
050,36,055,"New York","Monroe County",3,41,9252,4507,4745
050,36,055,"New York","Monroe County",3,42,8596,4171,4425
050,36,055,"New York","Monroe County",3,43,8170,3963,4207
050,36,055,"New York","Monroe County",3,44,8103,3880,4223
050,36,055,"New York","Monroe County",3,45,7922,3769,4153
050,36,055,"New York","Monroe County",3,46,8166,3949,4217
050,36,055,"New York","Monroe County",3,47,7781,3770,4011
050,36,055,"New York","Monroe County",3,48,7914,3797,4117
050,36,055,"New York","Monroe County",3,49,8467,3994,4473
050,36,055,"New York","Monroe County",3,50,9599,4627,4972
050,36,055,"New York","Monroe County",3,51,9842,4805,5037
050,36,055,"New York","Monroe County",3,52,9646,4705,4941
050,36,055,"New York","Monroe County",3,53,9330,4490,4840
050,36,055,"New York","Monroe County",3,54,9473,4589,4884
050,36,055,"New York","Monroe County",3,55,9751,4708,5043
050,36,055,"New York","Monroe County",3,56,10352,4989,5363
050,36,055,"New York","Monroe County",3,57,10497,5089,5408
050,36,055,"New York","Monroe County",3,58,10566,5083,5483
050,36,055,"New York","Monroe County",3,59,10601,5080,5521
050,36,055,"New York","Monroe County",3,60,10772,5164,5608
050,36,055,"New York","Monroe County",3,61,10698,5191,5507
050,36,055,"New York","Monroe County",3,62,10497,5067,5430
050,36,055,"New York","Monroe County",3,63,10247,4982,5265
050,36,055,"New York","Monroe County",3,64,9910,4820,5090
050,36,055,"New York","Monroe County",3,65,9455,4554,4901
050,36,055,"New York","Monroe County",3,66,9234,4415,4819
050,36,055,"New York","Monroe County",3,67,8882,4213,4669
050,36,055,"New York","Monroe County",3,68,8542,4037,4505
050,36,055,"New York","Monroe County",3,69,8214,3870,4344
050,36,055,"New York","Monroe County",3,70,7814,3651,4163
050,36,055,"New York","Monroe County",3,71,7401,3435,3966
050,36,055,"New York","Monroe County",3,72,7154,3236,3918
050,36,055,"New York","Monroe County",3,73,7048,3176,3872
050,36,055,"New York","Monroe County",3,74,7557,3492,4065
050,36,055,"New York","Monroe County",3,75,5327,2398,2929
050,36,055,"New York","Monroe County",3,76,5024,2195,2829
050,36,055,"New York","Monroe County",3,77,4875,2152,2723
050,36,055,"New York","Monroe County",3,78,5015,2185,2830
050,36,055,"New York","Monroe County",3,79,4285,1875,2410
050,36,055,"New York","Monroe County",3,80,3582,1532,2050
050,36,055,"New York","Monroe County",3,81,3221,1354,1867
050,36,055,"New York","Monroe County",3,82,3085,1265,1820
050,36,055,"New York","Monroe County",3,83,2894,1181,1713
050,36,055,"New York","Monroe County",3,84,2536,1024,1512
050,36,055,"New York","Monroe County",3,85,16220,5566,10654
050,36,055,"New York","Monroe County",4,0,7771,3976,3795
050,36,055,"New York","Monroe County",4,1,7428,3883,3545
050,36,055,"New York","Monroe County",4,2,7761,3924,3837
050,36,055,"New York","Monroe County",4,3,7877,4034,3843
050,36,055,"New York","Monroe County",4,4,8121,4126,3995
050,36,055,"New York","Monroe County",4,5,8204,4132,4072
050,36,055,"New York","Monroe County",4,6,8378,4248,4130
050,36,055,"New York","Monroe County",4,7,8616,4385,4231
050,36,055,"New York","Monroe County",4,8,8482,4355,4127
050,36,055,"New York","Monroe County",4,9,8520,4306,4214
050,36,055,"New York","Monroe County",4,10,8556,4312,4244
050,36,055,"New York","Monroe County",4,11,8736,4403,4333
050,36,055,"New York","Monroe County",4,12,8803,4506,4297
050,36,055,"New York","Monroe County",4,13,8845,4549,4296
050,36,055,"New York","Monroe County",4,14,9205,4770,4435
050,36,055,"New York","Monroe County",4,15,9260,4735,4525
050,36,055,"New York","Monroe County",4,16,9102,4616,4486
050,36,055,"New York","Monroe County",4,17,9037,4593,4444
050,36,055,"New York","Monroe County",4,18,11375,5812,5563
050,36,055,"New York","Monroe County",4,19,11683,6108,5575
050,36,055,"New York","Monroe County",4,20,10609,5310,5299
050,36,055,"New York","Monroe County",4,21,10170,5032,5138
050,36,055,"New York","Monroe County",4,22,9868,4915,4953
050,36,055,"New York","Monroe County",4,23,9405,4676,4729
050,36,055,"New York","Monroe County",4,24,9527,4742,4785
050,36,055,"New York","Monroe County",4,25,9531,4735,4796
050,36,055,"New York","Monroe County",4,26,9523,4693,4830
050,36,055,"New York","Monroe County",4,27,9906,4915,4991
050,36,055,"New York","Monroe County",4,28,10202,5057,5145
050,36,055,"New York","Monroe County",4,29,10396,5092,5304
050,36,055,"New York","Monroe County",4,30,10606,5241,5365
050,36,055,"New York","Monroe County",4,31,10579,5215,5364
050,36,055,"New York","Monroe County",4,32,11001,5424,5577
050,36,055,"New York","Monroe County",4,33,10857,5453,5404
050,36,055,"New York","Monroe County",4,34,10650,5283,5367
050,36,055,"New York","Monroe County",4,35,10469,5123,5346
050,36,055,"New York","Monroe County",4,36,10359,5069,5290
050,36,055,"New York","Monroe County",4,37,10182,4981,5201
050,36,055,"New York","Monroe County",4,38,9544,4691,4853
050,36,055,"New York","Monroe County",4,39,9462,4661,4801
050,36,055,"New York","Monroe County",4,40,9286,4544,4742
050,36,055,"New York","Monroe County",4,41,9219,4552,4667
050,36,055,"New York","Monroe County",4,42,9183,4489,4694
050,36,055,"New York","Monroe County",4,43,8532,4135,4397
050,36,055,"New York","Monroe County",4,44,8115,3916,4199
050,36,055,"New York","Monroe County",4,45,8000,3824,4176
050,36,055,"New York","Monroe County",4,46,7862,3759,4103
050,36,055,"New York","Monroe County",4,47,8096,3906,4190
050,36,055,"New York","Monroe County",4,48,7777,3776,4001
050,36,055,"New York","Monroe County",4,49,7778,3691,4087
050,36,055,"New York","Monroe County",4,50,8416,3976,4440
050,36,055,"New York","Monroe County",4,51,9478,4531,4947
050,36,055,"New York","Monroe County",4,52,9693,4740,4953
050,36,055,"New York","Monroe County",4,53,9524,4636,4888
050,36,055,"New York","Monroe County",4,54,9158,4393,4765
050,36,055,"New York","Monroe County",4,55,9386,4550,4836
050,36,055,"New York","Monroe County",4,56,9568,4592,4976
050,36,055,"New York","Monroe County",4,57,10135,4871,5264
050,36,055,"New York","Monroe County",4,58,10403,5032,5371
050,36,055,"New York","Monroe County",4,59,10377,4998,5379
050,36,055,"New York","Monroe County",4,60,10429,4996,5433
050,36,055,"New York","Monroe County",4,61,10606,5072,5534
050,36,055,"New York","Monroe County",4,62,10456,5071,5385
050,36,055,"New York","Monroe County",4,63,10227,4917,5310
050,36,055,"New York","Monroe County",4,64,10065,4861,5204
050,36,055,"New York","Monroe County",4,65,9672,4694,4978
050,36,055,"New York","Monroe County",4,66,9218,4441,4777
050,36,055,"New York","Monroe County",4,67,8990,4286,4704
050,36,055,"New York","Monroe County",4,68,8622,4066,4556
050,36,055,"New York","Monroe County",4,69,8389,3947,4442
050,36,055,"New York","Monroe County",4,70,8058,3774,4284
050,36,055,"New York","Monroe County",4,71,7640,3550,4090
050,36,055,"New York","Monroe County",4,72,7243,3331,3912
050,36,055,"New York","Monroe County",4,73,6962,3142,3820
050,36,055,"New York","Monroe County",4,74,6810,3058,3752
050,36,055,"New York","Monroe County",4,75,7302,3334,3968
050,36,055,"New York","Monroe County",4,76,5142,2287,2855
050,36,055,"New York","Monroe County",4,77,4865,2143,2722
050,36,055,"New York","Monroe County",4,78,4695,2042,2653
050,36,055,"New York","Monroe County",4,79,4839,2099,2740
050,36,055,"New York","Monroe County",4,80,4081,1771,2310
050,36,055,"New York","Monroe County",4,81,3411,1458,1953
050,36,055,"New York","Monroe County",4,82,3031,1248,1783
050,36,055,"New York","Monroe County",4,83,2911,1164,1747
050,36,055,"New York","Monroe County",4,84,2698,1086,1612
050,36,055,"New York","Monroe County",4,85,15933,5537,10396
050,36,055,"New York","Monroe County",5,0,7763,3971,3792
050,36,055,"New York","Monroe County",5,1,7714,3936,3778
050,36,055,"New York","Monroe County",5,2,7427,3868,3559
050,36,055,"New York","Monroe County",5,3,7837,3937,3900
050,36,055,"New York","Monroe County",5,4,7865,4041,3824
050,36,055,"New York","Monroe County",5,5,8098,4106,3992
050,36,055,"New York","Monroe County",5,6,8138,4076,4062
050,36,055,"New York","Monroe County",5,7,8354,4235,4119
050,36,055,"New York","Monroe County",5,8,8572,4367,4205
050,36,055,"New York","Monroe County",5,9,8451,4333,4118
050,36,055,"New York","Monroe County",5,10,8481,4287,4194
050,36,055,"New York","Monroe County",5,11,8484,4270,4214
050,36,055,"New York","Monroe County",5,12,8726,4427,4299
050,36,055,"New York","Monroe County",5,13,8785,4521,4264
050,36,055,"New York","Monroe County",5,14,8806,4520,4286
050,36,055,"New York","Monroe County",5,15,9130,4726,4404
050,36,055,"New York","Monroe County",5,16,9236,4724,4512
050,36,055,"New York","Monroe County",5,17,9095,4597,4498
050,36,055,"New York","Monroe County",5,18,11184,5678,5506
050,36,055,"New York","Monroe County",5,19,11574,6021,5553
050,36,055,"New York","Monroe County",5,20,10618,5348,5270
050,36,055,"New York","Monroe County",5,21,10096,4988,5108
050,36,055,"New York","Monroe County",5,22,9612,4790,4822
050,36,055,"New York","Monroe County",5,23,9520,4672,4848
050,36,055,"New York","Monroe County",5,24,9365,4671,4694
050,36,055,"New York","Monroe County",5,25,9465,4693,4772
050,36,055,"New York","Monroe County",5,26,9471,4700,4771
050,36,055,"New York","Monroe County",5,27,9460,4694,4766
050,36,055,"New York","Monroe County",5,28,9753,4837,4916
050,36,055,"New York","Monroe County",5,29,10147,5008,5139
050,36,055,"New York","Monroe County",5,30,10179,4954,5225
050,36,055,"New York","Monroe County",5,31,10560,5221,5339
050,36,055,"New York","Monroe County",5,32,10499,5181,5318
050,36,055,"New York","Monroe County",5,33,10887,5357,5530
050,36,055,"New York","Monroe County",5,34,10812,5455,5357
050,36,055,"New York","Monroe County",5,35,10580,5260,5320
050,36,055,"New York","Monroe County",5,36,10439,5127,5312
050,36,055,"New York","Monroe County",5,37,10272,5009,5263
050,36,055,"New York","Monroe County",5,38,10111,4958,5153
050,36,055,"New York","Monroe County",5,39,9485,4650,4835
050,36,055,"New York","Monroe County",5,40,9445,4644,4801
050,36,055,"New York","Monroe County",5,41,9258,4541,4717
050,36,055,"New York","Monroe County",5,42,9197,4544,4653
050,36,055,"New York","Monroe County",5,43,9114,4435,4679
050,36,055,"New York","Monroe County",5,44,8531,4139,4392
050,36,055,"New York","Monroe County",5,45,8087,3894,4193
050,36,055,"New York","Monroe County",5,46,7948,3811,4137
050,36,055,"New York","Monroe County",5,47,7803,3721,4082
050,36,055,"New York","Monroe County",5,48,8084,3918,4166
050,36,055,"New York","Monroe County",5,49,7690,3691,3999
050,36,055,"New York","Monroe County",5,50,7758,3686,4072
050,36,055,"New York","Monroe County",5,51,8323,3913,4410
050,36,055,"New York","Monroe County",5,52,9366,4482,4884
050,36,055,"New York","Monroe County",5,53,9589,4681,4908
050,36,055,"New York","Monroe County",5,54,9397,4581,4816
050,36,055,"New York","Monroe County",5,55,9076,4372,4704
050,36,055,"New York","Monroe County",5,56,9258,4483,4775
050,36,055,"New York","Monroe County",5,57,9373,4490,4883
050,36,055,"New York","Monroe County",5,58,10032,4840,5192
050,36,055,"New York","Monroe County",5,59,10273,4939,5334
050,36,055,"New York","Monroe County",5,60,10238,4918,5320
050,36,055,"New York","Monroe County",5,61,10274,4920,5354
050,36,055,"New York","Monroe County",5,62,10418,4963,5455
050,36,055,"New York","Monroe County",5,63,10246,4949,5297
050,36,055,"New York","Monroe County",5,64,10009,4796,5213
050,36,055,"New York","Monroe County",5,65,9853,4738,5115
050,36,055,"New York","Monroe County",5,66,9514,4612,4902
050,36,055,"New York","Monroe County",5,67,9019,4330,4689
050,36,055,"New York","Monroe County",5,68,8785,4180,4605
050,36,055,"New York","Monroe County",5,69,8516,4013,4503
050,36,055,"New York","Monroe County",5,70,8229,3852,4377
050,36,055,"New York","Monroe County",5,71,7911,3699,4212
050,36,055,"New York","Monroe County",5,72,7488,3465,4023
050,36,055,"New York","Monroe County",5,73,7084,3235,3849
050,36,055,"New York","Monroe County",5,74,6760,3049,3711
050,36,055,"New York","Monroe County",5,75,6603,2936,3667
050,36,055,"New York","Monroe County",5,76,7079,3205,3874
050,36,055,"New York","Monroe County",5,77,5009,2239,2770
050,36,055,"New York","Monroe County",5,78,4700,2049,2651
050,36,055,"New York","Monroe County",5,79,4542,1945,2597
050,36,055,"New York","Monroe County",5,80,4636,1985,2651
050,36,055,"New York","Monroe County",5,81,3911,1690,2221
050,36,055,"New York","Monroe County",5,82,3244,1368,1876
050,36,055,"New York","Monroe County",5,83,2881,1161,1720
050,36,055,"New York","Monroe County",5,84,2754,1095,1659
050,36,055,"New York","Monroe County",5,85,16126,5675,10451
050,36,057,"New York","Montgomery County",1,0,599,307,292
050,36,057,"New York","Montgomery County",1,1,589,288,301
050,36,057,"New York","Montgomery County",1,2,606,301,305
050,36,057,"New York","Montgomery County",1,3,627,313,314
050,36,057,"New York","Montgomery County",1,4,659,330,329
050,36,057,"New York","Montgomery County",1,5,632,330,302
050,36,057,"New York","Montgomery County",1,6,630,321,309
050,36,057,"New York","Montgomery County",1,7,590,298,292
050,36,057,"New York","Montgomery County",1,8,596,297,299
050,36,057,"New York","Montgomery County",1,9,595,314,281
050,36,057,"New York","Montgomery County",1,10,631,327,304
050,36,057,"New York","Montgomery County",1,11,659,343,316
050,36,057,"New York","Montgomery County",1,12,658,341,317
050,36,057,"New York","Montgomery County",1,13,658,338,320
050,36,057,"New York","Montgomery County",1,14,616,317,299
050,36,057,"New York","Montgomery County",1,15,678,345,333
050,36,057,"New York","Montgomery County",1,16,679,371,308
050,36,057,"New York","Montgomery County",1,17,679,367,312
050,36,057,"New York","Montgomery County",1,18,565,299,266
050,36,057,"New York","Montgomery County",1,19,487,251,236
050,36,057,"New York","Montgomery County",1,20,503,254,249
050,36,057,"New York","Montgomery County",1,21,532,258,274
050,36,057,"New York","Montgomery County",1,22,545,278,267
050,36,057,"New York","Montgomery County",1,23,546,269,277
050,36,057,"New York","Montgomery County",1,24,591,308,283
050,36,057,"New York","Montgomery County",1,25,595,310,285
050,36,057,"New York","Montgomery County",1,26,589,294,295
050,36,057,"New York","Montgomery County",1,27,564,279,285
050,36,057,"New York","Montgomery County",1,28,578,296,282
050,36,057,"New York","Montgomery County",1,29,629,323,306
050,36,057,"New York","Montgomery County",1,30,628,335,293
050,36,057,"New York","Montgomery County",1,31,594,303,291
050,36,057,"New York","Montgomery County",1,32,585,295,290
050,36,057,"New York","Montgomery County",1,33,594,276,318
050,36,057,"New York","Montgomery County",1,34,628,307,321
050,36,057,"New York","Montgomery County",1,35,688,343,345
050,36,057,"New York","Montgomery County",1,36,651,321,330
050,36,057,"New York","Montgomery County",1,37,660,317,343
050,36,057,"New York","Montgomery County",1,38,600,294,306
050,36,057,"New York","Montgomery County",1,39,606,300,306
050,36,057,"New York","Montgomery County",1,40,572,290,282
050,36,057,"New York","Montgomery County",1,41,579,281,298
050,36,057,"New York","Montgomery County",1,42,558,283,275
050,36,057,"New York","Montgomery County",1,43,533,280,253
050,36,057,"New York","Montgomery County",1,44,515,261,254
050,36,057,"New York","Montgomery County",1,45,520,254,266
050,36,057,"New York","Montgomery County",1,46,559,284,275
050,36,057,"New York","Montgomery County",1,47,558,281,277
050,36,057,"New York","Montgomery County",1,48,593,290,303
050,36,057,"New York","Montgomery County",1,49,678,344,334
050,36,057,"New York","Montgomery County",1,50,607,291,316
050,36,057,"New York","Montgomery County",1,51,596,295,301
050,36,057,"New York","Montgomery County",1,52,636,320,316
050,36,057,"New York","Montgomery County",1,53,632,325,307
050,36,057,"New York","Montgomery County",1,54,635,329,306
050,36,057,"New York","Montgomery County",1,55,685,322,363
050,36,057,"New York","Montgomery County",1,56,682,335,347
050,36,057,"New York","Montgomery County",1,57,695,329,366
050,36,057,"New York","Montgomery County",1,58,730,359,371
050,36,057,"New York","Montgomery County",1,59,713,347,366
050,36,057,"New York","Montgomery County",1,60,701,332,369
050,36,057,"New York","Montgomery County",1,61,714,338,376
050,36,057,"New York","Montgomery County",1,62,708,354,354
050,36,057,"New York","Montgomery County",1,63,666,332,334
050,36,057,"New York","Montgomery County",1,64,683,346,337
050,36,057,"New York","Montgomery County",1,65,686,346,340
050,36,057,"New York","Montgomery County",1,66,659,337,322
050,36,057,"New York","Montgomery County",1,67,608,326,282
050,36,057,"New York","Montgomery County",1,68,584,316,268
050,36,057,"New York","Montgomery County",1,69,566,275,291
050,36,057,"New York","Montgomery County",1,70,519,259,260
050,36,057,"New York","Montgomery County",1,71,503,240,263
050,36,057,"New York","Montgomery County",1,72,530,257,273
050,36,057,"New York","Montgomery County",1,73,528,272,256
050,36,057,"New York","Montgomery County",1,74,341,167,174
050,36,057,"New York","Montgomery County",1,75,354,176,178
050,36,057,"New York","Montgomery County",1,76,352,173,179
050,36,057,"New York","Montgomery County",1,77,345,152,193
050,36,057,"New York","Montgomery County",1,78,281,124,157
050,36,057,"New York","Montgomery County",1,79,252,119,133
050,36,057,"New York","Montgomery County",1,80,221,103,118
050,36,057,"New York","Montgomery County",1,81,212,85,127
050,36,057,"New York","Montgomery County",1,82,196,79,117
050,36,057,"New York","Montgomery County",1,83,182,70,112
050,36,057,"New York","Montgomery County",1,84,191,79,112
050,36,057,"New York","Montgomery County",1,85,1330,437,893
050,36,057,"New York","Montgomery County",2,0,606,301,305
050,36,057,"New York","Montgomery County",2,1,592,292,300
050,36,057,"New York","Montgomery County",2,2,602,297,305
050,36,057,"New York","Montgomery County",2,3,618,308,310
050,36,057,"New York","Montgomery County",2,4,650,326,324
050,36,057,"New York","Montgomery County",2,5,640,331,309
050,36,057,"New York","Montgomery County",2,6,631,326,305
050,36,057,"New York","Montgomery County",2,7,600,303,297
050,36,057,"New York","Montgomery County",2,8,593,296,297
050,36,057,"New York","Montgomery County",2,9,597,309,288
050,36,057,"New York","Montgomery County",2,10,621,323,298
050,36,057,"New York","Montgomery County",2,11,648,338,310
050,36,057,"New York","Montgomery County",2,12,659,342,317
050,36,057,"New York","Montgomery County",2,13,655,336,319
050,36,057,"New York","Montgomery County",2,14,625,322,303
050,36,057,"New York","Montgomery County",2,15,665,340,325
050,36,057,"New York","Montgomery County",2,16,683,366,317
050,36,057,"New York","Montgomery County",2,17,675,365,310
050,36,057,"New York","Montgomery County",2,18,566,303,263
050,36,057,"New York","Montgomery County",2,19,488,253,235
050,36,057,"New York","Montgomery County",2,20,509,257,252
050,36,057,"New York","Montgomery County",2,21,527,257,270
050,36,057,"New York","Montgomery County",2,22,546,274,272
050,36,057,"New York","Montgomery County",2,23,549,271,278
050,36,057,"New York","Montgomery County",2,24,583,300,283
050,36,057,"New York","Montgomery County",2,25,592,311,281
050,36,057,"New York","Montgomery County",2,26,597,301,296
050,36,057,"New York","Montgomery County",2,27,568,282,286
050,36,057,"New York","Montgomery County",2,28,575,291,284
050,36,057,"New York","Montgomery County",2,29,619,318,301
050,36,057,"New York","Montgomery County",2,30,634,334,300
050,36,057,"New York","Montgomery County",2,31,603,312,291
050,36,057,"New York","Montgomery County",2,32,587,297,290
050,36,057,"New York","Montgomery County",2,33,593,281,312
050,36,057,"New York","Montgomery County",2,34,620,298,322
050,36,057,"New York","Montgomery County",2,35,676,335,341
050,36,057,"New York","Montgomery County",2,36,649,320,329
050,36,057,"New York","Montgomery County",2,37,660,318,342
050,36,057,"New York","Montgomery County",2,38,618,304,314
050,36,057,"New York","Montgomery County",2,39,602,297,305
050,36,057,"New York","Montgomery County",2,40,585,292,293
050,36,057,"New York","Montgomery County",2,41,573,282,291
050,36,057,"New York","Montgomery County",2,42,558,278,280
050,36,057,"New York","Montgomery County",2,43,540,284,256
050,36,057,"New York","Montgomery County",2,44,513,260,253
050,36,057,"New York","Montgomery County",2,45,521,259,262
050,36,057,"New York","Montgomery County",2,46,550,279,271
050,36,057,"New York","Montgomery County",2,47,553,280,273
050,36,057,"New York","Montgomery County",2,48,588,292,296
050,36,057,"New York","Montgomery County",2,49,660,330,330
050,36,057,"New York","Montgomery County",2,50,626,303,323
050,36,057,"New York","Montgomery County",2,51,599,295,304
050,36,057,"New York","Montgomery County",2,52,622,313,309
050,36,057,"New York","Montgomery County",2,53,636,327,309
050,36,057,"New York","Montgomery County",2,54,625,323,302
050,36,057,"New York","Montgomery County",2,55,666,319,347
050,36,057,"New York","Montgomery County",2,56,684,332,352
050,36,057,"New York","Montgomery County",2,57,695,333,362
050,36,057,"New York","Montgomery County",2,58,714,348,366
050,36,057,"New York","Montgomery County",2,59,715,349,366
050,36,057,"New York","Montgomery County",2,60,704,337,367
050,36,057,"New York","Montgomery County",2,61,702,332,370
050,36,057,"New York","Montgomery County",2,62,704,347,357
050,36,057,"New York","Montgomery County",2,63,679,337,342
050,36,057,"New York","Montgomery County",2,64,677,342,335
050,36,057,"New York","Montgomery County",2,65,683,345,338
050,36,057,"New York","Montgomery County",2,66,660,336,324
050,36,057,"New York","Montgomery County",2,67,611,325,286
050,36,057,"New York","Montgomery County",2,68,585,317,268
050,36,057,"New York","Montgomery County",2,69,567,281,286
050,36,057,"New York","Montgomery County",2,70,527,261,266
050,36,057,"New York","Montgomery County",2,71,504,245,259
050,36,057,"New York","Montgomery County",2,72,515,247,268
050,36,057,"New York","Montgomery County",2,73,553,281,272
050,36,057,"New York","Montgomery County",2,74,358,177,181
050,36,057,"New York","Montgomery County",2,75,350,174,176
050,36,057,"New York","Montgomery County",2,76,344,169,175
050,36,057,"New York","Montgomery County",2,77,350,162,188
050,36,057,"New York","Montgomery County",2,78,286,127,159
050,36,057,"New York","Montgomery County",2,79,251,114,137
050,36,057,"New York","Montgomery County",2,80,226,104,122
050,36,057,"New York","Montgomery County",2,81,210,88,122
050,36,057,"New York","Montgomery County",2,82,200,83,117
050,36,057,"New York","Montgomery County",2,83,179,70,109
050,36,057,"New York","Montgomery County",2,84,186,74,112
050,36,057,"New York","Montgomery County",2,85,1330,440,890
050,36,057,"New York","Montgomery County",3,0,583,287,296
050,36,057,"New York","Montgomery County",3,1,610,312,298
050,36,057,"New York","Montgomery County",3,2,619,305,314
050,36,057,"New York","Montgomery County",3,3,613,305,308
050,36,057,"New York","Montgomery County",3,4,634,335,299
050,36,057,"New York","Montgomery County",3,5,662,340,322
050,36,057,"New York","Montgomery County",3,6,646,338,308
050,36,057,"New York","Montgomery County",3,7,636,331,305
050,36,057,"New York","Montgomery County",3,8,615,309,306
050,36,057,"New York","Montgomery County",3,9,594,294,300
050,36,057,"New York","Montgomery County",3,10,622,329,293
050,36,057,"New York","Montgomery County",3,11,617,310,307
050,36,057,"New York","Montgomery County",3,12,653,349,304
050,36,057,"New York","Montgomery County",3,13,668,346,322
050,36,057,"New York","Montgomery County",3,14,674,335,339
050,36,057,"New York","Montgomery County",3,15,647,343,304
050,36,057,"New York","Montgomery County",3,16,666,343,323
050,36,057,"New York","Montgomery County",3,17,675,370,305
050,36,057,"New York","Montgomery County",3,18,602,336,266
050,36,057,"New York","Montgomery County",3,19,477,255,222
050,36,057,"New York","Montgomery County",3,20,517,272,245
050,36,057,"New York","Montgomery County",3,21,535,253,282
050,36,057,"New York","Montgomery County",3,22,578,287,291
050,36,057,"New York","Montgomery County",3,23,535,277,258
050,36,057,"New York","Montgomery County",3,24,556,289,267
050,36,057,"New York","Montgomery County",3,25,571,288,283
050,36,057,"New York","Montgomery County",3,26,594,294,300
050,36,057,"New York","Montgomery County",3,27,579,303,276
050,36,057,"New York","Montgomery County",3,28,582,280,302
050,36,057,"New York","Montgomery County",3,29,607,316,291
050,36,057,"New York","Montgomery County",3,30,648,326,322
050,36,057,"New York","Montgomery County",3,31,630,330,300
050,36,057,"New York","Montgomery County",3,32,654,339,315
050,36,057,"New York","Montgomery County",3,33,598,313,285
050,36,057,"New York","Montgomery County",3,34,616,289,327
050,36,057,"New York","Montgomery County",3,35,632,314,318
050,36,057,"New York","Montgomery County",3,36,663,326,337
050,36,057,"New York","Montgomery County",3,37,650,314,336
050,36,057,"New York","Montgomery County",3,38,651,316,335
050,36,057,"New York","Montgomery County",3,39,627,307,320
050,36,057,"New York","Montgomery County",3,40,603,295,308
050,36,057,"New York","Montgomery County",3,41,579,283,296
050,36,057,"New York","Montgomery County",3,42,583,288,295
050,36,057,"New York","Montgomery County",3,43,568,292,276
050,36,057,"New York","Montgomery County",3,44,536,265,271
050,36,057,"New York","Montgomery County",3,45,507,261,246
050,36,057,"New York","Montgomery County",3,46,535,262,273
050,36,057,"New York","Montgomery County",3,47,545,268,277
050,36,057,"New York","Montgomery County",3,48,555,290,265
050,36,057,"New York","Montgomery County",3,49,583,284,299
050,36,057,"New York","Montgomery County",3,50,665,325,340
050,36,057,"New York","Montgomery County",3,51,628,309,319
050,36,057,"New York","Montgomery County",3,52,589,290,299
050,36,057,"New York","Montgomery County",3,53,631,329,302
050,36,057,"New York","Montgomery County",3,54,605,309,296
050,36,057,"New York","Montgomery County",3,55,618,322,296
050,36,057,"New York","Montgomery County",3,56,660,315,345
050,36,057,"New York","Montgomery County",3,57,680,331,349
050,36,057,"New York","Montgomery County",3,58,684,330,354
050,36,057,"New York","Montgomery County",3,59,699,341,358
050,36,057,"New York","Montgomery County",3,60,716,359,357
050,36,057,"New York","Montgomery County",3,61,680,318,362
050,36,057,"New York","Montgomery County",3,62,695,329,366
050,36,057,"New York","Montgomery County",3,63,685,333,352
050,36,057,"New York","Montgomery County",3,64,663,332,331
050,36,057,"New York","Montgomery County",3,65,643,326,317
050,36,057,"New York","Montgomery County",3,66,662,336,326
050,36,057,"New York","Montgomery County",3,67,637,319,318
050,36,057,"New York","Montgomery County",3,68,594,320,274
050,36,057,"New York","Montgomery County",3,69,553,296,257
050,36,057,"New York","Montgomery County",3,70,539,276,263
050,36,057,"New York","Montgomery County",3,71,501,246,255
050,36,057,"New York","Montgomery County",3,72,494,238,256
050,36,057,"New York","Montgomery County",3,73,489,233,256
050,36,057,"New York","Montgomery County",3,74,529,269,260
050,36,057,"New York","Montgomery County",3,75,347,171,176
050,36,057,"New York","Montgomery County",3,76,321,155,166
050,36,057,"New York","Montgomery County",3,77,328,161,167
050,36,057,"New York","Montgomery County",3,78,323,151,172
050,36,057,"New York","Montgomery County",3,79,271,119,152
050,36,057,"New York","Montgomery County",3,80,236,110,126
050,36,057,"New York","Montgomery County",3,81,210,91,119
050,36,057,"New York","Montgomery County",3,82,198,85,113
050,36,057,"New York","Montgomery County",3,83,182,72,110
050,36,057,"New York","Montgomery County",3,84,163,59,104
050,36,057,"New York","Montgomery County",3,85,1234,416,818
050,36,057,"New York","Montgomery County",4,0,595,294,301
050,36,057,"New York","Montgomery County",4,1,565,272,293
050,36,057,"New York","Montgomery County",4,2,629,322,307
050,36,057,"New York","Montgomery County",4,3,607,296,311
050,36,057,"New York","Montgomery County",4,4,622,319,303
050,36,057,"New York","Montgomery County",4,5,641,335,306
050,36,057,"New York","Montgomery County",4,6,674,343,331
050,36,057,"New York","Montgomery County",4,7,645,337,308
050,36,057,"New York","Montgomery County",4,8,634,318,316
050,36,057,"New York","Montgomery County",4,9,626,316,310
050,36,057,"New York","Montgomery County",4,10,601,306,295
050,36,057,"New York","Montgomery County",4,11,626,326,300
050,36,057,"New York","Montgomery County",4,12,623,319,304
050,36,057,"New York","Montgomery County",4,13,661,348,313
050,36,057,"New York","Montgomery County",4,14,670,343,327
050,36,057,"New York","Montgomery County",4,15,677,341,336
050,36,057,"New York","Montgomery County",4,16,663,345,318
050,36,057,"New York","Montgomery County",4,17,661,339,322
050,36,057,"New York","Montgomery County",4,18,597,336,261
050,36,057,"New York","Montgomery County",4,19,491,278,213
050,36,057,"New York","Montgomery County",4,20,495,268,227
050,36,057,"New York","Montgomery County",4,21,534,276,258
050,36,057,"New York","Montgomery County",4,22,563,274,289
050,36,057,"New York","Montgomery County",4,23,585,287,298
050,36,057,"New York","Montgomery County",4,24,547,279,268
050,36,057,"New York","Montgomery County",4,25,551,281,270
050,36,057,"New York","Montgomery County",4,26,558,275,283
050,36,057,"New York","Montgomery County",4,27,561,290,271
050,36,057,"New York","Montgomery County",4,28,586,292,294
050,36,057,"New York","Montgomery County",4,29,585,281,304
050,36,057,"New York","Montgomery County",4,30,626,316,310
050,36,057,"New York","Montgomery County",4,31,643,323,320
050,36,057,"New York","Montgomery County",4,32,625,334,291
050,36,057,"New York","Montgomery County",4,33,666,345,321
050,36,057,"New York","Montgomery County",4,34,602,312,290
050,36,057,"New York","Montgomery County",4,35,615,300,315
050,36,057,"New York","Montgomery County",4,36,624,308,316
050,36,057,"New York","Montgomery County",4,37,676,319,357
050,36,057,"New York","Montgomery County",4,38,657,330,327
050,36,057,"New York","Montgomery County",4,39,670,317,353
050,36,057,"New York","Montgomery County",4,40,629,309,320
050,36,057,"New York","Montgomery County",4,41,599,291,308
050,36,057,"New York","Montgomery County",4,42,581,275,306
050,36,057,"New York","Montgomery County",4,43,594,306,288
050,36,057,"New York","Montgomery County",4,44,567,280,287
050,36,057,"New York","Montgomery County",4,45,534,273,261
050,36,057,"New York","Montgomery County",4,46,512,262,250
050,36,057,"New York","Montgomery County",4,47,516,258,258
050,36,057,"New York","Montgomery County",4,48,551,280,271
050,36,057,"New York","Montgomery County",4,49,546,284,262
050,36,057,"New York","Montgomery County",4,50,575,275,300
050,36,057,"New York","Montgomery County",4,51,662,322,340
050,36,057,"New York","Montgomery County",4,52,614,307,307
050,36,057,"New York","Montgomery County",4,53,600,302,298
050,36,057,"New York","Montgomery County",4,54,607,302,305
050,36,057,"New York","Montgomery County",4,55,620,309,311
050,36,057,"New York","Montgomery County",4,56,635,334,301
050,36,057,"New York","Montgomery County",4,57,665,316,349
050,36,057,"New York","Montgomery County",4,58,669,327,342
050,36,057,"New York","Montgomery County",4,59,673,316,357
050,36,057,"New York","Montgomery County",4,60,702,346,356
050,36,057,"New York","Montgomery County",4,61,704,354,350
050,36,057,"New York","Montgomery County",4,62,674,317,357
050,36,057,"New York","Montgomery County",4,63,681,321,360
050,36,057,"New York","Montgomery County",4,64,669,327,342
050,36,057,"New York","Montgomery County",4,65,630,315,315
050,36,057,"New York","Montgomery County",4,66,629,314,315
050,36,057,"New York","Montgomery County",4,67,631,311,320
050,36,057,"New York","Montgomery County",4,68,631,321,310
050,36,057,"New York","Montgomery County",4,69,555,298,257
050,36,057,"New York","Montgomery County",4,70,527,282,245
050,36,057,"New York","Montgomery County",4,71,518,261,257
050,36,057,"New York","Montgomery County",4,72,474,232,242
050,36,057,"New York","Montgomery County",4,73,467,225,242
050,36,057,"New York","Montgomery County",4,74,467,220,247
050,36,057,"New York","Montgomery County",4,75,516,265,251
050,36,057,"New York","Montgomery County",4,76,326,156,170
050,36,057,"New York","Montgomery County",4,77,313,147,166
050,36,057,"New York","Montgomery County",4,78,308,150,158
050,36,057,"New York","Montgomery County",4,79,297,137,160
050,36,057,"New York","Montgomery County",4,80,259,112,147
050,36,057,"New York","Montgomery County",4,81,221,96,125
050,36,057,"New York","Montgomery County",4,82,204,96,108
050,36,057,"New York","Montgomery County",4,83,177,74,103
050,36,057,"New York","Montgomery County",4,84,166,56,110
050,36,057,"New York","Montgomery County",4,85,1161,380,781
050,36,057,"New York","Montgomery County",5,0,591,294,297
050,36,057,"New York","Montgomery County",5,1,626,311,315
050,36,057,"New York","Montgomery County",5,2,578,294,284
050,36,057,"New York","Montgomery County",5,3,631,326,305
050,36,057,"New York","Montgomery County",5,4,616,295,321
050,36,057,"New York","Montgomery County",5,5,627,320,307
050,36,057,"New York","Montgomery County",5,6,626,331,295
050,36,057,"New York","Montgomery County",5,7,687,344,343
050,36,057,"New York","Montgomery County",5,8,647,336,311
050,36,057,"New York","Montgomery County",5,9,649,335,314
050,36,057,"New York","Montgomery County",5,10,633,322,311
050,36,057,"New York","Montgomery County",5,11,595,309,286
050,36,057,"New York","Montgomery County",5,12,636,330,306
050,36,057,"New York","Montgomery County",5,13,629,317,312
050,36,057,"New York","Montgomery County",5,14,648,341,307
050,36,057,"New York","Montgomery County",5,15,689,356,333
050,36,057,"New York","Montgomery County",5,16,673,329,344
050,36,057,"New York","Montgomery County",5,17,669,347,322
050,36,057,"New York","Montgomery County",5,18,574,300,274
050,36,057,"New York","Montgomery County",5,19,498,281,217
050,36,057,"New York","Montgomery County",5,20,513,288,225
050,36,057,"New York","Montgomery County",5,21,519,280,239
050,36,057,"New York","Montgomery County",5,22,573,292,281
050,36,057,"New York","Montgomery County",5,23,558,273,285
050,36,057,"New York","Montgomery County",5,24,584,298,286
050,36,057,"New York","Montgomery County",5,25,547,272,275
050,36,057,"New York","Montgomery County",5,26,532,268,264
050,36,057,"New York","Montgomery County",5,27,572,276,296
050,36,057,"New York","Montgomery County",5,28,564,285,279
050,36,057,"New York","Montgomery County",5,29,602,308,294
050,36,057,"New York","Montgomery County",5,30,588,269,319
050,36,057,"New York","Montgomery County",5,31,631,323,308
050,36,057,"New York","Montgomery County",5,32,645,322,323
050,36,057,"New York","Montgomery County",5,33,636,343,293
050,36,057,"New York","Montgomery County",5,34,658,332,326
050,36,057,"New York","Montgomery County",5,35,615,321,294
050,36,057,"New York","Montgomery County",5,36,616,297,319
050,36,057,"New York","Montgomery County",5,37,634,306,328
050,36,057,"New York","Montgomery County",5,38,677,336,341
050,36,057,"New York","Montgomery County",5,39,667,324,343
050,36,057,"New York","Montgomery County",5,40,677,323,354
050,36,057,"New York","Montgomery County",5,41,615,311,304
050,36,057,"New York","Montgomery County",5,42,608,295,313
050,36,057,"New York","Montgomery County",5,43,585,289,296
050,36,057,"New York","Montgomery County",5,44,588,288,300
050,36,057,"New York","Montgomery County",5,45,570,280,290
050,36,057,"New York","Montgomery County",5,46,556,284,272
050,36,057,"New York","Montgomery County",5,47,516,269,247
050,36,057,"New York","Montgomery County",5,48,503,257,246
050,36,057,"New York","Montgomery County",5,49,533,270,263
050,36,057,"New York","Montgomery County",5,50,539,280,259
050,36,057,"New York","Montgomery County",5,51,572,272,300
050,36,057,"New York","Montgomery County",5,52,657,324,333
050,36,057,"New York","Montgomery County",5,53,629,321,308
050,36,057,"New York","Montgomery County",5,54,574,284,290
050,36,057,"New York","Montgomery County",5,55,617,298,319
050,36,057,"New York","Montgomery County",5,56,616,309,307
050,36,057,"New York","Montgomery County",5,57,646,333,313
050,36,057,"New York","Montgomery County",5,58,646,313,333
050,36,057,"New York","Montgomery County",5,59,660,318,342
050,36,057,"New York","Montgomery County",5,60,679,318,361
050,36,057,"New York","Montgomery County",5,61,691,335,356
050,36,057,"New York","Montgomery County",5,62,706,358,348
050,36,057,"New York","Montgomery County",5,63,659,309,350
050,36,057,"New York","Montgomery County",5,64,670,318,352
050,36,057,"New York","Montgomery County",5,65,641,314,327
050,36,057,"New York","Montgomery County",5,66,609,301,308
050,36,057,"New York","Montgomery County",5,67,605,294,311
050,36,057,"New York","Montgomery County",5,68,621,308,313
050,36,057,"New York","Montgomery County",5,69,597,302,295
050,36,057,"New York","Montgomery County",5,70,537,290,247
050,36,057,"New York","Montgomery County",5,71,508,272,236
050,36,057,"New York","Montgomery County",5,72,501,251,250
050,36,057,"New York","Montgomery County",5,73,452,222,230
050,36,057,"New York","Montgomery County",5,74,451,215,236
050,36,057,"New York","Montgomery County",5,75,456,218,238
050,36,057,"New York","Montgomery County",5,76,488,246,242
050,36,057,"New York","Montgomery County",5,77,317,149,168
050,36,057,"New York","Montgomery County",5,78,290,134,156
050,36,057,"New York","Montgomery County",5,79,290,140,150
050,36,057,"New York","Montgomery County",5,80,286,131,155
050,36,057,"New York","Montgomery County",5,81,239,96,143
050,36,057,"New York","Montgomery County",5,82,217,104,113
050,36,057,"New York","Montgomery County",5,83,183,85,98
050,36,057,"New York","Montgomery County",5,84,171,63,108
050,36,057,"New York","Montgomery County",5,85,1144,359,785
050,36,059,"New York","Nassau County",1,0,14252,7284,6968
050,36,059,"New York","Nassau County",1,1,14623,7529,7094
050,36,059,"New York","Nassau County",1,2,15292,7902,7390
050,36,059,"New York","Nassau County",1,3,15680,8086,7594
050,36,059,"New York","Nassau County",1,4,16007,8234,7773
050,36,059,"New York","Nassau County",1,5,16076,8320,7756
050,36,059,"New York","Nassau County",1,6,16186,8435,7751
050,36,059,"New York","Nassau County",1,7,16446,8469,7977
050,36,059,"New York","Nassau County",1,8,16885,8674,8211
050,36,059,"New York","Nassau County",1,9,17225,8846,8379
050,36,059,"New York","Nassau County",1,10,17440,8935,8505
050,36,059,"New York","Nassau County",1,11,17701,9175,8526
050,36,059,"New York","Nassau County",1,12,18145,9304,8841
050,36,059,"New York","Nassau County",1,13,18219,9289,8930
050,36,059,"New York","Nassau County",1,14,18263,9398,8865
050,36,059,"New York","Nassau County",1,15,18421,9489,8932
050,36,059,"New York","Nassau County",1,16,18776,9627,9149
050,36,059,"New York","Nassau County",1,17,18641,9677,8964
050,36,059,"New York","Nassau County",1,18,17129,8915,8214
050,36,059,"New York","Nassau County",1,19,15546,8018,7528
050,36,059,"New York","Nassau County",1,20,16357,8375,7982
050,36,059,"New York","Nassau County",1,21,16811,8593,8218
050,36,059,"New York","Nassau County",1,22,16880,8481,8399
050,36,059,"New York","Nassau County",1,23,17009,8589,8420
050,36,059,"New York","Nassau County",1,24,17344,8752,8592
050,36,059,"New York","Nassau County",1,25,17255,8793,8462
050,36,059,"New York","Nassau County",1,26,17075,8775,8300
050,36,059,"New York","Nassau County",1,27,16796,8537,8259
050,36,059,"New York","Nassau County",1,28,15735,7892,7843
050,36,059,"New York","Nassau County",1,29,15773,8007,7766
050,36,059,"New York","Nassau County",1,30,15886,8086,7800
050,36,059,"New York","Nassau County",1,31,15669,7834,7835
050,36,059,"New York","Nassau County",1,32,16083,8057,8026
050,36,059,"New York","Nassau County",1,33,16116,8062,8054
050,36,059,"New York","Nassau County",1,34,16376,8164,8212
050,36,059,"New York","Nassau County",1,35,16520,8244,8276
050,36,059,"New York","Nassau County",1,36,16712,8322,8390
050,36,059,"New York","Nassau County",1,37,17189,8607,8582
050,36,059,"New York","Nassau County",1,38,17141,8531,8610
050,36,059,"New York","Nassau County",1,39,17426,8748,8678
050,36,059,"New York","Nassau County",1,40,17832,8889,8943
050,36,059,"New York","Nassau County",1,41,17203,8579,8624
050,36,059,"New York","Nassau County",1,42,17337,8738,8599
050,36,059,"New York","Nassau County",1,43,17067,8545,8522
050,36,059,"New York","Nassau County",1,44,17124,8480,8644
050,36,059,"New York","Nassau County",1,45,17542,8745,8797
050,36,059,"New York","Nassau County",1,46,16980,8490,8490
050,36,059,"New York","Nassau County",1,47,17227,8554,8673
050,36,059,"New York","Nassau County",1,48,18243,9057,9186
050,36,059,"New York","Nassau County",1,49,19570,9709,9861
050,36,059,"New York","Nassau County",1,50,19570,9672,9898
050,36,059,"New York","Nassau County",1,51,19276,9432,9844
050,36,059,"New York","Nassau County",1,52,19283,9403,9880
050,36,059,"New York","Nassau County",1,53,20098,9781,10317
050,36,059,"New York","Nassau County",1,54,20510,10050,10460
050,36,059,"New York","Nassau County",1,55,21230,10307,10923
050,36,059,"New York","Nassau County",1,56,21365,10440,10925
050,36,059,"New York","Nassau County",1,57,20907,10225,10682
050,36,059,"New York","Nassau County",1,58,20976,10304,10672
050,36,059,"New York","Nassau County",1,59,20967,10323,10644
050,36,059,"New York","Nassau County",1,60,20703,10125,10578
050,36,059,"New York","Nassau County",1,61,20046,9730,10316
050,36,059,"New York","Nassau County",1,62,19729,9583,10146
050,36,059,"New York","Nassau County",1,63,18792,9132,9660
050,36,059,"New York","Nassau County",1,64,18060,8817,9243
050,36,059,"New York","Nassau County",1,65,17482,8429,9053
050,36,059,"New York","Nassau County",1,66,16519,7961,8558
050,36,059,"New York","Nassau County",1,67,15781,7628,8153
050,36,059,"New York","Nassau County",1,68,15371,7308,8063
050,36,059,"New York","Nassau County",1,69,14366,6793,7573
050,36,059,"New York","Nassau County",1,70,13874,6464,7410
050,36,059,"New York","Nassau County",1,71,13276,6204,7072
050,36,059,"New York","Nassau County",1,72,13363,6350,7013
050,36,059,"New York","Nassau County",1,73,13253,6198,7055
050,36,059,"New York","Nassau County",1,74,9672,4415,5257
050,36,059,"New York","Nassau County",1,75,9402,4276,5126
050,36,059,"New York","Nassau County",1,76,9002,3997,5005
050,36,059,"New York","Nassau County",1,77,9054,3922,5132
050,36,059,"New York","Nassau County",1,78,7759,3324,4435
050,36,059,"New York","Nassau County",1,79,6852,2919,3933
050,36,059,"New York","Nassau County",1,80,6509,2734,3775
050,36,059,"New York","Nassau County",1,81,6165,2552,3613
050,36,059,"New York","Nassau County",1,82,5871,2381,3490
050,36,059,"New York","Nassau County",1,83,5325,2135,3190
050,36,059,"New York","Nassau County",1,84,5168,2039,3129
050,36,059,"New York","Nassau County",1,85,34960,12100,22860
050,36,059,"New York","Nassau County",2,0,14113,7233,6880
050,36,059,"New York","Nassau County",2,1,14570,7485,7085
050,36,059,"New York","Nassau County",2,2,15179,7847,7332
050,36,059,"New York","Nassau County",2,3,15595,8048,7547
050,36,059,"New York","Nassau County",2,4,15992,8227,7765
050,36,059,"New York","Nassau County",2,5,16101,8327,7774
050,36,059,"New York","Nassau County",2,6,16209,8436,7773
050,36,059,"New York","Nassau County",2,7,16406,8474,7932
050,36,059,"New York","Nassau County",2,8,16755,8611,8144
050,36,059,"New York","Nassau County",2,9,17162,8819,8343
050,36,059,"New York","Nassau County",2,10,17403,8920,8483
050,36,059,"New York","Nassau County",2,11,17580,9083,8497
050,36,059,"New York","Nassau County",2,12,18138,9322,8816
050,36,059,"New York","Nassau County",2,13,18182,9286,8896
050,36,059,"New York","Nassau County",2,14,18276,9385,8891
050,36,059,"New York","Nassau County",2,15,18413,9488,8925
050,36,059,"New York","Nassau County",2,16,18729,9621,9108
050,36,059,"New York","Nassau County",2,17,18663,9653,9010
050,36,059,"New York","Nassau County",2,18,17015,8870,8145
050,36,059,"New York","Nassau County",2,19,15422,7957,7465
050,36,059,"New York","Nassau County",2,20,16390,8398,7992
050,36,059,"New York","Nassau County",2,21,16653,8518,8135
050,36,059,"New York","Nassau County",2,22,16791,8460,8331
050,36,059,"New York","Nassau County",2,23,16953,8544,8409
050,36,059,"New York","Nassau County",2,24,17177,8688,8489
050,36,059,"New York","Nassau County",2,25,17195,8751,8444
050,36,059,"New York","Nassau County",2,26,17069,8756,8313
050,36,059,"New York","Nassau County",2,27,16778,8549,8229
050,36,059,"New York","Nassau County",2,28,15939,8037,7902
050,36,059,"New York","Nassau County",2,29,15737,7968,7769
050,36,059,"New York","Nassau County",2,30,15920,8076,7844
050,36,059,"New York","Nassau County",2,31,15695,7874,7821
050,36,059,"New York","Nassau County",2,32,15982,8001,7981
050,36,059,"New York","Nassau County",2,33,16107,8052,8055
050,36,059,"New York","Nassau County",2,34,16346,8140,8206
050,36,059,"New York","Nassau County",2,35,16620,8302,8318
050,36,059,"New York","Nassau County",2,36,16610,8270,8340
050,36,059,"New York","Nassau County",2,37,17137,8557,8580
050,36,059,"New York","Nassau County",2,38,17271,8610,8661
050,36,059,"New York","Nassau County",2,39,17334,8694,8640
050,36,059,"New York","Nassau County",2,40,17881,8949,8932
050,36,059,"New York","Nassau County",2,41,17335,8633,8702
050,36,059,"New York","Nassau County",2,42,17243,8661,8582
050,36,059,"New York","Nassau County",2,43,17228,8629,8599
050,36,059,"New York","Nassau County",2,44,16996,8442,8554
050,36,059,"New York","Nassau County",2,45,17536,8732,8804
050,36,059,"New York","Nassau County",2,46,17053,8523,8530
050,36,059,"New York","Nassau County",2,47,17140,8534,8606
050,36,059,"New York","Nassau County",2,48,17982,8929,9053
050,36,059,"New York","Nassau County",2,49,19255,9567,9688
050,36,059,"New York","Nassau County",2,50,19561,9668,9893
050,36,059,"New York","Nassau County",2,51,19218,9416,9802
050,36,059,"New York","Nassau County",2,52,19228,9379,9849
050,36,059,"New York","Nassau County",2,53,19823,9648,10175
050,36,059,"New York","Nassau County",2,54,20297,9934,10363
050,36,059,"New York","Nassau County",2,55,20983,10204,10779
050,36,059,"New York","Nassau County",2,56,21282,10376,10906
050,36,059,"New York","Nassau County",2,57,20936,10238,10698
050,36,059,"New York","Nassau County",2,58,20842,10225,10617
050,36,059,"New York","Nassau County",2,59,20880,10266,10614
050,36,059,"New York","Nassau County",2,60,20643,10091,10552
050,36,059,"New York","Nassau County",2,61,20021,9717,10304
050,36,059,"New York","Nassau County",2,62,19623,9524,10099
050,36,059,"New York","Nassau County",2,63,18993,9214,9779
050,36,059,"New York","Nassau County",2,64,17979,8739,9240
050,36,059,"New York","Nassau County",2,65,17452,8420,9032
050,36,059,"New York","Nassau County",2,66,16589,7976,8613
050,36,059,"New York","Nassau County",2,67,15751,7586,8165
050,36,059,"New York","Nassau County",2,68,15217,7248,7969
050,36,059,"New York","Nassau County",2,69,14505,6835,7670
050,36,059,"New York","Nassau County",2,70,13837,6460,7377
050,36,059,"New York","Nassau County",2,71,13283,6186,7097
050,36,059,"New York","Nassau County",2,72,13012,6139,6873
050,36,059,"New York","Nassau County",2,73,13669,6399,7270
050,36,059,"New York","Nassau County",2,74,9841,4501,5340
050,36,059,"New York","Nassau County",2,75,9340,4243,5097
050,36,059,"New York","Nassau County",2,76,8883,3960,4923
050,36,059,"New York","Nassau County",2,77,9037,3915,5122
050,36,059,"New York","Nassau County",2,78,7789,3330,4459
050,36,059,"New York","Nassau County",2,79,6874,2919,3955
050,36,059,"New York","Nassau County",2,80,6435,2699,3736
050,36,059,"New York","Nassau County",2,81,6046,2513,3533
050,36,059,"New York","Nassau County",2,82,5775,2347,3428
050,36,059,"New York","Nassau County",2,83,5242,2100,3142
050,36,059,"New York","Nassau County",2,84,5007,1987,3020
050,36,059,"New York","Nassau County",2,85,33342,11617,21725
050,36,059,"New York","Nassau County",3,0,13508,6789,6719
050,36,059,"New York","Nassau County",3,1,14553,7453,7100
050,36,059,"New York","Nassau County",3,2,14807,7630,7177
050,36,059,"New York","Nassau County",3,3,15369,7953,7416
050,36,059,"New York","Nassau County",3,4,15837,8163,7674
050,36,059,"New York","Nassau County",3,5,16162,8299,7863
050,36,059,"New York","Nassau County",3,6,16213,8403,7810
050,36,059,"New York","Nassau County",3,7,16348,8486,7862
050,36,059,"New York","Nassau County",3,8,16566,8536,8030
050,36,059,"New York","Nassau County",3,9,16837,8664,8173
050,36,059,"New York","Nassau County",3,10,17160,8830,8330
050,36,059,"New York","Nassau County",3,11,17403,8921,8482
050,36,059,"New York","Nassau County",3,12,17643,9102,8541
050,36,059,"New York","Nassau County",3,13,18166,9364,8802
050,36,059,"New York","Nassau County",3,14,18255,9327,8928
050,36,059,"New York","Nassau County",3,15,18284,9424,8860
050,36,059,"New York","Nassau County",3,16,18408,9463,8945
050,36,059,"New York","Nassau County",3,17,18736,9583,9153
050,36,059,"New York","Nassau County",3,18,17418,9035,8383
050,36,059,"New York","Nassau County",3,19,15274,7890,7384
050,36,059,"New York","Nassau County",3,20,16381,8369,8012
050,36,059,"New York","Nassau County",3,21,16837,8616,8221
050,36,059,"New York","Nassau County",3,22,16746,8513,8233
050,36,059,"New York","Nassau County",3,23,16781,8481,8300
050,36,059,"New York","Nassau County",3,24,16984,8608,8376
050,36,059,"New York","Nassau County",3,25,17083,8711,8372
050,36,059,"New York","Nassau County",3,26,16984,8701,8283
050,36,059,"New York","Nassau County",3,27,16997,8668,8329
050,36,059,"New York","Nassau County",3,28,16757,8508,8249
050,36,059,"New York","Nassau County",3,29,15946,8044,7902
050,36,059,"New York","Nassau County",3,30,15821,7990,7831
050,36,059,"New York","Nassau County",3,31,16292,8206,8086
050,36,059,"New York","Nassau County",3,32,16153,8160,7993
050,36,059,"New York","Nassau County",3,33,16309,8160,8149
050,36,059,"New York","Nassau County",3,34,16479,8203,8276
050,36,059,"New York","Nassau County",3,35,16670,8333,8337
050,36,059,"New York","Nassau County",3,36,16882,8388,8494
050,36,059,"New York","Nassau County",3,37,16874,8402,8472
050,36,059,"New York","Nassau County",3,38,17388,8688,8700
050,36,059,"New York","Nassau County",3,39,17508,8731,8777
050,36,059,"New York","Nassau County",3,40,17568,8790,8778
050,36,059,"New York","Nassau County",3,41,17989,8977,9012
050,36,059,"New York","Nassau County",3,42,17489,8669,8820
050,36,059,"New York","Nassau County",3,43,17399,8779,8620
050,36,059,"New York","Nassau County",3,44,17316,8647,8669
050,36,059,"New York","Nassau County",3,45,17213,8550,8663
050,36,059,"New York","Nassau County",3,46,17517,8732,8785
050,36,059,"New York","Nassau County",3,47,17125,8577,8548
050,36,059,"New York","Nassau County",3,48,17208,8571,8637
050,36,059,"New York","Nassau County",3,49,17964,8925,9039
050,36,059,"New York","Nassau County",3,50,19201,9552,9649
050,36,059,"New York","Nassau County",3,51,19434,9609,9825
050,36,059,"New York","Nassau County",3,52,19049,9333,9716
050,36,059,"New York","Nassau County",3,53,19033,9306,9727
050,36,059,"New York","Nassau County",3,54,19608,9547,10061
050,36,059,"New York","Nassau County",3,55,20085,9835,10250
050,36,059,"New York","Nassau County",3,56,20679,10059,10620
050,36,059,"New York","Nassau County",3,57,20925,10227,10698
050,36,059,"New York","Nassau County",3,58,20675,10147,10528
050,36,059,"New York","Nassau County",3,59,20494,10049,10445
050,36,059,"New York","Nassau County",3,60,20478,10017,10461
050,36,059,"New York","Nassau County",3,61,20306,9906,10400
050,36,059,"New York","Nassau County",3,62,19527,9462,10065
050,36,059,"New York","Nassau County",3,63,19228,9309,9919
050,36,059,"New York","Nassau County",3,64,18555,8985,9570
050,36,059,"New York","Nassau County",3,65,17644,8543,9101
050,36,059,"New York","Nassau County",3,66,17056,8210,8846
050,36,059,"New York","Nassau County",3,67,16194,7756,8438
050,36,059,"New York","Nassau County",3,68,15408,7414,7994
050,36,059,"New York","Nassau County",3,69,14785,7005,7780
050,36,059,"New York","Nassau County",3,70,14210,6677,7533
050,36,059,"New York","Nassau County",3,71,13430,6251,7179
050,36,059,"New York","Nassau County",3,72,12934,6016,6918
050,36,059,"New York","Nassau County",3,73,12666,5917,6749
050,36,059,"New York","Nassau County",3,74,13208,6142,7066
050,36,059,"New York","Nassau County",3,75,9495,4325,5170
050,36,059,"New York","Nassau County",3,76,9052,4075,4977
050,36,059,"New York","Nassau County",3,77,8607,3781,4826
050,36,059,"New York","Nassau County",3,78,8670,3712,4958
050,36,059,"New York","Nassau County",3,79,7491,3174,4317
050,36,059,"New York","Nassau County",3,80,6643,2777,3866
050,36,059,"New York","Nassau County",3,81,6111,2552,3559
050,36,059,"New York","Nassau County",3,82,5741,2348,3393
050,36,059,"New York","Nassau County",3,83,5434,2161,3273
050,36,059,"New York","Nassau County",3,84,4904,1925,2979
050,36,059,"New York","Nassau County",3,85,33242,11614,21628
050,36,059,"New York","Nassau County",4,0,14316,7268,7048
050,36,059,"New York","Nassau County",4,1,13518,6757,6761
050,36,059,"New York","Nassau County",4,2,14557,7485,7072
050,36,059,"New York","Nassau County",4,3,14995,7750,7245
050,36,059,"New York","Nassau County",4,4,15512,8002,7510
050,36,059,"New York","Nassau County",4,5,16017,8234,7783
050,36,059,"New York","Nassau County",4,6,16369,8408,7961
050,36,059,"New York","Nassau County",4,7,16365,8475,7890
050,36,059,"New York","Nassau County",4,8,16439,8539,7900
050,36,059,"New York","Nassau County",4,9,16764,8673,8091
050,36,059,"New York","Nassau County",4,10,16987,8759,8228
050,36,059,"New York","Nassau County",4,11,17379,8936,8443
050,36,059,"New York","Nassau County",4,12,17620,9008,8612
050,36,059,"New York","Nassau County",4,13,17645,9094,8551
050,36,059,"New York","Nassau County",4,14,18300,9430,8870
050,36,059,"New York","Nassau County",4,15,18322,9381,8941
050,36,059,"New York","Nassau County",4,16,18392,9492,8900
050,36,059,"New York","Nassau County",4,17,18416,9462,8954
050,36,059,"New York","Nassau County",4,18,17306,8931,8375
050,36,059,"New York","Nassau County",4,19,15111,7793,7318
050,36,059,"New York","Nassau County",4,20,15773,8098,7675
050,36,059,"New York","Nassau County",4,21,16512,8416,8096
050,36,059,"New York","Nassau County",4,22,16730,8492,8238
050,36,059,"New York","Nassau County",4,23,16451,8379,8072
050,36,059,"New York","Nassau County",4,24,16521,8362,8159
050,36,059,"New York","Nassau County",4,25,16413,8350,8063
050,36,059,"New York","Nassau County",4,26,16577,8454,8123
050,36,059,"New York","Nassau County",4,27,16524,8445,8079
050,36,059,"New York","Nassau County",4,28,16351,8336,8015
050,36,059,"New York","Nassau County",4,29,16430,8353,8077
050,36,059,"New York","Nassau County",4,30,15601,7922,7679
050,36,059,"New York","Nassau County",4,31,15749,7961,7788
050,36,059,"New York","Nassau County",4,32,16279,8155,8124
050,36,059,"New York","Nassau County",4,33,16075,8070,8005
050,36,059,"New York","Nassau County",4,34,16434,8125,8309
050,36,059,"New York","Nassau County",4,35,16517,8283,8234
050,36,059,"New York","Nassau County",4,36,16729,8308,8421
050,36,059,"New York","Nassau County",4,37,17147,8569,8578
050,36,059,"New York","Nassau County",4,38,16914,8469,8445
050,36,059,"New York","Nassau County",4,39,17572,8800,8772
050,36,059,"New York","Nassau County",4,40,17713,8855,8858
050,36,059,"New York","Nassau County",4,41,17689,8876,8813
050,36,059,"New York","Nassau County",4,42,18015,8976,9039
050,36,059,"New York","Nassau County",4,43,17605,8755,8850
050,36,059,"New York","Nassau County",4,44,17477,8818,8659
050,36,059,"New York","Nassau County",4,45,17334,8631,8703
050,36,059,"New York","Nassau County",4,46,17229,8553,8676
050,36,059,"New York","Nassau County",4,47,17553,8747,8806
050,36,059,"New York","Nassau County",4,48,17142,8566,8576
050,36,059,"New York","Nassau County",4,49,17128,8561,8567
050,36,059,"New York","Nassau County",4,50,17949,8918,9031
050,36,059,"New York","Nassau County",4,51,19073,9558,9515
050,36,059,"New York","Nassau County",4,52,19267,9527,9740
050,36,059,"New York","Nassau County",4,53,18905,9257,9648
050,36,059,"New York","Nassau County",4,54,18873,9261,9612
050,36,059,"New York","Nassau County",4,55,19364,9417,9947
050,36,059,"New York","Nassau County",4,56,19760,9677,10083
050,36,059,"New York","Nassau County",4,57,20381,9914,10467
050,36,059,"New York","Nassau County",4,58,20602,10057,10545
050,36,059,"New York","Nassau County",4,59,20369,9992,10377
050,36,059,"New York","Nassau County",4,60,20116,9827,10289
050,36,059,"New York","Nassau County",4,61,20142,9875,10267
050,36,059,"New York","Nassau County",4,62,19769,9654,10115
050,36,059,"New York","Nassau County",4,63,19006,9241,9765
050,36,059,"New York","Nassau County",4,64,18777,9058,9719
050,36,059,"New York","Nassau County",4,65,18180,8752,9428
050,36,059,"New York","Nassau County",4,66,17109,8276,8833
050,36,059,"New York","Nassau County",4,67,16555,7931,8624
050,36,059,"New York","Nassau County",4,68,15745,7517,8228
050,36,059,"New York","Nassau County",4,69,14943,7142,7801
050,36,059,"New York","Nassau County",4,70,14389,6780,7609
050,36,059,"New York","Nassau County",4,71,13771,6455,7316
050,36,059,"New York","Nassau County",4,72,13016,6042,6974
050,36,059,"New York","Nassau County",4,73,12566,5809,6757
050,36,059,"New York","Nassau County",4,74,12274,5703,6571
050,36,059,"New York","Nassau County",4,75,12717,5897,6820
050,36,059,"New York","Nassau County",4,76,9167,4136,5031
050,36,059,"New York","Nassau County",4,77,8719,3870,4849
050,36,059,"New York","Nassau County",4,78,8279,3593,4686
050,36,059,"New York","Nassau County",4,79,8258,3516,4742
050,36,059,"New York","Nassau County",4,80,7201,3006,4195
050,36,059,"New York","Nassau County",4,81,6316,2631,3685
050,36,059,"New York","Nassau County",4,82,5759,2379,3380
050,36,059,"New York","Nassau County",4,83,5441,2168,3273
050,36,059,"New York","Nassau County",4,84,5116,1996,3120
050,36,059,"New York","Nassau County",4,85,32906,11459,21447
050,36,059,"New York","Nassau County",5,0,14252,7235,7017
050,36,059,"New York","Nassau County",5,1,14385,7220,7165
050,36,059,"New York","Nassau County",5,2,13680,6857,6823
050,36,059,"New York","Nassau County",5,3,14646,7525,7121
050,36,059,"New York","Nassau County",5,4,15167,7819,7348
050,36,059,"New York","Nassau County",5,5,15606,8045,7561
050,36,059,"New York","Nassau County",5,6,16167,8366,7801
050,36,059,"New York","Nassau County",5,7,16532,8466,8066
050,36,059,"New York","Nassau County",5,8,16491,8510,7981
050,36,059,"New York","Nassau County",5,9,16489,8571,7918
050,36,059,"New York","Nassau County",5,10,16838,8726,8112
050,36,059,"New York","Nassau County",5,11,17170,8860,8310
050,36,059,"New York","Nassau County",5,12,17431,8958,8473
050,36,059,"New York","Nassau County",5,13,17693,9030,8663
050,36,059,"New York","Nassau County",5,14,17726,9128,8598
050,36,059,"New York","Nassau County",5,15,18411,9508,8903
050,36,059,"New York","Nassau County",5,16,18411,9409,9002
050,36,059,"New York","Nassau County",5,17,18427,9489,8938
050,36,059,"New York","Nassau County",5,18,16990,8777,8213
050,36,059,"New York","Nassau County",5,19,15227,7798,7429
050,36,059,"New York","Nassau County",5,20,15988,8143,7845
050,36,059,"New York","Nassau County",5,21,16182,8333,7849
050,36,059,"New York","Nassau County",5,22,16439,8312,8127
050,36,059,"New York","Nassau County",5,23,16558,8379,8179
050,36,059,"New York","Nassau County",5,24,16345,8330,8015
050,36,059,"New York","Nassau County",5,25,16250,8257,7993
050,36,059,"New York","Nassau County",5,26,16037,8184,7853
050,36,059,"New York","Nassau County",5,27,16258,8303,7955
050,36,059,"New York","Nassau County",5,28,16021,8205,7816
050,36,059,"New York","Nassau County",5,29,16038,8178,7860
050,36,059,"New York","Nassau County",5,30,16049,8151,7898
050,36,059,"New York","Nassau County",5,31,15461,7835,7626
050,36,059,"New York","Nassau County",5,32,15816,8002,7814
050,36,059,"New York","Nassau County",5,33,16160,8066,8094
050,36,059,"New York","Nassau County",5,34,16229,8129,8100
050,36,059,"New York","Nassau County",5,35,16516,8167,8349
050,36,059,"New York","Nassau County",5,36,16609,8272,8337
050,36,059,"New York","Nassau County",5,37,16852,8321,8531
050,36,059,"New York","Nassau County",5,38,17192,8531,8661
050,36,059,"New York","Nassau County",5,39,16993,8490,8503
050,36,059,"New York","Nassau County",5,40,17763,8917,8846
050,36,059,"New York","Nassau County",5,41,17798,8853,8945
050,36,059,"New York","Nassau County",5,42,17676,8828,8848
050,36,059,"New York","Nassau County",5,43,18007,9023,8984
050,36,059,"New York","Nassau County",5,44,17664,8761,8903
050,36,059,"New York","Nassau County",5,45,17566,8835,8731
050,36,059,"New York","Nassau County",5,46,17422,8673,8749
050,36,059,"New York","Nassau County",5,47,17334,8601,8733
050,36,059,"New York","Nassau County",5,48,17560,8742,8818
050,36,059,"New York","Nassau County",5,49,17042,8536,8506
050,36,059,"New York","Nassau County",5,50,17143,8545,8598
050,36,059,"New York","Nassau County",5,51,17869,8911,8958
050,36,059,"New York","Nassau County",5,52,18901,9472,9429
050,36,059,"New York","Nassau County",5,53,19149,9493,9656
050,36,059,"New York","Nassau County",5,54,18700,9192,9508
050,36,059,"New York","Nassau County",5,55,18677,9153,9524
050,36,059,"New York","Nassau County",5,56,19170,9331,9839
050,36,059,"New York","Nassau County",5,57,19459,9577,9882
050,36,059,"New York","Nassau County",5,58,20189,9841,10348
050,36,059,"New York","Nassau County",5,59,20324,9889,10435
050,36,059,"New York","Nassau County",5,60,19921,9733,10188
050,36,059,"New York","Nassau County",5,61,19795,9614,10181
050,36,059,"New York","Nassau County",5,62,19766,9703,10063
050,36,059,"New York","Nassau County",5,63,19288,9391,9897
050,36,059,"New York","Nassau County",5,64,18589,9017,9572
050,36,059,"New York","Nassau County",5,65,18358,8834,9524
050,36,059,"New York","Nassau County",5,66,17735,8527,9208
050,36,059,"New York","Nassau County",5,67,16706,8088,8618
050,36,059,"New York","Nassau County",5,68,16144,7677,8467
050,36,059,"New York","Nassau County",5,69,15409,7330,8079
050,36,059,"New York","Nassau County",5,70,14653,6959,7694
050,36,059,"New York","Nassau County",5,71,14018,6588,7430
050,36,059,"New York","Nassau County",5,72,13401,6283,7118
050,36,059,"New York","Nassau County",5,73,12704,5893,6811
050,36,059,"New York","Nassau County",5,74,12219,5590,6629
050,36,059,"New York","Nassau County",5,75,11870,5482,6388
050,36,059,"New York","Nassau County",5,76,12323,5699,6624
050,36,059,"New York","Nassau County",5,77,8894,3989,4905
050,36,059,"New York","Nassau County",5,78,8397,3700,4697
050,36,059,"New York","Nassau County",5,79,7953,3438,4515
050,36,059,"New York","Nassau County",5,80,7959,3345,4614
050,36,059,"New York","Nassau County",5,81,6864,2863,4001
050,36,059,"New York","Nassau County",5,82,6012,2473,3539
050,36,059,"New York","Nassau County",5,83,5475,2242,3233
050,36,059,"New York","Nassau County",5,84,5128,2024,3104
050,36,059,"New York","Nassau County",5,85,32989,11513,21476
050,36,061,"New York","New York County",1,0,17791,9114,8677
050,36,061,"New York","New York County",1,1,16253,8292,7961
050,36,061,"New York","New York County",1,2,15275,7786,7489
050,36,061,"New York","New York County",1,3,14602,7422,7180
050,36,061,"New York","New York County",1,4,13966,7017,6949
050,36,061,"New York","New York County",1,5,13833,7014,6819
050,36,061,"New York","New York County",1,6,13367,6835,6532
050,36,061,"New York","New York County",1,7,13440,6775,6665
050,36,061,"New York","New York County",1,8,13336,6784,6552
050,36,061,"New York","New York County",1,9,13059,6637,6422
050,36,061,"New York","New York County",1,10,12634,6327,6307
050,36,061,"New York","New York County",1,11,12575,6309,6266
050,36,061,"New York","New York County",1,12,12644,6406,6238
050,36,061,"New York","New York County",1,13,12293,6117,6176
050,36,061,"New York","New York County",1,14,11877,5924,5953
050,36,061,"New York","New York County",1,15,11880,5973,5907
050,36,061,"New York","New York County",1,16,12010,6008,6002
050,36,061,"New York","New York County",1,17,11845,5911,5934
050,36,061,"New York","New York County",1,18,15825,6968,8857
050,36,061,"New York","New York County",1,19,18623,8027,10596
050,36,061,"New York","New York County",1,20,17796,7979,9817
050,36,061,"New York","New York County",1,21,17157,7690,9467
050,36,061,"New York","New York County",1,22,18065,8022,10043
050,36,061,"New York","New York County",1,23,25795,11382,14413
050,36,061,"New York","New York County",1,24,31477,14082,17395
050,36,061,"New York","New York County",1,25,34977,15890,19087
050,36,061,"New York","New York County",1,26,36869,17079,19790
050,36,061,"New York","New York County",1,27,38326,18269,20057
050,36,061,"New York","New York County",1,28,38716,18386,20330
050,36,061,"New York","New York County",1,29,39419,19100,20319
050,36,061,"New York","New York County",1,30,39507,19308,20199
050,36,061,"New York","New York County",1,31,37725,18543,19182
050,36,061,"New York","New York County",1,32,36762,18083,18679
050,36,061,"New York","New York County",1,33,34668,17316,17352
050,36,061,"New York","New York County",1,34,32905,16530,16375
050,36,061,"New York","New York County",1,35,31095,15659,15436
050,36,061,"New York","New York County",1,36,28975,14493,14482
050,36,061,"New York","New York County",1,37,27501,13840,13661
050,36,061,"New York","New York County",1,38,26028,13225,12803
050,36,061,"New York","New York County",1,39,24712,12398,12314
050,36,061,"New York","New York County",1,40,24059,12135,11924
050,36,061,"New York","New York County",1,41,22584,11468,11116
050,36,061,"New York","New York County",1,42,21873,11038,10835
050,36,061,"New York","New York County",1,43,21401,10578,10823
050,36,061,"New York","New York County",1,44,20820,10339,10481
050,36,061,"New York","New York County",1,45,20839,10495,10344
050,36,061,"New York","New York County",1,46,19924,9840,10084
050,36,061,"New York","New York County",1,47,19925,9948,9977
050,36,061,"New York","New York County",1,48,20708,10446,10262
050,36,061,"New York","New York County",1,49,21946,11103,10843
050,36,061,"New York","New York County",1,50,22045,11293,10752
050,36,061,"New York","New York County",1,51,20712,10424,10288
050,36,061,"New York","New York County",1,52,19902,10070,9832
050,36,061,"New York","New York County",1,53,20140,10199,9941
050,36,061,"New York","New York County",1,54,20457,10294,10163
050,36,061,"New York","New York County",1,55,21156,10855,10301
050,36,061,"New York","New York County",1,56,20758,10458,10300
050,36,061,"New York","New York County",1,57,20209,10021,10188
050,36,061,"New York","New York County",1,58,19729,9780,9949
050,36,061,"New York","New York County",1,59,19583,9662,9921
050,36,061,"New York","New York County",1,60,19704,9740,9964
050,36,061,"New York","New York County",1,61,18973,9273,9700
050,36,061,"New York","New York County",1,62,18920,9011,9909
050,36,061,"New York","New York County",1,63,18538,8665,9873
050,36,061,"New York","New York County",1,64,18136,8405,9731
050,36,061,"New York","New York County",1,65,18004,8349,9655
050,36,061,"New York","New York County",1,66,17363,7999,9364
050,36,061,"New York","New York County",1,67,16909,7659,9250
050,36,061,"New York","New York County",1,68,16468,7320,9148
050,36,061,"New York","New York County",1,69,15906,6926,8980
050,36,061,"New York","New York County",1,70,16067,6902,9165
050,36,061,"New York","New York County",1,71,15490,6646,8844
050,36,061,"New York","New York County",1,72,15316,6402,8914
050,36,061,"New York","New York County",1,73,15248,6378,8870
050,36,061,"New York","New York County",1,74,11896,4855,7041
050,36,061,"New York","New York County",1,75,11740,4817,6923
050,36,061,"New York","New York County",1,76,11271,4609,6662
050,36,061,"New York","New York County",1,77,11317,4622,6695
050,36,061,"New York","New York County",1,78,9884,4010,5874
050,36,061,"New York","New York County",1,79,8958,3670,5288
050,36,061,"New York","New York County",1,80,8389,3409,4980
050,36,061,"New York","New York County",1,81,7745,3104,4641
050,36,061,"New York","New York County",1,82,7116,2816,4300
050,36,061,"New York","New York County",1,83,6379,2471,3908
050,36,061,"New York","New York County",1,84,6090,2384,3706
050,36,061,"New York","New York County",1,85,38050,13707,24343
050,36,061,"New York","New York County",2,0,16856,8646,8210
050,36,061,"New York","New York County",2,1,16252,8284,7968
050,36,061,"New York","New York County",2,2,15253,7766,7487
050,36,061,"New York","New York County",2,3,14537,7381,7156
050,36,061,"New York","New York County",2,4,13968,7030,6938
050,36,061,"New York","New York County",2,5,13728,6939,6789
050,36,061,"New York","New York County",2,6,13395,6838,6557
050,36,061,"New York","New York County",2,7,13306,6719,6587
050,36,061,"New York","New York County",2,8,13256,6724,6532
050,36,061,"New York","New York County",2,9,13041,6621,6420
050,36,061,"New York","New York County",2,10,12654,6360,6294
050,36,061,"New York","New York County",2,11,12480,6257,6223
050,36,061,"New York","New York County",2,12,12629,6377,6252
050,36,061,"New York","New York County",2,13,12306,6158,6148
050,36,061,"New York","New York County",2,14,11915,5931,5984
050,36,061,"New York","New York County",2,15,11855,5940,5915
050,36,061,"New York","New York County",2,16,11934,5977,5957
050,36,061,"New York","New York County",2,17,11846,5911,5935
050,36,061,"New York","New York County",2,18,14577,6572,8005
050,36,061,"New York","New York County",2,19,16563,7280,9283
050,36,061,"New York","New York County",2,20,16286,7380,8906
050,36,061,"New York","New York County",2,21,16207,7308,8899
050,36,061,"New York","New York County",2,22,18130,8070,10060
050,36,061,"New York","New York County",2,23,24576,10850,13726
050,36,061,"New York","New York County",2,24,30354,13580,16774
050,36,061,"New York","New York County",2,25,34170,15518,18652
050,36,061,"New York","New York County",2,26,36315,16787,19528
050,36,061,"New York","New York County",2,27,37657,17882,19775
050,36,061,"New York","New York County",2,28,38329,18290,20039
050,36,061,"New York","New York County",2,29,38765,18720,20045
050,36,061,"New York","New York County",2,30,39176,19161,20015
050,36,061,"New York","New York County",2,31,37431,18421,19010
050,36,061,"New York","New York County",2,32,36281,17865,18416
050,36,061,"New York","New York County",2,33,34485,17181,17304
050,36,061,"New York","New York County",2,34,32719,16420,16299
050,36,061,"New York","New York County",2,35,31185,15719,15466
050,36,061,"New York","New York County",2,36,28849,14458,14391
050,36,061,"New York","New York County",2,37,27455,13811,13644
050,36,061,"New York","New York County",2,38,26168,13265,12903
050,36,061,"New York","New York County",2,39,24634,12374,12260
050,36,061,"New York","New York County",2,40,24153,12192,11961
050,36,061,"New York","New York County",2,41,22634,11445,11189
050,36,061,"New York","New York County",2,42,21754,10988,10766
050,36,061,"New York","New York County",2,43,21466,10636,10830
050,36,061,"New York","New York County",2,44,20671,10256,10415
050,36,061,"New York","New York County",2,45,20847,10477,10370
050,36,061,"New York","New York County",2,46,19936,9877,10059
050,36,061,"New York","New York County",2,47,19797,9842,9955
050,36,061,"New York","New York County",2,48,20424,10279,10145
050,36,061,"New York","New York County",2,49,21589,10910,10679
050,36,061,"New York","New York County",2,50,21961,11215,10746
050,36,061,"New York","New York County",2,51,20796,10484,10312
050,36,061,"New York","New York County",2,52,19999,10092,9907
050,36,061,"New York","New York County",2,53,19968,10104,9864
050,36,061,"New York","New York County",2,54,20263,10214,10049
050,36,061,"New York","New York County",2,55,20918,10692,10226
050,36,061,"New York","New York County",2,56,20805,10499,10306
050,36,061,"New York","New York County",2,57,20243,10057,10186
050,36,061,"New York","New York County",2,58,19700,9761,9939
050,36,061,"New York","New York County",2,59,19489,9605,9884
050,36,061,"New York","New York County",2,60,19651,9692,9959
050,36,061,"New York","New York County",2,61,18960,9257,9703
050,36,061,"New York","New York County",2,62,18776,8980,9796
050,36,061,"New York","New York County",2,63,18604,8718,9886
050,36,061,"New York","New York County",2,64,18002,8343,9659
050,36,061,"New York","New York County",2,65,17904,8283,9621
050,36,061,"New York","New York County",2,66,17385,8002,9383
050,36,061,"New York","New York County",2,67,16813,7625,9188
050,36,061,"New York","New York County",2,68,16362,7303,9059
050,36,061,"New York","New York County",2,69,15925,6937,8988
050,36,061,"New York","New York County",2,70,15914,6835,9079
050,36,061,"New York","New York County",2,71,15485,6627,8858
050,36,061,"New York","New York County",2,72,15063,6315,8748
050,36,061,"New York","New York County",2,73,15650,6545,9105
050,36,061,"New York","New York County",2,74,12017,4920,7097
050,36,061,"New York","New York County",2,75,11680,4764,6916
050,36,061,"New York","New York County",2,76,11162,4552,6610
050,36,061,"New York","New York County",2,77,11309,4597,6712
050,36,061,"New York","New York County",2,78,9945,4026,5919
050,36,061,"New York","New York County",2,79,8967,3634,5333
050,36,061,"New York","New York County",2,80,8391,3394,4997
050,36,061,"New York","New York County",2,81,7694,3082,4612
050,36,061,"New York","New York County",2,82,7113,2794,4319
050,36,061,"New York","New York County",2,83,6363,2456,3907
050,36,061,"New York","New York County",2,84,5950,2295,3655
050,36,061,"New York","New York County",2,85,37211,13365,23846
050,36,061,"New York","New York County",3,0,13983,7123,6860
050,36,061,"New York","New York County",3,1,13849,7042,6807
050,36,061,"New York","New York County",3,2,13554,6888,6666
050,36,061,"New York","New York County",3,3,13161,6706,6455
050,36,061,"New York","New York County",3,4,13012,6576,6436
050,36,061,"New York","New York County",3,5,12785,6485,6300
050,36,061,"New York","New York County",3,6,12727,6463,6264
050,36,061,"New York","New York County",3,7,12501,6381,6120
050,36,061,"New York","New York County",3,8,12552,6384,6168
050,36,061,"New York","New York County",3,9,12618,6412,6206
050,36,061,"New York","New York County",3,10,12479,6349,6130
050,36,061,"New York","New York County",3,11,12245,6161,6084
050,36,061,"New York","New York County",3,12,12091,6047,6044
050,36,061,"New York","New York County",3,13,12329,6251,6078
050,36,061,"New York","New York County",3,14,12034,6057,5977
050,36,061,"New York","New York County",3,15,11686,5770,5916
050,36,061,"New York","New York County",3,16,11658,5816,5842
050,36,061,"New York","New York County",3,17,11911,5927,5984
050,36,061,"New York","New York County",3,18,15922,7001,8921
050,36,061,"New York","New York County",3,19,18189,7865,10324
050,36,061,"New York","New York County",3,20,17275,7719,9556
050,36,061,"New York","New York County",3,21,16547,7452,9095
050,36,061,"New York","New York County",3,22,16007,7187,8820
050,36,061,"New York","New York County",3,23,20315,9119,11196
050,36,061,"New York","New York County",3,24,24865,10952,13913
050,36,061,"New York","New York County",3,25,28368,13038,15330
050,36,061,"New York","New York County",3,26,30706,14084,16622
050,36,061,"New York","New York County",3,27,32115,15174,16941
050,36,061,"New York","New York County",3,28,32877,15800,17077
050,36,061,"New York","New York County",3,29,33227,15937,17290
050,36,061,"New York","New York County",3,30,33545,16506,17039
050,36,061,"New York","New York County",3,31,33673,16799,16874
050,36,061,"New York","New York County",3,32,31953,15887,16066
050,36,061,"New York","New York County",3,33,30828,15308,15520
050,36,061,"New York","New York County",3,34,29492,14807,14685
050,36,061,"New York","New York County",3,35,28142,14229,13913
050,36,061,"New York","New York County",3,36,26790,13555,13235
050,36,061,"New York","New York County",3,37,25060,12528,12532
050,36,061,"New York","New York County",3,38,24113,12149,11964
050,36,061,"New York","New York County",3,39,23281,11705,11576
050,36,061,"New York","New York County",3,40,22248,11261,10987
050,36,061,"New York","New York County",3,41,21709,10799,10910
050,36,061,"New York","New York County",3,42,20732,10515,10217
050,36,061,"New York","New York County",3,43,20085,10070,10015
050,36,061,"New York","New York County",3,44,19851,9795,10056
050,36,061,"New York","New York County",3,45,19464,9727,9737
050,36,061,"New York","New York County",3,46,19356,9664,9692
050,36,061,"New York","New York County",3,47,18804,9273,9531
050,36,061,"New York","New York County",3,48,18638,9217,9421
050,36,061,"New York","New York County",3,49,19377,9735,9642
050,36,061,"New York","New York County",3,50,20696,10474,10222
050,36,061,"New York","New York County",3,51,20744,10489,10255
050,36,061,"New York","New York County",3,52,19784,9935,9849
050,36,061,"New York","New York County",3,53,19199,9715,9484
050,36,061,"New York","New York County",3,54,19101,9631,9470
050,36,061,"New York","New York County",3,55,19368,9718,9650
050,36,061,"New York","New York County",3,56,19848,10041,9807
050,36,061,"New York","New York County",3,57,19959,10016,9943
050,36,061,"New York","New York County",3,58,19413,9632,9781
050,36,061,"New York","New York County",3,59,18929,9281,9648
050,36,061,"New York","New York County",3,60,18897,9316,9581
050,36,061,"New York","New York County",3,61,18691,9171,9520
050,36,061,"New York","New York County",3,62,18229,8870,9359
050,36,061,"New York","New York County",3,63,17864,8502,9362
050,36,061,"New York","New York County",3,64,17827,8327,9500
050,36,061,"New York","New York County",3,65,17397,8016,9381
050,36,061,"New York","New York County",3,66,17334,7950,9384
050,36,061,"New York","New York County",3,67,16839,7674,9165
050,36,061,"New York","New York County",3,68,16319,7365,8954
050,36,061,"New York","New York County",3,69,15888,6997,8891
050,36,061,"New York","New York County",3,70,15483,6705,8778
050,36,061,"New York","New York County",3,71,15401,6575,8826
050,36,061,"New York","New York County",3,72,15053,6361,8692
050,36,061,"New York","New York County",3,73,14623,6083,8540
050,36,061,"New York","New York County",3,74,15145,6284,8861
050,36,061,"New York","New York County",3,75,11634,4680,6954
050,36,061,"New York","New York County",3,76,11324,4590,6734
050,36,061,"New York","New York County",3,77,10792,4387,6405
050,36,061,"New York","New York County",3,78,10937,4426,6511
050,36,061,"New York","New York County",3,79,9555,3841,5714
050,36,061,"New York","New York County",3,80,8582,3431,5151
050,36,061,"New York","New York County",3,81,7951,3198,4753
050,36,061,"New York","New York County",3,82,7396,2965,4431
050,36,061,"New York","New York County",3,83,6759,2620,4139
050,36,061,"New York","New York County",3,84,5968,2267,3701
050,36,061,"New York","New York County",3,85,38397,13804,24593
050,36,061,"New York","New York County",4,0,14226,7287,6939
050,36,061,"New York","New York County",4,1,12607,6373,6234
050,36,061,"New York","New York County",4,2,12574,6344,6230
050,36,061,"New York","New York County",4,3,12645,6447,6198
050,36,061,"New York","New York County",4,4,12437,6279,6158
050,36,061,"New York","New York County",4,5,12327,6274,6053
050,36,061,"New York","New York County",4,6,12307,6274,6033
050,36,061,"New York","New York County",4,7,12248,6170,6078
050,36,061,"New York","New York County",4,8,12141,6183,5958
050,36,061,"New York","New York County",4,9,12230,6230,6000
050,36,061,"New York","New York County",4,10,12220,6218,6002
050,36,061,"New York","New York County",4,11,12209,6230,5979
050,36,061,"New York","New York County",4,12,12051,6064,5987
050,36,061,"New York","New York County",4,13,11931,5991,5940
050,36,061,"New York","New York County",4,14,12089,6097,5992
050,36,061,"New York","New York County",4,15,11895,5976,5919
050,36,061,"New York","New York County",4,16,11701,5745,5956
050,36,061,"New York","New York County",4,17,11811,5865,5946
050,36,061,"New York","New York County",4,18,15891,7014,8877
050,36,061,"New York","New York County",4,19,18103,7826,10277
050,36,061,"New York","New York County",4,20,17164,7676,9488
050,36,061,"New York","New York County",4,21,16751,7421,9330
050,36,061,"New York","New York County",4,22,17701,7872,9829
050,36,061,"New York","New York County",4,23,24350,10557,13793
050,36,061,"New York","New York County",4,24,29066,12732,16334
050,36,061,"New York","New York County",4,25,31273,14090,17183
050,36,061,"New York","New York County",4,26,33479,15549,17930
050,36,061,"New York","New York County",4,27,34123,15972,18151
050,36,061,"New York","New York County",4,28,34615,16580,18035
050,36,061,"New York","New York County",4,29,34184,16648,17536
050,36,061,"New York","New York County",4,30,33848,16485,17363
050,36,061,"New York","New York County",4,31,33437,16692,16745
050,36,061,"New York","New York County",4,32,32963,16746,16217
050,36,061,"New York","New York County",4,33,30661,15498,15163
050,36,061,"New York","New York County",4,34,29372,14734,14638
050,36,061,"New York","New York County",4,35,28059,14327,13732
050,36,061,"New York","New York County",4,36,26715,13558,13157
050,36,061,"New York","New York County",4,37,25429,12904,12525
050,36,061,"New York","New York County",4,38,23953,12076,11877
050,36,061,"New York","New York County",4,39,23012,11501,11511
050,36,061,"New York","New York County",4,40,22578,11410,11168
050,36,061,"New York","New York County",4,41,21167,10629,10538
050,36,061,"New York","New York County",4,42,21137,10494,10643
050,36,061,"New York","New York County",4,43,20091,10122,9969
050,36,061,"New York","New York County",4,44,19486,9769,9717
050,36,061,"New York","New York County",4,45,19617,9774,9843
050,36,061,"New York","New York County",4,46,18864,9376,9488
050,36,061,"New York","New York County",4,47,18948,9423,9525
050,36,061,"New York","New York County",4,48,18441,9139,9302
050,36,061,"New York","New York County",4,49,18406,9113,9293
050,36,061,"New York","New York County",4,50,19191,9611,9580
050,36,061,"New York","New York County",4,51,20146,10050,10096
050,36,061,"New York","New York County",4,52,20435,10213,10222
050,36,061,"New York","New York County",4,53,19605,9857,9748
050,36,061,"New York","New York County",4,54,19026,9627,9399
050,36,061,"New York","New York County",4,55,18832,9483,9349
050,36,061,"New York","New York County",4,56,19007,9422,9585
050,36,061,"New York","New York County",4,57,19588,9842,9746
050,36,061,"New York","New York County",4,58,19651,9872,9779
050,36,061,"New York","New York County",4,59,19263,9519,9744
050,36,061,"New York","New York County",4,60,18881,9257,9624
050,36,061,"New York","New York County",4,61,18452,9041,9411
050,36,061,"New York","New York County",4,62,18442,8976,9466
050,36,061,"New York","New York County",4,63,17834,8697,9137
050,36,061,"New York","New York County",4,64,17570,8293,9277
050,36,061,"New York","New York County",4,65,17358,8110,9248
050,36,061,"New York","New York County",4,66,17018,7853,9165
050,36,061,"New York","New York County",4,67,16937,7731,9206
050,36,061,"New York","New York County",4,68,16430,7486,8944
050,36,061,"New York","New York County",4,69,15951,7154,8797
050,36,061,"New York","New York County",4,70,15474,6824,8650
050,36,061,"New York","New York County",4,71,15102,6518,8584
050,36,061,"New York","New York County",4,72,15066,6397,8669
050,36,061,"New York","New York County",4,73,14667,6185,8482
050,36,061,"New York","New York County",4,74,14283,5918,8365
050,36,061,"New York","New York County",4,75,14765,6079,8686
050,36,061,"New York","New York County",4,76,11327,4545,6782
050,36,061,"New York","New York County",4,77,10981,4435,6546
050,36,061,"New York","New York County",4,78,10463,4205,6258
050,36,061,"New York","New York County",4,79,10556,4251,6305
050,36,061,"New York","New York County",4,80,9168,3644,5524
050,36,061,"New York","New York County",4,81,8181,3260,4921
050,36,061,"New York","New York County",4,82,7612,3038,4574
050,36,061,"New York","New York County",4,83,7031,2781,4250
050,36,061,"New York","New York County",4,84,6372,2442,3930
050,36,061,"New York","New York County",4,85,39345,14136,25209
050,36,061,"New York","New York County",5,0,13857,7088,6769
050,36,061,"New York","New York County",5,1,12900,6577,6323
050,36,061,"New York","New York County",5,2,11391,5748,5643
050,36,061,"New York","New York County",5,3,11813,6022,5791
050,36,061,"New York","New York County",5,4,11939,6077,5862
050,36,061,"New York","New York County",5,5,11948,5987,5961
050,36,061,"New York","New York County",5,6,11940,6145,5795
050,36,061,"New York","New York County",5,7,11878,6035,5843
050,36,061,"New York","New York County",5,8,11917,6018,5899
050,36,061,"New York","New York County",5,9,11807,6015,5792
050,36,061,"New York","New York County",5,10,11753,5985,5768
050,36,061,"New York","New York County",5,11,11876,6007,5869
050,36,061,"New York","New York County",5,12,11886,6033,5853
050,36,061,"New York","New York County",5,13,11819,6003,5816
050,36,061,"New York","New York County",5,14,11728,5890,5838
050,36,061,"New York","New York County",5,15,11972,5983,5989
050,36,061,"New York","New York County",5,16,11882,5966,5916
050,36,061,"New York","New York County",5,17,11725,5757,5968
050,36,061,"New York","New York County",5,18,15886,7035,8851
050,36,061,"New York","New York County",5,19,18329,7915,10414
050,36,061,"New York","New York County",5,20,17320,7753,9567
050,36,061,"New York","New York County",5,21,16620,7442,9178
050,36,061,"New York","New York County",5,22,17958,7904,10054
050,36,061,"New York","New York County",5,23,25718,11281,14437
050,36,061,"New York","New York County",5,24,30696,13384,17312
050,36,061,"New York","New York County",5,25,33574,14978,18596
050,36,061,"New York","New York County",5,26,34574,15664,18910
050,36,061,"New York","New York County",5,27,35368,16706,18662
050,36,061,"New York","New York County",5,28,35193,16656,18537
050,36,061,"New York","New York County",5,29,34743,16904,17839
050,36,061,"New York","New York County",5,30,34071,16926,17145
050,36,061,"New York","New York County",5,31,32811,16191,16620
050,36,061,"New York","New York County",5,32,32107,16172,15935
050,36,061,"New York","New York County",5,33,31154,15917,15237
050,36,061,"New York","New York County",5,34,29150,14822,14328
050,36,061,"New York","New York County",5,35,27901,14113,13788
050,36,061,"New York","New York County",5,36,26486,13522,12964
050,36,061,"New York","New York County",5,37,25209,12812,12397
050,36,061,"New York","New York County",5,38,24197,12257,11940
050,36,061,"New York","New York County",5,39,22918,11475,11443
050,36,061,"New York","New York County",5,40,22288,11233,11055
050,36,061,"New York","New York County",5,41,21526,10818,10708
050,36,061,"New York","New York County",5,42,20574,10342,10232
050,36,061,"New York","New York County",5,43,20527,10162,10365
050,36,061,"New York","New York County",5,44,19636,9867,9769
050,36,061,"New York","New York County",5,45,19100,9726,9374
050,36,061,"New York","New York County",5,46,19004,9480,9524
050,36,061,"New York","New York County",5,47,18455,9080,9375
050,36,061,"New York","New York County",5,48,18620,9295,9325
050,36,061,"New York","New York County",5,49,18104,8945,9159
050,36,061,"New York","New York County",5,50,18150,8974,9176
050,36,061,"New York","New York County",5,51,18597,9235,9362
050,36,061,"New York","New York County",5,52,19728,9835,9893
050,36,061,"New York","New York County",5,53,20172,10081,10091
050,36,061,"New York","New York County",5,54,19295,9673,9622
050,36,061,"New York","New York County",5,55,18917,9539,9378
050,36,061,"New York","New York County",5,56,18441,9171,9270
050,36,061,"New York","New York County",5,57,18669,9204,9465
050,36,061,"New York","New York County",5,58,19235,9665,9570
050,36,061,"New York","New York County",5,59,19370,9687,9683
050,36,061,"New York","New York County",5,60,19185,9433,9752
050,36,061,"New York","New York County",5,61,18434,9012,9422
050,36,061,"New York","New York County",5,62,18259,8919,9340
050,36,061,"New York","New York County",5,63,17895,8633,9262
050,36,061,"New York","New York County",5,64,17469,8501,8968
050,36,061,"New York","New York County",5,65,17113,8078,9035
050,36,061,"New York","New York County",5,66,16968,7900,9068
050,36,061,"New York","New York County",5,67,16707,7640,9067
050,36,061,"New York","New York County",5,68,16611,7539,9072
050,36,061,"New York","New York County",5,69,16137,7337,8800
050,36,061,"New York","New York County",5,70,15633,7000,8633
050,36,061,"New York","New York County",5,71,15111,6638,8473
050,36,061,"New York","New York County",5,72,14806,6371,8435
050,36,061,"New York","New York County",5,73,14603,6179,8424
050,36,061,"New York","New York County",5,74,14389,6035,8354
050,36,061,"New York","New York County",5,75,13897,5695,8202
050,36,061,"New York","New York County",5,76,14365,5888,8477
050,36,061,"New York","New York County",5,77,11008,4410,6598
050,36,061,"New York","New York County",5,78,10684,4281,6403
050,36,061,"New York","New York County",5,79,10149,4059,6090
050,36,061,"New York","New York County",5,80,10172,4044,6128
050,36,061,"New York","New York County",5,81,8779,3460,5319
050,36,061,"New York","New York County",5,82,7888,3139,4749
050,36,061,"New York","New York County",5,83,7256,2851,4405
050,36,061,"New York","New York County",5,84,6651,2618,4033
050,36,061,"New York","New York County",5,85,40860,14731,26129
050,36,063,"New York","Niagara County",1,0,2061,1054,1007
050,36,063,"New York","Niagara County",1,1,2148,1091,1057
050,36,063,"New York","Niagara County",1,2,2182,1099,1083
050,36,063,"New York","Niagara County",1,3,2276,1122,1154
050,36,063,"New York","Niagara County",1,4,2294,1149,1145
050,36,063,"New York","Niagara County",1,5,2392,1226,1166
050,36,063,"New York","Niagara County",1,6,2306,1171,1135
050,36,063,"New York","Niagara County",1,7,2316,1200,1116
050,36,063,"New York","Niagara County",1,8,2312,1168,1144
050,36,063,"New York","Niagara County",1,9,2372,1216,1156
050,36,063,"New York","Niagara County",1,10,2464,1260,1204
050,36,063,"New York","Niagara County",1,11,2521,1251,1270
050,36,063,"New York","Niagara County",1,12,2554,1292,1262
050,36,063,"New York","Niagara County",1,13,2484,1264,1220
050,36,063,"New York","Niagara County",1,14,2472,1243,1229
050,36,063,"New York","Niagara County",1,15,2464,1261,1203
050,36,063,"New York","Niagara County",1,16,2563,1322,1241
050,36,063,"New York","Niagara County",1,17,2630,1343,1287
050,36,063,"New York","Niagara County",1,18,2556,1313,1243
050,36,063,"New York","Niagara County",1,19,2365,1192,1173
050,36,063,"New York","Niagara County",1,20,2389,1218,1171
050,36,063,"New York","Niagara County",1,21,2372,1212,1160
050,36,063,"New York","Niagara County",1,22,2373,1222,1151
050,36,063,"New York","Niagara County",1,23,2399,1230,1169
050,36,063,"New York","Niagara County",1,24,2460,1266,1194
050,36,063,"New York","Niagara County",1,25,2470,1243,1227
050,36,063,"New York","Niagara County",1,26,2544,1298,1246
050,36,063,"New York","Niagara County",1,27,2594,1326,1268
050,36,063,"New York","Niagara County",1,28,2643,1308,1335
050,36,063,"New York","Niagara County",1,29,2768,1403,1365
050,36,063,"New York","Niagara County",1,30,2748,1390,1358
050,36,063,"New York","Niagara County",1,31,2684,1374,1310
050,36,063,"New York","Niagara County",1,32,2699,1357,1342
050,36,063,"New York","Niagara County",1,33,2590,1289,1301
050,36,063,"New York","Niagara County",1,34,2556,1270,1286
050,36,063,"New York","Niagara County",1,35,2584,1315,1269
050,36,063,"New York","Niagara County",1,36,2486,1264,1222
050,36,063,"New York","Niagara County",1,37,2483,1232,1251
050,36,063,"New York","Niagara County",1,38,2511,1228,1283
050,36,063,"New York","Niagara County",1,39,2540,1250,1290
050,36,063,"New York","Niagara County",1,40,2534,1245,1289
050,36,063,"New York","Niagara County",1,41,2451,1216,1235
050,36,063,"New York","Niagara County",1,42,2310,1140,1170
050,36,063,"New York","Niagara County",1,43,2256,1094,1162
050,36,063,"New York","Niagara County",1,44,2251,1119,1132
050,36,063,"New York","Niagara County",1,45,2300,1131,1169
050,36,063,"New York","Niagara County",1,46,2253,1103,1150
050,36,063,"New York","Niagara County",1,47,2389,1171,1218
050,36,063,"New York","Niagara County",1,48,2619,1348,1271
050,36,063,"New York","Niagara County",1,49,2807,1407,1400
050,36,063,"New York","Niagara County",1,50,2808,1453,1355
050,36,063,"New York","Niagara County",1,51,2819,1400,1419
050,36,063,"New York","Niagara County",1,52,2846,1407,1439
050,36,063,"New York","Niagara County",1,53,2925,1382,1543
050,36,063,"New York","Niagara County",1,54,3023,1448,1575
050,36,063,"New York","Niagara County",1,55,3201,1562,1639
050,36,063,"New York","Niagara County",1,56,3277,1608,1669
050,36,063,"New York","Niagara County",1,57,3309,1631,1678
050,36,063,"New York","Niagara County",1,58,3493,1715,1778
050,36,063,"New York","Niagara County",1,59,3569,1765,1804
050,36,063,"New York","Niagara County",1,60,3456,1676,1780
050,36,063,"New York","Niagara County",1,61,3459,1699,1760
050,36,063,"New York","Niagara County",1,62,3571,1758,1813
050,36,063,"New York","Niagara County",1,63,3424,1692,1732
050,36,063,"New York","Niagara County",1,64,3208,1590,1618
050,36,063,"New York","Niagara County",1,65,3091,1534,1557
050,36,063,"New York","Niagara County",1,66,2939,1462,1477
050,36,063,"New York","Niagara County",1,67,2767,1360,1407
050,36,063,"New York","Niagara County",1,68,2645,1317,1328
050,36,063,"New York","Niagara County",1,69,2405,1162,1243
050,36,063,"New York","Niagara County",1,70,2371,1134,1237
050,36,063,"New York","Niagara County",1,71,2353,1127,1226
050,36,063,"New York","Niagara County",1,72,2307,1101,1206
050,36,063,"New York","Niagara County",1,73,2300,1124,1176
050,36,063,"New York","Niagara County",1,74,1563,725,838
050,36,063,"New York","Niagara County",1,75,1574,727,847
050,36,063,"New York","Niagara County",1,76,1580,731,849
050,36,063,"New York","Niagara County",1,77,1597,716,881
050,36,063,"New York","Niagara County",1,78,1300,560,740
050,36,063,"New York","Niagara County",1,79,1108,470,638
050,36,063,"New York","Niagara County",1,80,1012,436,576
050,36,063,"New York","Niagara County",1,81,1006,418,588
050,36,063,"New York","Niagara County",1,82,930,364,566
050,36,063,"New York","Niagara County",1,83,827,338,489
050,36,063,"New York","Niagara County",1,84,799,331,468
050,36,063,"New York","Niagara County",1,85,5009,1668,3341
050,36,063,"New York","Niagara County",2,0,2058,1028,1030
050,36,063,"New York","Niagara County",2,1,2122,1077,1045
050,36,063,"New York","Niagara County",2,2,2173,1097,1076
050,36,063,"New York","Niagara County",2,3,2242,1112,1130
050,36,063,"New York","Niagara County",2,4,2290,1144,1146
050,36,063,"New York","Niagara County",2,5,2365,1209,1156
050,36,063,"New York","Niagara County",2,6,2332,1190,1142
050,36,063,"New York","Niagara County",2,7,2311,1194,1117
050,36,063,"New York","Niagara County",2,8,2313,1173,1140
050,36,063,"New York","Niagara County",2,9,2352,1201,1151
050,36,063,"New York","Niagara County",2,10,2443,1248,1195
050,36,063,"New York","Niagara County",2,11,2498,1249,1249
050,36,063,"New York","Niagara County",2,12,2556,1289,1267
050,36,063,"New York","Niagara County",2,13,2504,1272,1232
050,36,063,"New York","Niagara County",2,14,2469,1244,1225
050,36,063,"New York","Niagara County",2,15,2466,1258,1208
050,36,063,"New York","Niagara County",2,16,2552,1313,1239
050,36,063,"New York","Niagara County",2,17,2608,1337,1271
050,36,063,"New York","Niagara County",2,18,2542,1303,1239
050,36,063,"New York","Niagara County",2,19,2354,1184,1170
050,36,063,"New York","Niagara County",2,20,2409,1225,1184
050,36,063,"New York","Niagara County",2,21,2371,1208,1163
050,36,063,"New York","Niagara County",2,22,2381,1224,1157
050,36,063,"New York","Niagara County",2,23,2394,1234,1160
050,36,063,"New York","Niagara County",2,24,2438,1254,1184
050,36,063,"New York","Niagara County",2,25,2461,1244,1217
050,36,063,"New York","Niagara County",2,26,2527,1287,1240
050,36,063,"New York","Niagara County",2,27,2568,1309,1259
050,36,063,"New York","Niagara County",2,28,2625,1313,1312
050,36,063,"New York","Niagara County",2,29,2732,1375,1357
050,36,063,"New York","Niagara County",2,30,2767,1397,1370
050,36,063,"New York","Niagara County",2,31,2685,1365,1320
050,36,063,"New York","Niagara County",2,32,2673,1348,1325
050,36,063,"New York","Niagara County",2,33,2611,1304,1307
050,36,063,"New York","Niagara County",2,34,2554,1266,1288
050,36,063,"New York","Niagara County",2,35,2587,1310,1277
050,36,063,"New York","Niagara County",2,36,2499,1269,1230
050,36,063,"New York","Niagara County",2,37,2489,1240,1249
050,36,063,"New York","Niagara County",2,38,2514,1232,1282
050,36,063,"New York","Niagara County",2,39,2522,1239,1283
050,36,063,"New York","Niagara County",2,40,2554,1256,1298
050,36,063,"New York","Niagara County",2,41,2460,1216,1244
050,36,063,"New York","Niagara County",2,42,2339,1156,1183
050,36,063,"New York","Niagara County",2,43,2281,1112,1169
050,36,063,"New York","Niagara County",2,44,2232,1107,1125
050,36,063,"New York","Niagara County",2,45,2299,1135,1164
050,36,063,"New York","Niagara County",2,46,2251,1104,1147
050,36,063,"New York","Niagara County",2,47,2347,1150,1197
050,36,063,"New York","Niagara County",2,48,2555,1300,1255
050,36,063,"New York","Niagara County",2,49,2769,1395,1374
050,36,063,"New York","Niagara County",2,50,2812,1443,1369
050,36,063,"New York","Niagara County",2,51,2802,1406,1396
050,36,063,"New York","Niagara County",2,52,2821,1395,1426
050,36,063,"New York","Niagara County",2,53,2915,1395,1520
050,36,063,"New York","Niagara County",2,54,2986,1429,1557
050,36,063,"New York","Niagara County",2,55,3151,1528,1623
050,36,063,"New York","Niagara County",2,56,3260,1595,1665
050,36,063,"New York","Niagara County",2,57,3292,1621,1671
050,36,063,"New York","Niagara County",2,58,3436,1687,1749
050,36,063,"New York","Niagara County",2,59,3552,1750,1802
050,36,063,"New York","Niagara County",2,60,3460,1686,1774
050,36,063,"New York","Niagara County",2,61,3436,1678,1758
050,36,063,"New York","Niagara County",2,62,3525,1732,1793
050,36,063,"New York","Niagara County",2,63,3477,1718,1759
050,36,063,"New York","Niagara County",2,64,3230,1601,1629
050,36,063,"New York","Niagara County",2,65,3101,1535,1566
050,36,063,"New York","Niagara County",2,66,2969,1473,1496
050,36,063,"New York","Niagara County",2,67,2786,1372,1414
050,36,063,"New York","Niagara County",2,68,2636,1309,1327
050,36,063,"New York","Niagara County",2,69,2470,1199,1271
050,36,063,"New York","Niagara County",2,70,2350,1131,1219
050,36,063,"New York","Niagara County",2,71,2334,1112,1222
050,36,063,"New York","Niagara County",2,72,2263,1081,1182
050,36,063,"New York","Niagara County",2,73,2395,1164,1231
050,36,063,"New York","Niagara County",2,74,1620,764,856
050,36,063,"New York","Niagara County",2,75,1549,716,833
050,36,063,"New York","Niagara County",2,76,1547,717,830
050,36,063,"New York","Niagara County",2,77,1616,733,883
050,36,063,"New York","Niagara County",2,78,1325,581,744
050,36,063,"New York","Niagara County",2,79,1134,485,649
050,36,063,"New York","Niagara County",2,80,1021,436,585
050,36,063,"New York","Niagara County",2,81,979,407,572
050,36,063,"New York","Niagara County",2,82,922,366,556
050,36,063,"New York","Niagara County",2,83,834,335,499
050,36,063,"New York","Niagara County",2,84,780,318,462
050,36,063,"New York","Niagara County",2,85,4896,1651,3245
050,36,063,"New York","Niagara County",3,0,1971,1004,967
050,36,063,"New York","Niagara County",3,1,2107,1057,1050
050,36,063,"New York","Niagara County",3,2,2154,1084,1070
050,36,063,"New York","Niagara County",3,3,2225,1123,1102
050,36,063,"New York","Niagara County",3,4,2291,1130,1161
050,36,063,"New York","Niagara County",3,5,2303,1154,1149
050,36,063,"New York","Niagara County",3,6,2374,1213,1161
050,36,063,"New York","Niagara County",3,7,2345,1191,1154
050,36,063,"New York","Niagara County",3,8,2318,1201,1117
050,36,063,"New York","Niagara County",3,9,2304,1168,1136
050,36,063,"New York","Niagara County",3,10,2336,1190,1146
050,36,063,"New York","Niagara County",3,11,2477,1259,1218
050,36,063,"New York","Niagara County",3,12,2522,1247,1275
050,36,063,"New York","Niagara County",3,13,2586,1294,1292
050,36,063,"New York","Niagara County",3,14,2499,1268,1231
050,36,063,"New York","Niagara County",3,15,2455,1226,1229
050,36,063,"New York","Niagara County",3,16,2481,1267,1214
050,36,063,"New York","Niagara County",3,17,2550,1314,1236
050,36,063,"New York","Niagara County",3,18,2560,1304,1256
050,36,063,"New York","Niagara County",3,19,2315,1151,1164
050,36,063,"New York","Niagara County",3,20,2395,1225,1170
050,36,063,"New York","Niagara County",3,21,2386,1209,1177
050,36,063,"New York","Niagara County",3,22,2403,1230,1173
050,36,063,"New York","Niagara County",3,23,2384,1248,1136
050,36,063,"New York","Niagara County",3,24,2423,1253,1170
050,36,063,"New York","Niagara County",3,25,2429,1245,1184
050,36,063,"New York","Niagara County",3,26,2416,1257,1159
050,36,063,"New York","Niagara County",3,27,2490,1270,1220
050,36,063,"New York","Niagara County",3,28,2542,1310,1232
050,36,063,"New York","Niagara County",3,29,2651,1341,1310
050,36,063,"New York","Niagara County",3,30,2773,1378,1395
050,36,063,"New York","Niagara County",3,31,2817,1395,1422
050,36,063,"New York","Niagara County",3,32,2712,1379,1333
050,36,063,"New York","Niagara County",3,33,2700,1360,1340
050,36,063,"New York","Niagara County",3,34,2655,1322,1333
050,36,063,"New York","Niagara County",3,35,2596,1301,1295
050,36,063,"New York","Niagara County",3,36,2645,1329,1316
050,36,063,"New York","Niagara County",3,37,2511,1278,1233
050,36,063,"New York","Niagara County",3,38,2512,1246,1266
050,36,063,"New York","Niagara County",3,39,2505,1225,1280
050,36,063,"New York","Niagara County",3,40,2537,1255,1282
050,36,063,"New York","Niagara County",3,41,2552,1248,1304
050,36,063,"New York","Niagara County",3,42,2476,1236,1240
050,36,063,"New York","Niagara County",3,43,2360,1163,1197
050,36,063,"New York","Niagara County",3,44,2292,1125,1167
050,36,063,"New York","Niagara County",3,45,2242,1115,1127
050,36,063,"New York","Niagara County",3,46,2304,1127,1177
050,36,063,"New York","Niagara County",3,47,2266,1111,1155
050,36,063,"New York","Niagara County",3,48,2362,1163,1199
050,36,063,"New York","Niagara County",3,49,2565,1301,1264
050,36,063,"New York","Niagara County",3,50,2761,1392,1369
050,36,063,"New York","Niagara County",3,51,2811,1453,1358
050,36,063,"New York","Niagara County",3,52,2785,1392,1393
050,36,063,"New York","Niagara County",3,53,2812,1393,1419
050,36,063,"New York","Niagara County",3,54,2897,1387,1510
050,36,063,"New York","Niagara County",3,55,2964,1408,1556
050,36,063,"New York","Niagara County",3,56,3118,1502,1616
050,36,063,"New York","Niagara County",3,57,3230,1577,1653
050,36,063,"New York","Niagara County",3,58,3255,1596,1659
050,36,063,"New York","Niagara County",3,59,3412,1661,1751
050,36,063,"New York","Niagara County",3,60,3515,1747,1768
050,36,063,"New York","Niagara County",3,61,3385,1651,1734
050,36,063,"New York","Niagara County",3,62,3343,1637,1706
050,36,063,"New York","Niagara County",3,63,3450,1695,1755
050,36,063,"New York","Niagara County",3,64,3413,1685,1728
050,36,063,"New York","Niagara County",3,65,3175,1572,1603
050,36,063,"New York","Niagara County",3,66,3041,1507,1534
050,36,063,"New York","Niagara County",3,67,2925,1445,1480
050,36,063,"New York","Niagara County",3,68,2718,1333,1385
050,36,063,"New York","Niagara County",3,69,2583,1276,1307
050,36,063,"New York","Niagara County",3,70,2431,1167,1264
050,36,063,"New York","Niagara County",3,71,2292,1106,1186
050,36,063,"New York","Niagara County",3,72,2270,1076,1194
050,36,063,"New York","Niagara County",3,73,2201,1046,1155
050,36,063,"New York","Niagara County",3,74,2291,1108,1183
050,36,063,"New York","Niagara County",3,75,1554,726,828
050,36,063,"New York","Niagara County",3,76,1493,694,799
050,36,063,"New York","Niagara County",3,77,1461,673,788
050,36,063,"New York","Niagara County",3,78,1524,678,846
050,36,063,"New York","Niagara County",3,79,1239,529,710
050,36,063,"New York","Niagara County",3,80,1078,451,627
050,36,063,"New York","Niagara County",3,81,953,399,554
050,36,063,"New York","Niagara County",3,82,901,376,525
050,36,063,"New York","Niagara County",3,83,883,346,537
050,36,063,"New York","Niagara County",3,84,771,295,476
050,36,063,"New York","Niagara County",3,85,4710,1600,3110
050,36,063,"New York","Niagara County",4,0,1975,998,977
050,36,063,"New York","Niagara County",4,1,2012,1025,987
050,36,063,"New York","Niagara County",4,2,2144,1068,1076
050,36,063,"New York","Niagara County",4,3,2197,1129,1068
050,36,063,"New York","Niagara County",4,4,2220,1123,1097
050,36,063,"New York","Niagara County",4,5,2284,1128,1156
050,36,063,"New York","Niagara County",4,6,2338,1190,1148
050,36,063,"New York","Niagara County",4,7,2348,1197,1151
050,36,063,"New York","Niagara County",4,8,2371,1205,1166
050,36,063,"New York","Niagara County",4,9,2313,1201,1112
050,36,063,"New York","Niagara County",4,10,2299,1160,1139
050,36,063,"New York","Niagara County",4,11,2337,1194,1143
050,36,063,"New York","Niagara County",4,12,2482,1251,1231
050,36,063,"New York","Niagara County",4,13,2506,1254,1252
050,36,063,"New York","Niagara County",4,14,2576,1289,1287
050,36,063,"New York","Niagara County",4,15,2491,1264,1227
050,36,063,"New York","Niagara County",4,16,2464,1244,1220
050,36,063,"New York","Niagara County",4,17,2485,1279,1206
050,36,063,"New York","Niagara County",4,18,2481,1272,1209
050,36,063,"New York","Niagara County",4,19,2225,1118,1107
050,36,063,"New York","Niagara County",4,20,2248,1133,1115
050,36,063,"New York","Niagara County",4,21,2350,1194,1156
050,36,063,"New York","Niagara County",4,22,2410,1216,1194
050,36,063,"New York","Niagara County",4,23,2402,1231,1171
050,36,063,"New York","Niagara County",4,24,2364,1244,1120
050,36,063,"New York","Niagara County",4,25,2419,1233,1186
050,36,063,"New York","Niagara County",4,26,2450,1241,1209
050,36,063,"New York","Niagara County",4,27,2382,1236,1146
050,36,063,"New York","Niagara County",4,28,2508,1280,1228
050,36,063,"New York","Niagara County",4,29,2491,1277,1214
050,36,063,"New York","Niagara County",4,30,2686,1368,1318
050,36,063,"New York","Niagara County",4,31,2763,1370,1393
050,36,063,"New York","Niagara County",4,32,2841,1417,1424
050,36,063,"New York","Niagara County",4,33,2689,1358,1331
050,36,063,"New York","Niagara County",4,34,2718,1383,1335
050,36,063,"New York","Niagara County",4,35,2689,1347,1342
050,36,063,"New York","Niagara County",4,36,2610,1286,1324
050,36,063,"New York","Niagara County",4,37,2658,1330,1328
050,36,063,"New York","Niagara County",4,38,2531,1295,1236
050,36,063,"New York","Niagara County",4,39,2499,1241,1258
050,36,063,"New York","Niagara County",4,40,2511,1226,1285
050,36,063,"New York","Niagara County",4,41,2550,1261,1289
050,36,063,"New York","Niagara County",4,42,2569,1267,1302
050,36,063,"New York","Niagara County",4,43,2488,1239,1249
050,36,063,"New York","Niagara County",4,44,2353,1154,1199
050,36,063,"New York","Niagara County",4,45,2292,1126,1166
050,36,063,"New York","Niagara County",4,46,2196,1089,1107
050,36,063,"New York","Niagara County",4,47,2299,1121,1178
050,36,063,"New York","Niagara County",4,48,2236,1099,1137
050,36,063,"New York","Niagara County",4,49,2343,1151,1192
050,36,063,"New York","Niagara County",4,50,2549,1299,1250
050,36,063,"New York","Niagara County",4,51,2725,1371,1354
050,36,063,"New York","Niagara County",4,52,2742,1409,1333
050,36,063,"New York","Niagara County",4,53,2788,1385,1403
050,36,063,"New York","Niagara County",4,54,2803,1381,1422
050,36,063,"New York","Niagara County",4,55,2865,1358,1507
050,36,063,"New York","Niagara County",4,56,2918,1383,1535
050,36,063,"New York","Niagara County",4,57,3097,1489,1608
050,36,063,"New York","Niagara County",4,58,3195,1559,1636
050,36,063,"New York","Niagara County",4,59,3241,1581,1660
050,36,063,"New York","Niagara County",4,60,3368,1634,1734
050,36,063,"New York","Niagara County",4,61,3442,1723,1719
050,36,063,"New York","Niagara County",4,62,3336,1620,1716
050,36,063,"New York","Niagara County",4,63,3273,1600,1673
050,36,063,"New York","Niagara County",4,64,3399,1677,1722
050,36,063,"New York","Niagara County",4,65,3324,1627,1697
050,36,063,"New York","Niagara County",4,66,3128,1543,1585
050,36,063,"New York","Niagara County",4,67,2986,1461,1525
050,36,063,"New York","Niagara County",4,68,2873,1411,1462
050,36,063,"New York","Niagara County",4,69,2662,1303,1359
050,36,063,"New York","Niagara County",4,70,2527,1248,1279
050,36,063,"New York","Niagara County",4,71,2381,1137,1244
050,36,063,"New York","Niagara County",4,72,2236,1072,1164
050,36,063,"New York","Niagara County",4,73,2198,1037,1161
050,36,063,"New York","Niagara County",4,74,2121,1007,1114
050,36,063,"New York","Niagara County",4,75,2202,1073,1129
050,36,063,"New York","Niagara County",4,76,1512,705,807
050,36,063,"New York","Niagara County",4,77,1427,668,759
050,36,063,"New York","Niagara County",4,78,1373,623,750
050,36,063,"New York","Niagara County",4,79,1438,632,806
050,36,063,"New York","Niagara County",4,80,1191,503,688
050,36,063,"New York","Niagara County",4,81,1006,411,595
050,36,063,"New York","Niagara County",4,82,870,368,502
050,36,063,"New York","Niagara County",4,83,858,354,504
050,36,063,"New York","Niagara County",4,84,823,310,513
050,36,063,"New York","Niagara County",4,85,4497,1502,2995
050,36,063,"New York","Niagara County",5,0,1978,1000,978
050,36,063,"New York","Niagara County",5,1,1999,997,1002
050,36,063,"New York","Niagara County",5,2,2000,1019,981
050,36,063,"New York","Niagara County",5,3,2149,1092,1057
050,36,063,"New York","Niagara County",5,4,2197,1127,1070
050,36,063,"New York","Niagara County",5,5,2220,1116,1104
050,36,063,"New York","Niagara County",5,6,2278,1137,1141
050,36,063,"New York","Niagara County",5,7,2336,1201,1135
050,36,063,"New York","Niagara County",5,8,2368,1213,1155
050,36,063,"New York","Niagara County",5,9,2380,1209,1171
050,36,063,"New York","Niagara County",5,10,2314,1189,1125
050,36,063,"New York","Niagara County",5,11,2310,1166,1144
050,36,063,"New York","Niagara County",5,12,2345,1203,1142
050,36,063,"New York","Niagara County",5,13,2459,1243,1216
050,36,063,"New York","Niagara County",5,14,2472,1237,1235
050,36,063,"New York","Niagara County",5,15,2603,1311,1292
050,36,063,"New York","Niagara County",5,16,2489,1253,1236
050,36,063,"New York","Niagara County",5,17,2469,1252,1217
050,36,063,"New York","Niagara County",5,18,2397,1234,1163
050,36,063,"New York","Niagara County",5,19,2190,1100,1090
050,36,063,"New York","Niagara County",5,20,2214,1118,1096
050,36,063,"New York","Niagara County",5,21,2249,1126,1123
050,36,063,"New York","Niagara County",5,22,2391,1215,1176
050,36,063,"New York","Niagara County",5,23,2405,1238,1167
050,36,063,"New York","Niagara County",5,24,2387,1236,1151
050,36,063,"New York","Niagara County",5,25,2350,1214,1136
050,36,063,"New York","Niagara County",5,26,2367,1195,1172
050,36,063,"New York","Niagara County",5,27,2393,1219,1174
050,36,063,"New York","Niagara County",5,28,2386,1235,1151
050,36,063,"New York","Niagara County",5,29,2501,1279,1222
050,36,063,"New York","Niagara County",5,30,2485,1269,1216
050,36,063,"New York","Niagara County",5,31,2731,1379,1352
050,36,063,"New York","Niagara County",5,32,2768,1371,1397
050,36,063,"New York","Niagara County",5,33,2864,1425,1439
050,36,063,"New York","Niagara County",5,34,2669,1351,1318
050,36,063,"New York","Niagara County",5,35,2742,1400,1342
050,36,063,"New York","Niagara County",5,36,2707,1347,1360
050,36,063,"New York","Niagara County",5,37,2618,1283,1335
050,36,063,"New York","Niagara County",5,38,2673,1348,1325
050,36,063,"New York","Niagara County",5,39,2526,1281,1245
050,36,063,"New York","Niagara County",5,40,2517,1265,1252
050,36,063,"New York","Niagara County",5,41,2471,1190,1281
050,36,063,"New York","Niagara County",5,42,2555,1265,1290
050,36,063,"New York","Niagara County",5,43,2560,1254,1306
050,36,063,"New York","Niagara County",5,44,2464,1236,1228
050,36,063,"New York","Niagara County",5,45,2346,1156,1190
050,36,063,"New York","Niagara County",5,46,2266,1105,1161
050,36,063,"New York","Niagara County",5,47,2186,1084,1102
050,36,063,"New York","Niagara County",5,48,2293,1121,1172
050,36,063,"New York","Niagara County",5,49,2249,1094,1155
050,36,063,"New York","Niagara County",5,50,2350,1165,1185
050,36,063,"New York","Niagara County",5,51,2542,1301,1241
050,36,063,"New York","Niagara County",5,52,2704,1343,1361
050,36,063,"New York","Niagara County",5,53,2769,1438,1331
050,36,063,"New York","Niagara County",5,54,2764,1377,1387
050,36,063,"New York","Niagara County",5,55,2782,1359,1423
050,36,063,"New York","Niagara County",5,56,2833,1344,1489
050,36,063,"New York","Niagara County",5,57,2902,1379,1523
050,36,063,"New York","Niagara County",5,58,3085,1483,1602
050,36,063,"New York","Niagara County",5,59,3154,1532,1622
050,36,063,"New York","Niagara County",5,60,3221,1578,1643
050,36,063,"New York","Niagara County",5,61,3311,1612,1699
050,36,063,"New York","Niagara County",5,62,3385,1698,1687
050,36,063,"New York","Niagara County",5,63,3251,1582,1669
050,36,063,"New York","Niagara County",5,64,3225,1567,1658
050,36,063,"New York","Niagara County",5,65,3328,1627,1701
050,36,063,"New York","Niagara County",5,66,3269,1594,1675
050,36,063,"New York","Niagara County",5,67,3071,1508,1563
050,36,063,"New York","Niagara County",5,68,2933,1428,1505
050,36,063,"New York","Niagara County",5,69,2808,1378,1430
050,36,063,"New York","Niagara County",5,70,2609,1268,1341
050,36,063,"New York","Niagara County",5,71,2460,1217,1243
050,36,063,"New York","Niagara County",5,72,2332,1109,1223
050,36,063,"New York","Niagara County",5,73,2162,1029,1133
050,36,063,"New York","Niagara County",5,74,2120,1000,1120
050,36,063,"New York","Niagara County",5,75,2040,983,1057
050,36,063,"New York","Niagara County",5,76,2142,1039,1103
050,36,063,"New York","Niagara County",5,77,1463,687,776
050,36,063,"New York","Niagara County",5,78,1356,635,721
050,36,063,"New York","Niagara County",5,79,1298,587,711
050,36,063,"New York","Niagara County",5,80,1374,592,782
050,36,063,"New York","Niagara County",5,81,1120,468,652
050,36,063,"New York","Niagara County",5,82,923,376,547
050,36,063,"New York","Niagara County",5,83,827,347,480
050,36,063,"New York","Niagara County",5,84,801,315,486
050,36,063,"New York","Niagara County",5,85,4457,1458,2999
050,36,065,"New York","Oneida County",1,0,2473,1271,1202
050,36,065,"New York","Oneida County",1,1,2536,1319,1217
050,36,065,"New York","Oneida County",1,2,2665,1378,1287
050,36,065,"New York","Oneida County",1,3,2586,1346,1240
050,36,065,"New York","Oneida County",1,4,2627,1356,1271
050,36,065,"New York","Oneida County",1,5,2712,1409,1303
050,36,065,"New York","Oneida County",1,6,2777,1407,1370
050,36,065,"New York","Oneida County",1,7,2880,1482,1398
050,36,065,"New York","Oneida County",1,8,2835,1453,1382
050,36,065,"New York","Oneida County",1,9,2816,1442,1374
050,36,065,"New York","Oneida County",1,10,2925,1465,1460
050,36,065,"New York","Oneida County",1,11,2902,1478,1424
050,36,065,"New York","Oneida County",1,12,2951,1502,1449
050,36,065,"New York","Oneida County",1,13,2931,1504,1427
050,36,065,"New York","Oneida County",1,14,2892,1484,1408
050,36,065,"New York","Oneida County",1,15,2910,1483,1427
050,36,065,"New York","Oneida County",1,16,2952,1521,1431
050,36,065,"New York","Oneida County",1,17,2929,1507,1422
050,36,065,"New York","Oneida County",1,18,3141,1659,1482
050,36,065,"New York","Oneida County",1,19,3273,1706,1567
050,36,065,"New York","Oneida County",1,20,3096,1642,1454
050,36,065,"New York","Oneida County",1,21,3132,1692,1440
050,36,065,"New York","Oneida County",1,22,2977,1588,1389
050,36,065,"New York","Oneida County",1,23,2803,1489,1314
050,36,065,"New York","Oneida County",1,24,2719,1417,1302
050,36,065,"New York","Oneida County",1,25,2784,1442,1342
050,36,065,"New York","Oneida County",1,26,2889,1523,1366
050,36,065,"New York","Oneida County",1,27,2805,1467,1338
050,36,065,"New York","Oneida County",1,28,2865,1497,1368
050,36,065,"New York","Oneida County",1,29,2884,1511,1373
050,36,065,"New York","Oneida County",1,30,2833,1452,1381
050,36,065,"New York","Oneida County",1,31,2790,1381,1409
050,36,065,"New York","Oneida County",1,32,2857,1441,1416
050,36,065,"New York","Oneida County",1,33,2924,1535,1389
050,36,065,"New York","Oneida County",1,34,2847,1483,1364
050,36,065,"New York","Oneida County",1,35,2812,1462,1350
050,36,065,"New York","Oneida County",1,36,2820,1464,1356
050,36,065,"New York","Oneida County",1,37,2857,1502,1355
050,36,065,"New York","Oneida County",1,38,2748,1421,1327
050,36,065,"New York","Oneida County",1,39,2748,1394,1354
050,36,065,"New York","Oneida County",1,40,2660,1351,1309
050,36,065,"New York","Oneida County",1,41,2589,1346,1243
050,36,065,"New York","Oneida County",1,42,2491,1289,1202
050,36,065,"New York","Oneida County",1,43,2441,1217,1224
050,36,065,"New York","Oneida County",1,44,2439,1243,1196
050,36,065,"New York","Oneida County",1,45,2479,1255,1224
050,36,065,"New York","Oneida County",1,46,2462,1242,1220
050,36,065,"New York","Oneida County",1,47,2616,1309,1307
050,36,065,"New York","Oneida County",1,48,2878,1442,1436
050,36,065,"New York","Oneida County",1,49,3131,1599,1532
050,36,065,"New York","Oneida County",1,50,3002,1541,1461
050,36,065,"New York","Oneida County",1,51,2971,1546,1425
050,36,065,"New York","Oneida County",1,52,2901,1488,1413
050,36,065,"New York","Oneida County",1,53,3060,1504,1556
050,36,065,"New York","Oneida County",1,54,3142,1575,1567
050,36,065,"New York","Oneida County",1,55,3246,1628,1618
050,36,065,"New York","Oneida County",1,56,3312,1659,1653
050,36,065,"New York","Oneida County",1,57,3354,1701,1653
050,36,065,"New York","Oneida County",1,58,3411,1715,1696
050,36,065,"New York","Oneida County",1,59,3431,1720,1711
050,36,065,"New York","Oneida County",1,60,3305,1678,1627
050,36,065,"New York","Oneida County",1,61,3339,1667,1672
050,36,065,"New York","Oneida County",1,62,3303,1619,1684
050,36,065,"New York","Oneida County",1,63,3149,1547,1602
050,36,065,"New York","Oneida County",1,64,3078,1496,1582
050,36,065,"New York","Oneida County",1,65,3002,1453,1549
050,36,065,"New York","Oneida County",1,66,2859,1401,1458
050,36,065,"New York","Oneida County",1,67,2672,1301,1371
050,36,065,"New York","Oneida County",1,68,2683,1288,1395
050,36,065,"New York","Oneida County",1,69,2529,1243,1286
050,36,065,"New York","Oneida County",1,70,2472,1208,1264
050,36,065,"New York","Oneida County",1,71,2444,1175,1269
050,36,065,"New York","Oneida County",1,72,2467,1152,1315
050,36,065,"New York","Oneida County",1,73,2380,1099,1281
050,36,065,"New York","Oneida County",1,74,1629,753,876
050,36,065,"New York","Oneida County",1,75,1653,784,869
050,36,065,"New York","Oneida County",1,76,1672,784,888
050,36,065,"New York","Oneida County",1,77,1667,739,928
050,36,065,"New York","Oneida County",1,78,1420,610,810
050,36,065,"New York","Oneida County",1,79,1254,542,712
050,36,065,"New York","Oneida County",1,80,1153,492,661
050,36,065,"New York","Oneida County",1,81,1080,444,636
050,36,065,"New York","Oneida County",1,82,1020,426,594
050,36,065,"New York","Oneida County",1,83,967,392,575
050,36,065,"New York","Oneida County",1,84,888,338,550
050,36,065,"New York","Oneida County",1,85,6109,2042,4067
050,36,065,"New York","Oneida County",2,0,2515,1304,1211
050,36,065,"New York","Oneida County",2,1,2511,1300,1211
050,36,065,"New York","Oneida County",2,2,2631,1363,1268
050,36,065,"New York","Oneida County",2,3,2595,1348,1247
050,36,065,"New York","Oneida County",2,4,2615,1354,1261
050,36,065,"New York","Oneida County",2,5,2694,1396,1298
050,36,065,"New York","Oneida County",2,6,2766,1413,1353
050,36,065,"New York","Oneida County",2,7,2852,1461,1391
050,36,065,"New York","Oneida County",2,8,2835,1455,1380
050,36,065,"New York","Oneida County",2,9,2815,1441,1374
050,36,065,"New York","Oneida County",2,10,2898,1459,1439
050,36,065,"New York","Oneida County",2,11,2899,1469,1430
050,36,065,"New York","Oneida County",2,12,2951,1501,1450
050,36,065,"New York","Oneida County",2,13,2933,1502,1431
050,36,065,"New York","Oneida County",2,14,2904,1490,1414
050,36,065,"New York","Oneida County",2,15,2909,1485,1424
050,36,065,"New York","Oneida County",2,16,2945,1515,1430
050,36,065,"New York","Oneida County",2,17,2925,1507,1418
050,36,065,"New York","Oneida County",2,18,3101,1632,1469
050,36,065,"New York","Oneida County",2,19,3236,1685,1551
050,36,065,"New York","Oneida County",2,20,3066,1624,1442
050,36,065,"New York","Oneida County",2,21,3095,1657,1438
050,36,065,"New York","Oneida County",2,22,2951,1565,1386
050,36,065,"New York","Oneida County",2,23,2767,1465,1302
050,36,065,"New York","Oneida County",2,24,2695,1399,1296
050,36,065,"New York","Oneida County",2,25,2755,1423,1332
050,36,065,"New York","Oneida County",2,26,2847,1489,1358
050,36,065,"New York","Oneida County",2,27,2796,1461,1335
050,36,065,"New York","Oneida County",2,28,2837,1483,1354
050,36,065,"New York","Oneida County",2,29,2863,1493,1370
050,36,065,"New York","Oneida County",2,30,2841,1450,1391
050,36,065,"New York","Oneida County",2,31,2781,1382,1399
050,36,065,"New York","Oneida County",2,32,2822,1412,1410
050,36,065,"New York","Oneida County",2,33,2890,1496,1394
050,36,065,"New York","Oneida County",2,34,2845,1477,1368
050,36,065,"New York","Oneida County",2,35,2823,1460,1363
050,36,065,"New York","Oneida County",2,36,2787,1443,1344
050,36,065,"New York","Oneida County",2,37,2847,1488,1359
050,36,065,"New York","Oneida County",2,38,2772,1429,1343
050,36,065,"New York","Oneida County",2,39,2730,1385,1345
050,36,065,"New York","Oneida County",2,40,2683,1356,1327
050,36,065,"New York","Oneida County",2,41,2593,1340,1253
050,36,065,"New York","Oneida County",2,42,2486,1281,1205
050,36,065,"New York","Oneida County",2,43,2456,1230,1226
050,36,065,"New York","Oneida County",2,44,2410,1217,1193
050,36,065,"New York","Oneida County",2,45,2468,1244,1224
050,36,065,"New York","Oneida County",2,46,2438,1223,1215
050,36,065,"New York","Oneida County",2,47,2559,1274,1285
050,36,065,"New York","Oneida County",2,48,2798,1391,1407
050,36,065,"New York","Oneida County",2,49,3069,1559,1510
050,36,065,"New York","Oneida County",2,50,3026,1544,1482
050,36,065,"New York","Oneida County",2,51,2957,1531,1426
050,36,065,"New York","Oneida County",2,52,2900,1493,1407
050,36,065,"New York","Oneida County",2,53,3006,1483,1523
050,36,065,"New York","Oneida County",2,54,3100,1544,1556
050,36,065,"New York","Oneida County",2,55,3208,1605,1603
050,36,065,"New York","Oneida County",2,56,3303,1655,1648
050,36,065,"New York","Oneida County",2,57,3333,1684,1649
050,36,065,"New York","Oneida County",2,58,3385,1702,1683
050,36,065,"New York","Oneida County",2,59,3437,1725,1712
050,36,065,"New York","Oneida County",2,60,3311,1670,1641
050,36,065,"New York","Oneida County",2,61,3300,1656,1644
050,36,065,"New York","Oneida County",2,62,3276,1610,1666
050,36,065,"New York","Oneida County",2,63,3204,1575,1629
050,36,065,"New York","Oneida County",2,64,3060,1491,1569
050,36,065,"New York","Oneida County",2,65,2990,1441,1549
050,36,065,"New York","Oneida County",2,66,2879,1405,1474
050,36,065,"New York","Oneida County",2,67,2693,1313,1380
050,36,065,"New York","Oneida County",2,68,2646,1275,1371
050,36,065,"New York","Oneida County",2,69,2563,1249,1314
050,36,065,"New York","Oneida County",2,70,2453,1196,1257
050,36,065,"New York","Oneida County",2,71,2427,1164,1263
050,36,065,"New York","Oneida County",2,72,2411,1136,1275
050,36,065,"New York","Oneida County",2,73,2501,1157,1344
050,36,065,"New York","Oneida County",2,74,1682,776,906
050,36,065,"New York","Oneida County",2,75,1630,767,863
050,36,065,"New York","Oneida County",2,76,1627,765,862
050,36,065,"New York","Oneida County",2,77,1680,750,930
050,36,065,"New York","Oneida County",2,78,1425,616,809
050,36,065,"New York","Oneida County",2,79,1262,542,720
050,36,065,"New York","Oneida County",2,80,1157,491,666
050,36,065,"New York","Oneida County",2,81,1081,450,631
050,36,065,"New York","Oneida County",2,82,1011,420,591
050,36,065,"New York","Oneida County",2,83,955,388,567
050,36,065,"New York","Oneida County",2,84,883,340,543
050,36,065,"New York","Oneida County",2,85,6020,2006,4014
050,36,065,"New York","Oneida County",3,0,2351,1221,1130
050,36,065,"New York","Oneida County",3,1,2548,1312,1236
050,36,065,"New York","Oneida County",3,2,2550,1327,1223
050,36,065,"New York","Oneida County",3,3,2632,1366,1266
050,36,065,"New York","Oneida County",3,4,2583,1350,1233
050,36,065,"New York","Oneida County",3,5,2636,1376,1260
050,36,065,"New York","Oneida County",3,6,2690,1390,1300
050,36,065,"New York","Oneida County",3,7,2721,1381,1340
050,36,065,"New York","Oneida County",3,8,2859,1464,1395
050,36,065,"New York","Oneida County",3,9,2832,1444,1388
050,36,065,"New York","Oneida County",3,10,2804,1447,1357
050,36,065,"New York","Oneida County",3,11,2890,1456,1434
050,36,065,"New York","Oneida County",3,12,2869,1459,1410
050,36,065,"New York","Oneida County",3,13,2939,1495,1444
050,36,065,"New York","Oneida County",3,14,2936,1517,1419
050,36,065,"New York","Oneida County",3,15,2886,1477,1409
050,36,065,"New York","Oneida County",3,16,2891,1470,1421
050,36,065,"New York","Oneida County",3,17,2910,1491,1419
050,36,065,"New York","Oneida County",3,18,3165,1649,1516
050,36,065,"New York","Oneida County",3,19,3303,1712,1591
050,36,065,"New York","Oneida County",3,20,3069,1642,1427
050,36,065,"New York","Oneida County",3,21,3127,1650,1477
050,36,065,"New York","Oneida County",3,22,2963,1571,1392
050,36,065,"New York","Oneida County",3,23,2765,1492,1273
050,36,065,"New York","Oneida County",3,24,2711,1434,1277
050,36,065,"New York","Oneida County",3,25,2656,1381,1275
050,36,065,"New York","Oneida County",3,26,2746,1384,1362
050,36,065,"New York","Oneida County",3,27,2769,1453,1316
050,36,065,"New York","Oneida County",3,28,2763,1441,1322
050,36,065,"New York","Oneida County",3,29,2823,1467,1356
050,36,065,"New York","Oneida County",3,30,2826,1469,1357
050,36,065,"New York","Oneida County",3,31,2856,1450,1406
050,36,065,"New York","Oneida County",3,32,2761,1367,1394
050,36,065,"New York","Oneida County",3,33,2839,1444,1395
050,36,065,"New York","Oneida County",3,34,2873,1462,1411
050,36,065,"New York","Oneida County",3,35,2839,1473,1366
050,36,065,"New York","Oneida County",3,36,2834,1474,1360
050,36,065,"New York","Oneida County",3,37,2826,1470,1356
050,36,065,"New York","Oneida County",3,38,2829,1465,1364
050,36,065,"New York","Oneida County",3,39,2790,1425,1365
050,36,065,"New York","Oneida County",3,40,2703,1359,1344
050,36,065,"New York","Oneida County",3,41,2675,1374,1301
050,36,065,"New York","Oneida County",3,42,2568,1327,1241
050,36,065,"New York","Oneida County",3,43,2470,1272,1198
050,36,065,"New York","Oneida County",3,44,2450,1228,1222
050,36,065,"New York","Oneida County",3,45,2349,1181,1168
050,36,065,"New York","Oneida County",3,46,2400,1205,1195
050,36,065,"New York","Oneida County",3,47,2422,1203,1219
050,36,065,"New York","Oneida County",3,48,2545,1251,1294
050,36,065,"New York","Oneida County",3,49,2771,1375,1396
050,36,065,"New York","Oneida County",3,50,3003,1506,1497
050,36,065,"New York","Oneida County",3,51,2979,1511,1468
050,36,065,"New York","Oneida County",3,52,2929,1525,1404
050,36,065,"New York","Oneida County",3,53,2848,1457,1391
050,36,065,"New York","Oneida County",3,54,2998,1494,1504
050,36,065,"New York","Oneida County",3,55,3041,1498,1543
050,36,065,"New York","Oneida County",3,56,3192,1601,1591
050,36,065,"New York","Oneida County",3,57,3266,1645,1621
050,36,065,"New York","Oneida County",3,58,3275,1650,1625
050,36,065,"New York","Oneida County",3,59,3370,1695,1675
050,36,065,"New York","Oneida County",3,60,3365,1679,1686
050,36,065,"New York","Oneida County",3,61,3267,1645,1622
050,36,065,"New York","Oneida County",3,62,3217,1600,1617
050,36,065,"New York","Oneida County",3,63,3206,1565,1641
050,36,065,"New York","Oneida County",3,64,3133,1530,1603
050,36,065,"New York","Oneida County",3,65,3000,1441,1559
050,36,065,"New York","Oneida County",3,66,2949,1409,1540
050,36,065,"New York","Oneida County",3,67,2811,1356,1455
050,36,065,"New York","Oneida County",3,68,2630,1288,1342
050,36,065,"New York","Oneida County",3,69,2559,1229,1330
050,36,065,"New York","Oneida County",3,70,2493,1203,1290
050,36,065,"New York","Oneida County",3,71,2362,1140,1222
050,36,065,"New York","Oneida County",3,72,2344,1120,1224
050,36,065,"New York","Oneida County",3,73,2318,1080,1238
050,36,065,"New York","Oneida County",3,74,2418,1111,1307
050,36,065,"New York","Oneida County",3,75,1620,743,877
050,36,065,"New York","Oneida County",3,76,1566,737,829
050,36,065,"New York","Oneida County",3,77,1562,723,839
050,36,065,"New York","Oneida County",3,78,1590,697,893
050,36,065,"New York","Oneida County",3,79,1362,591,771
050,36,065,"New York","Oneida County",3,80,1199,505,694
050,36,065,"New York","Oneida County",3,81,1094,455,639
050,36,065,"New York","Oneida County",3,82,982,398,584
050,36,065,"New York","Oneida County",3,83,959,386,573
050,36,065,"New York","Oneida County",3,84,860,349,511
050,36,065,"New York","Oneida County",3,85,5840,1935,3905
050,36,065,"New York","Oneida County",4,0,2470,1256,1214
050,36,065,"New York","Oneida County",4,1,2397,1255,1142
050,36,065,"New York","Oneida County",4,2,2546,1326,1220
050,36,065,"New York","Oneida County",4,3,2553,1342,1211
050,36,065,"New York","Oneida County",4,4,2634,1381,1253
050,36,065,"New York","Oneida County",4,5,2582,1346,1236
050,36,065,"New York","Oneida County",4,6,2610,1349,1261
050,36,065,"New York","Oneida County",4,7,2664,1369,1295
050,36,065,"New York","Oneida County",4,8,2767,1397,1370
050,36,065,"New York","Oneida County",4,9,2843,1469,1374
050,36,065,"New York","Oneida County",4,10,2843,1466,1377
050,36,065,"New York","Oneida County",4,11,2788,1432,1356
050,36,065,"New York","Oneida County",4,12,2881,1445,1436
050,36,065,"New York","Oneida County",4,13,2887,1473,1414
050,36,065,"New York","Oneida County",4,14,2915,1493,1422
050,36,065,"New York","Oneida County",4,15,2910,1503,1407
050,36,065,"New York","Oneida County",4,16,2855,1476,1379
050,36,065,"New York","Oneida County",4,17,2875,1469,1406
050,36,065,"New York","Oneida County",4,18,3140,1656,1484
050,36,065,"New York","Oneida County",4,19,3227,1668,1559
050,36,065,"New York","Oneida County",4,20,3010,1618,1392
050,36,065,"New York","Oneida County",4,21,3073,1640,1433
050,36,065,"New York","Oneida County",4,22,2971,1537,1434
050,36,065,"New York","Oneida County",4,23,2793,1527,1266
050,36,065,"New York","Oneida County",4,24,2643,1424,1219
050,36,065,"New York","Oneida County",4,25,2669,1407,1262
050,36,065,"New York","Oneida County",4,26,2609,1352,1257
050,36,065,"New York","Oneida County",4,27,2692,1357,1335
050,36,065,"New York","Oneida County",4,28,2792,1474,1318
050,36,065,"New York","Oneida County",4,29,2760,1432,1328
050,36,065,"New York","Oneida County",4,30,2807,1457,1350
050,36,065,"New York","Oneida County",4,31,2842,1487,1355
050,36,065,"New York","Oneida County",4,32,2860,1434,1426
050,36,065,"New York","Oneida County",4,33,2781,1387,1394
050,36,065,"New York","Oneida County",4,34,2801,1414,1387
050,36,065,"New York","Oneida County",4,35,2864,1458,1406
050,36,065,"New York","Oneida County",4,36,2855,1485,1370
050,36,065,"New York","Oneida County",4,37,2829,1484,1345
050,36,065,"New York","Oneida County",4,38,2811,1441,1370
050,36,065,"New York","Oneida County",4,39,2872,1500,1372
050,36,065,"New York","Oneida County",4,40,2766,1410,1356
050,36,065,"New York","Oneida County",4,41,2729,1387,1342
050,36,065,"New York","Oneida County",4,42,2645,1349,1296
050,36,065,"New York","Oneida County",4,43,2532,1304,1228
050,36,065,"New York","Oneida County",4,44,2466,1274,1192
050,36,065,"New York","Oneida County",4,45,2419,1217,1202
050,36,065,"New York","Oneida County",4,46,2321,1167,1154
050,36,065,"New York","Oneida County",4,47,2414,1215,1199
050,36,065,"New York","Oneida County",4,48,2419,1194,1225
050,36,065,"New York","Oneida County",4,49,2540,1271,1269
050,36,065,"New York","Oneida County",4,50,2735,1344,1391
050,36,065,"New York","Oneida County",4,51,2988,1492,1496
050,36,065,"New York","Oneida County",4,52,2957,1511,1446
050,36,065,"New York","Oneida County",4,53,2886,1493,1393
050,36,065,"New York","Oneida County",4,54,2831,1448,1383
050,36,065,"New York","Oneida County",4,55,2963,1468,1495
050,36,065,"New York","Oneida County",4,56,3068,1524,1544
050,36,065,"New York","Oneida County",4,57,3121,1555,1566
050,36,065,"New York","Oneida County",4,58,3236,1621,1615
050,36,065,"New York","Oneida County",4,59,3252,1639,1613
050,36,065,"New York","Oneida County",4,60,3301,1646,1655
050,36,065,"New York","Oneida County",4,61,3322,1643,1679
050,36,065,"New York","Oneida County",4,62,3177,1583,1594
050,36,065,"New York","Oneida County",4,63,3182,1569,1613
050,36,065,"New York","Oneida County",4,64,3131,1519,1612
050,36,065,"New York","Oneida County",4,65,3051,1465,1586
050,36,065,"New York","Oneida County",4,66,2921,1386,1535
050,36,065,"New York","Oneida County",4,67,2848,1343,1505
050,36,065,"New York","Oneida County",4,68,2780,1348,1432
050,36,065,"New York","Oneida County",4,69,2554,1252,1302
050,36,065,"New York","Oneida County",4,70,2484,1189,1295
050,36,065,"New York","Oneida County",4,71,2408,1154,1254
050,36,065,"New York","Oneida County",4,72,2280,1102,1178
050,36,065,"New York","Oneida County",4,73,2271,1075,1196
050,36,065,"New York","Oneida County",4,74,2255,1045,1210
050,36,065,"New York","Oneida County",4,75,2343,1068,1275
050,36,065,"New York","Oneida County",4,76,1544,709,835
050,36,065,"New York","Oneida County",4,77,1505,696,809
050,36,065,"New York","Oneida County",4,78,1489,677,812
050,36,065,"New York","Oneida County",4,79,1503,655,848
050,36,065,"New York","Oneida County",4,80,1281,543,738
050,36,065,"New York","Oneida County",4,81,1144,471,673
050,36,065,"New York","Oneida County",4,82,1010,418,592
050,36,065,"New York","Oneida County",4,83,928,363,565
050,36,065,"New York","Oneida County",4,84,865,346,519
050,36,065,"New York","Oneida County",4,85,5772,1929,3843
050,36,065,"New York","Oneida County",5,0,2469,1256,1213
050,36,065,"New York","Oneida County",5,1,2461,1237,1224
050,36,065,"New York","Oneida County",5,2,2371,1245,1126
050,36,065,"New York","Oneida County",5,3,2558,1314,1244
050,36,065,"New York","Oneida County",5,4,2567,1338,1229
050,36,065,"New York","Oneida County",5,5,2643,1370,1273
050,36,065,"New York","Oneida County",5,6,2578,1341,1237
050,36,065,"New York","Oneida County",5,7,2621,1355,1266
050,36,065,"New York","Oneida County",5,8,2692,1388,1304
050,36,065,"New York","Oneida County",5,9,2755,1404,1351
050,36,065,"New York","Oneida County",5,10,2849,1488,1361
050,36,065,"New York","Oneida County",5,11,2842,1456,1386
050,36,065,"New York","Oneida County",5,12,2768,1419,1349
050,36,065,"New York","Oneida County",5,13,2867,1447,1420
050,36,065,"New York","Oneida County",5,14,2872,1476,1396
050,36,065,"New York","Oneida County",5,15,2896,1494,1402
050,36,065,"New York","Oneida County",5,16,2936,1514,1422
050,36,065,"New York","Oneida County",5,17,2821,1476,1345
050,36,065,"New York","Oneida County",5,18,3100,1623,1477
050,36,065,"New York","Oneida County",5,19,3249,1688,1561
050,36,065,"New York","Oneida County",5,20,3003,1596,1407
050,36,065,"New York","Oneida County",5,21,3075,1650,1425
050,36,065,"New York","Oneida County",5,22,2904,1521,1383
050,36,065,"New York","Oneida County",5,23,2770,1445,1325
050,36,065,"New York","Oneida County",5,24,2718,1480,1238
050,36,065,"New York","Oneida County",5,25,2618,1435,1183
050,36,065,"New York","Oneida County",5,26,2613,1368,1245
050,36,065,"New York","Oneida County",5,27,2581,1340,1241
050,36,065,"New York","Oneida County",5,28,2669,1360,1309
050,36,065,"New York","Oneida County",5,29,2759,1454,1305
050,36,065,"New York","Oneida County",5,30,2748,1425,1323
050,36,065,"New York","Oneida County",5,31,2779,1451,1328
050,36,065,"New York","Oneida County",5,32,2843,1492,1351
050,36,065,"New York","Oneida County",5,33,2877,1449,1428
050,36,065,"New York","Oneida County",5,34,2776,1373,1403
050,36,065,"New York","Oneida County",5,35,2768,1391,1377
050,36,065,"New York","Oneida County",5,36,2853,1457,1396
050,36,065,"New York","Oneida County",5,37,2887,1513,1374
050,36,065,"New York","Oneida County",5,38,2810,1466,1344
050,36,065,"New York","Oneida County",5,39,2840,1469,1371
050,36,065,"New York","Oneida County",5,40,2888,1505,1383
050,36,065,"New York","Oneida County",5,41,2755,1406,1349
050,36,065,"New York","Oneida County",5,42,2700,1375,1325
050,36,065,"New York","Oneida County",5,43,2648,1352,1296
050,36,065,"New York","Oneida County",5,44,2561,1327,1234
050,36,065,"New York","Oneida County",5,45,2438,1260,1178
050,36,065,"New York","Oneida County",5,46,2416,1216,1200
050,36,065,"New York","Oneida County",5,47,2329,1170,1159
050,36,065,"New York","Oneida County",5,48,2404,1189,1215
050,36,065,"New York","Oneida County",5,49,2415,1199,1216
050,36,065,"New York","Oneida County",5,50,2514,1241,1273
050,36,065,"New York","Oneida County",5,51,2719,1341,1378
050,36,065,"New York","Oneida County",5,52,2943,1477,1466
050,36,065,"New York","Oneida County",5,53,2941,1485,1456
050,36,065,"New York","Oneida County",5,54,2875,1491,1384
050,36,065,"New York","Oneida County",5,55,2779,1415,1364
050,36,065,"New York","Oneida County",5,56,2970,1478,1492
050,36,065,"New York","Oneida County",5,57,3032,1495,1537
050,36,065,"New York","Oneida County",5,58,3114,1556,1558
050,36,065,"New York","Oneida County",5,59,3243,1638,1605
050,36,065,"New York","Oneida County",5,60,3205,1619,1586
050,36,065,"New York","Oneida County",5,61,3274,1624,1650
050,36,065,"New York","Oneida County",5,62,3257,1597,1660
050,36,065,"New York","Oneida County",5,63,3135,1558,1577
050,36,065,"New York","Oneida County",5,64,3120,1535,1585
050,36,065,"New York","Oneida County",5,65,3083,1471,1612
050,36,065,"New York","Oneida County",5,66,2985,1431,1554
050,36,065,"New York","Oneida County",5,67,2836,1327,1509
050,36,065,"New York","Oneida County",5,68,2815,1333,1482
050,36,065,"New York","Oneida County",5,69,2700,1314,1386
050,36,065,"New York","Oneida County",5,70,2484,1213,1271
050,36,065,"New York","Oneida County",5,71,2407,1142,1265
050,36,065,"New York","Oneida County",5,72,2326,1114,1212
050,36,065,"New York","Oneida County",5,73,2208,1062,1146
050,36,065,"New York","Oneida County",5,74,2204,1042,1162
050,36,065,"New York","Oneida County",5,75,2188,1009,1179
050,36,065,"New York","Oneida County",5,76,2257,1037,1220
050,36,065,"New York","Oneida County",5,77,1483,670,813
050,36,065,"New York","Oneida County",5,78,1437,655,782
050,36,065,"New York","Oneida County",5,79,1413,630,783
050,36,065,"New York","Oneida County",5,80,1420,606,814
050,36,065,"New York","Oneida County",5,81,1222,515,707
050,36,065,"New York","Oneida County",5,82,1063,437,626
050,36,065,"New York","Oneida County",5,83,961,391,570
050,36,065,"New York","Oneida County",5,84,838,323,515
050,36,065,"New York","Oneida County",5,85,5744,1931,3813
050,36,067,"New York","Onondaga County",1,0,5247,2682,2565
050,36,067,"New York","Onondaga County",1,1,5264,2691,2573
050,36,067,"New York","Onondaga County",1,2,5361,2719,2642
050,36,067,"New York","Onondaga County",1,3,5392,2756,2636
050,36,067,"New York","Onondaga County",1,4,5517,2768,2749
050,36,067,"New York","Onondaga County",1,5,5542,2787,2755
050,36,067,"New York","Onondaga County",1,6,5511,2854,2657
050,36,067,"New York","Onondaga County",1,7,5637,2915,2722
050,36,067,"New York","Onondaga County",1,8,5649,2895,2754
050,36,067,"New York","Onondaga County",1,9,5636,2901,2735
050,36,067,"New York","Onondaga County",1,10,5833,2940,2893
050,36,067,"New York","Onondaga County",1,11,5727,2952,2775
050,36,067,"New York","Onondaga County",1,12,5825,3017,2808
050,36,067,"New York","Onondaga County",1,13,5863,3030,2833
050,36,067,"New York","Onondaga County",1,14,5736,2948,2788
050,36,067,"New York","Onondaga County",1,15,5780,2936,2844
050,36,067,"New York","Onondaga County",1,16,5981,3058,2923
050,36,067,"New York","Onondaga County",1,17,6065,3053,3012
050,36,067,"New York","Onondaga County",1,18,7646,3643,4003
050,36,067,"New York","Onondaga County",1,19,8399,3940,4459
050,36,067,"New York","Onondaga County",1,20,8273,4039,4234
050,36,067,"New York","Onondaga County",1,21,6282,3099,3183
050,36,067,"New York","Onondaga County",1,22,5937,2915,3022
050,36,067,"New York","Onondaga County",1,23,5889,2865,3024
050,36,067,"New York","Onondaga County",1,24,5944,2893,3051
050,36,067,"New York","Onondaga County",1,25,6213,3028,3185
050,36,067,"New York","Onondaga County",1,26,6274,3084,3190
050,36,067,"New York","Onondaga County",1,27,6115,3017,3098
050,36,067,"New York","Onondaga County",1,28,6096,3013,3083
050,36,067,"New York","Onondaga County",1,29,6222,3078,3144
050,36,067,"New York","Onondaga County",1,30,6335,3203,3132
050,36,067,"New York","Onondaga County",1,31,6338,3143,3195
050,36,067,"New York","Onondaga County",1,32,6448,3142,3306
050,36,067,"New York","Onondaga County",1,33,6389,3140,3249
050,36,067,"New York","Onondaga County",1,34,6349,3090,3259
050,36,067,"New York","Onondaga County",1,35,6095,3077,3018
050,36,067,"New York","Onondaga County",1,36,5883,2943,2940
050,36,067,"New York","Onondaga County",1,37,5971,2928,3043
050,36,067,"New York","Onondaga County",1,38,5775,2813,2962
050,36,067,"New York","Onondaga County",1,39,5755,2845,2910
050,36,067,"New York","Onondaga County",1,40,5532,2735,2797
050,36,067,"New York","Onondaga County",1,41,5318,2612,2706
050,36,067,"New York","Onondaga County",1,42,5247,2536,2711
050,36,067,"New York","Onondaga County",1,43,5112,2503,2609
050,36,067,"New York","Onondaga County",1,44,5023,2406,2617
050,36,067,"New York","Onondaga County",1,45,4936,2443,2493
050,36,067,"New York","Onondaga County",1,46,4824,2358,2466
050,36,067,"New York","Onondaga County",1,47,5042,2428,2614
050,36,067,"New York","Onondaga County",1,48,5510,2662,2848
050,36,067,"New York","Onondaga County",1,49,6114,2997,3117
050,36,067,"New York","Onondaga County",1,50,5991,2927,3064
050,36,067,"New York","Onondaga County",1,51,6023,2959,3064
050,36,067,"New York","Onondaga County",1,52,5917,2920,2997
050,36,067,"New York","Onondaga County",1,53,6169,3063,3106
050,36,067,"New York","Onondaga County",1,54,6486,3153,3333
050,36,067,"New York","Onondaga County",1,55,6770,3247,3523
050,36,067,"New York","Onondaga County",1,56,6874,3341,3533
050,36,067,"New York","Onondaga County",1,57,6935,3387,3548
050,36,067,"New York","Onondaga County",1,58,7017,3402,3615
050,36,067,"New York","Onondaga County",1,59,6864,3350,3514
050,36,067,"New York","Onondaga County",1,60,6787,3334,3453
050,36,067,"New York","Onondaga County",1,61,6799,3308,3491
050,36,067,"New York","Onondaga County",1,62,6653,3263,3390
050,36,067,"New York","Onondaga County",1,63,6417,3122,3295
050,36,067,"New York","Onondaga County",1,64,6168,2973,3195
050,36,067,"New York","Onondaga County",1,65,5995,2892,3103
050,36,067,"New York","Onondaga County",1,66,5741,2763,2978
050,36,067,"New York","Onondaga County",1,67,5563,2699,2864
050,36,067,"New York","Onondaga County",1,68,5371,2600,2771
050,36,067,"New York","Onondaga County",1,69,4946,2356,2590
050,36,067,"New York","Onondaga County",1,70,4702,2212,2490
050,36,067,"New York","Onondaga County",1,71,4505,2046,2459
050,36,067,"New York","Onondaga County",1,72,4457,2025,2432
050,36,067,"New York","Onondaga County",1,73,4409,2057,2352
050,36,067,"New York","Onondaga County",1,74,3045,1369,1676
050,36,067,"New York","Onondaga County",1,75,3048,1371,1677
050,36,067,"New York","Onondaga County",1,76,3066,1318,1748
050,36,067,"New York","Onondaga County",1,77,3113,1365,1748
050,36,067,"New York","Onondaga County",1,78,2648,1157,1491
050,36,067,"New York","Onondaga County",1,79,2290,994,1296
050,36,067,"New York","Onondaga County",1,80,2119,908,1211
050,36,067,"New York","Onondaga County",1,81,2071,860,1211
050,36,067,"New York","Onondaga County",1,82,1969,784,1185
050,36,067,"New York","Onondaga County",1,83,1728,705,1023
050,36,067,"New York","Onondaga County",1,84,1595,631,964
050,36,067,"New York","Onondaga County",1,85,11420,3806,7614
050,36,067,"New York","Onondaga County",2,0,5173,2633,2540
050,36,067,"New York","Onondaga County",2,1,5251,2678,2573
050,36,067,"New York","Onondaga County",2,2,5338,2711,2627
050,36,067,"New York","Onondaga County",2,3,5370,2738,2632
050,36,067,"New York","Onondaga County",2,4,5503,2774,2729
050,36,067,"New York","Onondaga County",2,5,5542,2788,2754
050,36,067,"New York","Onondaga County",2,6,5526,2843,2683
050,36,067,"New York","Onondaga County",2,7,5595,2895,2700
050,36,067,"New York","Onondaga County",2,8,5625,2889,2736
050,36,067,"New York","Onondaga County",2,9,5626,2898,2728
050,36,067,"New York","Onondaga County",2,10,5770,2924,2846
050,36,067,"New York","Onondaga County",2,11,5721,2935,2786
050,36,067,"New York","Onondaga County",2,12,5822,3011,2811
050,36,067,"New York","Onondaga County",2,13,5845,3021,2824
050,36,067,"New York","Onondaga County",2,14,5757,2961,2796
050,36,067,"New York","Onondaga County",2,15,5771,2938,2833
050,36,067,"New York","Onondaga County",2,16,5929,3025,2904
050,36,067,"New York","Onondaga County",2,17,6038,3046,2992
050,36,067,"New York","Onondaga County",2,18,7330,3506,3824
050,36,067,"New York","Onondaga County",2,19,7939,3742,4197
050,36,067,"New York","Onondaga County",2,20,7957,3884,4073
050,36,067,"New York","Onondaga County",2,21,6151,3035,3116
050,36,067,"New York","Onondaga County",2,22,5862,2876,2986
050,36,067,"New York","Onondaga County",2,23,5830,2849,2981
050,36,067,"New York","Onondaga County",2,24,5914,2885,3029
050,36,067,"New York","Onondaga County",2,25,6134,2997,3137
050,36,067,"New York","Onondaga County",2,26,6247,3063,3184
050,36,067,"New York","Onondaga County",2,27,6133,3028,3105
050,36,067,"New York","Onondaga County",2,28,6092,3017,3075
050,36,067,"New York","Onondaga County",2,29,6198,3067,3131
050,36,067,"New York","Onondaga County",2,30,6332,3182,3150
050,36,067,"New York","Onondaga County",2,31,6298,3138,3160
050,36,067,"New York","Onondaga County",2,32,6394,3126,3268
050,36,067,"New York","Onondaga County",2,33,6384,3135,3249
050,36,067,"New York","Onondaga County",2,34,6339,3084,3255
050,36,067,"New York","Onondaga County",2,35,6178,3096,3082
050,36,067,"New York","Onondaga County",2,36,5891,2952,2939
050,36,067,"New York","Onondaga County",2,37,5951,2931,3020
050,36,067,"New York","Onondaga County",2,38,5837,2851,2986
050,36,067,"New York","Onondaga County",2,39,5738,2823,2915
050,36,067,"New York","Onondaga County",2,40,5603,2769,2834
050,36,067,"New York","Onondaga County",2,41,5359,2635,2724
050,36,067,"New York","Onondaga County",2,42,5228,2536,2692
050,36,067,"New York","Onondaga County",2,43,5173,2523,2650
050,36,067,"New York","Onondaga County",2,44,4992,2402,2590
050,36,067,"New York","Onondaga County",2,45,4965,2439,2526
050,36,067,"New York","Onondaga County",2,46,4828,2366,2462
050,36,067,"New York","Onondaga County",2,47,4960,2396,2564
050,36,067,"New York","Onondaga County",2,48,5377,2593,2784
050,36,067,"New York","Onondaga County",2,49,5985,2932,3053
050,36,067,"New York","Onondaga County",2,50,6012,2936,3076
050,36,067,"New York","Onondaga County",2,51,5978,2938,3040
050,36,067,"New York","Onondaga County",2,52,5910,2915,2995
050,36,067,"New York","Onondaga County",2,53,6092,3021,3071
050,36,067,"New York","Onondaga County",2,54,6364,3102,3262
050,36,067,"New York","Onondaga County",2,55,6676,3220,3456
050,36,067,"New York","Onondaga County",2,56,6841,3314,3527
050,36,067,"New York","Onondaga County",2,57,6904,3371,3533
050,36,067,"New York","Onondaga County",2,58,6969,3381,3588
050,36,067,"New York","Onondaga County",2,59,6907,3367,3540
050,36,067,"New York","Onondaga County",2,60,6760,3315,3445
050,36,067,"New York","Onondaga County",2,61,6746,3290,3456
050,36,067,"New York","Onondaga County",2,62,6655,3256,3399
050,36,067,"New York","Onondaga County",2,63,6501,3164,3337
050,36,067,"New York","Onondaga County",2,64,6154,2967,3187
050,36,067,"New York","Onondaga County",2,65,5986,2885,3101
050,36,067,"New York","Onondaga County",2,66,5785,2786,2999
050,36,067,"New York","Onondaga County",2,67,5545,2677,2868
050,36,067,"New York","Onondaga County",2,68,5355,2590,2765
050,36,067,"New York","Onondaga County",2,69,5053,2412,2641
050,36,067,"New York","Onondaga County",2,70,4714,2223,2491
050,36,067,"New York","Onondaga County",2,71,4525,2072,2453
050,36,067,"New York","Onondaga County",2,72,4367,1981,2386
050,36,067,"New York","Onondaga County",2,73,4612,2141,2471
050,36,067,"New York","Onondaga County",2,74,3149,1433,1716
050,36,067,"New York","Onondaga County",2,75,3035,1368,1667
050,36,067,"New York","Onondaga County",2,76,2995,1298,1697
050,36,067,"New York","Onondaga County",2,77,3140,1369,1771
050,36,067,"New York","Onondaga County",2,78,2674,1174,1500
050,36,067,"New York","Onondaga County",2,79,2337,1013,1324
050,36,067,"New York","Onondaga County",2,80,2138,918,1220
050,36,067,"New York","Onondaga County",2,81,2025,852,1173
050,36,067,"New York","Onondaga County",2,82,1968,786,1182
050,36,067,"New York","Onondaga County",2,83,1732,699,1033
050,36,067,"New York","Onondaga County",2,84,1586,634,952
050,36,067,"New York","Onondaga County",2,85,11201,3758,7443
050,36,067,"New York","Onondaga County",3,0,4825,2454,2371
050,36,067,"New York","Onondaga County",3,1,5117,2602,2515
050,36,067,"New York","Onondaga County",3,2,5313,2695,2618
050,36,067,"New York","Onondaga County",3,3,5329,2711,2618
050,36,067,"New York","Onondaga County",3,4,5400,2751,2649
050,36,067,"New York","Onondaga County",3,5,5512,2771,2741
050,36,067,"New York","Onondaga County",3,6,5557,2798,2759
050,36,067,"New York","Onondaga County",3,7,5486,2811,2675
050,36,067,"New York","Onondaga County",3,8,5590,2884,2706
050,36,067,"New York","Onondaga County",3,9,5607,2879,2728
050,36,067,"New York","Onondaga County",3,10,5574,2856,2718
050,36,067,"New York","Onondaga County",3,11,5752,2918,2834
050,36,067,"New York","Onondaga County",3,12,5722,2943,2779
050,36,067,"New York","Onondaga County",3,13,5806,3001,2805
050,36,067,"New York","Onondaga County",3,14,5820,3032,2788
050,36,067,"New York","Onondaga County",3,15,5717,2937,2780
050,36,067,"New York","Onondaga County",3,16,5770,2931,2839
050,36,067,"New York","Onondaga County",3,17,5918,3008,2910
050,36,067,"New York","Onondaga County",3,18,7320,3519,3801
050,36,067,"New York","Onondaga County",3,19,7744,3660,4084
050,36,067,"New York","Onondaga County",3,20,7819,3810,4009
050,36,067,"New York","Onondaga County",3,21,6163,3035,3128
050,36,067,"New York","Onondaga County",3,22,5876,2881,2995
050,36,067,"New York","Onondaga County",3,23,5796,2856,2940
050,36,067,"New York","Onondaga County",3,24,5955,2876,3079
050,36,067,"New York","Onondaga County",3,25,5934,2916,3018
050,36,067,"New York","Onondaga County",3,26,6073,2990,3083
050,36,067,"New York","Onondaga County",3,27,6284,3067,3217
050,36,067,"New York","Onondaga County",3,28,6124,3056,3068
050,36,067,"New York","Onondaga County",3,29,6111,3012,3099
050,36,067,"New York","Onondaga County",3,30,6201,3074,3127
050,36,067,"New York","Onondaga County",3,31,6242,3126,3116
050,36,067,"New York","Onondaga County",3,32,6327,3154,3173
050,36,067,"New York","Onondaga County",3,33,6335,3115,3220
050,36,067,"New York","Onondaga County",3,34,6322,3086,3236
050,36,067,"New York","Onondaga County",3,35,6293,3046,3247
050,36,067,"New York","Onondaga County",3,36,6176,3058,3118
050,36,067,"New York","Onondaga County",3,37,5902,2973,2929
050,36,067,"New York","Onondaga County",3,38,5965,2922,3043
050,36,067,"New York","Onondaga County",3,39,5847,2853,2994
050,36,067,"New York","Onondaga County",3,40,5710,2800,2910
050,36,067,"New York","Onondaga County",3,41,5573,2769,2804
050,36,067,"New York","Onondaga County",3,42,5356,2639,2717
050,36,067,"New York","Onondaga County",3,43,5208,2530,2678
050,36,067,"New York","Onondaga County",3,44,5166,2507,2659
050,36,067,"New York","Onondaga County",3,45,4935,2389,2546
050,36,067,"New York","Onondaga County",3,46,4973,2431,2542
050,36,067,"New York","Onondaga County",3,47,4791,2336,2455
050,36,067,"New York","Onondaga County",3,48,4862,2345,2517
050,36,067,"New York","Onondaga County",3,49,5310,2600,2710
050,36,067,"New York","Onondaga County",3,50,5919,2868,3051
050,36,067,"New York","Onondaga County",3,51,5942,2891,3051
050,36,067,"New York","Onondaga County",3,52,5947,2950,2997
050,36,067,"New York","Onondaga County",3,53,5834,2884,2950
050,36,067,"New York","Onondaga County",3,54,6000,2953,3047
050,36,067,"New York","Onondaga County",3,55,6302,3066,3236
050,36,067,"New York","Onondaga County",3,56,6570,3163,3407
050,36,067,"New York","Onondaga County",3,57,6739,3260,3479
050,36,067,"New York","Onondaga County",3,58,6805,3316,3489
050,36,067,"New York","Onondaga County",3,59,6862,3332,3530
050,36,067,"New York","Onondaga County",3,60,6787,3288,3499
050,36,067,"New York","Onondaga County",3,61,6612,3231,3381
050,36,067,"New York","Onondaga County",3,62,6607,3221,3386
050,36,067,"New York","Onondaga County",3,63,6497,3149,3348
050,36,067,"New York","Onondaga County",3,64,6398,3103,3295
050,36,067,"New York","Onondaga County",3,65,6003,2889,3114
050,36,067,"New York","Onondaga County",3,66,5842,2818,3024
050,36,067,"New York","Onondaga County",3,67,5637,2714,2923
050,36,067,"New York","Onondaga County",3,68,5436,2610,2826
050,36,067,"New York","Onondaga County",3,69,5240,2529,2711
050,36,067,"New York","Onondaga County",3,70,4907,2336,2571
050,36,067,"New York","Onondaga County",3,71,4592,2145,2447
050,36,067,"New York","Onondaga County",3,72,4414,2013,2401
050,36,067,"New York","Onondaga County",3,73,4236,1909,2327
050,36,067,"New York","Onondaga County",3,74,4426,2026,2400
050,36,067,"New York","Onondaga County",3,75,3055,1375,1680
050,36,067,"New York","Onondaga County",3,76,2930,1320,1610
050,36,067,"New York","Onondaga County",3,77,2895,1258,1637
050,36,067,"New York","Onondaga County",3,78,3028,1318,1710
050,36,067,"New York","Onondaga County",3,79,2526,1099,1427
050,36,067,"New York","Onondaga County",3,80,2226,948,1278
050,36,067,"New York","Onondaga County",3,81,2024,867,1157
050,36,067,"New York","Onondaga County",3,82,1902,776,1126
050,36,067,"New York","Onondaga County",3,83,1803,711,1092
050,36,067,"New York","Onondaga County",3,84,1586,641,945
050,36,067,"New York","Onondaga County",3,85,10850,3628,7222
050,36,067,"New York","Onondaga County",4,0,4932,2504,2428
050,36,067,"New York","Onondaga County",4,1,4818,2441,2377
050,36,067,"New York","Onondaga County",4,2,5086,2572,2514
050,36,067,"New York","Onondaga County",4,3,5308,2717,2591
050,36,067,"New York","Onondaga County",4,4,5303,2682,2621
050,36,067,"New York","Onondaga County",4,5,5333,2727,2606
050,36,067,"New York","Onondaga County",4,6,5492,2759,2733
050,36,067,"New York","Onondaga County",4,7,5488,2761,2727
050,36,067,"New York","Onondaga County",4,8,5437,2807,2630
050,36,067,"New York","Onondaga County",4,9,5500,2821,2679
050,36,067,"New York","Onondaga County",4,10,5624,2889,2735
050,36,067,"New York","Onondaga County",4,11,5516,2852,2664
050,36,067,"New York","Onondaga County",4,12,5707,2910,2797
050,36,067,"New York","Onondaga County",4,13,5686,2943,2743
050,36,067,"New York","Onondaga County",4,14,5769,2987,2782
050,36,067,"New York","Onondaga County",4,15,5766,2982,2784
050,36,067,"New York","Onondaga County",4,16,5680,2911,2769
050,36,067,"New York","Onondaga County",4,17,5764,2915,2849
050,36,067,"New York","Onondaga County",4,18,7501,3581,3920
050,36,067,"New York","Onondaga County",4,19,8198,3862,4336
050,36,067,"New York","Onondaga County",4,20,8157,3973,4184
050,36,067,"New York","Onondaga County",4,21,6219,3063,3156
050,36,067,"New York","Onondaga County",4,22,5968,2911,3057
050,36,067,"New York","Onondaga County",4,23,5767,2824,2943
050,36,067,"New York","Onondaga County",4,24,5795,2875,2920
050,36,067,"New York","Onondaga County",4,25,5862,2880,2982
050,36,067,"New York","Onondaga County",4,26,5727,2773,2954
050,36,067,"New York","Onondaga County",4,27,5978,2939,3039
050,36,067,"New York","Onondaga County",4,28,6189,3050,3139
050,36,067,"New York","Onondaga County",4,29,6059,3033,3026
050,36,067,"New York","Onondaga County",4,30,6096,2987,3109
050,36,067,"New York","Onondaga County",4,31,6093,3025,3068
050,36,067,"New York","Onondaga County",4,32,6225,3136,3089
050,36,067,"New York","Onondaga County",4,33,6286,3130,3156
050,36,067,"New York","Onondaga County",4,34,6274,3065,3209
050,36,067,"New York","Onondaga County",4,35,6298,3100,3198
050,36,067,"New York","Onondaga County",4,36,6153,2977,3176
050,36,067,"New York","Onondaga County",4,37,6116,3062,3054
050,36,067,"New York","Onondaga County",4,38,5872,2945,2927
050,36,067,"New York","Onondaga County",4,39,5908,2897,3011
050,36,067,"New York","Onondaga County",4,40,5807,2824,2983
050,36,067,"New York","Onondaga County",4,41,5712,2811,2901
050,36,067,"New York","Onondaga County",4,42,5542,2760,2782
050,36,067,"New York","Onondaga County",4,43,5341,2622,2719
050,36,067,"New York","Onondaga County",4,44,5191,2511,2680
050,36,067,"New York","Onondaga County",4,45,5098,2479,2619
050,36,067,"New York","Onondaga County",4,46,4898,2377,2521
050,36,067,"New York","Onondaga County",4,47,4895,2383,2512
050,36,067,"New York","Onondaga County",4,48,4679,2276,2403
050,36,067,"New York","Onondaga County",4,49,4840,2356,2484
050,36,067,"New York","Onondaga County",4,50,5246,2547,2699
050,36,067,"New York","Onondaga County",4,51,5842,2828,3014
050,36,067,"New York","Onondaga County",4,52,5899,2868,3031
050,36,067,"New York","Onondaga County",4,53,5888,2928,2960
050,36,067,"New York","Onondaga County",4,54,5700,2799,2901
050,36,067,"New York","Onondaga County",4,55,5925,2917,3008
050,36,067,"New York","Onondaga County",4,56,6222,3021,3201
050,36,067,"New York","Onondaga County",4,57,6467,3123,3344
050,36,067,"New York","Onondaga County",4,58,6651,3194,3457
050,36,067,"New York","Onondaga County",4,59,6665,3256,3409
050,36,067,"New York","Onondaga County",4,60,6707,3258,3449
050,36,067,"New York","Onondaga County",4,61,6654,3217,3437
050,36,067,"New York","Onondaga County",4,62,6470,3175,3295
050,36,067,"New York","Onondaga County",4,63,6439,3127,3312
050,36,067,"New York","Onondaga County",4,64,6352,3061,3291
050,36,067,"New York","Onondaga County",4,65,6256,3020,3236
050,36,067,"New York","Onondaga County",4,66,5844,2802,3042
050,36,067,"New York","Onondaga County",4,67,5673,2725,2948
050,36,067,"New York","Onondaga County",4,68,5520,2638,2882
050,36,067,"New York","Onondaga County",4,69,5338,2559,2779
050,36,067,"New York","Onondaga County",4,70,5083,2445,2638
050,36,067,"New York","Onondaga County",4,71,4767,2259,2508
050,36,067,"New York","Onondaga County",4,72,4503,2084,2419
050,36,067,"New York","Onondaga County",4,73,4320,1961,2359
050,36,067,"New York","Onondaga County",4,74,4084,1823,2261
050,36,067,"New York","Onondaga County",4,75,4295,1934,2361
050,36,067,"New York","Onondaga County",4,76,2942,1322,1620
050,36,067,"New York","Onondaga County",4,77,2846,1284,1562
050,36,067,"New York","Onondaga County",4,78,2797,1205,1592
050,36,067,"New York","Onondaga County",4,79,2860,1238,1622
050,36,067,"New York","Onondaga County",4,80,2439,1044,1395
050,36,067,"New York","Onondaga County",4,81,2095,886,1209
050,36,067,"New York","Onondaga County",4,82,1919,791,1128
050,36,067,"New York","Onondaga County",4,83,1741,710,1031
050,36,067,"New York","Onondaga County",4,84,1669,662,1007
050,36,067,"New York","Onondaga County",4,85,10657,3616,7041
050,36,067,"New York","Onondaga County",5,0,4930,2505,2425
050,36,067,"New York","Onondaga County",5,1,4930,2511,2419
050,36,067,"New York","Onondaga County",5,2,4825,2443,2382
050,36,067,"New York","Onondaga County",5,3,5116,2610,2506
050,36,067,"New York","Onondaga County",5,4,5248,2667,2581
050,36,067,"New York","Onondaga County",5,5,5272,2666,2606
050,36,067,"New York","Onondaga County",5,6,5328,2716,2612
050,36,067,"New York","Onondaga County",5,7,5494,2768,2726
050,36,067,"New York","Onondaga County",5,8,5483,2757,2726
050,36,067,"New York","Onondaga County",5,9,5413,2798,2615
050,36,067,"New York","Onondaga County",5,10,5509,2793,2716
050,36,067,"New York","Onondaga County",5,11,5623,2888,2735
050,36,067,"New York","Onondaga County",5,12,5520,2843,2677
050,36,067,"New York","Onondaga County",5,13,5691,2893,2798
050,36,067,"New York","Onondaga County",5,14,5669,2932,2737
050,36,067,"New York","Onondaga County",5,15,5740,2959,2781
050,36,067,"New York","Onondaga County",5,16,5744,2965,2779
050,36,067,"New York","Onondaga County",5,17,5701,2895,2806
050,36,067,"New York","Onondaga County",5,18,7304,3475,3829
050,36,067,"New York","Onondaga County",5,19,8157,3864,4293
050,36,067,"New York","Onondaga County",5,20,8142,3967,4175
050,36,067,"New York","Onondaga County",5,21,6088,3006,3082
050,36,067,"New York","Onondaga County",5,22,5907,2900,3007
050,36,067,"New York","Onondaga County",5,23,5835,2853,2982
050,36,067,"New York","Onondaga County",5,24,5815,2880,2935
050,36,067,"New York","Onondaga County",5,25,5735,2890,2845
050,36,067,"New York","Onondaga County",5,26,5799,2846,2953
050,36,067,"New York","Onondaga County",5,27,5711,2780,2931
050,36,067,"New York","Onondaga County",5,28,5849,2878,2971
050,36,067,"New York","Onondaga County",5,29,6098,3003,3095
050,36,067,"New York","Onondaga County",5,30,6030,2991,3039
050,36,067,"New York","Onondaga County",5,31,5980,2924,3056
050,36,067,"New York","Onondaga County",5,32,6044,3005,3039
050,36,067,"New York","Onondaga County",5,33,6229,3124,3105
050,36,067,"New York","Onondaga County",5,34,6272,3110,3162
050,36,067,"New York","Onondaga County",5,35,6242,3042,3200
050,36,067,"New York","Onondaga County",5,36,6268,3098,3170
050,36,067,"New York","Onondaga County",5,37,6120,2984,3136
050,36,067,"New York","Onondaga County",5,38,6070,3035,3035
050,36,067,"New York","Onondaga County",5,39,5872,2962,2910
050,36,067,"New York","Onondaga County",5,40,5879,2902,2977
050,36,067,"New York","Onondaga County",5,41,5774,2799,2975
050,36,067,"New York","Onondaga County",5,42,5691,2801,2890
050,36,067,"New York","Onondaga County",5,43,5532,2753,2779
050,36,067,"New York","Onondaga County",5,44,5300,2576,2724
050,36,067,"New York","Onondaga County",5,45,5124,2495,2629
050,36,067,"New York","Onondaga County",5,46,5057,2436,2621
050,36,067,"New York","Onondaga County",5,47,4877,2352,2525
050,36,067,"New York","Onondaga County",5,48,4839,2360,2479
050,36,067,"New York","Onondaga County",5,49,4685,2303,2382
050,36,067,"New York","Onondaga County",5,50,4814,2322,2492
050,36,067,"New York","Onondaga County",5,51,5192,2514,2678
050,36,067,"New York","Onondaga County",5,52,5790,2806,2984
050,36,067,"New York","Onondaga County",5,53,5815,2834,2981
050,36,067,"New York","Onondaga County",5,54,5810,2878,2932
050,36,067,"New York","Onondaga County",5,55,5623,2762,2861
050,36,067,"New York","Onondaga County",5,56,5804,2861,2943
050,36,067,"New York","Onondaga County",5,57,6141,2980,3161
050,36,067,"New York","Onondaga County",5,58,6390,3081,3309
050,36,067,"New York","Onondaga County",5,59,6546,3112,3434
050,36,067,"New York","Onondaga County",5,60,6559,3201,3358
050,36,067,"New York","Onondaga County",5,61,6591,3196,3395
050,36,067,"New York","Onondaga County",5,62,6531,3154,3377
050,36,067,"New York","Onondaga County",5,63,6347,3118,3229
050,36,067,"New York","Onondaga County",5,64,6315,3052,3263
050,36,067,"New York","Onondaga County",5,65,6244,2994,3250
050,36,067,"New York","Onondaga County",5,66,6151,2973,3178
050,36,067,"New York","Onondaga County",5,67,5730,2747,2983
050,36,067,"New York","Onondaga County",5,68,5585,2664,2921
050,36,067,"New York","Onondaga County",5,69,5406,2579,2827
050,36,067,"New York","Onondaga County",5,70,5221,2495,2726
050,36,067,"New York","Onondaga County",5,71,4978,2383,2595
050,36,067,"New York","Onondaga County",5,72,4666,2203,2463
050,36,067,"New York","Onondaga County",5,73,4398,2029,2369
050,36,067,"New York","Onondaga County",5,74,4173,1878,2295
050,36,067,"New York","Onondaga County",5,75,4001,1761,2240
050,36,067,"New York","Onondaga County",5,76,4127,1848,2279
050,36,067,"New York","Onondaga County",5,77,2858,1280,1578
050,36,067,"New York","Onondaga County",5,78,2756,1244,1512
050,36,067,"New York","Onondaga County",5,79,2647,1133,1514
050,36,067,"New York","Onondaga County",5,80,2766,1183,1583
050,36,067,"New York","Onondaga County",5,81,2314,987,1327
050,36,067,"New York","Onondaga County",5,82,1985,814,1171
050,36,067,"New York","Onondaga County",5,83,1760,721,1039
050,36,067,"New York","Onondaga County",5,84,1617,658,959
050,36,067,"New York","Onondaga County",5,85,10661,3651,7010
050,36,069,"New York","Ontario County",1,0,946,482,464
050,36,069,"New York","Ontario County",1,1,1005,488,517
050,36,069,"New York","Ontario County",1,2,1088,554,534
050,36,069,"New York","Ontario County",1,3,1124,581,543
050,36,069,"New York","Ontario County",1,4,1192,587,605
050,36,069,"New York","Ontario County",1,5,1210,628,582
050,36,069,"New York","Ontario County",1,6,1251,621,630
050,36,069,"New York","Ontario County",1,7,1196,600,596
050,36,069,"New York","Ontario County",1,8,1242,642,600
050,36,069,"New York","Ontario County",1,9,1211,653,558
050,36,069,"New York","Ontario County",1,10,1295,664,631
050,36,069,"New York","Ontario County",1,11,1332,690,642
050,36,069,"New York","Ontario County",1,12,1356,696,660
050,36,069,"New York","Ontario County",1,13,1366,686,680
050,36,069,"New York","Ontario County",1,14,1312,676,636
050,36,069,"New York","Ontario County",1,15,1333,691,642
050,36,069,"New York","Ontario County",1,16,1433,731,702
050,36,069,"New York","Ontario County",1,17,1440,745,695
050,36,069,"New York","Ontario County",1,18,1570,770,800
050,36,069,"New York","Ontario County",1,19,1593,807,786
050,36,069,"New York","Ontario County",1,20,1626,833,793
050,36,069,"New York","Ontario County",1,21,1561,776,785
050,36,069,"New York","Ontario County",1,22,1412,725,687
050,36,069,"New York","Ontario County",1,23,1179,603,576
050,36,069,"New York","Ontario County",1,24,1173,609,564
050,36,069,"New York","Ontario County",1,25,1240,646,594
050,36,069,"New York","Ontario County",1,26,1277,661,616
050,36,069,"New York","Ontario County",1,27,1232,639,593
050,36,069,"New York","Ontario County",1,28,1203,644,559
050,36,069,"New York","Ontario County",1,29,1258,643,615
050,36,069,"New York","Ontario County",1,30,1209,608,601
050,36,069,"New York","Ontario County",1,31,1246,630,616
050,36,069,"New York","Ontario County",1,32,1299,666,633
050,36,069,"New York","Ontario County",1,33,1245,621,624
050,36,069,"New York","Ontario County",1,34,1357,686,671
050,36,069,"New York","Ontario County",1,35,1316,657,659
050,36,069,"New York","Ontario County",1,36,1323,676,647
050,36,069,"New York","Ontario County",1,37,1361,676,685
050,36,069,"New York","Ontario County",1,38,1278,617,661
050,36,069,"New York","Ontario County",1,39,1306,648,658
050,36,069,"New York","Ontario County",1,40,1377,677,700
050,36,069,"New York","Ontario County",1,41,1321,666,655
050,36,069,"New York","Ontario County",1,42,1270,650,620
050,36,069,"New York","Ontario County",1,43,1200,569,631
050,36,069,"New York","Ontario County",1,44,1112,542,570
050,36,069,"New York","Ontario County",1,45,1131,578,553
050,36,069,"New York","Ontario County",1,46,1136,575,561
050,36,069,"New York","Ontario County",1,47,1240,618,622
050,36,069,"New York","Ontario County",1,48,1402,686,716
050,36,069,"New York","Ontario County",1,49,1531,771,760
050,36,069,"New York","Ontario County",1,50,1503,738,765
050,36,069,"New York","Ontario County",1,51,1522,763,759
050,36,069,"New York","Ontario County",1,52,1506,761,745
050,36,069,"New York","Ontario County",1,53,1519,746,773
050,36,069,"New York","Ontario County",1,54,1628,792,836
050,36,069,"New York","Ontario County",1,55,1710,813,897
050,36,069,"New York","Ontario County",1,56,1753,847,906
050,36,069,"New York","Ontario County",1,57,1740,839,901
050,36,069,"New York","Ontario County",1,58,1790,879,911
050,36,069,"New York","Ontario County",1,59,1772,878,894
050,36,069,"New York","Ontario County",1,60,1760,862,898
050,36,069,"New York","Ontario County",1,61,1761,880,881
050,36,069,"New York","Ontario County",1,62,1718,844,874
050,36,069,"New York","Ontario County",1,63,1605,779,826
050,36,069,"New York","Ontario County",1,64,1625,807,818
050,36,069,"New York","Ontario County",1,65,1662,821,841
050,36,069,"New York","Ontario County",1,66,1559,764,795
050,36,069,"New York","Ontario County",1,67,1528,733,795
050,36,069,"New York","Ontario County",1,68,1478,716,762
050,36,069,"New York","Ontario County",1,69,1411,650,761
050,36,069,"New York","Ontario County",1,70,1392,670,722
050,36,069,"New York","Ontario County",1,71,1318,619,699
050,36,069,"New York","Ontario County",1,72,1354,642,712
050,36,069,"New York","Ontario County",1,73,1360,658,702
050,36,069,"New York","Ontario County",1,74,918,447,471
050,36,069,"New York","Ontario County",1,75,927,433,494
050,36,069,"New York","Ontario County",1,76,929,421,508
050,36,069,"New York","Ontario County",1,77,920,444,476
050,36,069,"New York","Ontario County",1,78,733,341,392
050,36,069,"New York","Ontario County",1,79,615,278,337
050,36,069,"New York","Ontario County",1,80,571,246,325
050,36,069,"New York","Ontario County",1,81,548,229,319
050,36,069,"New York","Ontario County",1,82,535,236,299
050,36,069,"New York","Ontario County",1,83,466,184,282
050,36,069,"New York","Ontario County",1,84,423,177,246
050,36,069,"New York","Ontario County",1,85,2610,878,1732
050,36,069,"New York","Ontario County",2,0,957,482,475
050,36,069,"New York","Ontario County",2,1,994,488,506
050,36,069,"New York","Ontario County",2,2,1076,542,534
050,36,069,"New York","Ontario County",2,3,1120,578,542
050,36,069,"New York","Ontario County",2,4,1185,593,592
050,36,069,"New York","Ontario County",2,5,1211,622,589
050,36,069,"New York","Ontario County",2,6,1245,627,618
050,36,069,"New York","Ontario County",2,7,1210,606,604
050,36,069,"New York","Ontario County",2,8,1224,631,593
050,36,069,"New York","Ontario County",2,9,1220,652,568
050,36,069,"New York","Ontario County",2,10,1275,663,612
050,36,069,"New York","Ontario County",2,11,1316,679,637
050,36,069,"New York","Ontario County",2,12,1352,694,658
050,36,069,"New York","Ontario County",2,13,1363,690,673
050,36,069,"New York","Ontario County",2,14,1320,675,645
050,36,069,"New York","Ontario County",2,15,1327,685,642
050,36,069,"New York","Ontario County",2,16,1410,721,689
050,36,069,"New York","Ontario County",2,17,1444,746,698
050,36,069,"New York","Ontario County",2,18,1534,755,779
050,36,069,"New York","Ontario County",2,19,1568,789,779
050,36,069,"New York","Ontario County",2,20,1614,824,790
050,36,069,"New York","Ontario County",2,21,1552,782,770
050,36,069,"New York","Ontario County",2,22,1387,710,677
050,36,069,"New York","Ontario County",2,23,1184,606,578
050,36,069,"New York","Ontario County",2,24,1172,606,566
050,36,069,"New York","Ontario County",2,25,1227,639,588
050,36,069,"New York","Ontario County",2,26,1270,655,615
050,36,069,"New York","Ontario County",2,27,1240,645,595
050,36,069,"New York","Ontario County",2,28,1212,644,568
050,36,069,"New York","Ontario County",2,29,1244,641,603
050,36,069,"New York","Ontario County",2,30,1225,616,609
050,36,069,"New York","Ontario County",2,31,1245,632,613
050,36,069,"New York","Ontario County",2,32,1288,658,630
050,36,069,"New York","Ontario County",2,33,1263,634,629
050,36,069,"New York","Ontario County",2,34,1337,673,664
050,36,069,"New York","Ontario County",2,35,1345,675,670
050,36,069,"New York","Ontario County",2,36,1315,668,647
050,36,069,"New York","Ontario County",2,37,1356,677,679
050,36,069,"New York","Ontario County",2,38,1303,636,667
050,36,069,"New York","Ontario County",2,39,1305,645,660
050,36,069,"New York","Ontario County",2,40,1375,677,698
050,36,069,"New York","Ontario County",2,41,1331,669,662
050,36,069,"New York","Ontario County",2,42,1274,649,625
050,36,069,"New York","Ontario County",2,43,1220,589,631
050,36,069,"New York","Ontario County",2,44,1125,548,577
050,36,069,"New York","Ontario County",2,45,1133,573,560
050,36,069,"New York","Ontario County",2,46,1131,571,560
050,36,069,"New York","Ontario County",2,47,1213,606,607
050,36,069,"New York","Ontario County",2,48,1361,669,692
050,36,069,"New York","Ontario County",2,49,1507,756,751
050,36,069,"New York","Ontario County",2,50,1516,749,767
050,36,069,"New York","Ontario County",2,51,1512,757,755
050,36,069,"New York","Ontario County",2,52,1495,757,738
050,36,069,"New York","Ontario County",2,53,1521,751,770
050,36,069,"New York","Ontario County",2,54,1597,777,820
050,36,069,"New York","Ontario County",2,55,1689,806,883
050,36,069,"New York","Ontario County",2,56,1753,842,911
050,36,069,"New York","Ontario County",2,57,1749,842,907
050,36,069,"New York","Ontario County",2,58,1775,864,911
050,36,069,"New York","Ontario County",2,59,1787,883,904
050,36,069,"New York","Ontario County",2,60,1753,859,894
050,36,069,"New York","Ontario County",2,61,1765,879,886
050,36,069,"New York","Ontario County",2,62,1725,846,879
050,36,069,"New York","Ontario County",2,63,1642,801,841
050,36,069,"New York","Ontario County",2,64,1607,796,811
050,36,069,"New York","Ontario County",2,65,1650,814,836
050,36,069,"New York","Ontario County",2,66,1594,783,811
050,36,069,"New York","Ontario County",2,67,1527,735,792
050,36,069,"New York","Ontario County",2,68,1471,711,760
050,36,069,"New York","Ontario County",2,69,1439,669,770
050,36,069,"New York","Ontario County",2,70,1384,659,725
050,36,069,"New York","Ontario County",2,71,1332,630,702
050,36,069,"New York","Ontario County",2,72,1309,618,691
050,36,069,"New York","Ontario County",2,73,1423,685,738
050,36,069,"New York","Ontario County",2,74,953,462,491
050,36,069,"New York","Ontario County",2,75,928,437,491
050,36,069,"New York","Ontario County",2,76,917,420,497
050,36,069,"New York","Ontario County",2,77,938,445,493
050,36,069,"New York","Ontario County",2,78,754,353,401
050,36,069,"New York","Ontario County",2,79,636,290,346
050,36,069,"New York","Ontario County",2,80,569,246,323
050,36,069,"New York","Ontario County",2,81,541,224,317
050,36,069,"New York","Ontario County",2,82,531,229,302
050,36,069,"New York","Ontario County",2,83,469,188,281
050,36,069,"New York","Ontario County",2,84,418,170,248
050,36,069,"New York","Ontario County",2,85,2589,871,1718
050,36,069,"New York","Ontario County",3,0,927,470,457
050,36,069,"New York","Ontario County",3,1,1014,505,509
050,36,069,"New York","Ontario County",3,2,1035,512,523
050,36,069,"New York","Ontario County",3,3,1078,529,549
050,36,069,"New York","Ontario County",3,4,1125,572,553
050,36,069,"New York","Ontario County",3,5,1197,591,606
050,36,069,"New York","Ontario County",3,6,1217,626,591
050,36,069,"New York","Ontario County",3,7,1276,640,636
050,36,069,"New York","Ontario County",3,8,1204,600,604
050,36,069,"New York","Ontario County",3,9,1217,629,588
050,36,069,"New York","Ontario County",3,10,1211,649,562
050,36,069,"New York","Ontario County",3,11,1284,660,624
050,36,069,"New York","Ontario County",3,12,1322,679,643
050,36,069,"New York","Ontario County",3,13,1357,701,656
050,36,069,"New York","Ontario County",3,14,1382,693,689
050,36,069,"New York","Ontario County",3,15,1320,674,646
050,36,069,"New York","Ontario County",3,16,1321,675,646
050,36,069,"New York","Ontario County",3,17,1389,723,666
050,36,069,"New York","Ontario County",3,18,1526,753,773
050,36,069,"New York","Ontario County",3,19,1531,754,777
050,36,069,"New York","Ontario County",3,20,1590,813,777
050,36,069,"New York","Ontario County",3,21,1576,811,765
050,36,069,"New York","Ontario County",3,22,1412,725,687
050,36,069,"New York","Ontario County",3,23,1204,586,618
050,36,069,"New York","Ontario County",3,24,1217,627,590
050,36,069,"New York","Ontario County",3,25,1212,594,618
050,36,069,"New York","Ontario County",3,26,1248,664,584
050,36,069,"New York","Ontario County",3,27,1292,670,622
050,36,069,"New York","Ontario County",3,28,1237,631,606
050,36,069,"New York","Ontario County",3,29,1215,633,582
050,36,069,"New York","Ontario County",3,30,1277,666,611
050,36,069,"New York","Ontario County",3,31,1262,638,624
050,36,069,"New York","Ontario County",3,32,1270,643,627
050,36,069,"New York","Ontario County",3,33,1311,673,638
050,36,069,"New York","Ontario County",3,34,1275,647,628
050,36,069,"New York","Ontario County",3,35,1365,678,687
050,36,069,"New York","Ontario County",3,36,1353,682,671
050,36,069,"New York","Ontario County",3,37,1377,704,673
050,36,069,"New York","Ontario County",3,38,1366,677,689
050,36,069,"New York","Ontario County",3,39,1308,636,672
050,36,069,"New York","Ontario County",3,40,1312,651,661
050,36,069,"New York","Ontario County",3,41,1370,685,685
050,36,069,"New York","Ontario County",3,42,1331,668,663
050,36,069,"New York","Ontario County",3,43,1265,638,627
050,36,069,"New York","Ontario County",3,44,1226,600,626
050,36,069,"New York","Ontario County",3,45,1114,543,571
050,36,069,"New York","Ontario County",3,46,1151,581,570
050,36,069,"New York","Ontario County",3,47,1164,586,578
050,36,069,"New York","Ontario County",3,48,1212,611,601
050,36,069,"New York","Ontario County",3,49,1375,684,691
050,36,069,"New York","Ontario County",3,50,1503,745,758
050,36,069,"New York","Ontario County",3,51,1514,759,755
050,36,069,"New York","Ontario County",3,52,1482,739,743
050,36,069,"New York","Ontario County",3,53,1507,765,742
050,36,069,"New York","Ontario County",3,54,1536,767,769
050,36,069,"New York","Ontario County",3,55,1585,772,813
050,36,069,"New York","Ontario County",3,56,1687,807,880
050,36,069,"New York","Ontario County",3,57,1730,837,893
050,36,069,"New York","Ontario County",3,58,1748,849,899
050,36,069,"New York","Ontario County",3,59,1779,845,934
050,36,069,"New York","Ontario County",3,60,1771,879,892
050,36,069,"New York","Ontario County",3,61,1744,858,886
050,36,069,"New York","Ontario County",3,62,1739,853,886
050,36,069,"New York","Ontario County",3,63,1698,833,865
050,36,069,"New York","Ontario County",3,64,1623,801,822
050,36,069,"New York","Ontario County",3,65,1594,777,817
050,36,069,"New York","Ontario County",3,66,1651,816,835
050,36,069,"New York","Ontario County",3,67,1604,777,827
050,36,069,"New York","Ontario County",3,68,1508,728,780
050,36,069,"New York","Ontario County",3,69,1448,687,761
050,36,069,"New York","Ontario County",3,70,1425,678,747
050,36,069,"New York","Ontario County",3,71,1374,645,729
050,36,069,"New York","Ontario County",3,72,1311,619,692
050,36,069,"New York","Ontario County",3,73,1266,597,669
050,36,069,"New York","Ontario County",3,74,1391,670,721
050,36,069,"New York","Ontario County",3,75,947,458,489
050,36,069,"New York","Ontario County",3,76,911,433,478
050,36,069,"New York","Ontario County",3,77,898,404,494
050,36,069,"New York","Ontario County",3,78,909,425,484
050,36,069,"New York","Ontario County",3,79,730,337,393
050,36,069,"New York","Ontario County",3,80,602,274,328
050,36,069,"New York","Ontario County",3,81,545,236,309
050,36,069,"New York","Ontario County",3,82,521,215,306
050,36,069,"New York","Ontario County",3,83,492,206,286
050,36,069,"New York","Ontario County",3,84,412,158,254
050,36,069,"New York","Ontario County",3,85,2656,899,1757
050,36,069,"New York","Ontario County",4,0,973,495,478
050,36,069,"New York","Ontario County",4,1,991,487,504
050,36,069,"New York","Ontario County",4,2,1031,535,496
050,36,069,"New York","Ontario County",4,3,1032,504,528
050,36,069,"New York","Ontario County",4,4,1094,544,550
050,36,069,"New York","Ontario County",4,5,1135,583,552
050,36,069,"New York","Ontario County",4,6,1175,592,583
050,36,069,"New York","Ontario County",4,7,1237,630,607
050,36,069,"New York","Ontario County",4,8,1277,649,628
050,36,069,"New York","Ontario County",4,9,1218,595,623
050,36,069,"New York","Ontario County",4,10,1218,617,601
050,36,069,"New York","Ontario County",4,11,1207,644,563
050,36,069,"New York","Ontario County",4,12,1279,666,613
050,36,069,"New York","Ontario County",4,13,1325,689,636
050,36,069,"New York","Ontario County",4,14,1362,713,649
050,36,069,"New York","Ontario County",4,15,1370,692,678
050,36,069,"New York","Ontario County",4,16,1319,682,637
050,36,069,"New York","Ontario County",4,17,1347,697,650
050,36,069,"New York","Ontario County",4,18,1436,715,721
050,36,069,"New York","Ontario County",4,19,1474,726,748
050,36,069,"New York","Ontario County",4,20,1535,776,759
050,36,069,"New York","Ontario County",4,21,1546,798,748
050,36,069,"New York","Ontario County",4,22,1419,742,677
050,36,069,"New York","Ontario County",4,23,1232,606,626
050,36,069,"New York","Ontario County",4,24,1150,578,572
050,36,069,"New York","Ontario County",4,25,1172,615,557
050,36,069,"New York","Ontario County",4,26,1176,583,593
050,36,069,"New York","Ontario County",4,27,1200,637,563
050,36,069,"New York","Ontario County",4,28,1277,671,606
050,36,069,"New York","Ontario County",4,29,1240,632,608
050,36,069,"New York","Ontario County",4,30,1193,626,567
050,36,069,"New York","Ontario County",4,31,1291,683,608
050,36,069,"New York","Ontario County",4,32,1265,635,630
050,36,069,"New York","Ontario County",4,33,1278,653,625
050,36,069,"New York","Ontario County",4,34,1346,679,667
050,36,069,"New York","Ontario County",4,35,1274,628,646
050,36,069,"New York","Ontario County",4,36,1375,671,704
050,36,069,"New York","Ontario County",4,37,1399,705,694
050,36,069,"New York","Ontario County",4,38,1384,725,659
050,36,069,"New York","Ontario County",4,39,1391,689,702
050,36,069,"New York","Ontario County",4,40,1339,651,688
050,36,069,"New York","Ontario County",4,41,1314,656,658
050,36,069,"New York","Ontario County",4,42,1385,700,685
050,36,069,"New York","Ontario County",4,43,1334,660,674
050,36,069,"New York","Ontario County",4,44,1265,639,626
050,36,069,"New York","Ontario County",4,45,1242,609,633
050,36,069,"New York","Ontario County",4,46,1154,554,600
050,36,069,"New York","Ontario County",4,47,1159,592,567
050,36,069,"New York","Ontario County",4,48,1169,595,574
050,36,069,"New York","Ontario County",4,49,1220,622,598
050,36,069,"New York","Ontario County",4,50,1348,658,690
050,36,069,"New York","Ontario County",4,51,1512,768,744
050,36,069,"New York","Ontario County",4,52,1513,759,754
050,36,069,"New York","Ontario County",4,53,1495,750,745
050,36,069,"New York","Ontario County",4,54,1492,754,738
050,36,069,"New York","Ontario County",4,55,1526,755,771
050,36,069,"New York","Ontario County",4,56,1599,784,815
050,36,069,"New York","Ontario County",4,57,1671,807,864
050,36,069,"New York","Ontario County",4,58,1712,831,881
050,36,069,"New York","Ontario County",4,59,1739,840,899
050,36,069,"New York","Ontario County",4,60,1751,823,928
050,36,069,"New York","Ontario County",4,61,1786,897,889
050,36,069,"New York","Ontario County",4,62,1718,827,891
050,36,069,"New York","Ontario County",4,63,1742,855,887
050,36,069,"New York","Ontario County",4,64,1703,842,861
050,36,069,"New York","Ontario County",4,65,1597,774,823
050,36,069,"New York","Ontario County",4,66,1625,792,833
050,36,069,"New York","Ontario County",4,67,1647,804,843
050,36,069,"New York","Ontario County",4,68,1603,773,830
050,36,069,"New York","Ontario County",4,69,1489,707,782
050,36,069,"New York","Ontario County",4,70,1426,684,742
050,36,069,"New York","Ontario County",4,71,1398,671,727
050,36,069,"New York","Ontario County",4,72,1350,638,712
050,36,069,"New York","Ontario County",4,73,1284,602,682
050,36,069,"New York","Ontario County",4,74,1237,586,651
050,36,069,"New York","Ontario County",4,75,1367,664,703
050,36,069,"New York","Ontario County",4,76,923,449,474
050,36,069,"New York","Ontario County",4,77,900,422,478
050,36,069,"New York","Ontario County",4,78,859,378,481
050,36,069,"New York","Ontario County",4,79,866,404,462
050,36,069,"New York","Ontario County",4,80,702,315,387
050,36,069,"New York","Ontario County",4,81,574,265,309
050,36,069,"New York","Ontario County",4,82,528,232,296
050,36,069,"New York","Ontario County",4,83,477,194,283
050,36,069,"New York","Ontario County",4,84,439,179,260
050,36,069,"New York","Ontario County",4,85,2659,891,1768
050,36,069,"New York","Ontario County",5,0,972,495,477
050,36,069,"New York","Ontario County",5,1,998,511,487
050,36,069,"New York","Ontario County",5,2,1008,507,501
050,36,069,"New York","Ontario County",5,3,1031,518,513
050,36,069,"New York","Ontario County",5,4,1059,514,545
050,36,069,"New York","Ontario County",5,5,1111,556,555
050,36,069,"New York","Ontario County",5,6,1160,596,564
050,36,069,"New York","Ontario County",5,7,1191,603,588
050,36,069,"New York","Ontario County",5,8,1230,633,597
050,36,069,"New York","Ontario County",5,9,1294,658,636
050,36,069,"New York","Ontario County",5,10,1208,593,615
050,36,069,"New York","Ontario County",5,11,1219,613,606
050,36,069,"New York","Ontario County",5,12,1220,646,574
050,36,069,"New York","Ontario County",5,13,1286,662,624
050,36,069,"New York","Ontario County",5,14,1291,674,617
050,36,069,"New York","Ontario County",5,15,1358,717,641
050,36,069,"New York","Ontario County",5,16,1366,701,665
050,36,069,"New York","Ontario County",5,17,1317,684,633
050,36,069,"New York","Ontario County",5,18,1378,679,699
050,36,069,"New York","Ontario County",5,19,1410,699,711
050,36,069,"New York","Ontario County",5,20,1502,757,745
050,36,069,"New York","Ontario County",5,21,1484,756,728
050,36,069,"New York","Ontario County",5,22,1401,720,681
050,36,069,"New York","Ontario County",5,23,1235,659,576
050,36,069,"New York","Ontario County",5,24,1212,614,598
050,36,069,"New York","Ontario County",5,25,1162,585,577
050,36,069,"New York","Ontario County",5,26,1163,599,564
050,36,069,"New York","Ontario County",5,27,1175,592,583
050,36,069,"New York","Ontario County",5,28,1242,671,571
050,36,069,"New York","Ontario County",5,29,1295,669,626
050,36,069,"New York","Ontario County",5,30,1237,628,609
050,36,069,"New York","Ontario County",5,31,1263,657,606
050,36,069,"New York","Ontario County",5,32,1286,676,610
050,36,069,"New York","Ontario County",5,33,1298,650,648
050,36,069,"New York","Ontario County",5,34,1293,666,627
050,36,069,"New York","Ontario County",5,35,1375,706,669
050,36,069,"New York","Ontario County",5,36,1293,635,658
050,36,069,"New York","Ontario County",5,37,1391,682,709
050,36,069,"New York","Ontario County",5,38,1395,701,694
050,36,069,"New York","Ontario County",5,39,1387,727,660
050,36,069,"New York","Ontario County",5,40,1386,680,706
050,36,069,"New York","Ontario County",5,41,1352,656,696
050,36,069,"New York","Ontario County",5,42,1317,662,655
050,36,069,"New York","Ontario County",5,43,1391,689,702
050,36,069,"New York","Ontario County",5,44,1332,665,667
050,36,069,"New York","Ontario County",5,45,1259,647,612
050,36,069,"New York","Ontario County",5,46,1262,621,641
050,36,069,"New York","Ontario County",5,47,1156,566,590
050,36,069,"New York","Ontario County",5,48,1170,595,575
050,36,069,"New York","Ontario County",5,49,1151,594,557
050,36,069,"New York","Ontario County",5,50,1196,604,592
050,36,069,"New York","Ontario County",5,51,1342,658,684
050,36,069,"New York","Ontario County",5,52,1510,763,747
050,36,069,"New York","Ontario County",5,53,1506,756,750
050,36,069,"New York","Ontario County",5,54,1475,733,742
050,36,069,"New York","Ontario County",5,55,1488,744,744
050,36,069,"New York","Ontario County",5,56,1543,761,782
050,36,069,"New York","Ontario County",5,57,1572,771,801
050,36,069,"New York","Ontario County",5,58,1686,818,868
050,36,069,"New York","Ontario County",5,59,1692,819,873
050,36,069,"New York","Ontario County",5,60,1721,820,901
050,36,069,"New York","Ontario County",5,61,1769,836,933
050,36,069,"New York","Ontario County",5,62,1754,871,883
050,36,069,"New York","Ontario County",5,63,1712,825,887
050,36,069,"New York","Ontario County",5,64,1721,845,876
050,36,069,"New York","Ontario County",5,65,1682,817,865
050,36,069,"New York","Ontario County",5,66,1596,776,820
050,36,069,"New York","Ontario County",5,67,1616,785,831
050,36,069,"New York","Ontario County",5,68,1624,786,838
050,36,069,"New York","Ontario County",5,69,1592,755,837
050,36,069,"New York","Ontario County",5,70,1476,720,756
050,36,069,"New York","Ontario County",5,71,1426,684,742
050,36,069,"New York","Ontario County",5,72,1383,669,714
050,36,069,"New York","Ontario County",5,73,1318,622,696
050,36,069,"New York","Ontario County",5,74,1241,579,662
050,36,069,"New York","Ontario County",5,75,1207,570,637
050,36,069,"New York","Ontario County",5,76,1347,658,689
050,36,069,"New York","Ontario County",5,77,901,432,469
050,36,069,"New York","Ontario County",5,78,867,404,463
050,36,069,"New York","Ontario County",5,79,828,372,456
050,36,069,"New York","Ontario County",5,80,833,385,448
050,36,069,"New York","Ontario County",5,81,676,301,375
050,36,069,"New York","Ontario County",5,82,555,259,296
050,36,069,"New York","Ontario County",5,83,501,215,286
050,36,069,"New York","Ontario County",5,84,424,168,256
050,36,069,"New York","Ontario County",5,85,2742,923,1819
050,36,071,"New York","Orange County",1,0,5203,2656,2547
050,36,071,"New York","Orange County",1,1,5302,2713,2589
050,36,071,"New York","Orange County",1,2,5383,2749,2634
050,36,071,"New York","Orange County",1,3,5414,2807,2607
050,36,071,"New York","Orange County",1,4,5428,2766,2662
050,36,071,"New York","Orange County",1,5,5499,2805,2694
050,36,071,"New York","Orange County",1,6,5365,2753,2612
050,36,071,"New York","Orange County",1,7,5472,2765,2707
050,36,071,"New York","Orange County",1,8,5631,2904,2727
050,36,071,"New York","Orange County",1,9,5667,2890,2777
050,36,071,"New York","Orange County",1,10,5848,3007,2841
050,36,071,"New York","Orange County",1,11,5997,3091,2906
050,36,071,"New York","Orange County",1,12,6149,3132,3017
050,36,071,"New York","Orange County",1,13,6180,3211,2969
050,36,071,"New York","Orange County",1,14,6202,3210,2992
050,36,071,"New York","Orange County",1,15,6148,3204,2944
050,36,071,"New York","Orange County",1,16,6214,3212,3002
050,36,071,"New York","Orange County",1,17,6231,3221,3010
050,36,071,"New York","Orange County",1,18,6560,3044,3516
050,36,071,"New York","Orange County",1,19,6296,3117,3179
050,36,071,"New York","Orange County",1,20,6284,3219,3065
050,36,071,"New York","Orange County",1,21,6190,3247,2943
050,36,071,"New York","Orange County",1,22,5800,3077,2723
050,36,071,"New York","Orange County",1,23,5100,2707,2393
050,36,071,"New York","Orange County",1,24,4945,2548,2397
050,36,071,"New York","Orange County",1,25,4913,2600,2313
050,36,071,"New York","Orange County",1,26,4924,2584,2340
050,36,071,"New York","Orange County",1,27,4800,2504,2296
050,36,071,"New York","Orange County",1,28,4683,2395,2288
050,36,071,"New York","Orange County",1,29,4745,2422,2323
050,36,071,"New York","Orange County",1,30,4724,2369,2355
050,36,071,"New York","Orange County",1,31,4542,2270,2272
050,36,071,"New York","Orange County",1,32,4645,2341,2304
050,36,071,"New York","Orange County",1,33,4728,2453,2275
050,36,071,"New York","Orange County",1,34,4755,2453,2302
050,36,071,"New York","Orange County",1,35,4852,2503,2349
050,36,071,"New York","Orange County",1,36,4906,2483,2423
050,36,071,"New York","Orange County",1,37,4878,2389,2489
050,36,071,"New York","Orange County",1,38,4852,2375,2477
050,36,071,"New York","Orange County",1,39,4962,2497,2465
050,36,071,"New York","Orange County",1,40,4905,2441,2464
050,36,071,"New York","Orange County",1,41,4852,2466,2386
050,36,071,"New York","Orange County",1,42,4801,2390,2411
050,36,071,"New York","Orange County",1,43,4727,2359,2368
050,36,071,"New York","Orange County",1,44,4693,2396,2297
050,36,071,"New York","Orange County",1,45,4680,2320,2360
050,36,071,"New York","Orange County",1,46,4632,2291,2341
050,36,071,"New York","Orange County",1,47,4830,2398,2432
050,36,071,"New York","Orange County",1,48,5259,2647,2612
050,36,071,"New York","Orange County",1,49,5695,2836,2859
050,36,071,"New York","Orange County",1,50,5596,2823,2773
050,36,071,"New York","Orange County",1,51,5410,2734,2676
050,36,071,"New York","Orange County",1,52,5363,2692,2671
050,36,071,"New York","Orange County",1,53,5524,2724,2800
050,36,071,"New York","Orange County",1,54,5579,2738,2841
050,36,071,"New York","Orange County",1,55,5734,2849,2885
050,36,071,"New York","Orange County",1,56,5770,2919,2851
050,36,071,"New York","Orange County",1,57,5619,2797,2822
050,36,071,"New York","Orange County",1,58,5530,2741,2789
050,36,071,"New York","Orange County",1,59,5394,2699,2695
050,36,071,"New York","Orange County",1,60,5119,2540,2579
050,36,071,"New York","Orange County",1,61,4993,2496,2497
050,36,071,"New York","Orange County",1,62,4843,2423,2420
050,36,071,"New York","Orange County",1,63,4584,2309,2275
050,36,071,"New York","Orange County",1,64,4369,2224,2145
050,36,071,"New York","Orange County",1,65,4105,2051,2054
050,36,071,"New York","Orange County",1,66,3911,1940,1971
050,36,071,"New York","Orange County",1,67,3806,1818,1988
050,36,071,"New York","Orange County",1,68,3637,1708,1929
050,36,071,"New York","Orange County",1,69,3405,1568,1837
050,36,071,"New York","Orange County",1,70,3291,1544,1747
050,36,071,"New York","Orange County",1,71,3256,1525,1731
050,36,071,"New York","Orange County",1,72,3212,1537,1675
050,36,071,"New York","Orange County",1,73,3157,1491,1666
050,36,071,"New York","Orange County",1,74,2261,1006,1255
050,36,071,"New York","Orange County",1,75,2250,1021,1229
050,36,071,"New York","Orange County",1,76,2164,1016,1148
050,36,071,"New York","Orange County",1,77,2106,975,1131
050,36,071,"New York","Orange County",1,78,1815,799,1016
050,36,071,"New York","Orange County",1,79,1610,681,929
050,36,071,"New York","Orange County",1,80,1464,644,820
050,36,071,"New York","Orange County",1,81,1344,576,768
050,36,071,"New York","Orange County",1,82,1253,530,723
050,36,071,"New York","Orange County",1,83,1103,442,661
050,36,071,"New York","Orange County",1,84,1037,403,634
050,36,071,"New York","Orange County",1,85,6210,2140,4070
050,36,071,"New York","Orange County",2,0,5257,2700,2557
050,36,071,"New York","Orange County",2,1,5288,2701,2587
050,36,071,"New York","Orange County",2,2,5385,2752,2633
050,36,071,"New York","Orange County",2,3,5403,2786,2617
050,36,071,"New York","Orange County",2,4,5451,2789,2662
050,36,071,"New York","Orange County",2,5,5501,2806,2695
050,36,071,"New York","Orange County",2,6,5422,2780,2642
050,36,071,"New York","Orange County",2,7,5450,2764,2686
050,36,071,"New York","Orange County",2,8,5593,2866,2727
050,36,071,"New York","Orange County",2,9,5660,2891,2769
050,36,071,"New York","Orange County",2,10,5817,2993,2824
050,36,071,"New York","Orange County",2,11,5940,3059,2881
050,36,071,"New York","Orange County",2,12,6155,3147,3008
050,36,071,"New York","Orange County",2,13,6175,3197,2978
050,36,071,"New York","Orange County",2,14,6210,3221,2989
050,36,071,"New York","Orange County",2,15,6186,3217,2969
050,36,071,"New York","Orange County",2,16,6212,3214,2998
050,36,071,"New York","Orange County",2,17,6242,3229,3013
050,36,071,"New York","Orange County",2,18,6589,3076,3513
050,36,071,"New York","Orange County",2,19,6251,3070,3181
050,36,071,"New York","Orange County",2,20,6299,3209,3090
050,36,071,"New York","Orange County",2,21,6131,3197,2934
050,36,071,"New York","Orange County",2,22,5736,3040,2696
050,36,071,"New York","Orange County",2,23,5137,2727,2410
050,36,071,"New York","Orange County",2,24,4928,2550,2378
050,36,071,"New York","Orange County",2,25,4911,2586,2325
050,36,071,"New York","Orange County",2,26,4903,2568,2335
050,36,071,"New York","Orange County",2,27,4813,2513,2300
050,36,071,"New York","Orange County",2,28,4720,2424,2296
050,36,071,"New York","Orange County",2,29,4733,2413,2320
050,36,071,"New York","Orange County",2,30,4779,2404,2375
050,36,071,"New York","Orange County",2,31,4574,2283,2291
050,36,071,"New York","Orange County",2,32,4654,2350,2304
050,36,071,"New York","Orange County",2,33,4699,2415,2284
050,36,071,"New York","Orange County",2,34,4747,2447,2300
050,36,071,"New York","Orange County",2,35,4874,2521,2353
050,36,071,"New York","Orange County",2,36,4868,2471,2397
050,36,071,"New York","Orange County",2,37,4901,2410,2491
050,36,071,"New York","Orange County",2,38,4895,2386,2509
050,36,071,"New York","Orange County",2,39,4932,2465,2467
050,36,071,"New York","Orange County",2,40,4968,2480,2488
050,36,071,"New York","Orange County",2,41,4865,2458,2407
050,36,071,"New York","Orange County",2,42,4802,2407,2395
050,36,071,"New York","Orange County",2,43,4773,2384,2389
050,36,071,"New York","Orange County",2,44,4665,2367,2298
050,36,071,"New York","Orange County",2,45,4691,2339,2352
050,36,071,"New York","Orange County",2,46,4629,2293,2336
050,36,071,"New York","Orange County",2,47,4764,2359,2405
050,36,071,"New York","Orange County",2,48,5145,2579,2566
050,36,071,"New York","Orange County",2,49,5599,2799,2800
050,36,071,"New York","Orange County",2,50,5608,2815,2793
050,36,071,"New York","Orange County",2,51,5430,2745,2685
050,36,071,"New York","Orange County",2,52,5339,2684,2655
050,36,071,"New York","Orange County",2,53,5451,2690,2761
050,36,071,"New York","Orange County",2,54,5542,2722,2820
050,36,071,"New York","Orange County",2,55,5671,2814,2857
050,36,071,"New York","Orange County",2,56,5754,2896,2858
050,36,071,"New York","Orange County",2,57,5623,2811,2812
050,36,071,"New York","Orange County",2,58,5521,2730,2791
050,36,071,"New York","Orange County",2,59,5403,2698,2705
050,36,071,"New York","Orange County",2,60,5126,2547,2579
050,36,071,"New York","Orange County",2,61,4980,2480,2500
050,36,071,"New York","Orange County",2,62,4822,2405,2417
050,36,071,"New York","Orange County",2,63,4649,2332,2317
050,36,071,"New York","Orange County",2,64,4365,2221,2144
050,36,071,"New York","Orange County",2,65,4135,2071,2064
050,36,071,"New York","Orange County",2,66,3918,1942,1976
050,36,071,"New York","Orange County",2,67,3788,1831,1957
050,36,071,"New York","Orange County",2,68,3612,1691,1921
050,36,071,"New York","Orange County",2,69,3444,1590,1854
050,36,071,"New York","Orange County",2,70,3286,1539,1747
050,36,071,"New York","Orange County",2,71,3243,1515,1728
050,36,071,"New York","Orange County",2,72,3139,1490,1649
050,36,071,"New York","Orange County",2,73,3283,1548,1735
050,36,071,"New York","Orange County",2,74,2304,1039,1265
050,36,071,"New York","Orange County",2,75,2228,1005,1223
050,36,071,"New York","Orange County",2,76,2137,996,1141
050,36,071,"New York","Orange County",2,77,2144,995,1149
050,36,071,"New York","Orange County",2,78,1824,812,1012
050,36,071,"New York","Orange County",2,79,1618,686,932
050,36,071,"New York","Orange County",2,80,1472,639,833
050,36,071,"New York","Orange County",2,81,1335,576,759
050,36,071,"New York","Orange County",2,82,1252,531,721
050,36,071,"New York","Orange County",2,83,1107,448,659
050,36,071,"New York","Orange County",2,84,1032,406,626
050,36,071,"New York","Orange County",2,85,6079,2100,3979
050,36,071,"New York","Orange County",3,0,5348,2706,2642
050,36,071,"New York","Orange County",3,1,5358,2736,2622
050,36,071,"New York","Orange County",3,2,5406,2765,2641
050,36,071,"New York","Orange County",3,3,5521,2832,2689
050,36,071,"New York","Orange County",3,4,5524,2839,2685
050,36,071,"New York","Orange County",3,5,5512,2823,2689
050,36,071,"New York","Orange County",3,6,5602,2845,2757
050,36,071,"New York","Orange County",3,7,5529,2821,2708
050,36,071,"New York","Orange County",3,8,5559,2811,2748
050,36,071,"New York","Orange County",3,9,5682,2904,2778
050,36,071,"New York","Orange County",3,10,5742,2923,2819
050,36,071,"New York","Orange County",3,11,5912,3040,2872
050,36,071,"New York","Orange County",3,12,5997,3095,2902
050,36,071,"New York","Orange County",3,13,6216,3193,3023
050,36,071,"New York","Orange County",3,14,6255,3236,3019
050,36,071,"New York","Orange County",3,15,6291,3246,3045
050,36,071,"New York","Orange County",3,16,6241,3240,3001
050,36,071,"New York","Orange County",3,17,6272,3259,3013
050,36,071,"New York","Orange County",3,18,6792,3220,3572
050,36,071,"New York","Orange County",3,19,6338,3121,3217
050,36,071,"New York","Orange County",3,20,6256,3142,3114
050,36,071,"New York","Orange County",3,21,6216,3220,2996
050,36,071,"New York","Orange County",3,22,5812,3103,2709
050,36,071,"New York","Orange County",3,23,5177,2735,2442
050,36,071,"New York","Orange County",3,24,5059,2631,2428
050,36,071,"New York","Orange County",3,25,4938,2578,2360
050,36,071,"New York","Orange County",3,26,4826,2524,2302
050,36,071,"New York","Orange County",3,27,4876,2554,2322
050,36,071,"New York","Orange County",3,28,4825,2499,2326
050,36,071,"New York","Orange County",3,29,4762,2446,2316
050,36,071,"New York","Orange County",3,30,4871,2481,2390
050,36,071,"New York","Orange County",3,31,4835,2396,2439
050,36,071,"New York","Orange County",3,32,4823,2423,2400
050,36,071,"New York","Orange County",3,33,4808,2464,2344
050,36,071,"New York","Orange County",3,34,4851,2467,2384
050,36,071,"New York","Orange County",3,35,4906,2527,2379
050,36,071,"New York","Orange County",3,36,4989,2566,2423
050,36,071,"New York","Orange County",3,37,5000,2533,2467
050,36,071,"New York","Orange County",3,38,5103,2499,2604
050,36,071,"New York","Orange County",3,39,5079,2501,2578
050,36,071,"New York","Orange County",3,40,5055,2539,2516
050,36,071,"New York","Orange County",3,41,5101,2562,2539
050,36,071,"New York","Orange County",3,42,5037,2555,2482
050,36,071,"New York","Orange County",3,43,4882,2457,2425
050,36,071,"New York","Orange County",3,44,4861,2436,2425
050,36,071,"New York","Orange County",3,45,4709,2387,2322
050,36,071,"New York","Orange County",3,46,4785,2397,2388
050,36,071,"New York","Orange County",3,47,4634,2291,2343
050,36,071,"New York","Orange County",3,48,4822,2358,2464
050,36,071,"New York","Orange County",3,49,5195,2632,2563
050,36,071,"New York","Orange County",3,50,5577,2790,2787
050,36,071,"New York","Orange County",3,51,5626,2850,2776
050,36,071,"New York","Orange County",3,52,5377,2737,2640
050,36,071,"New York","Orange County",3,53,5224,2599,2625
050,36,071,"New York","Orange County",3,54,5433,2707,2726
050,36,071,"New York","Orange County",3,55,5489,2727,2762
050,36,071,"New York","Orange County",3,56,5634,2796,2838
050,36,071,"New York","Orange County",3,57,5614,2834,2780
050,36,071,"New York","Orange County",3,58,5497,2723,2774
050,36,071,"New York","Orange County",3,59,5424,2703,2721
050,36,071,"New York","Orange County",3,60,5199,2563,2636
050,36,071,"New York","Orange County",3,61,4980,2456,2524
050,36,071,"New York","Orange County",3,62,4837,2393,2444
050,36,071,"New York","Orange County",3,63,4665,2303,2362
050,36,071,"New York","Orange County",3,64,4526,2297,2229
050,36,071,"New York","Orange County",3,65,4247,2122,2125
050,36,071,"New York","Orange County",3,66,3997,1995,2002
050,36,071,"New York","Orange County",3,67,3839,1911,1928
050,36,071,"New York","Orange County",3,68,3716,1784,1932
050,36,071,"New York","Orange County",3,69,3495,1613,1882
050,36,071,"New York","Orange County",3,70,3333,1535,1798
050,36,071,"New York","Orange County",3,71,3243,1502,1741
050,36,071,"New York","Orange County",3,72,3152,1471,1681
050,36,071,"New York","Orange County",3,73,3051,1457,1594
050,36,071,"New York","Orange County",3,74,3127,1448,1679
050,36,071,"New York","Orange County",3,75,2250,1000,1250
050,36,071,"New York","Orange County",3,76,2147,950,1197
050,36,071,"New York","Orange County",3,77,2051,960,1091
050,36,071,"New York","Orange County",3,78,2053,937,1116
050,36,071,"New York","Orange County",3,79,1732,753,979
050,36,071,"New York","Orange County",3,80,1545,647,898
050,36,071,"New York","Orange County",3,81,1398,593,805
050,36,071,"New York","Orange County",3,82,1272,543,729
050,36,071,"New York","Orange County",3,83,1151,489,662
050,36,071,"New York","Orange County",3,84,1037,407,630
050,36,071,"New York","Orange County",3,85,6039,2088,3951
050,36,071,"New York","Orange County",4,0,5619,2854,2765
050,36,071,"New York","Orange County",4,1,5353,2743,2610
050,36,071,"New York","Orange County",4,2,5448,2802,2646
050,36,071,"New York","Orange County",4,3,5465,2814,2651
050,36,071,"New York","Orange County",4,4,5575,2864,2711
050,36,071,"New York","Orange County",4,5,5616,2916,2700
050,36,071,"New York","Orange County",4,6,5641,2862,2779
050,36,071,"New York","Orange County",4,7,5640,2863,2777
050,36,071,"New York","Orange County",4,8,5601,2872,2729
050,36,071,"New York","Orange County",4,9,5581,2824,2757
050,36,071,"New York","Orange County",4,10,5794,2969,2825
050,36,071,"New York","Orange County",4,11,5787,2918,2869
050,36,071,"New York","Orange County",4,12,6006,3083,2923
050,36,071,"New York","Orange County",4,13,6042,3122,2920
050,36,071,"New York","Orange County",4,14,6315,3249,3066
050,36,071,"New York","Orange County",4,15,6325,3277,3048
050,36,071,"New York","Orange County",4,16,6372,3279,3093
050,36,071,"New York","Orange County",4,17,6275,3271,3004
050,36,071,"New York","Orange County",4,18,6652,3145,3507
050,36,071,"New York","Orange County",4,19,6251,3119,3132
050,36,071,"New York","Orange County",4,20,6204,3118,3086
050,36,071,"New York","Orange County",4,21,6087,3106,2981
050,36,071,"New York","Orange County",4,22,5876,3138,2738
050,36,071,"New York","Orange County",4,23,5258,2827,2431
050,36,071,"New York","Orange County",4,24,4958,2509,2449
050,36,071,"New York","Orange County",4,25,4825,2502,2323
050,36,071,"New York","Orange County",4,26,4780,2453,2327
050,36,071,"New York","Orange County",4,27,4697,2452,2245
050,36,071,"New York","Orange County",4,28,4811,2521,2290
050,36,071,"New York","Orange County",4,29,4760,2466,2294
050,36,071,"New York","Orange County",4,30,4896,2505,2391
050,36,071,"New York","Orange County",4,31,4825,2415,2410
050,36,071,"New York","Orange County",4,32,5016,2540,2476
050,36,071,"New York","Orange County",4,33,4900,2432,2468
050,36,071,"New York","Orange County",4,34,4923,2502,2421
050,36,071,"New York","Orange County",4,35,4971,2562,2409
050,36,071,"New York","Orange County",4,36,4996,2542,2454
050,36,071,"New York","Orange County",4,37,5072,2588,2484
050,36,071,"New York","Orange County",4,38,5093,2570,2523
050,36,071,"New York","Orange County",4,39,5204,2560,2644
050,36,071,"New York","Orange County",4,40,5167,2524,2643
050,36,071,"New York","Orange County",4,41,5095,2592,2503
050,36,071,"New York","Orange County",4,42,5203,2624,2579
050,36,071,"New York","Orange County",4,43,5126,2610,2516
050,36,071,"New York","Orange County",4,44,4953,2475,2478
050,36,071,"New York","Orange County",4,45,4913,2463,2450
050,36,071,"New York","Orange County",4,46,4745,2430,2315
050,36,071,"New York","Orange County",4,47,4824,2395,2429
050,36,071,"New York","Orange County",4,48,4670,2287,2383
050,36,071,"New York","Orange County",4,49,4832,2372,2460
050,36,071,"New York","Orange County",4,50,5122,2594,2528
050,36,071,"New York","Orange County",4,51,5602,2871,2731
050,36,071,"New York","Orange County",4,52,5503,2788,2715
050,36,071,"New York","Orange County",4,53,5234,2613,2621
050,36,071,"New York","Orange County",4,54,5226,2602,2624
050,36,071,"New York","Orange County",4,55,5320,2648,2672
050,36,071,"New York","Orange County",4,56,5373,2668,2705
050,36,071,"New York","Orange County",4,57,5505,2725,2780
050,36,071,"New York","Orange County",4,58,5479,2739,2740
050,36,071,"New York","Orange County",4,59,5348,2676,2672
050,36,071,"New York","Orange County",4,60,5182,2580,2602
050,36,071,"New York","Orange County",4,61,5037,2491,2546
050,36,071,"New York","Orange County",4,62,4812,2364,2448
050,36,071,"New York","Orange County",4,63,4674,2290,2384
050,36,071,"New York","Orange County",4,64,4516,2231,2285
050,36,071,"New York","Orange County",4,65,4449,2238,2211
050,36,071,"New York","Orange County",4,66,4076,2015,2061
050,36,071,"New York","Orange County",4,67,3914,1958,1956
050,36,071,"New York","Orange County",4,68,3753,1850,1903
050,36,071,"New York","Orange County",4,69,3563,1695,1868
050,36,071,"New York","Orange County",4,70,3401,1550,1851
050,36,071,"New York","Orange County",4,71,3254,1490,1764
050,36,071,"New York","Orange County",4,72,3134,1449,1685
050,36,071,"New York","Orange County",4,73,3073,1433,1640
050,36,071,"New York","Orange County",4,74,2919,1375,1544
050,36,071,"New York","Orange County",4,75,3004,1384,1620
050,36,071,"New York","Orange County",4,76,2159,935,1224
050,36,071,"New York","Orange County",4,77,2077,927,1150
050,36,071,"New York","Orange County",4,78,1975,911,1064
050,36,071,"New York","Orange County",4,79,1964,894,1070
050,36,071,"New York","Orange County",4,80,1656,719,937
050,36,071,"New York","Orange County",4,81,1466,604,862
050,36,071,"New York","Orange County",4,82,1326,558,768
050,36,071,"New York","Orange County",4,83,1172,498,674
050,36,071,"New York","Orange County",4,84,1109,460,649
050,36,071,"New York","Orange County",4,85,6076,2138,3938
050,36,071,"New York","Orange County",5,0,5583,2840,2743
050,36,071,"New York","Orange County",5,1,5700,2883,2817
050,36,071,"New York","Orange County",5,2,5456,2759,2697
050,36,071,"New York","Orange County",5,3,5425,2792,2633
050,36,071,"New York","Orange County",5,4,5491,2813,2678
050,36,071,"New York","Orange County",5,5,5599,2875,2724
050,36,071,"New York","Orange County",5,6,5683,2917,2766
050,36,071,"New York","Orange County",5,7,5627,2875,2752
050,36,071,"New York","Orange County",5,8,5643,2875,2768
050,36,071,"New York","Orange County",5,9,5634,2914,2720
050,36,071,"New York","Orange County",5,10,5625,2835,2790
050,36,071,"New York","Orange County",5,11,5798,2920,2878
050,36,071,"New York","Orange County",5,12,5819,2949,2870
050,36,071,"New York","Orange County",5,13,6023,3096,2927
050,36,071,"New York","Orange County",5,14,6051,3139,2912
050,36,071,"New York","Orange County",5,15,6368,3287,3081
050,36,071,"New York","Orange County",5,16,6321,3236,3085
050,36,071,"New York","Orange County",5,17,6362,3273,3089
050,36,071,"New York","Orange County",5,18,6601,3145,3456
050,36,071,"New York","Orange County",5,19,6200,3079,3121
050,36,071,"New York","Orange County",5,20,6243,3200,3043
050,36,071,"New York","Orange County",5,21,6108,3120,2988
050,36,071,"New York","Orange County",5,22,5799,3024,2775
050,36,071,"New York","Orange County",5,23,5333,2856,2477
050,36,071,"New York","Orange County",5,24,5123,2692,2431
050,36,071,"New York","Orange County",5,25,4820,2424,2396
050,36,071,"New York","Orange County",5,26,4718,2413,2305
050,36,071,"New York","Orange County",5,27,4708,2387,2321
050,36,071,"New York","Orange County",5,28,4625,2387,2238
050,36,071,"New York","Orange County",5,29,4798,2511,2287
050,36,071,"New York","Orange County",5,30,4838,2506,2332
050,36,071,"New York","Orange County",5,31,4833,2429,2404
050,36,071,"New York","Orange County",5,32,4991,2548,2443
050,36,071,"New York","Orange County",5,33,5130,2588,2542
050,36,071,"New York","Orange County",5,34,5009,2508,2501
050,36,071,"New York","Orange County",5,35,4982,2543,2439
050,36,071,"New York","Orange County",5,36,4991,2529,2462
050,36,071,"New York","Orange County",5,37,5053,2578,2475
050,36,071,"New York","Orange County",5,38,5130,2576,2554
050,36,071,"New York","Orange County",5,39,5121,2596,2525
050,36,071,"New York","Orange County",5,40,5257,2599,2658
050,36,071,"New York","Orange County",5,41,5232,2583,2649
050,36,071,"New York","Orange County",5,42,5137,2601,2536
050,36,071,"New York","Orange County",5,43,5164,2604,2560
050,36,071,"New York","Orange County",5,44,5105,2599,2506
050,36,071,"New York","Orange County",5,45,4965,2465,2500
050,36,071,"New York","Orange County",5,46,4939,2492,2447
050,36,071,"New York","Orange County",5,47,4751,2425,2326
050,36,071,"New York","Orange County",5,48,4826,2370,2456
050,36,071,"New York","Orange County",5,49,4658,2282,2376
050,36,071,"New York","Orange County",5,50,4749,2310,2439
050,36,071,"New York","Orange County",5,51,5169,2653,2516
050,36,071,"New York","Orange County",5,52,5557,2842,2715
050,36,071,"New York","Orange County",5,53,5420,2715,2705
050,36,071,"New York","Orange County",5,54,5176,2601,2575
050,36,071,"New York","Orange County",5,55,5163,2584,2579
050,36,071,"New York","Orange County",5,56,5246,2607,2639
050,36,071,"New York","Orange County",5,57,5265,2616,2649
050,36,071,"New York","Orange County",5,58,5412,2657,2755
050,36,071,"New York","Orange County",5,59,5370,2713,2657
050,36,071,"New York","Orange County",5,60,5158,2579,2579
050,36,071,"New York","Orange County",5,61,5044,2499,2545
050,36,071,"New York","Orange County",5,62,4894,2408,2486
050,36,071,"New York","Orange County",5,63,4704,2295,2409
050,36,071,"New York","Orange County",5,64,4543,2235,2308
050,36,071,"New York","Orange County",5,65,4390,2135,2255
050,36,071,"New York","Orange County",5,66,4274,2138,2136
050,36,071,"New York","Orange County",5,67,4001,1993,2008
050,36,071,"New York","Orange County",5,68,3822,1909,1913
050,36,071,"New York","Orange County",5,69,3647,1782,1865
050,36,071,"New York","Orange County",5,70,3496,1653,1843
050,36,071,"New York","Orange County",5,71,3316,1495,1821
050,36,071,"New York","Orange County",5,72,3140,1432,1708
050,36,071,"New York","Orange County",5,73,3036,1400,1636
050,36,071,"New York","Orange County",5,74,2931,1349,1582
050,36,071,"New York","Orange County",5,75,2840,1326,1514
050,36,071,"New York","Orange County",5,76,2889,1316,1573
050,36,071,"New York","Orange County",5,77,2088,907,1181
050,36,071,"New York","Orange County",5,78,2001,875,1126
050,36,071,"New York","Orange County",5,79,1888,857,1031
050,36,071,"New York","Orange County",5,80,1890,853,1037
050,36,071,"New York","Orange County",5,81,1573,676,897
050,36,071,"New York","Orange County",5,82,1403,578,825
050,36,071,"New York","Orange County",5,83,1223,507,716
050,36,071,"New York","Orange County",5,84,1118,466,652
050,36,071,"New York","Orange County",5,85,6238,2251,3987
050,36,073,"New York","Orleans County",1,0,335,170,165
050,36,073,"New York","Orleans County",1,1,355,178,177
050,36,073,"New York","Orleans County",1,2,396,208,188
050,36,073,"New York","Orleans County",1,3,406,214,192
050,36,073,"New York","Orleans County",1,4,435,228,207
050,36,073,"New York","Orleans County",1,5,447,230,217
050,36,073,"New York","Orleans County",1,6,425,221,204
050,36,073,"New York","Orleans County",1,7,399,212,187
050,36,073,"New York","Orleans County",1,8,390,188,202
050,36,073,"New York","Orleans County",1,9,449,226,223
050,36,073,"New York","Orleans County",1,10,428,215,213
050,36,073,"New York","Orleans County",1,11,446,237,209
050,36,073,"New York","Orleans County",1,12,457,236,221
050,36,073,"New York","Orleans County",1,13,457,223,234
050,36,073,"New York","Orleans County",1,14,460,230,230
050,36,073,"New York","Orleans County",1,15,472,235,237
050,36,073,"New York","Orleans County",1,16,501,243,258
050,36,073,"New York","Orleans County",1,17,545,271,274
050,36,073,"New York","Orleans County",1,18,533,287,246
050,36,073,"New York","Orleans County",1,19,446,238,208
050,36,073,"New York","Orleans County",1,20,477,242,235
050,36,073,"New York","Orleans County",1,21,482,266,216
050,36,073,"New York","Orleans County",1,22,468,238,230
050,36,073,"New York","Orleans County",1,23,491,257,234
050,36,073,"New York","Orleans County",1,24,521,280,241
050,36,073,"New York","Orleans County",1,25,497,271,226
050,36,073,"New York","Orleans County",1,26,525,292,233
050,36,073,"New York","Orleans County",1,27,534,290,244
050,36,073,"New York","Orleans County",1,28,517,271,246
050,36,073,"New York","Orleans County",1,29,538,300,238
050,36,073,"New York","Orleans County",1,30,551,296,255
050,36,073,"New York","Orleans County",1,31,507,265,242
050,36,073,"New York","Orleans County",1,32,460,246,214
050,36,073,"New York","Orleans County",1,33,466,231,235
050,36,073,"New York","Orleans County",1,34,492,256,236
050,36,073,"New York","Orleans County",1,35,482,256,226
050,36,073,"New York","Orleans County",1,36,461,230,231
050,36,073,"New York","Orleans County",1,37,488,251,237
050,36,073,"New York","Orleans County",1,38,503,256,247
050,36,073,"New York","Orleans County",1,39,497,250,247
050,36,073,"New York","Orleans County",1,40,435,216,219
050,36,073,"New York","Orleans County",1,41,444,216,228
050,36,073,"New York","Orleans County",1,42,448,222,226
050,36,073,"New York","Orleans County",1,43,436,210,226
050,36,073,"New York","Orleans County",1,44,422,203,219
050,36,073,"New York","Orleans County",1,45,433,218,215
050,36,073,"New York","Orleans County",1,46,451,207,244
050,36,073,"New York","Orleans County",1,47,468,229,239
050,36,073,"New York","Orleans County",1,48,513,260,253
050,36,073,"New York","Orleans County",1,49,563,275,288
050,36,073,"New York","Orleans County",1,50,598,298,300
050,36,073,"New York","Orleans County",1,51,575,298,277
050,36,073,"New York","Orleans County",1,52,551,276,275
050,36,073,"New York","Orleans County",1,53,606,299,307
050,36,073,"New York","Orleans County",1,54,580,300,280
050,36,073,"New York","Orleans County",1,55,646,318,328
050,36,073,"New York","Orleans County",1,56,685,340,345
050,36,073,"New York","Orleans County",1,57,673,343,330
050,36,073,"New York","Orleans County",1,58,710,377,333
050,36,073,"New York","Orleans County",1,59,662,333,329
050,36,073,"New York","Orleans County",1,60,667,339,328
050,36,073,"New York","Orleans County",1,61,652,318,334
050,36,073,"New York","Orleans County",1,62,653,328,325
050,36,073,"New York","Orleans County",1,63,636,303,333
050,36,073,"New York","Orleans County",1,64,615,310,305
050,36,073,"New York","Orleans County",1,65,593,310,283
050,36,073,"New York","Orleans County",1,66,535,275,260
050,36,073,"New York","Orleans County",1,67,496,250,246
050,36,073,"New York","Orleans County",1,68,503,265,238
050,36,073,"New York","Orleans County",1,69,457,222,235
050,36,073,"New York","Orleans County",1,70,435,204,231
050,36,073,"New York","Orleans County",1,71,456,229,227
050,36,073,"New York","Orleans County",1,72,426,213,213
050,36,073,"New York","Orleans County",1,73,428,207,221
050,36,073,"New York","Orleans County",1,74,287,140,147
050,36,073,"New York","Orleans County",1,75,285,135,150
050,36,073,"New York","Orleans County",1,76,275,121,154
050,36,073,"New York","Orleans County",1,77,298,141,157
050,36,073,"New York","Orleans County",1,78,223,98,125
050,36,073,"New York","Orleans County",1,79,198,95,103
050,36,073,"New York","Orleans County",1,80,190,88,102
050,36,073,"New York","Orleans County",1,81,175,76,99
050,36,073,"New York","Orleans County",1,82,164,74,90
050,36,073,"New York","Orleans County",1,83,147,65,82
050,36,073,"New York","Orleans County",1,84,135,61,74
050,36,073,"New York","Orleans County",1,85,790,284,506
050,36,073,"New York","Orleans County",2,0,350,179,171
050,36,073,"New York","Orleans County",2,1,352,176,176
050,36,073,"New York","Orleans County",2,2,388,201,187
050,36,073,"New York","Orleans County",2,3,403,212,191
050,36,073,"New York","Orleans County",2,4,429,226,203
050,36,073,"New York","Orleans County",2,5,439,226,213
050,36,073,"New York","Orleans County",2,6,429,222,207
050,36,073,"New York","Orleans County",2,7,405,214,191
050,36,073,"New York","Orleans County",2,8,389,193,196
050,36,073,"New York","Orleans County",2,9,430,216,214
050,36,073,"New York","Orleans County",2,10,431,216,215
050,36,073,"New York","Orleans County",2,11,440,233,207
050,36,073,"New York","Orleans County",2,12,455,235,220
050,36,073,"New York","Orleans County",2,13,456,226,230
050,36,073,"New York","Orleans County",2,14,459,228,231
050,36,073,"New York","Orleans County",2,15,467,232,235
050,36,073,"New York","Orleans County",2,16,492,239,253
050,36,073,"New York","Orleans County",2,17,542,269,273
050,36,073,"New York","Orleans County",2,18,526,282,244
050,36,073,"New York","Orleans County",2,19,447,236,211
050,36,073,"New York","Orleans County",2,20,470,239,231
050,36,073,"New York","Orleans County",2,21,481,261,220
050,36,073,"New York","Orleans County",2,22,469,242,227
050,36,073,"New York","Orleans County",2,23,491,256,235
050,36,073,"New York","Orleans County",2,24,510,274,236
050,36,073,"New York","Orleans County",2,25,497,271,226
050,36,073,"New York","Orleans County",2,26,513,286,227
050,36,073,"New York","Orleans County",2,27,526,286,240
050,36,073,"New York","Orleans County",2,28,521,277,244
050,36,073,"New York","Orleans County",2,29,524,288,236
050,36,073,"New York","Orleans County",2,30,547,295,252
050,36,073,"New York","Orleans County",2,31,513,270,243
050,36,073,"New York","Orleans County",2,32,460,243,217
050,36,073,"New York","Orleans County",2,33,463,233,230
050,36,073,"New York","Orleans County",2,34,483,249,234
050,36,073,"New York","Orleans County",2,35,487,256,231
050,36,073,"New York","Orleans County",2,36,458,231,227
050,36,073,"New York","Orleans County",2,37,481,246,235
050,36,073,"New York","Orleans County",2,38,500,253,247
050,36,073,"New York","Orleans County",2,39,492,250,242
050,36,073,"New York","Orleans County",2,40,445,223,222
050,36,073,"New York","Orleans County",2,41,439,214,225
050,36,073,"New York","Orleans County",2,42,439,217,222
050,36,073,"New York","Orleans County",2,43,439,213,226
050,36,073,"New York","Orleans County",2,44,417,202,215
050,36,073,"New York","Orleans County",2,45,425,212,213
050,36,073,"New York","Orleans County",2,46,445,209,236
050,36,073,"New York","Orleans County",2,47,462,224,238
050,36,073,"New York","Orleans County",2,48,497,252,245
050,36,073,"New York","Orleans County",2,49,549,270,279
050,36,073,"New York","Orleans County",2,50,592,296,296
050,36,073,"New York","Orleans County",2,51,571,292,279
050,36,073,"New York","Orleans County",2,52,556,281,275
050,36,073,"New York","Orleans County",2,53,592,292,300
050,36,073,"New York","Orleans County",2,54,580,297,283
050,36,073,"New York","Orleans County",2,55,630,311,319
050,36,073,"New York","Orleans County",2,56,677,335,342
050,36,073,"New York","Orleans County",2,57,675,342,333
050,36,073,"New York","Orleans County",2,58,700,367,333
050,36,073,"New York","Orleans County",2,59,672,343,329
050,36,073,"New York","Orleans County",2,60,664,337,327
050,36,073,"New York","Orleans County",2,61,654,322,332
050,36,073,"New York","Orleans County",2,62,649,324,325
050,36,073,"New York","Orleans County",2,63,642,310,332
050,36,073,"New York","Orleans County",2,64,617,306,311
050,36,073,"New York","Orleans County",2,65,598,309,289
050,36,073,"New York","Orleans County",2,66,549,283,266
050,36,073,"New York","Orleans County",2,67,504,256,248
050,36,073,"New York","Orleans County",2,68,496,258,238
050,36,073,"New York","Orleans County",2,69,471,234,237
050,36,073,"New York","Orleans County",2,70,435,204,231
050,36,073,"New York","Orleans County",2,71,451,222,229
050,36,073,"New York","Orleans County",2,72,421,210,211
050,36,073,"New York","Orleans County",2,73,444,216,228
050,36,073,"New York","Orleans County",2,74,295,147,148
050,36,073,"New York","Orleans County",2,75,283,136,147
050,36,073,"New York","Orleans County",2,76,270,122,148
050,36,073,"New York","Orleans County",2,77,292,134,158
050,36,073,"New York","Orleans County",2,78,229,103,126
050,36,073,"New York","Orleans County",2,79,197,96,101
050,36,073,"New York","Orleans County",2,80,182,86,96
050,36,073,"New York","Orleans County",2,81,171,76,95
050,36,073,"New York","Orleans County",2,82,164,75,89
050,36,073,"New York","Orleans County",2,83,144,64,80
050,36,073,"New York","Orleans County",2,84,133,61,72
050,36,073,"New York","Orleans County",2,85,763,280,483
050,36,073,"New York","Orleans County",3,0,378,205,173
050,36,073,"New York","Orleans County",3,1,363,188,175
050,36,073,"New York","Orleans County",3,2,355,178,177
050,36,073,"New York","Orleans County",3,3,389,201,188
050,36,073,"New York","Orleans County",3,4,414,218,196
050,36,073,"New York","Orleans County",3,5,436,235,201
050,36,073,"New York","Orleans County",3,6,442,224,218
050,36,073,"New York","Orleans County",3,7,428,224,204
050,36,073,"New York","Orleans County",3,8,407,223,184
050,36,073,"New York","Orleans County",3,9,386,194,192
050,36,073,"New York","Orleans County",3,10,429,213,216
050,36,073,"New York","Orleans County",3,11,427,213,214
050,36,073,"New York","Orleans County",3,12,437,232,205
050,36,073,"New York","Orleans County",3,13,455,232,223
050,36,073,"New York","Orleans County",3,14,454,229,225
050,36,073,"New York","Orleans County",3,15,451,229,222
050,36,073,"New York","Orleans County",3,16,475,239,236
050,36,073,"New York","Orleans County",3,17,519,253,266
050,36,073,"New York","Orleans County",3,18,524,281,243
050,36,073,"New York","Orleans County",3,19,422,219,203
050,36,073,"New York","Orleans County",3,20,432,224,208
050,36,073,"New York","Orleans County",3,21,489,253,236
050,36,073,"New York","Orleans County",3,22,466,248,218
050,36,073,"New York","Orleans County",3,23,460,249,211
050,36,073,"New York","Orleans County",3,24,484,256,228
050,36,073,"New York","Orleans County",3,25,476,254,222
050,36,073,"New York","Orleans County",3,26,471,253,218
050,36,073,"New York","Orleans County",3,27,526,282,244
050,36,073,"New York","Orleans County",3,28,523,296,227
050,36,073,"New York","Orleans County",3,29,500,255,245
050,36,073,"New York","Orleans County",3,30,528,286,242
050,36,073,"New York","Orleans County",3,31,534,291,243
050,36,073,"New York","Orleans County",3,32,491,257,234
050,36,073,"New York","Orleans County",3,33,456,236,220
050,36,073,"New York","Orleans County",3,34,455,232,223
050,36,073,"New York","Orleans County",3,35,466,245,221
050,36,073,"New York","Orleans County",3,36,463,242,221
050,36,073,"New York","Orleans County",3,37,454,232,222
050,36,073,"New York","Orleans County",3,38,483,240,243
050,36,073,"New York","Orleans County",3,39,503,266,237
050,36,073,"New York","Orleans County",3,40,467,240,227
050,36,073,"New York","Orleans County",3,41,444,217,227
050,36,073,"New York","Orleans County",3,42,438,222,216
050,36,073,"New York","Orleans County",3,43,431,216,215
050,36,073,"New York","Orleans County",3,44,416,201,215
050,36,073,"New York","Orleans County",3,45,391,192,199
050,36,073,"New York","Orleans County",3,46,417,201,216
050,36,073,"New York","Orleans County",3,47,432,199,233
050,36,073,"New York","Orleans County",3,48,447,223,224
050,36,073,"New York","Orleans County",3,49,470,228,242
050,36,073,"New York","Orleans County",3,50,543,270,273
050,36,073,"New York","Orleans County",3,51,568,284,284
050,36,073,"New York","Orleans County",3,52,562,290,272
050,36,073,"New York","Orleans County",3,53,555,280,275
050,36,073,"New York","Orleans County",3,54,569,285,284
050,36,073,"New York","Orleans County",3,55,556,277,279
050,36,073,"New York","Orleans County",3,56,625,311,314
050,36,073,"New York","Orleans County",3,57,665,333,332
050,36,073,"New York","Orleans County",3,58,662,337,325
050,36,073,"New York","Orleans County",3,59,681,357,324
050,36,073,"New York","Orleans County",3,60,656,334,322
050,36,073,"New York","Orleans County",3,61,652,329,323
050,36,073,"New York","Orleans County",3,62,639,315,324
050,36,073,"New York","Orleans County",3,63,642,316,326
050,36,073,"New York","Orleans County",3,64,632,296,336
050,36,073,"New York","Orleans County",3,65,614,299,315
050,36,073,"New York","Orleans County",3,66,581,303,278
050,36,073,"New York","Orleans County",3,67,550,286,264
050,36,073,"New York","Orleans County",3,68,489,250,239
050,36,073,"New York","Orleans County",3,69,475,241,234
050,36,073,"New York","Orleans County",3,70,461,228,233
050,36,073,"New York","Orleans County",3,71,422,197,225
050,36,073,"New York","Orleans County",3,72,438,216,222
050,36,073,"New York","Orleans County",3,73,407,199,208
050,36,073,"New York","Orleans County",3,74,420,199,221
050,36,073,"New York","Orleans County",3,75,285,142,143
050,36,073,"New York","Orleans County",3,76,266,123,143
050,36,073,"New York","Orleans County",3,77,258,114,144
050,36,073,"New York","Orleans County",3,78,272,124,148
050,36,073,"New York","Orleans County",3,79,217,98,119
050,36,073,"New York","Orleans County",3,80,185,88,97
050,36,073,"New York","Orleans County",3,81,160,72,88
050,36,073,"New York","Orleans County",3,82,157,68,89
050,36,073,"New York","Orleans County",3,83,150,68,82
050,36,073,"New York","Orleans County",3,84,130,58,72
050,36,073,"New York","Orleans County",3,85,767,282,485
050,36,073,"New York","Orleans County",4,0,386,197,189
050,36,073,"New York","Orleans County",4,1,367,192,175
050,36,073,"New York","Orleans County",4,2,371,190,181
050,36,073,"New York","Orleans County",4,3,358,171,187
050,36,073,"New York","Orleans County",4,4,393,206,187
050,36,073,"New York","Orleans County",4,5,410,216,194
050,36,073,"New York","Orleans County",4,6,422,228,194
050,36,073,"New York","Orleans County",4,7,443,223,220
050,36,073,"New York","Orleans County",4,8,426,225,201
050,36,073,"New York","Orleans County",4,9,399,215,184
050,36,073,"New York","Orleans County",4,10,380,183,197
050,36,073,"New York","Orleans County",4,11,430,216,214
050,36,073,"New York","Orleans County",4,12,422,208,214
050,36,073,"New York","Orleans County",4,13,419,227,192
050,36,073,"New York","Orleans County",4,14,453,234,219
050,36,073,"New York","Orleans County",4,15,439,214,225
050,36,073,"New York","Orleans County",4,16,462,234,228
050,36,073,"New York","Orleans County",4,17,511,256,255
050,36,073,"New York","Orleans County",4,18,485,256,229
050,36,073,"New York","Orleans County",4,19,413,211,202
050,36,073,"New York","Orleans County",4,20,398,203,195
050,36,073,"New York","Orleans County",4,21,453,238,215
050,36,073,"New York","Orleans County",4,22,485,241,244
050,36,073,"New York","Orleans County",4,23,474,252,222
050,36,073,"New York","Orleans County",4,24,454,247,207
050,36,073,"New York","Orleans County",4,25,464,261,203
050,36,073,"New York","Orleans County",4,26,435,233,202
050,36,073,"New York","Orleans County",4,27,477,251,226
050,36,073,"New York","Orleans County",4,28,512,281,231
050,36,073,"New York","Orleans County",4,29,504,279,225
050,36,073,"New York","Orleans County",4,30,518,269,249
050,36,073,"New York","Orleans County",4,31,519,288,231
050,36,073,"New York","Orleans County",4,32,505,269,236
050,36,073,"New York","Orleans County",4,33,508,268,240
050,36,073,"New York","Orleans County",4,34,452,237,215
050,36,073,"New York","Orleans County",4,35,461,234,227
050,36,073,"New York","Orleans County",4,36,455,241,214
050,36,073,"New York","Orleans County",4,37,476,251,225
050,36,073,"New York","Orleans County",4,38,453,235,218
050,36,073,"New York","Orleans County",4,39,501,259,242
050,36,073,"New York","Orleans County",4,40,480,255,225
050,36,073,"New York","Orleans County",4,41,479,242,237
050,36,073,"New York","Orleans County",4,42,453,223,230
050,36,073,"New York","Orleans County",4,43,441,228,213
050,36,073,"New York","Orleans County",4,44,432,212,220
050,36,073,"New York","Orleans County",4,45,417,208,209
050,36,073,"New York","Orleans County",4,46,389,194,195
050,36,073,"New York","Orleans County",4,47,415,201,214
050,36,073,"New York","Orleans County",4,48,426,203,223
050,36,073,"New York","Orleans County",4,49,419,203,216
050,36,073,"New York","Orleans County",4,50,467,235,232
050,36,073,"New York","Orleans County",4,51,540,266,274
050,36,073,"New York","Orleans County",4,52,582,293,289
050,36,073,"New York","Orleans County",4,53,565,289,276
050,36,073,"New York","Orleans County",4,54,557,285,272
050,36,073,"New York","Orleans County",4,55,559,275,284
050,36,073,"New York","Orleans County",4,56,558,284,274
050,36,073,"New York","Orleans County",4,57,619,310,309
050,36,073,"New York","Orleans County",4,58,665,329,336
050,36,073,"New York","Orleans County",4,59,649,334,315
050,36,073,"New York","Orleans County",4,60,678,348,330
050,36,073,"New York","Orleans County",4,61,650,323,327
050,36,073,"New York","Orleans County",4,62,642,336,306
050,36,073,"New York","Orleans County",4,63,629,308,321
050,36,073,"New York","Orleans County",4,64,638,310,328
050,36,073,"New York","Orleans County",4,65,624,294,330
050,36,073,"New York","Orleans County",4,66,581,286,295
050,36,073,"New York","Orleans County",4,67,573,298,275
050,36,073,"New York","Orleans County",4,68,540,278,262
050,36,073,"New York","Orleans County",4,69,477,240,237
050,36,073,"New York","Orleans County",4,70,469,237,232
050,36,073,"New York","Orleans County",4,71,452,227,225
050,36,073,"New York","Orleans County",4,72,399,190,209
050,36,073,"New York","Orleans County",4,73,427,207,220
050,36,073,"New York","Orleans County",4,74,392,190,202
050,36,073,"New York","Orleans County",4,75,405,190,215
050,36,073,"New York","Orleans County",4,76,269,131,138
050,36,073,"New York","Orleans County",4,77,246,116,130
050,36,073,"New York","Orleans County",4,78,246,113,133
050,36,073,"New York","Orleans County",4,79,255,123,132
050,36,073,"New York","Orleans County",4,80,207,91,116
050,36,073,"New York","Orleans County",4,81,171,83,88
050,36,073,"New York","Orleans County",4,82,137,62,75
050,36,073,"New York","Orleans County",4,83,136,61,75
050,36,073,"New York","Orleans County",4,84,137,57,80
050,36,073,"New York","Orleans County",4,85,778,289,489
050,36,073,"New York","Orleans County",5,0,385,197,188
050,36,073,"New York","Orleans County",5,1,379,191,188
050,36,073,"New York","Orleans County",5,2,372,196,176
050,36,073,"New York","Orleans County",5,3,373,190,183
050,36,073,"New York","Orleans County",5,4,360,177,183
050,36,073,"New York","Orleans County",5,5,391,203,188
050,36,073,"New York","Orleans County",5,6,413,217,196
050,36,073,"New York","Orleans County",5,7,428,229,199
050,36,073,"New York","Orleans County",5,8,443,223,220
050,36,073,"New York","Orleans County",5,9,437,235,202
050,36,073,"New York","Orleans County",5,10,402,218,184
050,36,073,"New York","Orleans County",5,11,367,174,193
050,36,073,"New York","Orleans County",5,12,421,206,215
050,36,073,"New York","Orleans County",5,13,424,209,215
050,36,073,"New York","Orleans County",5,14,415,226,189
050,36,073,"New York","Orleans County",5,15,439,223,216
050,36,073,"New York","Orleans County",5,16,446,218,228
050,36,073,"New York","Orleans County",5,17,493,246,247
050,36,073,"New York","Orleans County",5,18,472,245,227
050,36,073,"New York","Orleans County",5,19,399,203,196
050,36,073,"New York","Orleans County",5,20,414,214,200
050,36,073,"New York","Orleans County",5,21,414,208,206
050,36,073,"New York","Orleans County",5,22,450,231,219
050,36,073,"New York","Orleans County",5,23,504,255,249
050,36,073,"New York","Orleans County",5,24,458,237,221
050,36,073,"New York","Orleans County",5,25,451,244,207
050,36,073,"New York","Orleans County",5,26,448,255,193
050,36,073,"New York","Orleans County",5,27,449,237,212
050,36,073,"New York","Orleans County",5,28,474,254,220
050,36,073,"New York","Orleans County",5,29,494,270,224
050,36,073,"New York","Orleans County",5,30,525,287,238
050,36,073,"New York","Orleans County",5,31,538,279,259
050,36,073,"New York","Orleans County",5,32,506,269,237
050,36,073,"New York","Orleans County",5,33,510,267,243
050,36,073,"New York","Orleans County",5,34,498,265,233
050,36,073,"New York","Orleans County",5,35,465,245,220
050,36,073,"New York","Orleans County",5,36,470,242,228
050,36,073,"New York","Orleans County",5,37,479,248,231
050,36,073,"New York","Orleans County",5,38,485,249,236
050,36,073,"New York","Orleans County",5,39,464,247,217
050,36,073,"New York","Orleans County",5,40,505,257,248
050,36,073,"New York","Orleans County",5,41,492,259,233
050,36,073,"New York","Orleans County",5,42,476,236,240
050,36,073,"New York","Orleans County",5,43,461,233,228
050,36,073,"New York","Orleans County",5,44,437,225,212
050,36,073,"New York","Orleans County",5,45,417,212,205
050,36,073,"New York","Orleans County",5,46,420,204,216
050,36,073,"New York","Orleans County",5,47,406,202,204
050,36,073,"New York","Orleans County",5,48,415,203,212
050,36,073,"New York","Orleans County",5,49,415,192,223
050,36,073,"New York","Orleans County",5,50,419,206,213
050,36,073,"New York","Orleans County",5,51,464,232,232
050,36,073,"New York","Orleans County",5,52,537,267,270
050,36,073,"New York","Orleans County",5,53,583,291,292
050,36,073,"New York","Orleans County",5,54,566,295,271
050,36,073,"New York","Orleans County",5,55,549,272,277
050,36,073,"New York","Orleans County",5,56,563,276,287
050,36,073,"New York","Orleans County",5,57,562,289,273
050,36,073,"New York","Orleans County",5,58,623,311,312
050,36,073,"New York","Orleans County",5,59,651,324,327
050,36,073,"New York","Orleans County",5,60,656,337,319
050,36,073,"New York","Orleans County",5,61,672,343,329
050,36,073,"New York","Orleans County",5,62,637,320,317
050,36,073,"New York","Orleans County",5,63,638,328,310
050,36,073,"New York","Orleans County",5,64,618,300,318
050,36,073,"New York","Orleans County",5,65,635,308,327
050,36,073,"New York","Orleans County",5,66,613,291,322
050,36,073,"New York","Orleans County",5,67,581,287,294
050,36,073,"New York","Orleans County",5,68,566,293,273
050,36,073,"New York","Orleans County",5,69,522,270,252
050,36,073,"New York","Orleans County",5,70,470,231,239
050,36,073,"New York","Orleans County",5,71,461,230,231
050,36,073,"New York","Orleans County",5,72,435,218,217
050,36,073,"New York","Orleans County",5,73,383,180,203
050,36,073,"New York","Orleans County",5,74,414,201,213
050,36,073,"New York","Orleans County",5,75,368,175,193
050,36,073,"New York","Orleans County",5,76,385,177,208
050,36,073,"New York","Orleans County",5,77,253,123,130
050,36,073,"New York","Orleans County",5,78,230,109,121
050,36,073,"New York","Orleans County",5,79,229,107,122
050,36,073,"New York","Orleans County",5,80,243,109,134
050,36,073,"New York","Orleans County",5,81,190,82,108
050,36,073,"New York","Orleans County",5,82,152,74,78
050,36,073,"New York","Orleans County",5,83,133,59,74
050,36,073,"New York","Orleans County",5,84,121,49,72
050,36,073,"New York","Orleans County",5,85,803,293,510
050,36,075,"New York","Oswego County",1,0,1170,596,574
050,36,075,"New York","Oswego County",1,1,1218,604,614
050,36,075,"New York","Oswego County",1,2,1274,625,649
050,36,075,"New York","Oswego County",1,3,1315,666,649
050,36,075,"New York","Oswego County",1,4,1319,661,658
050,36,075,"New York","Oswego County",1,5,1323,683,640
050,36,075,"New York","Oswego County",1,6,1328,699,629
050,36,075,"New York","Oswego County",1,7,1344,691,653
050,36,075,"New York","Oswego County",1,8,1367,729,638
050,36,075,"New York","Oswego County",1,9,1351,709,642
050,36,075,"New York","Oswego County",1,10,1412,727,685
050,36,075,"New York","Oswego County",1,11,1446,752,694
050,36,075,"New York","Oswego County",1,12,1490,751,739
050,36,075,"New York","Oswego County",1,13,1479,766,713
050,36,075,"New York","Oswego County",1,14,1477,765,712
050,36,075,"New York","Oswego County",1,15,1462,757,705
050,36,075,"New York","Oswego County",1,16,1507,765,742
050,36,075,"New York","Oswego County",1,17,1497,792,705
050,36,075,"New York","Oswego County",1,18,2044,1007,1037
050,36,075,"New York","Oswego County",1,19,2167,1059,1108
050,36,075,"New York","Oswego County",1,20,2014,1040,974
050,36,075,"New York","Oswego County",1,21,1741,927,814
050,36,075,"New York","Oswego County",1,22,1475,769,706
050,36,075,"New York","Oswego County",1,23,1350,684,666
050,36,075,"New York","Oswego County",1,24,1424,732,692
050,36,075,"New York","Oswego County",1,25,1368,706,662
050,36,075,"New York","Oswego County",1,26,1355,696,659
050,36,075,"New York","Oswego County",1,27,1426,743,683
050,36,075,"New York","Oswego County",1,28,1420,716,704
050,36,075,"New York","Oswego County",1,29,1500,776,724
050,36,075,"New York","Oswego County",1,30,1556,790,766
050,36,075,"New York","Oswego County",1,31,1453,748,705
050,36,075,"New York","Oswego County",1,32,1423,744,679
050,36,075,"New York","Oswego County",1,33,1383,701,682
050,36,075,"New York","Oswego County",1,34,1436,736,700
050,36,075,"New York","Oswego County",1,35,1375,696,679
050,36,075,"New York","Oswego County",1,36,1339,680,659
050,36,075,"New York","Oswego County",1,37,1344,689,655
050,36,075,"New York","Oswego County",1,38,1361,694,667
050,36,075,"New York","Oswego County",1,39,1409,695,714
050,36,075,"New York","Oswego County",1,40,1394,705,689
050,36,075,"New York","Oswego County",1,41,1315,666,649
050,36,075,"New York","Oswego County",1,42,1246,615,631
050,36,075,"New York","Oswego County",1,43,1212,601,611
050,36,075,"New York","Oswego County",1,44,1200,607,593
050,36,075,"New York","Oswego County",1,45,1246,619,627
050,36,075,"New York","Oswego County",1,46,1218,611,607
050,36,075,"New York","Oswego County",1,47,1297,645,652
050,36,075,"New York","Oswego County",1,48,1449,736,713
050,36,075,"New York","Oswego County",1,49,1613,785,828
050,36,075,"New York","Oswego County",1,50,1579,769,810
050,36,075,"New York","Oswego County",1,51,1611,816,795
050,36,075,"New York","Oswego County",1,52,1623,814,809
050,36,075,"New York","Oswego County",1,53,1698,857,841
050,36,075,"New York","Oswego County",1,54,1741,888,853
050,36,075,"New York","Oswego County",1,55,1854,946,908
050,36,075,"New York","Oswego County",1,56,1928,979,949
050,36,075,"New York","Oswego County",1,57,1884,940,944
050,36,075,"New York","Oswego County",1,58,1963,1020,943
050,36,075,"New York","Oswego County",1,59,1908,982,926
050,36,075,"New York","Oswego County",1,60,1856,936,920
050,36,075,"New York","Oswego County",1,61,1750,888,862
050,36,075,"New York","Oswego County",1,62,1764,900,864
050,36,075,"New York","Oswego County",1,63,1649,846,803
050,36,075,"New York","Oswego County",1,64,1601,830,771
050,36,075,"New York","Oswego County",1,65,1504,777,727
050,36,075,"New York","Oswego County",1,66,1426,744,682
050,36,075,"New York","Oswego County",1,67,1399,717,682
050,36,075,"New York","Oswego County",1,68,1338,653,685
050,36,075,"New York","Oswego County",1,69,1254,599,655
050,36,075,"New York","Oswego County",1,70,1205,585,620
050,36,075,"New York","Oswego County",1,71,1139,563,576
050,36,075,"New York","Oswego County",1,72,1127,550,577
050,36,075,"New York","Oswego County",1,73,1133,587,546
050,36,075,"New York","Oswego County",1,74,723,359,364
050,36,075,"New York","Oswego County",1,75,728,345,383
050,36,075,"New York","Oswego County",1,76,785,362,423
050,36,075,"New York","Oswego County",1,77,779,361,418
050,36,075,"New York","Oswego County",1,78,625,286,339
050,36,075,"New York","Oswego County",1,79,570,276,294
050,36,075,"New York","Oswego County",1,80,506,218,288
050,36,075,"New York","Oswego County",1,81,471,195,276
050,36,075,"New York","Oswego County",1,82,396,168,228
050,36,075,"New York","Oswego County",1,83,366,148,218
050,36,075,"New York","Oswego County",1,84,348,154,194
050,36,075,"New York","Oswego County",1,85,1965,759,1206
050,36,075,"New York","Oswego County",2,0,1182,614,568
050,36,075,"New York","Oswego County",2,1,1206,601,605
050,36,075,"New York","Oswego County",2,2,1265,622,643
050,36,075,"New York","Oswego County",2,3,1301,654,647
050,36,075,"New York","Oswego County",2,4,1323,666,657
050,36,075,"New York","Oswego County",2,5,1317,677,640
050,36,075,"New York","Oswego County",2,6,1324,693,631
050,36,075,"New York","Oswego County",2,7,1342,691,651
050,36,075,"New York","Oswego County",2,8,1352,713,639
050,36,075,"New York","Oswego County",2,9,1353,712,641
050,36,075,"New York","Oswego County",2,10,1398,722,676
050,36,075,"New York","Oswego County",2,11,1436,743,693
050,36,075,"New York","Oswego County",2,12,1485,755,730
050,36,075,"New York","Oswego County",2,13,1477,760,717
050,36,075,"New York","Oswego County",2,14,1474,763,711
050,36,075,"New York","Oswego County",2,15,1466,759,707
050,36,075,"New York","Oswego County",2,16,1500,766,734
050,36,075,"New York","Oswego County",2,17,1499,785,714
050,36,075,"New York","Oswego County",2,18,2033,1008,1025
050,36,075,"New York","Oswego County",2,19,2161,1052,1109
050,36,075,"New York","Oswego County",2,20,2031,1051,980
050,36,075,"New York","Oswego County",2,21,1740,925,815
050,36,075,"New York","Oswego County",2,22,1477,777,700
050,36,075,"New York","Oswego County",2,23,1355,691,664
050,36,075,"New York","Oswego County",2,24,1396,714,682
050,36,075,"New York","Oswego County",2,25,1362,703,659
050,36,075,"New York","Oswego County",2,26,1350,692,658
050,36,075,"New York","Oswego County",2,27,1406,729,677
050,36,075,"New York","Oswego County",2,28,1413,719,694
050,36,075,"New York","Oswego County",2,29,1476,759,717
050,36,075,"New York","Oswego County",2,30,1547,788,759
050,36,075,"New York","Oswego County",2,31,1464,751,713
050,36,075,"New York","Oswego County",2,32,1427,741,686
050,36,075,"New York","Oswego County",2,33,1392,710,682
050,36,075,"New York","Oswego County",2,34,1422,728,694
050,36,075,"New York","Oswego County",2,35,1404,712,692
050,36,075,"New York","Oswego County",2,36,1343,684,659
050,36,075,"New York","Oswego County",2,37,1349,690,659
050,36,075,"New York","Oswego County",2,38,1366,698,668
050,36,075,"New York","Oswego County",2,39,1391,694,697
050,36,075,"New York","Oswego County",2,40,1402,706,696
050,36,075,"New York","Oswego County",2,41,1334,676,658
050,36,075,"New York","Oswego County",2,42,1255,624,631
050,36,075,"New York","Oswego County",2,43,1228,609,619
050,36,075,"New York","Oswego County",2,44,1187,597,590
050,36,075,"New York","Oswego County",2,45,1244,624,620
050,36,075,"New York","Oswego County",2,46,1215,608,607
050,36,075,"New York","Oswego County",2,47,1278,636,642
050,36,075,"New York","Oswego County",2,48,1415,714,701
050,36,075,"New York","Oswego County",2,49,1581,779,802
050,36,075,"New York","Oswego County",2,50,1585,771,814
050,36,075,"New York","Oswego County",2,51,1599,801,798
050,36,075,"New York","Oswego County",2,52,1613,809,804
050,36,075,"New York","Oswego County",2,53,1679,845,834
050,36,075,"New York","Oswego County",2,54,1720,879,841
050,36,075,"New York","Oswego County",2,55,1827,929,898
050,36,075,"New York","Oswego County",2,56,1914,972,942
050,36,075,"New York","Oswego County",2,57,1893,946,947
050,36,075,"New York","Oswego County",2,58,1940,1000,940
050,36,075,"New York","Oswego County",2,59,1928,994,934
050,36,075,"New York","Oswego County",2,60,1851,941,910
050,36,075,"New York","Oswego County",2,61,1764,893,871
050,36,075,"New York","Oswego County",2,62,1753,891,862
050,36,075,"New York","Oswego County",2,63,1691,867,824
050,36,075,"New York","Oswego County",2,64,1589,821,768
050,36,075,"New York","Oswego County",2,65,1519,782,737
050,36,075,"New York","Oswego County",2,66,1443,751,692
050,36,075,"New York","Oswego County",2,67,1394,720,674
050,36,075,"New York","Oswego County",2,68,1338,661,677
050,36,075,"New York","Oswego County",2,69,1278,615,663
050,36,075,"New York","Oswego County",2,70,1207,584,623
050,36,075,"New York","Oswego County",2,71,1148,562,586
050,36,075,"New York","Oswego County",2,72,1109,543,566
050,36,075,"New York","Oswego County",2,73,1182,603,579
050,36,075,"New York","Oswego County",2,74,763,382,381
050,36,075,"New York","Oswego County",2,75,725,346,379
050,36,075,"New York","Oswego County",2,76,760,354,406
050,36,075,"New York","Oswego County",2,77,784,364,420
050,36,075,"New York","Oswego County",2,78,640,293,347
050,36,075,"New York","Oswego County",2,79,573,275,298
050,36,075,"New York","Oswego County",2,80,523,233,290
050,36,075,"New York","Oswego County",2,81,466,195,271
050,36,075,"New York","Oswego County",2,82,403,169,234
050,36,075,"New York","Oswego County",2,83,361,146,215
050,36,075,"New York","Oswego County",2,84,346,152,194
050,36,075,"New York","Oswego County",2,85,1977,764,1213
050,36,075,"New York","Oswego County",3,0,1143,591,552
050,36,075,"New York","Oswego County",3,1,1192,620,572
050,36,075,"New York","Oswego County",3,2,1222,601,621
050,36,075,"New York","Oswego County",3,3,1301,645,656
050,36,075,"New York","Oswego County",3,4,1324,658,666
050,36,075,"New York","Oswego County",3,5,1342,674,668
050,36,075,"New York","Oswego County",3,6,1338,695,643
050,36,075,"New York","Oswego County",3,7,1325,699,626
050,36,075,"New York","Oswego County",3,8,1368,698,670
050,36,075,"New York","Oswego County",3,9,1365,721,644
050,36,075,"New York","Oswego County",3,10,1363,722,641
050,36,075,"New York","Oswego County",3,11,1400,727,673
050,36,075,"New York","Oswego County",3,12,1437,744,693
050,36,075,"New York","Oswego County",3,13,1493,756,737
050,36,075,"New York","Oswego County",3,14,1466,753,713
050,36,075,"New York","Oswego County",3,15,1481,768,713
050,36,075,"New York","Oswego County",3,16,1454,757,697
050,36,075,"New York","Oswego County",3,17,1495,761,734
050,36,075,"New York","Oswego County",3,18,2139,1059,1080
050,36,075,"New York","Oswego County",3,19,2278,1107,1171
050,36,075,"New York","Oswego County",3,20,2113,1093,1020
050,36,075,"New York","Oswego County",3,21,1791,942,849
050,36,075,"New York","Oswego County",3,22,1542,828,714
050,36,075,"New York","Oswego County",3,23,1410,747,663
050,36,075,"New York","Oswego County",3,24,1337,687,650
050,36,075,"New York","Oswego County",3,25,1329,671,658
050,36,075,"New York","Oswego County",3,26,1341,674,667
050,36,075,"New York","Oswego County",3,27,1418,736,682
050,36,075,"New York","Oswego County",3,28,1385,712,673
050,36,075,"New York","Oswego County",3,29,1427,719,708
050,36,075,"New York","Oswego County",3,30,1491,763,728
050,36,075,"New York","Oswego County",3,31,1564,797,767
050,36,075,"New York","Oswego County",3,32,1481,751,730
050,36,075,"New York","Oswego County",3,33,1447,761,686
050,36,075,"New York","Oswego County",3,34,1420,722,698
050,36,075,"New York","Oswego County",3,35,1460,753,707
050,36,075,"New York","Oswego County",3,36,1387,706,681
050,36,075,"New York","Oswego County",3,37,1357,694,663
050,36,075,"New York","Oswego County",3,38,1366,709,657
050,36,075,"New York","Oswego County",3,39,1374,702,672
050,36,075,"New York","Oswego County",3,40,1385,694,691
050,36,075,"New York","Oswego County",3,41,1418,718,700
050,36,075,"New York","Oswego County",3,42,1350,683,667
050,36,075,"New York","Oswego County",3,43,1255,623,632
050,36,075,"New York","Oswego County",3,44,1224,603,621
050,36,075,"New York","Oswego County",3,45,1203,616,587
050,36,075,"New York","Oswego County",3,46,1230,613,617
050,36,075,"New York","Oswego County",3,47,1225,622,603
050,36,075,"New York","Oswego County",3,48,1279,635,644
050,36,075,"New York","Oswego County",3,49,1433,724,709
050,36,075,"New York","Oswego County",3,50,1575,769,806
050,36,075,"New York","Oswego County",3,51,1579,774,805
050,36,075,"New York","Oswego County",3,52,1609,796,813
050,36,075,"New York","Oswego County",3,53,1614,809,805
050,36,075,"New York","Oswego County",3,54,1683,854,829
050,36,075,"New York","Oswego County",3,55,1722,884,838
050,36,075,"New York","Oswego County",3,56,1816,929,887
050,36,075,"New York","Oswego County",3,57,1883,949,934
050,36,075,"New York","Oswego County",3,58,1884,945,939
050,36,075,"New York","Oswego County",3,59,1913,971,942
050,36,075,"New York","Oswego County",3,60,1919,985,934
050,36,075,"New York","Oswego County",3,61,1834,933,901
050,36,075,"New York","Oswego County",3,62,1735,876,859
050,36,075,"New York","Oswego County",3,63,1732,878,854
050,36,075,"New York","Oswego County",3,64,1661,846,815
050,36,075,"New York","Oswego County",3,65,1559,801,758
050,36,075,"New York","Oswego County",3,66,1506,776,730
050,36,075,"New York","Oswego County",3,67,1417,742,675
050,36,075,"New York","Oswego County",3,68,1372,695,677
050,36,075,"New York","Oswego County",3,69,1298,635,663
050,36,075,"New York","Oswego County",3,70,1258,597,661
050,36,075,"New York","Oswego County",3,71,1153,561,592
050,36,075,"New York","Oswego County",3,72,1122,547,575
050,36,075,"New York","Oswego County",3,73,1078,529,549
050,36,075,"New York","Oswego County",3,74,1130,578,552
050,36,075,"New York","Oswego County",3,75,747,375,372
050,36,075,"New York","Oswego County",3,76,685,330,355
050,36,075,"New York","Oswego County",3,77,715,330,385
050,36,075,"New York","Oswego County",3,78,736,334,402
050,36,075,"New York","Oswego County",3,79,596,276,320
050,36,075,"New York","Oswego County",3,80,541,253,288
050,36,075,"New York","Oswego County",3,81,483,214,269
050,36,075,"New York","Oswego County",3,82,424,170,254
050,36,075,"New York","Oswego County",3,83,374,153,221
050,36,075,"New York","Oswego County",3,84,321,133,188
050,36,075,"New York","Oswego County",3,85,1942,761,1181
050,36,075,"New York","Oswego County",4,0,1132,580,552
050,36,075,"New York","Oswego County",4,1,1152,606,546
050,36,075,"New York","Oswego County",4,2,1217,629,588
050,36,075,"New York","Oswego County",4,3,1227,603,624
050,36,075,"New York","Oswego County",4,4,1316,654,662
050,36,075,"New York","Oswego County",4,5,1337,676,661
050,36,075,"New York","Oswego County",4,6,1342,675,667
050,36,075,"New York","Oswego County",4,7,1361,703,658
050,36,075,"New York","Oswego County",4,8,1344,707,637
050,36,075,"New York","Oswego County",4,9,1374,695,679
050,36,075,"New York","Oswego County",4,10,1380,734,646
050,36,075,"New York","Oswego County",4,11,1371,726,645
050,36,075,"New York","Oswego County",4,12,1419,742,677
050,36,075,"New York","Oswego County",4,13,1434,736,698
050,36,075,"New York","Oswego County",4,14,1480,754,726
050,36,075,"New York","Oswego County",4,15,1484,765,719
050,36,075,"New York","Oswego County",4,16,1488,767,721
050,36,075,"New York","Oswego County",4,17,1462,762,700
050,36,075,"New York","Oswego County",4,18,2195,1072,1123
050,36,075,"New York","Oswego County",4,19,2337,1127,1210
050,36,075,"New York","Oswego County",4,20,2160,1117,1043
050,36,075,"New York","Oswego County",4,21,1850,999,851
050,36,075,"New York","Oswego County",4,22,1557,818,739
050,36,075,"New York","Oswego County",4,23,1422,755,667
050,36,075,"New York","Oswego County",4,24,1397,733,664
050,36,075,"New York","Oswego County",4,25,1311,665,646
050,36,075,"New York","Oswego County",4,26,1311,684,627
050,36,075,"New York","Oswego County",4,27,1367,680,687
050,36,075,"New York","Oswego County",4,28,1388,719,669
050,36,075,"New York","Oswego County",4,29,1387,723,664
050,36,075,"New York","Oswego County",4,30,1423,724,699
050,36,075,"New York","Oswego County",4,31,1465,749,716
050,36,075,"New York","Oswego County",4,32,1563,789,774
050,36,075,"New York","Oswego County",4,33,1489,745,744
050,36,075,"New York","Oswego County",4,34,1475,763,712
050,36,075,"New York","Oswego County",4,35,1403,714,689
050,36,075,"New York","Oswego County",4,36,1470,745,725
050,36,075,"New York","Oswego County",4,37,1410,708,702
050,36,075,"New York","Oswego County",4,38,1390,716,674
050,36,075,"New York","Oswego County",4,39,1396,721,675
050,36,075,"New York","Oswego County",4,40,1406,732,674
050,36,075,"New York","Oswego County",4,41,1382,693,689
050,36,075,"New York","Oswego County",4,42,1414,728,686
050,36,075,"New York","Oswego County",4,43,1355,688,667
050,36,075,"New York","Oswego County",4,44,1250,624,626
050,36,075,"New York","Oswego County",4,45,1236,616,620
050,36,075,"New York","Oswego County",4,46,1193,596,597
050,36,075,"New York","Oswego County",4,47,1233,621,612
050,36,075,"New York","Oswego County",4,48,1203,604,599
050,36,075,"New York","Oswego County",4,49,1271,636,635
050,36,075,"New York","Oswego County",4,50,1411,710,701
050,36,075,"New York","Oswego County",4,51,1566,765,801
050,36,075,"New York","Oswego County",4,52,1581,777,804
050,36,075,"New York","Oswego County",4,53,1598,788,810
050,36,075,"New York","Oswego County",4,54,1606,807,799
050,36,075,"New York","Oswego County",4,55,1665,839,826
050,36,075,"New York","Oswego County",4,56,1713,876,837
050,36,075,"New York","Oswego County",4,57,1802,915,887
050,36,075,"New York","Oswego County",4,58,1880,953,927
050,36,075,"New York","Oswego County",4,59,1867,928,939
050,36,075,"New York","Oswego County",4,60,1884,953,931
050,36,075,"New York","Oswego County",4,61,1880,966,914
050,36,075,"New York","Oswego County",4,62,1799,913,886
050,36,075,"New York","Oswego County",4,63,1706,855,851
050,36,075,"New York","Oswego County",4,64,1685,848,837
050,36,075,"New York","Oswego County",4,65,1630,842,788
050,36,075,"New York","Oswego County",4,66,1525,779,746
050,36,075,"New York","Oswego County",4,67,1485,762,723
050,36,075,"New York","Oswego County",4,68,1393,721,672
050,36,075,"New York","Oswego County",4,69,1350,684,666
050,36,075,"New York","Oswego County",4,70,1280,632,648
050,36,075,"New York","Oswego County",4,71,1228,584,644
050,36,075,"New York","Oswego County",4,72,1121,537,584
050,36,075,"New York","Oswego County",4,73,1087,531,556
050,36,075,"New York","Oswego County",4,74,1049,511,538
050,36,075,"New York","Oswego County",4,75,1094,558,536
050,36,075,"New York","Oswego County",4,76,727,367,360
050,36,075,"New York","Oswego County",4,77,646,309,337
050,36,075,"New York","Oswego County",4,78,679,310,369
050,36,075,"New York","Oswego County",4,79,693,313,380
050,36,075,"New York","Oswego County",4,80,568,260,308
050,36,075,"New York","Oswego County",4,81,512,239,273
050,36,075,"New York","Oswego County",4,82,439,191,248
050,36,075,"New York","Oswego County",4,83,392,154,238
050,36,075,"New York","Oswego County",4,84,339,141,198
050,36,075,"New York","Oswego County",4,85,1930,740,1190
050,36,075,"New York","Oswego County",5,0,1134,581,553
050,36,075,"New York","Oswego County",5,1,1148,598,550
050,36,075,"New York","Oswego County",5,2,1172,618,554
050,36,075,"New York","Oswego County",5,3,1252,646,606
050,36,075,"New York","Oswego County",5,4,1244,609,635
050,36,075,"New York","Oswego County",5,5,1326,655,671
050,36,075,"New York","Oswego County",5,6,1349,674,675
050,36,075,"New York","Oswego County",5,7,1348,684,664
050,36,075,"New York","Oswego County",5,8,1367,705,662
050,36,075,"New York","Oswego County",5,9,1344,700,644
050,36,075,"New York","Oswego County",5,10,1362,691,671
050,36,075,"New York","Oswego County",5,11,1385,732,653
050,36,075,"New York","Oswego County",5,12,1366,725,641
050,36,075,"New York","Oswego County",5,13,1424,744,680
050,36,075,"New York","Oswego County",5,14,1429,738,691
050,36,075,"New York","Oswego County",5,15,1476,764,712
050,36,075,"New York","Oswego County",5,16,1493,761,732
050,36,075,"New York","Oswego County",5,17,1464,754,710
050,36,075,"New York","Oswego County",5,18,2155,1067,1088
050,36,075,"New York","Oswego County",5,19,2329,1118,1211
050,36,075,"New York","Oswego County",5,20,2127,1100,1027
050,36,075,"New York","Oswego County",5,21,1837,999,838
050,36,075,"New York","Oswego County",5,22,1553,832,721
050,36,075,"New York","Oswego County",5,23,1415,741,674
050,36,075,"New York","Oswego County",5,24,1422,752,670
050,36,075,"New York","Oswego County",5,25,1334,714,620
050,36,075,"New York","Oswego County",5,26,1290,647,643
050,36,075,"New York","Oswego County",5,27,1313,692,621
050,36,075,"New York","Oswego County",5,28,1348,670,678
050,36,075,"New York","Oswego County",5,29,1410,717,693
050,36,075,"New York","Oswego County",5,30,1405,734,671
050,36,075,"New York","Oswego County",5,31,1435,734,701
050,36,075,"New York","Oswego County",5,32,1497,759,738
050,36,075,"New York","Oswego County",5,33,1566,785,781
050,36,075,"New York","Oswego County",5,34,1473,748,725
050,36,075,"New York","Oswego County",5,35,1460,765,695
050,36,075,"New York","Oswego County",5,36,1420,718,702
050,36,075,"New York","Oswego County",5,37,1467,738,729
050,36,075,"New York","Oswego County",5,38,1425,715,710
050,36,075,"New York","Oswego County",5,39,1381,716,665
050,36,075,"New York","Oswego County",5,40,1398,716,682
050,36,075,"New York","Oswego County",5,41,1397,737,660
050,36,075,"New York","Oswego County",5,42,1371,681,690
050,36,075,"New York","Oswego County",5,43,1415,734,681
050,36,075,"New York","Oswego County",5,44,1339,671,668
050,36,075,"New York","Oswego County",5,45,1258,633,625
050,36,075,"New York","Oswego County",5,46,1259,623,636
050,36,075,"New York","Oswego County",5,47,1207,608,599
050,36,075,"New York","Oswego County",5,48,1243,621,622
050,36,075,"New York","Oswego County",5,49,1203,602,601
050,36,075,"New York","Oswego County",5,50,1252,621,631
050,36,075,"New York","Oswego County",5,51,1405,710,695
050,36,075,"New York","Oswego County",5,52,1569,754,815
050,36,075,"New York","Oswego County",5,53,1581,768,813
050,36,075,"New York","Oswego County",5,54,1597,794,803
050,36,075,"New York","Oswego County",5,55,1585,795,790
050,36,075,"New York","Oswego County",5,56,1663,838,825
050,36,075,"New York","Oswego County",5,57,1694,865,829
050,36,075,"New York","Oswego County",5,58,1798,919,879
050,36,075,"New York","Oswego County",5,59,1873,944,929
050,36,075,"New York","Oswego County",5,60,1850,917,933
050,36,075,"New York","Oswego County",5,61,1837,930,907
050,36,075,"New York","Oswego County",5,62,1871,965,906
050,36,075,"New York","Oswego County",5,63,1769,883,886
050,36,075,"New York","Oswego County",5,64,1688,843,845
050,36,075,"New York","Oswego County",5,65,1666,840,826
050,36,075,"New York","Oswego County",5,66,1601,826,775
050,36,075,"New York","Oswego County",5,67,1500,764,736
050,36,075,"New York","Oswego County",5,68,1455,744,711
050,36,075,"New York","Oswego County",5,69,1373,708,665
050,36,075,"New York","Oswego County",5,70,1329,664,665
050,36,075,"New York","Oswego County",5,71,1226,601,625
050,36,075,"New York","Oswego County",5,72,1189,554,635
050,36,075,"New York","Oswego County",5,73,1096,520,576
050,36,075,"New York","Oswego County",5,74,1069,517,552
050,36,075,"New York","Oswego County",5,75,1011,495,516
050,36,075,"New York","Oswego County",5,76,1079,550,529
050,36,075,"New York","Oswego County",5,77,698,352,346
050,36,075,"New York","Oswego County",5,78,619,297,322
050,36,075,"New York","Oswego County",5,79,631,296,335
050,36,075,"New York","Oswego County",5,80,663,294,369
050,36,075,"New York","Oswego County",5,81,523,238,285
050,36,075,"New York","Oswego County",5,82,465,213,252
050,36,075,"New York","Oswego County",5,83,407,177,230
050,36,075,"New York","Oswego County",5,84,354,142,212
050,36,075,"New York","Oswego County",5,85,1941,728,1213
050,36,077,"New York","Otsego County",1,0,479,245,234
050,36,077,"New York","Otsego County",1,1,498,261,237
050,36,077,"New York","Otsego County",1,2,465,231,234
050,36,077,"New York","Otsego County",1,3,475,252,223
050,36,077,"New York","Otsego County",1,4,480,265,215
050,36,077,"New York","Otsego County",1,5,505,254,251
050,36,077,"New York","Otsego County",1,6,507,256,251
050,36,077,"New York","Otsego County",1,7,494,254,240
050,36,077,"New York","Otsego County",1,8,486,254,232
050,36,077,"New York","Otsego County",1,9,494,271,223
050,36,077,"New York","Otsego County",1,10,503,271,232
050,36,077,"New York","Otsego County",1,11,533,278,255
050,36,077,"New York","Otsego County",1,12,560,283,277
050,36,077,"New York","Otsego County",1,13,527,263,264
050,36,077,"New York","Otsego County",1,14,496,236,260
050,36,077,"New York","Otsego County",1,15,510,235,275
050,36,077,"New York","Otsego County",1,16,545,266,279
050,36,077,"New York","Otsego County",1,17,683,341,342
050,36,077,"New York","Otsego County",1,18,1553,646,907
050,36,077,"New York","Otsego County",1,19,2006,880,1126
050,36,077,"New York","Otsego County",1,20,2043,864,1179
050,36,077,"New York","Otsego County",1,21,1803,865,938
050,36,077,"New York","Otsego County",1,22,1310,655,655
050,36,077,"New York","Otsego County",1,23,766,361,405
050,36,077,"New York","Otsego County",1,24,690,343,347
050,36,077,"New York","Otsego County",1,25,654,329,325
050,36,077,"New York","Otsego County",1,26,643,337,306
050,36,077,"New York","Otsego County",1,27,589,297,292
050,36,077,"New York","Otsego County",1,28,582,274,308
050,36,077,"New York","Otsego County",1,29,537,268,269
050,36,077,"New York","Otsego County",1,30,549,299,250
050,36,077,"New York","Otsego County",1,31,572,294,278
050,36,077,"New York","Otsego County",1,32,559,277,282
050,36,077,"New York","Otsego County",1,33,568,299,269
050,36,077,"New York","Otsego County",1,34,543,282,261
050,36,077,"New York","Otsego County",1,35,599,306,293
050,36,077,"New York","Otsego County",1,36,595,303,292
050,36,077,"New York","Otsego County",1,37,565,283,282
050,36,077,"New York","Otsego County",1,38,599,310,289
050,36,077,"New York","Otsego County",1,39,606,302,304
050,36,077,"New York","Otsego County",1,40,599,304,295
050,36,077,"New York","Otsego County",1,41,562,301,261
050,36,077,"New York","Otsego County",1,42,539,266,273
050,36,077,"New York","Otsego County",1,43,531,271,260
050,36,077,"New York","Otsego County",1,44,521,270,251
050,36,077,"New York","Otsego County",1,45,552,279,273
050,36,077,"New York","Otsego County",1,46,548,272,276
050,36,077,"New York","Otsego County",1,47,592,292,300
050,36,077,"New York","Otsego County",1,48,638,320,318
050,36,077,"New York","Otsego County",1,49,698,351,347
050,36,077,"New York","Otsego County",1,50,711,355,356
050,36,077,"New York","Otsego County",1,51,710,355,355
050,36,077,"New York","Otsego County",1,52,690,339,351
050,36,077,"New York","Otsego County",1,53,698,353,345
050,36,077,"New York","Otsego County",1,54,721,359,362
050,36,077,"New York","Otsego County",1,55,780,384,396
050,36,077,"New York","Otsego County",1,56,846,432,414
050,36,077,"New York","Otsego County",1,57,852,430,422
050,36,077,"New York","Otsego County",1,58,864,426,438
050,36,077,"New York","Otsego County",1,59,907,450,457
050,36,077,"New York","Otsego County",1,60,927,469,458
050,36,077,"New York","Otsego County",1,61,906,440,466
050,36,077,"New York","Otsego County",1,62,882,440,442
050,36,077,"New York","Otsego County",1,63,899,424,475
050,36,077,"New York","Otsego County",1,64,834,384,450
050,36,077,"New York","Otsego County",1,65,846,404,442
050,36,077,"New York","Otsego County",1,66,788,377,411
050,36,077,"New York","Otsego County",1,67,770,373,397
050,36,077,"New York","Otsego County",1,68,775,381,394
050,36,077,"New York","Otsego County",1,69,761,371,390
050,36,077,"New York","Otsego County",1,70,732,376,356
050,36,077,"New York","Otsego County",1,71,684,345,339
050,36,077,"New York","Otsego County",1,72,696,353,343
050,36,077,"New York","Otsego County",1,73,691,342,349
050,36,077,"New York","Otsego County",1,74,485,219,266
050,36,077,"New York","Otsego County",1,75,490,221,269
050,36,077,"New York","Otsego County",1,76,476,223,253
050,36,077,"New York","Otsego County",1,77,504,245,259
050,36,077,"New York","Otsego County",1,78,419,199,220
050,36,077,"New York","Otsego County",1,79,363,174,189
050,36,077,"New York","Otsego County",1,80,329,155,174
050,36,077,"New York","Otsego County",1,81,329,139,190
050,36,077,"New York","Otsego County",1,82,291,127,164
050,36,077,"New York","Otsego County",1,83,258,114,144
050,36,077,"New York","Otsego County",1,84,208,96,112
050,36,077,"New York","Otsego County",1,85,1455,542,913
050,36,077,"New York","Otsego County",2,0,489,250,239
050,36,077,"New York","Otsego County",2,1,488,253,235
050,36,077,"New York","Otsego County",2,2,469,236,233
050,36,077,"New York","Otsego County",2,3,467,243,224
050,36,077,"New York","Otsego County",2,4,479,262,217
050,36,077,"New York","Otsego County",2,5,495,256,239
050,36,077,"New York","Otsego County",2,6,503,256,247
050,36,077,"New York","Otsego County",2,7,493,252,241
050,36,077,"New York","Otsego County",2,8,483,251,232
050,36,077,"New York","Otsego County",2,9,493,267,226
050,36,077,"New York","Otsego County",2,10,498,268,230
050,36,077,"New York","Otsego County",2,11,523,275,248
050,36,077,"New York","Otsego County",2,12,553,280,273
050,36,077,"New York","Otsego County",2,13,529,264,265
050,36,077,"New York","Otsego County",2,14,501,240,261
050,36,077,"New York","Otsego County",2,15,500,232,268
050,36,077,"New York","Otsego County",2,16,538,259,279
050,36,077,"New York","Otsego County",2,17,673,336,337
050,36,077,"New York","Otsego County",2,18,1544,643,901
050,36,077,"New York","Otsego County",2,19,1991,873,1118
050,36,077,"New York","Otsego County",2,20,2060,870,1190
050,36,077,"New York","Otsego County",2,21,1805,863,942
050,36,077,"New York","Otsego County",2,22,1303,658,645
050,36,077,"New York","Otsego County",2,23,767,360,407
050,36,077,"New York","Otsego County",2,24,688,347,341
050,36,077,"New York","Otsego County",2,25,643,324,319
050,36,077,"New York","Otsego County",2,26,637,329,308
050,36,077,"New York","Otsego County",2,27,589,303,286
050,36,077,"New York","Otsego County",2,28,589,284,305
050,36,077,"New York","Otsego County",2,29,543,268,275
050,36,077,"New York","Otsego County",2,30,551,295,256
050,36,077,"New York","Otsego County",2,31,561,291,270
050,36,077,"New York","Otsego County",2,32,568,287,281
050,36,077,"New York","Otsego County",2,33,563,292,271
050,36,077,"New York","Otsego County",2,34,553,287,266
050,36,077,"New York","Otsego County",2,35,592,305,287
050,36,077,"New York","Otsego County",2,36,586,299,287
050,36,077,"New York","Otsego County",2,37,574,288,286
050,36,077,"New York","Otsego County",2,38,593,305,288
050,36,077,"New York","Otsego County",2,39,602,302,300
050,36,077,"New York","Otsego County",2,40,605,306,299
050,36,077,"New York","Otsego County",2,41,570,302,268
050,36,077,"New York","Otsego County",2,42,544,272,272
050,36,077,"New York","Otsego County",2,43,537,272,265
050,36,077,"New York","Otsego County",2,44,518,268,250
050,36,077,"New York","Otsego County",2,45,548,278,270
050,36,077,"New York","Otsego County",2,46,547,272,275
050,36,077,"New York","Otsego County",2,47,581,286,295
050,36,077,"New York","Otsego County",2,48,625,313,312
050,36,077,"New York","Otsego County",2,49,685,344,341
050,36,077,"New York","Otsego County",2,50,708,354,354
050,36,077,"New York","Otsego County",2,51,704,353,351
050,36,077,"New York","Otsego County",2,52,690,342,348
050,36,077,"New York","Otsego County",2,53,692,345,347
050,36,077,"New York","Otsego County",2,54,714,358,356
050,36,077,"New York","Otsego County",2,55,765,378,387
050,36,077,"New York","Otsego County",2,56,831,422,409
050,36,077,"New York","Otsego County",2,57,850,428,422
050,36,077,"New York","Otsego County",2,58,858,426,432
050,36,077,"New York","Otsego County",2,59,902,449,453
050,36,077,"New York","Otsego County",2,60,917,463,454
050,36,077,"New York","Otsego County",2,61,909,446,463
050,36,077,"New York","Otsego County",2,62,891,441,450
050,36,077,"New York","Otsego County",2,63,899,429,470
050,36,077,"New York","Otsego County",2,64,840,389,451
050,36,077,"New York","Otsego County",2,65,841,398,443
050,36,077,"New York","Otsego County",2,66,802,384,418
050,36,077,"New York","Otsego County",2,67,770,370,400
050,36,077,"New York","Otsego County",2,68,765,374,391
050,36,077,"New York","Otsego County",2,69,767,374,393
050,36,077,"New York","Otsego County",2,70,732,373,359
050,36,077,"New York","Otsego County",2,71,695,352,343
050,36,077,"New York","Otsego County",2,72,679,343,336
050,36,077,"New York","Otsego County",2,73,723,358,365
050,36,077,"New York","Otsego County",2,74,497,231,266
050,36,077,"New York","Otsego County",2,75,485,219,266
050,36,077,"New York","Otsego County",2,76,471,219,252
050,36,077,"New York","Otsego County",2,77,501,240,261
050,36,077,"New York","Otsego County",2,78,423,203,220
050,36,077,"New York","Otsego County",2,79,371,176,195
050,36,077,"New York","Otsego County",2,80,333,159,174
050,36,077,"New York","Otsego County",2,81,322,143,179
050,36,077,"New York","Otsego County",2,82,292,123,169
050,36,077,"New York","Otsego County",2,83,255,113,142
050,36,077,"New York","Otsego County",2,84,206,95,111
050,36,077,"New York","Otsego County",2,85,1437,534,903
050,36,077,"New York","Otsego County",3,0,487,250,237
050,36,077,"New York","Otsego County",3,1,525,267,258
050,36,077,"New York","Otsego County",3,2,482,254,228
050,36,077,"New York","Otsego County",3,3,470,228,242
050,36,077,"New York","Otsego County",3,4,472,241,231
050,36,077,"New York","Otsego County",3,5,471,253,218
050,36,077,"New York","Otsego County",3,6,502,259,243
050,36,077,"New York","Otsego County",3,7,511,260,251
050,36,077,"New York","Otsego County",3,8,495,250,245
050,36,077,"New York","Otsego County",3,9,497,260,237
050,36,077,"New York","Otsego County",3,10,491,268,223
050,36,077,"New York","Otsego County",3,11,492,276,216
050,36,077,"New York","Otsego County",3,12,513,274,239
050,36,077,"New York","Otsego County",3,13,529,263,266
050,36,077,"New York","Otsego County",3,14,524,267,257
050,36,077,"New York","Otsego County",3,15,480,230,250
050,36,077,"New York","Otsego County",3,16,510,241,269
050,36,077,"New York","Otsego County",3,17,662,326,336
050,36,077,"New York","Otsego County",3,18,2103,831,1272
050,36,077,"New York","Otsego County",3,19,2752,1163,1589
050,36,077,"New York","Otsego County",3,20,2639,1091,1548
050,36,077,"New York","Otsego County",3,21,2160,1033,1127
050,36,077,"New York","Otsego County",3,22,1426,726,700
050,36,077,"New York","Otsego County",3,23,781,375,406
050,36,077,"New York","Otsego County",3,24,689,360,329
050,36,077,"New York","Otsego County",3,25,620,310,310
050,36,077,"New York","Otsego County",3,26,615,286,329
050,36,077,"New York","Otsego County",3,27,603,318,285
050,36,077,"New York","Otsego County",3,28,617,318,299
050,36,077,"New York","Otsego County",3,29,553,269,284
050,36,077,"New York","Otsego County",3,30,556,280,276
050,36,077,"New York","Otsego County",3,31,561,293,268
050,36,077,"New York","Otsego County",3,32,595,304,291
050,36,077,"New York","Otsego County",3,33,564,290,274
050,36,077,"New York","Otsego County",3,34,577,291,286
050,36,077,"New York","Otsego County",3,35,570,306,264
050,36,077,"New York","Otsego County",3,36,582,301,281
050,36,077,"New York","Otsego County",3,37,612,307,305
050,36,077,"New York","Otsego County",3,38,593,304,289
050,36,077,"New York","Otsego County",3,39,601,306,295
050,36,077,"New York","Otsego County",3,40,625,314,311
050,36,077,"New York","Otsego County",3,41,603,304,299
050,36,077,"New York","Otsego County",3,42,585,305,280
050,36,077,"New York","Otsego County",3,43,559,283,276
050,36,077,"New York","Otsego County",3,44,525,277,248
050,36,077,"New York","Otsego County",3,45,525,268,257
050,36,077,"New York","Otsego County",3,46,543,273,270
050,36,077,"New York","Otsego County",3,47,550,277,273
050,36,077,"New York","Otsego County",3,48,575,282,293
050,36,077,"New York","Otsego County",3,49,621,301,320
050,36,077,"New York","Otsego County",3,50,711,362,349
050,36,077,"New York","Otsego County",3,51,702,350,352
050,36,077,"New York","Otsego County",3,52,714,366,348
050,36,077,"New York","Otsego County",3,53,676,336,340
050,36,077,"New York","Otsego County",3,54,682,338,344
050,36,077,"New York","Otsego County",3,55,719,359,360
050,36,077,"New York","Otsego County",3,56,758,370,388
050,36,077,"New York","Otsego County",3,57,829,414,415
050,36,077,"New York","Otsego County",3,58,857,435,422
050,36,077,"New York","Otsego County",3,59,857,425,432
050,36,077,"New York","Otsego County",3,60,882,433,449
050,36,077,"New York","Otsego County",3,61,906,457,449
050,36,077,"New York","Otsego County",3,62,908,450,458
050,36,077,"New York","Otsego County",3,63,883,436,447
050,36,077,"New York","Otsego County",3,64,880,426,454
050,36,077,"New York","Otsego County",3,65,825,369,456
050,36,077,"New York","Otsego County",3,66,822,395,427
050,36,077,"New York","Otsego County",3,67,799,375,424
050,36,077,"New York","Otsego County",3,68,762,374,388
050,36,077,"New York","Otsego County",3,69,759,373,386
050,36,077,"New York","Otsego County",3,70,759,367,392
050,36,077,"New York","Otsego County",3,71,716,369,347
050,36,077,"New York","Otsego County",3,72,679,341,338
050,36,077,"New York","Otsego County",3,73,664,338,326
050,36,077,"New York","Otsego County",3,74,706,347,359
050,36,077,"New York","Otsego County",3,75,479,224,255
050,36,077,"New York","Otsego County",3,76,464,204,260
050,36,077,"New York","Otsego County",3,77,451,203,248
050,36,077,"New York","Otsego County",3,78,469,226,243
050,36,077,"New York","Otsego County",3,79,395,185,210
050,36,077,"New York","Otsego County",3,80,347,158,189
050,36,077,"New York","Otsego County",3,81,320,151,169
050,36,077,"New York","Otsego County",3,82,300,134,166
050,36,077,"New York","Otsego County",3,83,269,113,156
050,36,077,"New York","Otsego County",3,84,230,104,126
050,36,077,"New York","Otsego County",3,85,1360,513,847
050,36,077,"New York","Otsego County",4,0,471,240,231
050,36,077,"New York","Otsego County",4,1,467,227,240
050,36,077,"New York","Otsego County",4,2,511,263,248
050,36,077,"New York","Otsego County",4,3,497,274,223
050,36,077,"New York","Otsego County",4,4,466,230,236
050,36,077,"New York","Otsego County",4,5,482,246,236
050,36,077,"New York","Otsego County",4,6,473,247,226
050,36,077,"New York","Otsego County",4,7,495,257,238
050,36,077,"New York","Otsego County",4,8,509,258,251
050,36,077,"New York","Otsego County",4,9,490,248,242
050,36,077,"New York","Otsego County",4,10,510,268,242
050,36,077,"New York","Otsego County",4,11,496,274,222
050,36,077,"New York","Otsego County",4,12,476,261,215
050,36,077,"New York","Otsego County",4,13,501,269,232
050,36,077,"New York","Otsego County",4,14,512,257,255
050,36,077,"New York","Otsego County",4,15,517,268,249
050,36,077,"New York","Otsego County",4,16,501,244,257
050,36,077,"New York","Otsego County",4,17,608,293,315
050,36,077,"New York","Otsego County",4,18,2030,802,1228
050,36,077,"New York","Otsego County",4,19,2703,1150,1553
050,36,077,"New York","Otsego County",4,20,2592,1072,1520
050,36,077,"New York","Otsego County",4,21,2133,999,1134
050,36,077,"New York","Otsego County",4,22,1439,735,704
050,36,077,"New York","Otsego County",4,23,782,376,406
050,36,077,"New York","Otsego County",4,24,689,361,328
050,36,077,"New York","Otsego County",4,25,599,308,291
050,36,077,"New York","Otsego County",4,26,583,293,290
050,36,077,"New York","Otsego County",4,27,579,286,293
050,36,077,"New York","Otsego County",4,28,605,312,293
050,36,077,"New York","Otsego County",4,29,593,301,292
050,36,077,"New York","Otsego County",4,30,579,286,293
050,36,077,"New York","Otsego County",4,31,564,270,294
050,36,077,"New York","Otsego County",4,32,585,301,284
050,36,077,"New York","Otsego County",4,33,601,302,299
050,36,077,"New York","Otsego County",4,34,572,303,269
050,36,077,"New York","Otsego County",4,35,599,306,293
050,36,077,"New York","Otsego County",4,36,574,306,268
050,36,077,"New York","Otsego County",4,37,576,298,278
050,36,077,"New York","Otsego County",4,38,618,314,304
050,36,077,"New York","Otsego County",4,39,591,297,294
050,36,077,"New York","Otsego County",4,40,594,305,289
050,36,077,"New York","Otsego County",4,41,620,315,305
050,36,077,"New York","Otsego County",4,42,605,301,304
050,36,077,"New York","Otsego County",4,43,586,309,277
050,36,077,"New York","Otsego County",4,44,569,294,275
050,36,077,"New York","Otsego County",4,45,537,280,257
050,36,077,"New York","Otsego County",4,46,519,267,252
050,36,077,"New York","Otsego County",4,47,548,272,276
050,36,077,"New York","Otsego County",4,48,550,281,269
050,36,077,"New York","Otsego County",4,49,570,272,298
050,36,077,"New York","Otsego County",4,50,627,305,322
050,36,077,"New York","Otsego County",4,51,697,354,343
050,36,077,"New York","Otsego County",4,52,691,344,347
050,36,077,"New York","Otsego County",4,53,704,357,347
050,36,077,"New York","Otsego County",4,54,681,341,340
050,36,077,"New York","Otsego County",4,55,688,335,353
050,36,077,"New York","Otsego County",4,56,729,370,359
050,36,077,"New York","Otsego County",4,57,765,372,393
050,36,077,"New York","Otsego County",4,58,829,414,415
050,36,077,"New York","Otsego County",4,59,861,437,424
050,36,077,"New York","Otsego County",4,60,862,420,442
050,36,077,"New York","Otsego County",4,61,882,436,446
050,36,077,"New York","Otsego County",4,62,895,453,442
050,36,077,"New York","Otsego County",4,63,906,451,455
050,36,077,"New York","Otsego County",4,64,869,422,447
050,36,077,"New York","Otsego County",4,65,857,416,441
050,36,077,"New York","Otsego County",4,66,807,360,447
050,36,077,"New York","Otsego County",4,67,825,391,434
050,36,077,"New York","Otsego County",4,68,781,369,412
050,36,077,"New York","Otsego County",4,69,752,370,382
050,36,077,"New York","Otsego County",4,70,750,369,381
050,36,077,"New York","Otsego County",4,71,746,363,383
050,36,077,"New York","Otsego County",4,72,689,352,337
050,36,077,"New York","Otsego County",4,73,651,321,330
050,36,077,"New York","Otsego County",4,74,646,333,313
050,36,077,"New York","Otsego County",4,75,685,335,350
050,36,077,"New York","Otsego County",4,76,463,213,250
050,36,077,"New York","Otsego County",4,77,438,195,243
050,36,077,"New York","Otsego County",4,78,429,190,239
050,36,077,"New York","Otsego County",4,79,438,208,230
050,36,077,"New York","Otsego County",4,80,376,171,205
050,36,077,"New York","Otsego County",4,81,332,155,177
050,36,077,"New York","Otsego County",4,82,305,140,165
050,36,077,"New York","Otsego County",4,83,287,128,159
050,36,077,"New York","Otsego County",4,84,234,96,138
050,36,077,"New York","Otsego County",4,85,1366,517,849
050,36,077,"New York","Otsego County",5,0,471,240,231
050,36,077,"New York","Otsego County",5,1,456,224,232
050,36,077,"New York","Otsego County",5,2,459,225,234
050,36,077,"New York","Otsego County",5,3,487,256,231
050,36,077,"New York","Otsego County",5,4,502,273,229
050,36,077,"New York","Otsego County",5,5,471,229,242
050,36,077,"New York","Otsego County",5,6,484,244,240
050,36,077,"New York","Otsego County",5,7,471,249,222
050,36,077,"New York","Otsego County",5,8,492,252,240
050,36,077,"New York","Otsego County",5,9,499,253,246
050,36,077,"New York","Otsego County",5,10,482,240,242
050,36,077,"New York","Otsego County",5,11,499,273,226
050,36,077,"New York","Otsego County",5,12,490,273,217
050,36,077,"New York","Otsego County",5,13,478,262,216
050,36,077,"New York","Otsego County",5,14,490,258,232
050,36,077,"New York","Otsego County",5,15,517,252,265
050,36,077,"New York","Otsego County",5,16,534,275,259
050,36,077,"New York","Otsego County",5,17,607,299,308
050,36,077,"New York","Otsego County",5,18,1989,774,1215
050,36,077,"New York","Otsego County",5,19,2676,1128,1548
050,36,077,"New York","Otsego County",5,20,2603,1077,1526
050,36,077,"New York","Otsego County",5,21,2103,984,1119
050,36,077,"New York","Otsego County",5,22,1405,701,704
050,36,077,"New York","Otsego County",5,23,797,370,427
050,36,077,"New York","Otsego County",5,24,671,354,317
050,36,077,"New York","Otsego County",5,25,595,310,285
050,36,077,"New York","Otsego County",5,26,580,285,295
050,36,077,"New York","Otsego County",5,27,553,297,256
050,36,077,"New York","Otsego County",5,28,595,305,290
050,36,077,"New York","Otsego County",5,29,574,295,279
050,36,077,"New York","Otsego County",5,30,625,325,300
050,36,077,"New York","Otsego County",5,31,583,282,301
050,36,077,"New York","Otsego County",5,32,570,278,292
050,36,077,"New York","Otsego County",5,33,560,277,283
050,36,077,"New York","Otsego County",5,34,616,311,305
050,36,077,"New York","Otsego County",5,35,577,306,271
050,36,077,"New York","Otsego County",5,36,606,316,290
050,36,077,"New York","Otsego County",5,37,570,299,271
050,36,077,"New York","Otsego County",5,38,591,309,282
050,36,077,"New York","Otsego County",5,39,600,304,296
050,36,077,"New York","Otsego County",5,40,598,303,295
050,36,077,"New York","Otsego County",5,41,592,299,293
050,36,077,"New York","Otsego County",5,42,609,305,304
050,36,077,"New York","Otsego County",5,43,606,297,309
050,36,077,"New York","Otsego County",5,44,593,317,276
050,36,077,"New York","Otsego County",5,45,582,302,280
050,36,077,"New York","Otsego County",5,46,534,283,251
050,36,077,"New York","Otsego County",5,47,528,269,259
050,36,077,"New York","Otsego County",5,48,551,268,283
050,36,077,"New York","Otsego County",5,49,551,271,280
050,36,077,"New York","Otsego County",5,50,582,278,304
050,36,077,"New York","Otsego County",5,51,624,300,324
050,36,077,"New York","Otsego County",5,52,686,352,334
050,36,077,"New York","Otsego County",5,53,690,346,344
050,36,077,"New York","Otsego County",5,54,698,355,343
050,36,077,"New York","Otsego County",5,55,676,339,337
050,36,077,"New York","Otsego County",5,56,687,343,344
050,36,077,"New York","Otsego County",5,57,725,363,362
050,36,077,"New York","Otsego County",5,58,758,377,381
050,36,077,"New York","Otsego County",5,59,836,420,416
050,36,077,"New York","Otsego County",5,60,850,434,416
050,36,077,"New York","Otsego County",5,61,843,411,432
050,36,077,"New York","Otsego County",5,62,868,435,433
050,36,077,"New York","Otsego County",5,63,885,449,436
050,36,077,"New York","Otsego County",5,64,893,445,448
050,36,077,"New York","Otsego County",5,65,863,414,449
050,36,077,"New York","Otsego County",5,66,830,405,425
050,36,077,"New York","Otsego County",5,67,804,354,450
050,36,077,"New York","Otsego County",5,68,811,388,423
050,36,077,"New York","Otsego County",5,69,776,368,408
050,36,077,"New York","Otsego County",5,70,741,370,371
050,36,077,"New York","Otsego County",5,71,727,363,364
050,36,077,"New York","Otsego County",5,72,731,351,380
050,36,077,"New York","Otsego County",5,73,663,337,326
050,36,077,"New York","Otsego County",5,74,634,314,320
050,36,077,"New York","Otsego County",5,75,629,322,307
050,36,077,"New York","Otsego County",5,76,664,318,346
050,36,077,"New York","Otsego County",5,77,449,205,244
050,36,077,"New York","Otsego County",5,78,420,186,234
050,36,077,"New York","Otsego County",5,79,403,175,228
050,36,077,"New York","Otsego County",5,80,415,194,221
050,36,077,"New York","Otsego County",5,81,367,165,202
050,36,077,"New York","Otsego County",5,82,311,138,173
050,36,077,"New York","Otsego County",5,83,286,130,156
050,36,077,"New York","Otsego County",5,84,254,117,137
050,36,077,"New York","Otsego County",5,85,1375,521,854
050,36,079,"New York","Putnam County",1,0,828,420,408
050,36,079,"New York","Putnam County",1,1,880,443,437
050,36,079,"New York","Putnam County",1,2,933,441,492
050,36,079,"New York","Putnam County",1,3,893,448,445
050,36,079,"New York","Putnam County",1,4,910,484,426
050,36,079,"New York","Putnam County",1,5,1003,513,490
050,36,079,"New York","Putnam County",1,6,976,497,479
050,36,079,"New York","Putnam County",1,7,981,507,474
050,36,079,"New York","Putnam County",1,8,1015,511,504
050,36,079,"New York","Putnam County",1,9,1068,547,521
050,36,079,"New York","Putnam County",1,10,1103,569,534
050,36,079,"New York","Putnam County",1,11,1112,575,537
050,36,079,"New York","Putnam County",1,12,1194,632,562
050,36,079,"New York","Putnam County",1,13,1215,632,583
050,36,079,"New York","Putnam County",1,14,1254,641,613
050,36,079,"New York","Putnam County",1,15,1283,641,642
050,36,079,"New York","Putnam County",1,16,1350,681,669
050,36,079,"New York","Putnam County",1,17,1359,681,678
050,36,079,"New York","Putnam County",1,18,1178,627,551
050,36,079,"New York","Putnam County",1,19,983,512,471
050,36,079,"New York","Putnam County",1,20,1057,544,513
050,36,079,"New York","Putnam County",1,21,1131,598,533
050,36,079,"New York","Putnam County",1,22,1181,624,557
050,36,079,"New York","Putnam County",1,23,1208,638,570
050,36,079,"New York","Putnam County",1,24,1213,648,565
050,36,079,"New York","Putnam County",1,25,1158,627,531
050,36,079,"New York","Putnam County",1,26,1088,572,516
050,36,079,"New York","Putnam County",1,27,1071,578,493
050,36,079,"New York","Putnam County",1,28,1004,528,476
050,36,079,"New York","Putnam County",1,29,1025,518,507
050,36,079,"New York","Putnam County",1,30,989,510,479
050,36,079,"New York","Putnam County",1,31,1016,528,488
050,36,079,"New York","Putnam County",1,32,1083,570,513
050,36,079,"New York","Putnam County",1,33,1057,526,531
050,36,079,"New York","Putnam County",1,34,1118,572,546
050,36,079,"New York","Putnam County",1,35,1215,638,577
050,36,079,"New York","Putnam County",1,36,1195,610,585
050,36,079,"New York","Putnam County",1,37,1173,641,532
050,36,079,"New York","Putnam County",1,38,1199,632,567
050,36,079,"New York","Putnam County",1,39,1238,653,585
050,36,079,"New York","Putnam County",1,40,1174,610,564
050,36,079,"New York","Putnam County",1,41,1132,592,540
050,36,079,"New York","Putnam County",1,42,1171,593,578
050,36,079,"New York","Putnam County",1,43,1132,569,563
050,36,079,"New York","Putnam County",1,44,1220,605,615
050,36,079,"New York","Putnam County",1,45,1248,634,614
050,36,079,"New York","Putnam County",1,46,1247,634,613
050,36,079,"New York","Putnam County",1,47,1278,654,624
050,36,079,"New York","Putnam County",1,48,1414,715,699
050,36,079,"New York","Putnam County",1,49,1550,780,770
050,36,079,"New York","Putnam County",1,50,1506,741,765
050,36,079,"New York","Putnam County",1,51,1502,766,736
050,36,079,"New York","Putnam County",1,52,1543,789,754
050,36,079,"New York","Putnam County",1,53,1585,801,784
050,36,079,"New York","Putnam County",1,54,1666,840,826
050,36,079,"New York","Putnam County",1,55,1766,895,871
050,36,079,"New York","Putnam County",1,56,1723,887,836
050,36,079,"New York","Putnam County",1,57,1666,822,844
050,36,079,"New York","Putnam County",1,58,1685,817,868
050,36,079,"New York","Putnam County",1,59,1662,824,838
050,36,079,"New York","Putnam County",1,60,1591,794,797
050,36,079,"New York","Putnam County",1,61,1526,778,748
050,36,079,"New York","Putnam County",1,62,1498,768,730
050,36,079,"New York","Putnam County",1,63,1400,702,698
050,36,079,"New York","Putnam County",1,64,1345,672,673
050,36,079,"New York","Putnam County",1,65,1302,650,652
050,36,079,"New York","Putnam County",1,66,1201,591,610
050,36,079,"New York","Putnam County",1,67,1209,594,615
050,36,079,"New York","Putnam County",1,68,1150,555,595
050,36,079,"New York","Putnam County",1,69,1019,507,512
050,36,079,"New York","Putnam County",1,70,975,471,504
050,36,079,"New York","Putnam County",1,71,959,459,500
050,36,079,"New York","Putnam County",1,72,946,453,493
050,36,079,"New York","Putnam County",1,73,1004,515,489
050,36,079,"New York","Putnam County",1,74,708,344,364
050,36,079,"New York","Putnam County",1,75,705,327,378
050,36,079,"New York","Putnam County",1,76,715,328,387
050,36,079,"New York","Putnam County",1,77,708,331,377
050,36,079,"New York","Putnam County",1,78,615,290,325
050,36,079,"New York","Putnam County",1,79,514,235,279
050,36,079,"New York","Putnam County",1,80,460,203,257
050,36,079,"New York","Putnam County",1,81,417,181,236
050,36,079,"New York","Putnam County",1,82,380,158,222
050,36,079,"New York","Putnam County",1,83,352,140,212
050,36,079,"New York","Putnam County",1,84,316,126,190
050,36,079,"New York","Putnam County",1,85,1856,634,1222
050,36,079,"New York","Putnam County",2,0,843,432,411
050,36,079,"New York","Putnam County",2,1,873,443,430
050,36,079,"New York","Putnam County",2,2,928,447,481
050,36,079,"New York","Putnam County",2,3,903,448,455
050,36,079,"New York","Putnam County",2,4,913,479,434
050,36,079,"New York","Putnam County",2,5,984,510,474
050,36,079,"New York","Putnam County",2,6,991,506,485
050,36,079,"New York","Putnam County",2,7,986,509,477
050,36,079,"New York","Putnam County",2,8,1009,511,498
050,36,079,"New York","Putnam County",2,9,1059,538,521
050,36,079,"New York","Putnam County",2,10,1097,562,535
050,36,079,"New York","Putnam County",2,11,1111,574,537
050,36,079,"New York","Putnam County",2,12,1182,622,560
050,36,079,"New York","Putnam County",2,13,1212,631,581
050,36,079,"New York","Putnam County",2,14,1246,639,607
050,36,079,"New York","Putnam County",2,15,1277,643,634
050,36,079,"New York","Putnam County",2,16,1341,676,665
050,36,079,"New York","Putnam County",2,17,1354,682,672
050,36,079,"New York","Putnam County",2,18,1169,617,552
050,36,079,"New York","Putnam County",2,19,984,515,469
050,36,079,"New York","Putnam County",2,20,1076,558,518
050,36,079,"New York","Putnam County",2,21,1120,590,530
050,36,079,"New York","Putnam County",2,22,1179,624,555
050,36,079,"New York","Putnam County",2,23,1201,632,569
050,36,079,"New York","Putnam County",2,24,1200,643,557
050,36,079,"New York","Putnam County",2,25,1165,627,538
050,36,079,"New York","Putnam County",2,26,1097,580,517
050,36,079,"New York","Putnam County",2,27,1059,567,492
050,36,079,"New York","Putnam County",2,28,1024,540,484
050,36,079,"New York","Putnam County",2,29,1028,523,505
050,36,079,"New York","Putnam County",2,30,1016,519,497
050,36,079,"New York","Putnam County",2,31,1013,526,487
050,36,079,"New York","Putnam County",2,32,1076,559,517
050,36,079,"New York","Putnam County",2,33,1070,539,531
050,36,079,"New York","Putnam County",2,34,1125,575,550
050,36,079,"New York","Putnam County",2,35,1210,631,579
050,36,079,"New York","Putnam County",2,36,1200,619,581
050,36,079,"New York","Putnam County",2,37,1191,642,549
050,36,079,"New York","Putnam County",2,38,1207,645,562
050,36,079,"New York","Putnam County",2,39,1231,651,580
050,36,079,"New York","Putnam County",2,40,1196,621,575
050,36,079,"New York","Putnam County",2,41,1149,598,551
050,36,079,"New York","Putnam County",2,42,1161,594,567
050,36,079,"New York","Putnam County",2,43,1155,583,572
050,36,079,"New York","Putnam County",2,44,1191,594,597
050,36,079,"New York","Putnam County",2,45,1251,633,618
050,36,079,"New York","Putnam County",2,46,1243,633,610
050,36,079,"New York","Putnam County",2,47,1271,649,622
050,36,079,"New York","Putnam County",2,48,1380,703,677
050,36,079,"New York","Putnam County",2,49,1526,770,756
050,36,079,"New York","Putnam County",2,50,1516,752,764
050,36,079,"New York","Putnam County",2,51,1501,759,742
050,36,079,"New York","Putnam County",2,52,1531,783,748
050,36,079,"New York","Putnam County",2,53,1567,795,772
050,36,079,"New York","Putnam County",2,54,1632,826,806
050,36,079,"New York","Putnam County",2,55,1737,882,855
050,36,079,"New York","Putnam County",2,56,1727,887,840
050,36,079,"New York","Putnam County",2,57,1666,832,834
050,36,079,"New York","Putnam County",2,58,1670,815,855
050,36,079,"New York","Putnam County",2,59,1674,824,850
050,36,079,"New York","Putnam County",2,60,1594,795,799
050,36,079,"New York","Putnam County",2,61,1533,779,754
050,36,079,"New York","Putnam County",2,62,1491,763,728
050,36,079,"New York","Putnam County",2,63,1431,722,709
050,36,079,"New York","Putnam County",2,64,1338,670,668
050,36,079,"New York","Putnam County",2,65,1300,646,654
050,36,079,"New York","Putnam County",2,66,1223,603,620
050,36,079,"New York","Putnam County",2,67,1195,585,610
050,36,079,"New York","Putnam County",2,68,1145,554,591
050,36,079,"New York","Putnam County",2,69,1053,517,536
050,36,079,"New York","Putnam County",2,70,978,475,503
050,36,079,"New York","Putnam County",2,71,957,459,498
050,36,079,"New York","Putnam County",2,72,929,445,484
050,36,079,"New York","Putnam County",2,73,1031,521,510
050,36,079,"New York","Putnam County",2,74,723,356,367
050,36,079,"New York","Putnam County",2,75,705,330,375
050,36,079,"New York","Putnam County",2,76,703,324,379
050,36,079,"New York","Putnam County",2,77,710,326,384
050,36,079,"New York","Putnam County",2,78,614,285,329
050,36,079,"New York","Putnam County",2,79,522,239,283
050,36,079,"New York","Putnam County",2,80,459,204,255
050,36,079,"New York","Putnam County",2,81,419,183,236
050,36,079,"New York","Putnam County",2,82,381,158,223
050,36,079,"New York","Putnam County",2,83,351,142,209
050,36,079,"New York","Putnam County",2,84,320,128,192
050,36,079,"New York","Putnam County",2,85,1836,625,1211
050,36,079,"New York","Putnam County",3,0,882,424,458
050,36,079,"New York","Putnam County",3,1,903,471,432
050,36,079,"New York","Putnam County",3,2,910,459,451
050,36,079,"New York","Putnam County",3,3,947,455,492
050,36,079,"New York","Putnam County",3,4,914,448,466
050,36,079,"New York","Putnam County",3,5,951,502,449
050,36,079,"New York","Putnam County",3,6,993,517,476
050,36,079,"New York","Putnam County",3,7,1004,503,501
050,36,079,"New York","Putnam County",3,8,1002,519,483
050,36,079,"New York","Putnam County",3,9,1013,530,483
050,36,079,"New York","Putnam County",3,10,1067,545,522
050,36,079,"New York","Putnam County",3,11,1105,568,537
050,36,079,"New York","Putnam County",3,12,1127,583,544
050,36,079,"New York","Putnam County",3,13,1197,620,577
050,36,079,"New York","Putnam County",3,14,1223,634,589
050,36,079,"New York","Putnam County",3,15,1267,658,609
050,36,079,"New York","Putnam County",3,16,1292,648,644
050,36,079,"New York","Putnam County",3,17,1330,671,659
050,36,079,"New York","Putnam County",3,18,1170,608,562
050,36,079,"New York","Putnam County",3,19,959,501,458
050,36,079,"New York","Putnam County",3,20,1073,568,505
050,36,079,"New York","Putnam County",3,21,1120,582,538
050,36,079,"New York","Putnam County",3,22,1186,630,556
050,36,079,"New York","Putnam County",3,23,1174,602,572
050,36,079,"New York","Putnam County",3,24,1165,613,552
050,36,079,"New York","Putnam County",3,25,1203,656,547
050,36,079,"New York","Putnam County",3,26,1113,593,520
050,36,079,"New York","Putnam County",3,27,1119,573,546
050,36,079,"New York","Putnam County",3,28,1048,556,492
050,36,079,"New York","Putnam County",3,29,1058,558,500
050,36,079,"New York","Putnam County",3,30,1054,530,524
050,36,079,"New York","Putnam County",3,31,1090,569,521
050,36,079,"New York","Putnam County",3,32,1113,580,533
050,36,079,"New York","Putnam County",3,33,1122,564,558
050,36,079,"New York","Putnam County",3,34,1150,578,572
050,36,079,"New York","Putnam County",3,35,1229,641,588
050,36,079,"New York","Putnam County",3,36,1243,645,598
050,36,079,"New York","Putnam County",3,37,1237,640,597
050,36,079,"New York","Putnam County",3,38,1253,681,572
050,36,079,"New York","Putnam County",3,39,1252,661,591
050,36,079,"New York","Putnam County",3,40,1246,634,612
050,36,079,"New York","Putnam County",3,41,1246,655,591
050,36,079,"New York","Putnam County",3,42,1185,611,574
050,36,079,"New York","Putnam County",3,43,1204,635,569
050,36,079,"New York","Putnam County",3,44,1173,589,584
050,36,079,"New York","Putnam County",3,45,1203,602,601
050,36,079,"New York","Putnam County",3,46,1257,637,620
050,36,079,"New York","Putnam County",3,47,1249,644,605
050,36,079,"New York","Putnam County",3,48,1259,654,605
050,36,079,"New York","Putnam County",3,49,1391,710,681
050,36,079,"New York","Putnam County",3,50,1523,774,749
050,36,079,"New York","Putnam County",3,51,1487,735,752
050,36,079,"New York","Putnam County",3,52,1512,770,742
050,36,079,"New York","Putnam County",3,53,1512,772,740
050,36,079,"New York","Putnam County",3,54,1557,793,764
050,36,079,"New York","Putnam County",3,55,1636,826,810
050,36,079,"New York","Putnam County",3,56,1677,853,824
050,36,079,"New York","Putnam County",3,57,1687,857,830
050,36,079,"New York","Putnam County",3,58,1637,816,821
050,36,079,"New York","Putnam County",3,59,1652,796,856
050,36,079,"New York","Putnam County",3,60,1633,811,822
050,36,079,"New York","Putnam County",3,61,1557,789,768
050,36,079,"New York","Putnam County",3,62,1485,750,735
050,36,079,"New York","Putnam County",3,63,1440,732,708
050,36,079,"New York","Putnam County",3,64,1387,701,686
050,36,079,"New York","Putnam County",3,65,1317,657,660
050,36,079,"New York","Putnam County",3,66,1269,625,644
050,36,079,"New York","Putnam County",3,67,1193,597,596
050,36,079,"New York","Putnam County",3,68,1176,570,606
050,36,079,"New York","Putnam County",3,69,1116,529,587
050,36,079,"New York","Putnam County",3,70,1039,508,531
050,36,079,"New York","Putnam County",3,71,955,462,493
050,36,079,"New York","Putnam County",3,72,930,441,489
050,36,079,"New York","Putnam County",3,73,906,428,478
050,36,079,"New York","Putnam County",3,74,994,495,499
050,36,079,"New York","Putnam County",3,75,691,340,351
050,36,079,"New York","Putnam County",3,76,701,332,369
050,36,079,"New York","Putnam County",3,77,676,303,373
050,36,079,"New York","Putnam County",3,78,707,320,387
050,36,079,"New York","Putnam County",3,79,581,269,312
050,36,079,"New York","Putnam County",3,80,511,231,280
050,36,079,"New York","Putnam County",3,81,436,188,248
050,36,079,"New York","Putnam County",3,82,387,165,222
050,36,079,"New York","Putnam County",3,83,366,146,220
050,36,079,"New York","Putnam County",3,84,314,126,188
050,36,079,"New York","Putnam County",3,85,1910,663,1247
050,36,079,"New York","Putnam County",4,0,928,469,459
050,36,079,"New York","Putnam County",4,1,933,461,472
050,36,079,"New York","Putnam County",4,2,942,484,458
050,36,079,"New York","Putnam County",4,3,964,487,477
050,36,079,"New York","Putnam County",4,4,958,463,495
050,36,079,"New York","Putnam County",4,5,941,466,475
050,36,079,"New York","Putnam County",4,6,981,513,468
050,36,079,"New York","Putnam County",4,7,1034,534,500
050,36,079,"New York","Putnam County",4,8,1021,502,519
050,36,079,"New York","Putnam County",4,9,1027,534,493
050,36,079,"New York","Putnam County",4,10,1006,518,488
050,36,079,"New York","Putnam County",4,11,1113,565,548
050,36,079,"New York","Putnam County",4,12,1112,574,538
050,36,079,"New York","Putnam County",4,13,1139,577,562
050,36,079,"New York","Putnam County",4,14,1196,625,571
050,36,079,"New York","Putnam County",4,15,1239,638,601
050,36,079,"New York","Putnam County",4,16,1268,638,630
050,36,079,"New York","Putnam County",4,17,1293,640,653
050,36,079,"New York","Putnam County",4,18,1132,590,542
050,36,079,"New York","Putnam County",4,19,957,494,463
050,36,079,"New York","Putnam County",4,20,1011,529,482
050,36,079,"New York","Putnam County",4,21,1102,581,521
050,36,079,"New York","Putnam County",4,22,1182,621,561
050,36,079,"New York","Putnam County",4,23,1164,606,558
050,36,079,"New York","Putnam County",4,24,1121,570,551
050,36,079,"New York","Putnam County",4,25,1116,599,517
050,36,079,"New York","Putnam County",4,26,1116,612,504
050,36,079,"New York","Putnam County",4,27,1045,549,496
050,36,079,"New York","Putnam County",4,28,1107,573,534
050,36,079,"New York","Putnam County",4,29,1034,544,490
050,36,079,"New York","Putnam County",4,30,1071,556,515
050,36,079,"New York","Putnam County",4,31,1088,555,533
050,36,079,"New York","Putnam County",4,32,1098,567,531
050,36,079,"New York","Putnam County",4,33,1150,589,561
050,36,079,"New York","Putnam County",4,34,1214,618,596
050,36,079,"New York","Putnam County",4,35,1236,630,606
050,36,079,"New York","Putnam County",4,36,1273,665,608
050,36,079,"New York","Putnam County",4,37,1288,668,620
050,36,079,"New York","Putnam County",4,38,1270,652,618
050,36,079,"New York","Putnam County",4,39,1316,704,612
050,36,079,"New York","Putnam County",4,40,1269,667,602
050,36,079,"New York","Putnam County",4,41,1308,669,639
050,36,079,"New York","Putnam County",4,42,1262,664,598
050,36,079,"New York","Putnam County",4,43,1215,627,588
050,36,079,"New York","Putnam County",4,44,1232,651,581
050,36,079,"New York","Putnam County",4,45,1198,595,603
050,36,079,"New York","Putnam County",4,46,1221,612,609
050,36,079,"New York","Putnam County",4,47,1273,640,633
050,36,079,"New York","Putnam County",4,48,1223,636,587
050,36,079,"New York","Putnam County",4,49,1250,649,601
050,36,079,"New York","Putnam County",4,50,1362,688,674
050,36,079,"New York","Putnam County",4,51,1484,752,732
050,36,079,"New York","Putnam County",4,52,1488,734,754
050,36,079,"New York","Putnam County",4,53,1493,763,730
050,36,079,"New York","Putnam County",4,54,1483,755,728
050,36,079,"New York","Putnam County",4,55,1556,789,767
050,36,079,"New York","Putnam County",4,56,1591,802,789
050,36,079,"New York","Putnam County",4,57,1617,823,794
050,36,079,"New York","Putnam County",4,58,1650,835,815
050,36,079,"New York","Putnam County",4,59,1628,818,810
050,36,079,"New York","Putnam County",4,60,1578,773,805
050,36,079,"New York","Putnam County",4,61,1605,806,799
050,36,079,"New York","Putnam County",4,62,1492,739,753
050,36,079,"New York","Putnam County",4,63,1449,740,709
050,36,079,"New York","Putnam County",4,64,1414,706,708
050,36,079,"New York","Putnam County",4,65,1331,680,651
050,36,079,"New York","Putnam County",4,66,1296,645,651
050,36,079,"New York","Putnam County",4,67,1241,611,630
050,36,079,"New York","Putnam County",4,68,1182,589,593
050,36,079,"New York","Putnam County",4,69,1161,561,600
050,36,079,"New York","Putnam County",4,70,1095,513,582
050,36,079,"New York","Putnam County",4,71,1002,488,514
050,36,079,"New York","Putnam County",4,72,931,449,482
050,36,079,"New York","Putnam County",4,73,917,432,485
050,36,079,"New York","Putnam County",4,74,886,417,469
050,36,079,"New York","Putnam County",4,75,944,471,473
050,36,079,"New York","Putnam County",4,76,676,323,353
050,36,079,"New York","Putnam County",4,77,662,312,350
050,36,079,"New York","Putnam County",4,78,661,298,363
050,36,079,"New York","Putnam County",4,79,669,301,368
050,36,079,"New York","Putnam County",4,80,556,256,300
050,36,079,"New York","Putnam County",4,81,495,224,271
050,36,079,"New York","Putnam County",4,82,410,176,234
050,36,079,"New York","Putnam County",4,83,380,156,224
050,36,079,"New York","Putnam County",4,84,336,132,204
050,36,079,"New York","Putnam County",4,85,1954,691,1263
050,36,079,"New York","Putnam County",5,0,929,469,460
050,36,079,"New York","Putnam County",5,1,971,489,482
050,36,079,"New York","Putnam County",5,2,945,469,476
050,36,079,"New York","Putnam County",5,3,971,506,465
050,36,079,"New York","Putnam County",5,4,945,471,474
050,36,079,"New York","Putnam County",5,5,964,474,490
050,36,079,"New York","Putnam County",5,6,966,483,483
050,36,079,"New York","Putnam County",5,7,983,507,476
050,36,079,"New York","Putnam County",5,8,1084,559,525
050,36,079,"New York","Putnam County",5,9,1028,513,515
050,36,079,"New York","Putnam County",5,10,1052,541,511
050,36,079,"New York","Putnam County",5,11,1016,514,502
050,36,079,"New York","Putnam County",5,12,1121,575,546
050,36,079,"New York","Putnam County",5,13,1126,580,546
050,36,079,"New York","Putnam County",5,14,1140,586,554
050,36,079,"New York","Putnam County",5,15,1196,629,567
050,36,079,"New York","Putnam County",5,16,1264,647,617
050,36,079,"New York","Putnam County",5,17,1266,638,628
050,36,079,"New York","Putnam County",5,18,1104,569,535
050,36,079,"New York","Putnam County",5,19,916,472,444
050,36,079,"New York","Putnam County",5,20,1038,538,500
050,36,079,"New York","Putnam County",5,21,1070,560,510
050,36,079,"New York","Putnam County",5,22,1154,615,539
050,36,079,"New York","Putnam County",5,23,1163,613,550
050,36,079,"New York","Putnam County",5,24,1103,584,519
050,36,079,"New York","Putnam County",5,25,1070,557,513
050,36,079,"New York","Putnam County",5,26,1042,564,478
050,36,079,"New York","Putnam County",5,27,1054,564,490
050,36,079,"New York","Putnam County",5,28,1036,560,476
050,36,079,"New York","Putnam County",5,29,1089,551,538
050,36,079,"New York","Putnam County",5,30,1026,539,487
050,36,079,"New York","Putnam County",5,31,1079,568,511
050,36,079,"New York","Putnam County",5,32,1096,548,548
050,36,079,"New York","Putnam County",5,33,1083,569,514
050,36,079,"New York","Putnam County",5,34,1191,611,580
050,36,079,"New York","Putnam County",5,35,1216,608,608
050,36,079,"New York","Putnam County",5,36,1283,665,618
050,36,079,"New York","Putnam County",5,37,1304,675,629
050,36,079,"New York","Putnam County",5,38,1294,682,612
050,36,079,"New York","Putnam County",5,39,1287,663,624
050,36,079,"New York","Putnam County",5,40,1326,708,618
050,36,079,"New York","Putnam County",5,41,1301,688,613
050,36,079,"New York","Putnam County",5,42,1326,679,647
050,36,079,"New York","Putnam County",5,43,1258,658,600
050,36,079,"New York","Putnam County",5,44,1229,623,606
050,36,079,"New York","Putnam County",5,45,1236,650,586
050,36,079,"New York","Putnam County",5,46,1199,579,620
050,36,079,"New York","Putnam County",5,47,1204,596,608
050,36,079,"New York","Putnam County",5,48,1273,649,624
050,36,079,"New York","Putnam County",5,49,1236,641,595
050,36,079,"New York","Putnam County",5,50,1231,640,591
050,36,079,"New York","Putnam County",5,51,1341,679,662
050,36,079,"New York","Putnam County",5,52,1493,756,737
050,36,079,"New York","Putnam County",5,53,1476,735,741
050,36,079,"New York","Putnam County",5,54,1470,762,708
050,36,079,"New York","Putnam County",5,55,1479,751,728
050,36,079,"New York","Putnam County",5,56,1520,768,752
050,36,079,"New York","Putnam County",5,57,1552,784,768
050,36,079,"New York","Putnam County",5,58,1586,806,780
050,36,079,"New York","Putnam County",5,59,1618,816,802
050,36,079,"New York","Putnam County",5,60,1576,791,785
050,36,079,"New York","Putnam County",5,61,1563,774,789
050,36,079,"New York","Putnam County",5,62,1551,777,774
050,36,079,"New York","Putnam County",5,63,1467,734,733
050,36,079,"New York","Putnam County",5,64,1412,711,701
050,36,079,"New York","Putnam County",5,65,1369,675,694
050,36,079,"New York","Putnam County",5,66,1294,652,642
050,36,079,"New York","Putnam County",5,67,1263,624,639
050,36,079,"New York","Putnam County",5,68,1228,613,615
050,36,079,"New York","Putnam County",5,69,1148,560,588
050,36,079,"New York","Putnam County",5,70,1133,542,591
050,36,079,"New York","Putnam County",5,71,1074,499,575
050,36,079,"New York","Putnam County",5,72,998,476,522
050,36,079,"New York","Putnam County",5,73,924,440,484
050,36,079,"New York","Putnam County",5,74,881,412,469
050,36,079,"New York","Putnam County",5,75,862,396,466
050,36,079,"New York","Putnam County",5,76,936,462,474
050,36,079,"New York","Putnam County",5,77,641,304,337
050,36,079,"New York","Putnam County",5,78,642,299,343
050,36,079,"New York","Putnam County",5,79,631,288,343
050,36,079,"New York","Putnam County",5,80,648,292,356
050,36,079,"New York","Putnam County",5,81,536,245,291
050,36,079,"New York","Putnam County",5,82,470,208,262
050,36,079,"New York","Putnam County",5,83,400,166,234
050,36,079,"New York","Putnam County",5,84,343,138,205
050,36,079,"New York","Putnam County",5,85,2051,730,1321
050,36,081,"New York","Queens County",1,0,28936,14770,14166
050,36,081,"New York","Queens County",1,1,28546,14521,14025
050,36,081,"New York","Queens County",1,2,28937,14861,14076
050,36,081,"New York","Queens County",1,3,28762,14722,14040
050,36,081,"New York","Queens County",1,4,28361,14520,13841
050,36,081,"New York","Queens County",1,5,28065,14312,13753
050,36,081,"New York","Queens County",1,6,27416,14001,13415
050,36,081,"New York","Queens County",1,7,27395,13948,13447
050,36,081,"New York","Queens County",1,8,26821,13758,13063
050,36,081,"New York","Queens County",1,9,26777,13916,12861
050,36,081,"New York","Queens County",1,10,25379,13027,12352
050,36,081,"New York","Queens County",1,11,25497,13164,12333
050,36,081,"New York","Queens County",1,12,26119,13362,12757
050,36,081,"New York","Queens County",1,13,26010,13411,12599
050,36,081,"New York","Queens County",1,14,25327,13062,12265
050,36,081,"New York","Queens County",1,15,25570,13153,12417
050,36,081,"New York","Queens County",1,16,26015,13380,12635
050,36,081,"New York","Queens County",1,17,25740,13231,12509
050,36,081,"New York","Queens County",1,18,23796,12323,11473
050,36,081,"New York","Queens County",1,19,21974,11417,10557
050,36,081,"New York","Queens County",1,20,22783,11545,11238
050,36,081,"New York","Queens County",1,21,23719,11772,11947
050,36,081,"New York","Queens County",1,22,25463,12435,13028
050,36,081,"New York","Queens County",1,23,28079,13570,14509
050,36,081,"New York","Queens County",1,24,30939,14976,15963
050,36,081,"New York","Queens County",1,25,33070,16055,17015
050,36,081,"New York","Queens County",1,26,34843,17010,17833
050,36,081,"New York","Queens County",1,27,36614,17987,18627
050,36,081,"New York","Queens County",1,28,38325,18932,19393
050,36,081,"New York","Queens County",1,29,40422,20258,20164
050,36,081,"New York","Queens County",1,30,40750,20534,20216
050,36,081,"New York","Queens County",1,31,39703,20155,19548
050,36,081,"New York","Queens County",1,32,38278,19251,19027
050,36,081,"New York","Queens County",1,33,37706,19171,18535
050,36,081,"New York","Queens County",1,34,36811,18889,17922
050,36,081,"New York","Queens County",1,35,35911,18391,17520
050,36,081,"New York","Queens County",1,36,34390,17403,16987
050,36,081,"New York","Queens County",1,37,34667,17580,17087
050,36,081,"New York","Queens County",1,38,33749,16952,16797
050,36,081,"New York","Queens County",1,39,33068,16701,16367
050,36,081,"New York","Queens County",1,40,33011,16515,16496
050,36,081,"New York","Queens County",1,41,32029,15937,16092
050,36,081,"New York","Queens County",1,42,31546,15666,15880
050,36,081,"New York","Queens County",1,43,30841,15237,15604
050,36,081,"New York","Queens County",1,44,30571,15088,15483
050,36,081,"New York","Queens County",1,45,31032,15470,15562
050,36,081,"New York","Queens County",1,46,30390,14995,15395
050,36,081,"New York","Queens County",1,47,30550,15223,15327
050,36,081,"New York","Queens County",1,48,31515,15642,15873
050,36,081,"New York","Queens County",1,49,33383,16642,16741
050,36,081,"New York","Queens County",1,50,33508,16540,16968
050,36,081,"New York","Queens County",1,51,32642,16164,16478
050,36,081,"New York","Queens County",1,52,31938,15825,16113
050,36,081,"New York","Queens County",1,53,31819,15692,16127
050,36,081,"New York","Queens County",1,54,32844,16136,16708
050,36,081,"New York","Queens County",1,55,33999,16683,17316
050,36,081,"New York","Queens County",1,56,34090,16625,17465
050,36,081,"New York","Queens County",1,57,34061,16648,17413
050,36,081,"New York","Queens County",1,58,33018,16168,16850
050,36,081,"New York","Queens County",1,59,33184,16218,16966
050,36,081,"New York","Queens County",1,60,33265,16226,17039
050,36,081,"New York","Queens County",1,61,31905,15374,16531
050,36,081,"New York","Queens County",1,62,31580,15124,16456
050,36,081,"New York","Queens County",1,63,30599,14591,16008
050,36,081,"New York","Queens County",1,64,29848,14201,15647
050,36,081,"New York","Queens County",1,65,29080,13746,15334
050,36,081,"New York","Queens County",1,66,26540,12457,14083
050,36,081,"New York","Queens County",1,67,25405,11835,13570
050,36,081,"New York","Queens County",1,68,24295,11246,13049
050,36,081,"New York","Queens County",1,69,23286,10671,12615
050,36,081,"New York","Queens County",1,70,22950,10421,12529
050,36,081,"New York","Queens County",1,71,21407,9614,11793
050,36,081,"New York","Queens County",1,72,20546,9172,11374
050,36,081,"New York","Queens County",1,73,19691,8895,10796
050,36,081,"New York","Queens County",1,74,15441,6821,8620
050,36,081,"New York","Queens County",1,75,14803,6466,8337
050,36,081,"New York","Queens County",1,76,14065,6042,8023
050,36,081,"New York","Queens County",1,77,13665,5840,7825
050,36,081,"New York","Queens County",1,78,12284,5095,7189
050,36,081,"New York","Queens County",1,79,11632,4751,6881
050,36,081,"New York","Queens County",1,80,11097,4484,6613
050,36,081,"New York","Queens County",1,81,10152,4126,6026
050,36,081,"New York","Queens County",1,82,9433,3825,5608
050,36,081,"New York","Queens County",1,83,8645,3433,5212
050,36,081,"New York","Queens County",1,84,7934,3151,4783
050,36,081,"New York","Queens County",1,85,49173,17085,32088
050,36,081,"New York","Queens County",2,0,27799,14237,13562
050,36,081,"New York","Queens County",2,1,28329,14405,13924
050,36,081,"New York","Queens County",2,2,28572,14628,13944
050,36,081,"New York","Queens County",2,3,28471,14567,13904
050,36,081,"New York","Queens County",2,4,28182,14420,13762
050,36,081,"New York","Queens County",2,5,27920,14256,13664
050,36,081,"New York","Queens County",2,6,27384,13970,13414
050,36,081,"New York","Queens County",2,7,27154,13846,13308
050,36,081,"New York","Queens County",2,8,26687,13670,13017
050,36,081,"New York","Queens County",2,9,26615,13793,12822
050,36,081,"New York","Queens County",2,10,25593,13180,12413
050,36,081,"New York","Queens County",2,11,25202,12975,12227
050,36,081,"New York","Queens County",2,12,25968,13306,12662
050,36,081,"New York","Queens County",2,13,25873,13324,12549
050,36,081,"New York","Queens County",2,14,25379,13094,12285
050,36,081,"New York","Queens County",2,15,25415,13079,12336
050,36,081,"New York","Queens County",2,16,25842,13292,12550
050,36,081,"New York","Queens County",2,17,25741,13229,12512
050,36,081,"New York","Queens County",2,18,23679,12260,11419
050,36,081,"New York","Queens County",2,19,21930,11393,10537
050,36,081,"New York","Queens County",2,20,22903,11617,11286
050,36,081,"New York","Queens County",2,21,23602,11742,11860
050,36,081,"New York","Queens County",2,22,25400,12413,12987
050,36,081,"New York","Queens County",2,23,27820,13473,14347
050,36,081,"New York","Queens County",2,24,30404,14708,15696
050,36,081,"New York","Queens County",2,25,32651,15843,16808
050,36,081,"New York","Queens County",2,26,34500,16861,17639
050,36,081,"New York","Queens County",2,27,36089,17738,18351
050,36,081,"New York","Queens County",2,28,37819,18694,19125
050,36,081,"New York","Queens County",2,29,39716,19856,19860
050,36,081,"New York","Queens County",2,30,40626,20479,20147
050,36,081,"New York","Queens County",2,31,39495,19997,19498
050,36,081,"New York","Queens County",2,32,38227,19290,18937
050,36,081,"New York","Queens County",2,33,37483,19025,18458
050,36,081,"New York","Queens County",2,34,36691,18796,17895
050,36,081,"New York","Queens County",2,35,35931,18398,17533
050,36,081,"New York","Queens County",2,36,34274,17393,16881
050,36,081,"New York","Queens County",2,37,34310,17380,16930
050,36,081,"New York","Queens County",2,38,33817,17011,16806
050,36,081,"New York","Queens County",2,39,32763,16502,16261
050,36,081,"New York","Queens County",2,40,33013,16553,16460
050,36,081,"New York","Queens County",2,41,31940,15882,16058
050,36,081,"New York","Queens County",2,42,31308,15556,15752
050,36,081,"New York","Queens County",2,43,30940,15287,15653
050,36,081,"New York","Queens County",2,44,30239,14932,15307
050,36,081,"New York","Queens County",2,45,30840,15317,15523
050,36,081,"New York","Queens County",2,46,30304,14994,15310
050,36,081,"New York","Queens County",2,47,30302,15047,15255
050,36,081,"New York","Queens County",2,48,31187,15464,15723
050,36,081,"New York","Queens County",2,49,32744,16284,16460
050,36,081,"New York","Queens County",2,50,33392,16518,16874
050,36,081,"New York","Queens County",2,51,32513,16071,16442
050,36,081,"New York","Queens County",2,52,32040,15855,16185
050,36,081,"New York","Queens County",2,53,31496,15518,15978
050,36,081,"New York","Queens County",2,54,32424,15920,16504
050,36,081,"New York","Queens County",2,55,33532,16441,17091
050,36,081,"New York","Queens County",2,56,33950,16556,17394
050,36,081,"New York","Queens County",2,57,33910,16540,17370
050,36,081,"New York","Queens County",2,58,33066,16171,16895
050,36,081,"New York","Queens County",2,59,32770,15986,16784
050,36,081,"New York","Queens County",2,60,33211,16178,17033
050,36,081,"New York","Queens County",2,61,31837,15362,16475
050,36,081,"New York","Queens County",2,62,31320,14999,16321
050,36,081,"New York","Queens County",2,63,30627,14584,16043
050,36,081,"New York","Queens County",2,64,29628,14060,15568
050,36,081,"New York","Queens County",2,65,28951,13665,15286
050,36,081,"New York","Queens County",2,66,26872,12596,14276
050,36,081,"New York","Queens County",2,67,25225,11736,13489
050,36,081,"New York","Queens County",2,68,24190,11191,12999
050,36,081,"New York","Queens County",2,69,23199,10600,12599
050,36,081,"New York","Queens County",2,70,22809,10346,12463
050,36,081,"New York","Queens County",2,71,21383,9578,11805
050,36,081,"New York","Queens County",2,72,20290,9024,11266
050,36,081,"New York","Queens County",2,73,20105,9020,11085
050,36,081,"New York","Queens County",2,74,15556,6872,8684
050,36,081,"New York","Queens County",2,75,14696,6414,8282
050,36,081,"New York","Queens County",2,76,13893,5951,7942
050,36,081,"New York","Queens County",2,77,13571,5756,7815
050,36,081,"New York","Queens County",2,78,12212,5077,7135
050,36,081,"New York","Queens County",2,79,11453,4663,6790
050,36,081,"New York","Queens County",2,80,10928,4389,6539
050,36,081,"New York","Queens County",2,81,9987,4037,5950
050,36,081,"New York","Queens County",2,82,9277,3736,5541
050,36,081,"New York","Queens County",2,83,8453,3343,5110
050,36,081,"New York","Queens County",2,84,7742,3033,4709
050,36,081,"New York","Queens County",2,85,47283,16454,30829
050,36,081,"New York","Queens County",3,0,23548,12124,11424
050,36,081,"New York","Queens County",3,1,25870,13254,12616
050,36,081,"New York","Queens County",3,2,26520,13501,13019
050,36,081,"New York","Queens County",3,3,26988,13805,13183
050,36,081,"New York","Queens County",3,4,26963,13792,13171
050,36,081,"New York","Queens County",3,5,26854,13746,13108
050,36,081,"New York","Queens County",3,6,26557,13564,12993
050,36,081,"New York","Queens County",3,7,26292,13469,12823
050,36,081,"New York","Queens County",3,8,26111,13331,12780
050,36,081,"New York","Queens County",3,9,25712,13181,12531
050,36,081,"New York","Queens County",3,10,25763,13361,12402
050,36,081,"New York","Queens County",3,11,24740,12759,11981
050,36,081,"New York","Queens County",3,12,24368,12532,11836
050,36,081,"New York","Queens County",3,13,25419,13011,12408
050,36,081,"New York","Queens County",3,14,25137,12971,12166
050,36,081,"New York","Queens County",3,15,24829,12831,11998
050,36,081,"New York","Queens County",3,16,24963,12803,12160
050,36,081,"New York","Queens County",3,17,25509,13128,12381
050,36,081,"New York","Queens County",3,18,23519,12209,11310
050,36,081,"New York","Queens County",3,19,21278,11087,10191
050,36,081,"New York","Queens County",3,20,22381,11432,10949
050,36,081,"New York","Queens County",3,21,23349,11725,11624
050,36,081,"New York","Queens County",3,22,24405,12003,12402
050,36,081,"New York","Queens County",3,23,26274,12794,13480
050,36,081,"New York","Queens County",3,24,28029,13588,14441
050,36,081,"New York","Queens County",3,25,30117,14564,15553
050,36,081,"New York","Queens County",3,26,32026,15721,16305
050,36,081,"New York","Queens County",3,27,33590,16521,17069
050,36,081,"New York","Queens County",3,28,34652,17127,17525
050,36,081,"New York","Queens County",3,29,36136,17926,18210
050,36,081,"New York","Queens County",3,30,37661,18910,18751
050,36,081,"New York","Queens County",3,31,38404,19454,18950
050,36,081,"New York","Queens County",3,32,37210,18870,18340
050,36,081,"New York","Queens County",3,33,36008,18159,17849
050,36,081,"New York","Queens County",3,34,35357,17967,17390
050,36,081,"New York","Queens County",3,35,34602,17759,16843
050,36,081,"New York","Queens County",3,36,33740,17313,16427
050,36,081,"New York","Queens County",3,37,32340,16374,15966
050,36,081,"New York","Queens County",3,38,32510,16395,16115
050,36,081,"New York","Queens County",3,39,31997,16100,15897
050,36,081,"New York","Queens County",3,40,31294,15731,15563
050,36,081,"New York","Queens County",3,41,31430,15714,15716
050,36,081,"New York","Queens County",3,42,30600,15185,15415
050,36,081,"New York","Queens County",3,43,30148,14909,15239
050,36,081,"New York","Queens County",3,44,29926,14729,15197
050,36,081,"New York","Queens County",3,45,29223,14379,14844
050,36,081,"New York","Queens County",3,46,30016,14861,15155
050,36,081,"New York","Queens County",3,47,29447,14516,14931
050,36,081,"New York","Queens County",3,48,29592,14576,15016
050,36,081,"New York","Queens County",3,49,30421,15039,15382
050,36,081,"New York","Queens County",3,50,32018,15805,16213
050,36,081,"New York","Queens County",3,51,32747,16192,16555
050,36,081,"New York","Queens County",3,52,31962,15770,16192
050,36,081,"New York","Queens County",3,53,31454,15544,15910
050,36,081,"New York","Queens County",3,54,31063,15289,15774
050,36,081,"New York","Queens County",3,55,31863,15635,16228
050,36,081,"New York","Queens County",3,56,32909,16106,16803
050,36,081,"New York","Queens County",3,57,33388,16298,17090
050,36,081,"New York","Queens County",3,58,33188,16158,17030
050,36,081,"New York","Queens County",3,59,32372,15844,16528
050,36,081,"New York","Queens County",3,60,31915,15519,16396
050,36,081,"New York","Queens County",3,61,32434,15794,16640
050,36,081,"New York","Queens County",3,62,31181,15026,16155
050,36,081,"New York","Queens County",3,63,30593,14620,15973
050,36,081,"New York","Queens County",3,64,29676,14060,15616
050,36,081,"New York","Queens County",3,65,29011,13706,15305
050,36,081,"New York","Queens County",3,66,28210,13304,14906
050,36,081,"New York","Queens County",3,67,26232,12292,13940
050,36,081,"New York","Queens County",3,68,24584,11396,13188
050,36,081,"New York","Queens County",3,69,23610,10917,12693
050,36,081,"New York","Queens County",3,70,22610,10296,12314
050,36,081,"New York","Queens County",3,71,22207,10057,12150
050,36,081,"New York","Queens County",3,72,20722,9204,11518
050,36,081,"New York","Queens County",3,73,19771,8784,10987
050,36,081,"New York","Queens County",3,74,19511,8692,10819
050,36,081,"New York","Queens County",3,75,15017,6589,8428
050,36,081,"New York","Queens County",3,76,14233,6161,8072
050,36,081,"New York","Queens County",3,77,13453,5722,7731
050,36,081,"New York","Queens County",3,78,13047,5492,7555
050,36,081,"New York","Queens County",3,79,11715,4827,6888
050,36,081,"New York","Queens County",3,80,11010,4421,6589
050,36,081,"New York","Queens County",3,81,10433,4179,6254
050,36,081,"New York","Queens County",3,82,9516,3808,5708
050,36,081,"New York","Queens County",3,83,8772,3493,5279
050,36,081,"New York","Queens County",3,84,7943,3072,4871
050,36,081,"New York","Queens County",3,85,48813,17166,31647
050,36,081,"New York","Queens County",4,0,24165,12280,11885
050,36,081,"New York","Queens County",4,1,22092,11393,10699
050,36,081,"New York","Queens County",4,2,24448,12561,11887
050,36,081,"New York","Queens County",4,3,24966,12707,12259
050,36,081,"New York","Queens County",4,4,25555,13050,12505
050,36,081,"New York","Queens County",4,5,25545,13135,12410
050,36,081,"New York","Queens County",4,6,25455,13042,12413
050,36,081,"New York","Queens County",4,7,25334,12913,12421
050,36,081,"New York","Queens County",4,8,25267,12935,12332
050,36,081,"New York","Queens County",4,9,25032,12779,12253
050,36,081,"New York","Queens County",4,10,24873,12776,12097
050,36,081,"New York","Queens County",4,11,24758,12837,11921
050,36,081,"New York","Queens County",4,12,23924,12373,11551
050,36,081,"New York","Queens County",4,13,23937,12278,11659
050,36,081,"New York","Queens County",4,14,24674,12609,12065
050,36,081,"New York","Queens County",4,15,24539,12684,11855
050,36,081,"New York","Queens County",4,16,24365,12576,11789
050,36,081,"New York","Queens County",4,17,24692,12637,12055
050,36,081,"New York","Queens County",4,18,23220,12052,11168
050,36,081,"New York","Queens County",4,19,20886,10930,9956
050,36,081,"New York","Queens County",4,20,21628,11070,10558
050,36,081,"New York","Queens County",4,21,22691,11458,11233
050,36,081,"New York","Queens County",4,22,24167,11960,12207
050,36,081,"New York","Queens County",4,23,25539,12473,13066
050,36,081,"New York","Queens County",4,24,26993,13152,13841
050,36,081,"New York","Queens County",4,25,28668,13871,14797
050,36,081,"New York","Queens County",4,26,30743,14935,15808
050,36,081,"New York","Queens County",4,27,32127,15766,16361
050,36,081,"New York","Queens County",4,28,33279,16375,16904
050,36,081,"New York","Queens County",4,29,34053,17002,17051
050,36,081,"New York","Queens County",4,30,35249,17578,17671
050,36,081,"New York","Queens County",4,31,36372,18382,17990
050,36,081,"New York","Queens County",4,32,36697,18632,18065
050,36,081,"New York","Queens County",4,33,35668,18081,17587
050,36,081,"New York","Queens County",4,34,34332,17420,16912
050,36,081,"New York","Queens County",4,35,33779,17179,16600
050,36,081,"New York","Queens County",4,36,32924,16897,16027
050,36,081,"New York","Queens County",4,37,32098,16495,15603
050,36,081,"New York","Queens County",4,38,30769,15515,15254
050,36,081,"New York","Queens County",4,39,30787,15507,15280
050,36,081,"New York","Queens County",4,40,30709,15422,15287
050,36,081,"New York","Queens County",4,41,29971,14938,15033
050,36,081,"New York","Queens County",4,42,30227,15005,15222
050,36,081,"New York","Queens County",4,43,29514,14676,14838
050,36,081,"New York","Queens County",4,44,28944,14223,14721
050,36,081,"New York","Queens County",4,45,29025,14319,14706
050,36,081,"New York","Queens County",4,46,28326,13930,14396
050,36,081,"New York","Queens County",4,47,29128,14395,14733
050,36,081,"New York","Queens County",4,48,28725,14087,14638
050,36,081,"New York","Queens County",4,49,28807,14192,14615
050,36,081,"New York","Queens County",4,50,29685,14577,15108
050,36,081,"New York","Queens County",4,51,31372,15353,16019
050,36,081,"New York","Queens County",4,52,32004,15826,16178
050,36,081,"New York","Queens County",4,53,31175,15331,15844
050,36,081,"New York","Queens County",4,54,30828,15166,15662
050,36,081,"New York","Queens County",4,55,30415,14956,15459
050,36,081,"New York","Queens County",4,56,31199,15304,15895
050,36,081,"New York","Queens County",4,57,32167,15698,16469
050,36,081,"New York","Queens County",4,58,32675,15933,16742
050,36,081,"New York","Queens County",4,59,32580,15881,16699
050,36,081,"New York","Queens County",4,60,31608,15494,16114
050,36,081,"New York","Queens County",4,61,31161,15145,16016
050,36,081,"New York","Queens County",4,62,31720,15438,16282
050,36,081,"New York","Queens County",4,63,30281,14570,15711
050,36,081,"New York","Queens County",4,64,29620,14100,15520
050,36,081,"New York","Queens County",4,65,28957,13699,15258
050,36,081,"New York","Queens County",4,66,28085,13257,14828
050,36,081,"New York","Queens County",4,67,27350,12866,14484
050,36,081,"New York","Queens County",4,68,25459,11847,13612
050,36,081,"New York","Queens County",4,69,23838,11026,12812
050,36,081,"New York","Queens County",4,70,22862,10537,12325
050,36,081,"New York","Queens County",4,71,21859,9889,11970
050,36,081,"New York","Queens County",4,72,21465,9626,11839
050,36,081,"New York","Queens County",4,73,20010,8862,11148
050,36,081,"New York","Queens County",4,74,19114,8444,10670
050,36,081,"New York","Queens County",4,75,18786,8311,10475
050,36,081,"New York","Queens County",4,76,14453,6313,8140
050,36,081,"New York","Queens County",4,77,13742,5914,7828
050,36,081,"New York","Queens County",4,78,12928,5477,7451
050,36,081,"New York","Queens County",4,79,12491,5220,7271
050,36,081,"New York","Queens County",4,80,11195,4556,6639
050,36,081,"New York","Queens County",4,81,10480,4181,6299
050,36,081,"New York","Queens County",4,82,9958,3922,6036
050,36,081,"New York","Queens County",4,83,8991,3579,5412
050,36,081,"New York","Queens County",4,84,8181,3212,4969
050,36,081,"New York","Queens County",4,85,50198,17762,32436
050,36,081,"New York","Queens County",5,0,23744,12060,11684
050,36,081,"New York","Queens County",5,1,23101,11812,11289
050,36,081,"New York","Queens County",5,2,21251,11020,10231
050,36,081,"New York","Queens County",5,3,23460,12072,11388
050,36,081,"New York","Queens County",5,4,23925,12178,11747
050,36,081,"New York","Queens County",5,5,24566,12598,11968
050,36,081,"New York","Queens County",5,6,24609,12608,12001
050,36,081,"New York","Queens County",5,7,24583,12592,11991
050,36,081,"New York","Queens County",5,8,24611,12523,12088
050,36,081,"New York","Queens County",5,9,24610,12626,11984
050,36,081,"New York","Queens County",5,10,24408,12504,11904
050,36,081,"New York","Queens County",5,11,24139,12416,11723
050,36,081,"New York","Queens County",5,12,24238,12577,11661
050,36,081,"New York","Queens County",5,13,23525,12105,11420
050,36,081,"New York","Queens County",5,14,23386,12027,11359
050,36,081,"New York","Queens County",5,15,24219,12384,11835
050,36,081,"New York","Queens County",5,16,24172,12502,11670
050,36,081,"New York","Queens County",5,17,24142,12404,11738
050,36,081,"New York","Queens County",5,18,22705,11747,10958
050,36,081,"New York","Queens County",5,19,20936,10949,9987
050,36,081,"New York","Queens County",5,20,21755,11212,10543
050,36,081,"New York","Queens County",5,21,22323,11247,11076
050,36,081,"New York","Queens County",5,22,23847,11869,11978
050,36,081,"New York","Queens County",5,23,25769,12684,13085
050,36,081,"New York","Queens County",5,24,26992,13090,13902
050,36,081,"New York","Queens County",5,25,28286,13657,14629
050,36,081,"New York","Queens County",5,26,29774,14431,15343
050,36,081,"New York","Queens County",5,27,31266,15140,16126
050,36,081,"New York","Queens County",5,28,32385,15900,16485
050,36,081,"New York","Queens County",5,29,33387,16464,16923
050,36,081,"New York","Queens County",5,30,33938,17001,16937
050,36,081,"New York","Queens County",5,31,34923,17490,17433
050,36,081,"New York","Queens County",5,32,35594,17941,17653
050,36,081,"New York","Queens County",5,33,36014,18345,17669
050,36,081,"New York","Queens County",5,34,34740,17624,17116
050,36,081,"New York","Queens County",5,35,33364,16986,16378
050,36,081,"New York","Queens County",5,36,32645,16654,15991
050,36,081,"New York","Queens County",5,37,31868,16351,15517
050,36,081,"New York","Queens County",5,38,30931,15915,15016
050,36,081,"New York","Queens County",5,39,29731,15022,14709
050,36,081,"New York","Queens County",5,40,29868,15013,14855
050,36,081,"New York","Queens County",5,41,29704,14841,14863
050,36,081,"New York","Queens County",5,42,29033,14473,14560
050,36,081,"New York","Queens County",5,43,29494,14617,14877
050,36,081,"New York","Queens County",5,44,28605,14197,14408
050,36,081,"New York","Queens County",5,45,28140,13825,14315
050,36,081,"New York","Queens County",5,46,28309,13891,14418
050,36,081,"New York","Queens County",5,47,27625,13546,14079
050,36,081,"New York","Queens County",5,48,28492,13978,14514
050,36,081,"New York","Queens County",5,49,28104,13813,14291
050,36,081,"New York","Queens County",5,50,28372,13910,14462
050,36,081,"New York","Queens County",5,51,29194,14265,14929
050,36,081,"New York","Queens County",5,52,30866,15079,15787
050,36,081,"New York","Queens County",5,53,31414,15512,15902
050,36,081,"New York","Queens County",5,54,30671,15063,15608
050,36,081,"New York","Queens County",5,55,30221,14838,15383
050,36,081,"New York","Queens County",5,56,29975,14742,15233
050,36,081,"New York","Queens County",5,57,30552,14981,15571
050,36,081,"New York","Queens County",5,58,31580,15382,16198
050,36,081,"New York","Queens County",5,59,32118,15714,16404
050,36,081,"New York","Queens County",5,60,31887,15533,16354
050,36,081,"New York","Queens County",5,61,31007,15196,15811
050,36,081,"New York","Queens County",5,62,30471,14749,15722
050,36,081,"New York","Queens County",5,63,31007,15071,15936
050,36,081,"New York","Queens County",5,64,29521,14202,15319
050,36,081,"New York","Queens County",5,65,29025,13789,15236
050,36,081,"New York","Queens County",5,66,28248,13380,14868
050,36,081,"New York","Queens County",5,67,27390,12927,14463
050,36,081,"New York","Queens County",5,68,26657,12494,14163
050,36,081,"New York","Queens County",5,69,24818,11507,13311
050,36,081,"New York","Queens County",5,70,23196,10703,12493
050,36,081,"New York","Queens County",5,71,22242,10207,12035
050,36,081,"New York","Queens County",5,72,21233,9540,11693
050,36,081,"New York","Queens County",5,73,20860,9338,11522
050,36,081,"New York","Queens County",5,74,19458,8550,10908
050,36,081,"New York","Queens County",5,75,18421,8090,10331
050,36,081,"New York","Queens County",5,76,18212,7998,10214
050,36,081,"New York","Queens County",5,77,14024,6097,7927
050,36,081,"New York","Queens County",5,78,13233,5679,7554
050,36,081,"New York","Queens County",5,79,12436,5255,7181
050,36,081,"New York","Queens County",5,80,12034,5002,7032
050,36,081,"New York","Queens County",5,81,10659,4342,6317
050,36,081,"New York","Queens County",5,82,9997,3950,6047
050,36,081,"New York","Queens County",5,83,9445,3718,5727
050,36,081,"New York","Queens County",5,84,8477,3325,5152
050,36,081,"New York","Queens County",5,85,52039,18655,33384
050,36,083,"New York","Rensselaer County",1,0,1568,808,760
050,36,083,"New York","Rensselaer County",1,1,1556,813,743
050,36,083,"New York","Rensselaer County",1,2,1615,865,750
050,36,083,"New York","Rensselaer County",1,3,1718,884,834
050,36,083,"New York","Rensselaer County",1,4,1663,866,797
050,36,083,"New York","Rensselaer County",1,5,1624,830,794
050,36,083,"New York","Rensselaer County",1,6,1747,882,865
050,36,083,"New York","Rensselaer County",1,7,1737,866,871
050,36,083,"New York","Rensselaer County",1,8,1716,865,851
050,36,083,"New York","Rensselaer County",1,9,1748,934,814
050,36,083,"New York","Rensselaer County",1,10,1818,964,854
050,36,083,"New York","Rensselaer County",1,11,1837,955,882
050,36,083,"New York","Rensselaer County",1,12,1875,956,919
050,36,083,"New York","Rensselaer County",1,13,1812,936,876
050,36,083,"New York","Rensselaer County",1,14,1829,956,873
050,36,083,"New York","Rensselaer County",1,15,1838,947,891
050,36,083,"New York","Rensselaer County",1,16,1907,959,948
050,36,083,"New York","Rensselaer County",1,17,1914,950,964
050,36,083,"New York","Rensselaer County",1,18,2640,1502,1138
050,36,083,"New York","Rensselaer County",1,19,2862,1754,1108
050,36,083,"New York","Rensselaer County",1,20,2465,1428,1037
050,36,083,"New York","Rensselaer County",1,21,2214,1243,971
050,36,083,"New York","Rensselaer County",1,22,2050,1111,939
050,36,083,"New York","Rensselaer County",1,23,1963,981,982
050,36,083,"New York","Rensselaer County",1,24,2092,1054,1038
050,36,083,"New York","Rensselaer County",1,25,2137,1083,1054
050,36,083,"New York","Rensselaer County",1,26,2146,1087,1059
050,36,083,"New York","Rensselaer County",1,27,2280,1165,1115
050,36,083,"New York","Rensselaer County",1,28,2199,1137,1062
050,36,083,"New York","Rensselaer County",1,29,2266,1158,1108
050,36,083,"New York","Rensselaer County",1,30,2324,1165,1159
050,36,083,"New York","Rensselaer County",1,31,2259,1106,1153
050,36,083,"New York","Rensselaer County",1,32,2250,1121,1129
050,36,083,"New York","Rensselaer County",1,33,2277,1129,1148
050,36,083,"New York","Rensselaer County",1,34,2241,1098,1143
050,36,083,"New York","Rensselaer County",1,35,2151,1055,1096
050,36,083,"New York","Rensselaer County",1,36,2098,1042,1056
050,36,083,"New York","Rensselaer County",1,37,2073,1032,1041
050,36,083,"New York","Rensselaer County",1,38,2043,1021,1022
050,36,083,"New York","Rensselaer County",1,39,2088,1022,1066
050,36,083,"New York","Rensselaer County",1,40,1960,965,995
050,36,083,"New York","Rensselaer County",1,41,1894,919,975
050,36,083,"New York","Rensselaer County",1,42,1935,989,946
050,36,083,"New York","Rensselaer County",1,43,1852,956,896
050,36,083,"New York","Rensselaer County",1,44,1760,876,884
050,36,083,"New York","Rensselaer County",1,45,1785,883,902
050,36,083,"New York","Rensselaer County",1,46,1737,871,866
050,36,083,"New York","Rensselaer County",1,47,1807,905,902
050,36,083,"New York","Rensselaer County",1,48,2016,1002,1014
050,36,083,"New York","Rensselaer County",1,49,2108,1055,1053
050,36,083,"New York","Rensselaer County",1,50,2089,1038,1051
050,36,083,"New York","Rensselaer County",1,51,2153,1077,1076
050,36,083,"New York","Rensselaer County",1,52,2049,1021,1028
050,36,083,"New York","Rensselaer County",1,53,2050,994,1056
050,36,083,"New York","Rensselaer County",1,54,2193,1033,1160
050,36,083,"New York","Rensselaer County",1,55,2315,1115,1200
050,36,083,"New York","Rensselaer County",1,56,2335,1105,1230
050,36,083,"New York","Rensselaer County",1,57,2321,1133,1188
050,36,083,"New York","Rensselaer County",1,58,2361,1165,1196
050,36,083,"New York","Rensselaer County",1,59,2428,1186,1242
050,36,083,"New York","Rensselaer County",1,60,2336,1154,1182
050,36,083,"New York","Rensselaer County",1,61,2326,1140,1186
050,36,083,"New York","Rensselaer County",1,62,2314,1122,1192
050,36,083,"New York","Rensselaer County",1,63,2219,1087,1132
050,36,083,"New York","Rensselaer County",1,64,2085,997,1088
050,36,083,"New York","Rensselaer County",1,65,2027,1005,1022
050,36,083,"New York","Rensselaer County",1,66,2022,990,1032
050,36,083,"New York","Rensselaer County",1,67,1974,951,1023
050,36,083,"New York","Rensselaer County",1,68,1855,905,950
050,36,083,"New York","Rensselaer County",1,69,1696,859,837
050,36,083,"New York","Rensselaer County",1,70,1657,796,861
050,36,083,"New York","Rensselaer County",1,71,1609,750,859
050,36,083,"New York","Rensselaer County",1,72,1654,788,866
050,36,083,"New York","Rensselaer County",1,73,1621,783,838
050,36,083,"New York","Rensselaer County",1,74,1082,510,572
050,36,083,"New York","Rensselaer County",1,75,1014,480,534
050,36,083,"New York","Rensselaer County",1,76,1006,455,551
050,36,083,"New York","Rensselaer County",1,77,1019,464,555
050,36,083,"New York","Rensselaer County",1,78,871,378,493
050,36,083,"New York","Rensselaer County",1,79,726,319,407
050,36,083,"New York","Rensselaer County",1,80,664,286,378
050,36,083,"New York","Rensselaer County",1,81,653,268,385
050,36,083,"New York","Rensselaer County",1,82,574,240,334
050,36,083,"New York","Rensselaer County",1,83,551,229,322
050,36,083,"New York","Rensselaer County",1,84,544,225,319
050,36,083,"New York","Rensselaer County",1,85,3237,1074,2163
050,36,083,"New York","Rensselaer County",2,0,1576,796,780
050,36,083,"New York","Rensselaer County",2,1,1550,808,742
050,36,083,"New York","Rensselaer County",2,2,1607,854,753
050,36,083,"New York","Rensselaer County",2,3,1679,873,806
050,36,083,"New York","Rensselaer County",2,4,1675,871,804
050,36,083,"New York","Rensselaer County",2,5,1634,837,797
050,36,083,"New York","Rensselaer County",2,6,1716,870,846
050,36,083,"New York","Rensselaer County",2,7,1733,864,869
050,36,083,"New York","Rensselaer County",2,8,1710,861,849
050,36,083,"New York","Rensselaer County",2,9,1736,914,822
050,36,083,"New York","Rensselaer County",2,10,1796,951,845
050,36,083,"New York","Rensselaer County",2,11,1827,955,872
050,36,083,"New York","Rensselaer County",2,12,1874,960,914
050,36,083,"New York","Rensselaer County",2,13,1829,941,888
050,36,083,"New York","Rensselaer County",2,14,1835,956,879
050,36,083,"New York","Rensselaer County",2,15,1833,947,886
050,36,083,"New York","Rensselaer County",2,16,1903,963,940
050,36,083,"New York","Rensselaer County",2,17,1909,951,958
050,36,083,"New York","Rensselaer County",2,18,2613,1477,1136
050,36,083,"New York","Rensselaer County",2,19,2859,1744,1115
050,36,083,"New York","Rensselaer County",2,20,2493,1441,1052
050,36,083,"New York","Rensselaer County",2,21,2215,1239,976
050,36,083,"New York","Rensselaer County",2,22,2039,1111,928
050,36,083,"New York","Rensselaer County",2,23,1970,987,983
050,36,083,"New York","Rensselaer County",2,24,2062,1038,1024
050,36,083,"New York","Rensselaer County",2,25,2124,1071,1053
050,36,083,"New York","Rensselaer County",2,26,2155,1092,1063
050,36,083,"New York","Rensselaer County",2,27,2246,1146,1100
050,36,083,"New York","Rensselaer County",2,28,2212,1142,1070
050,36,083,"New York","Rensselaer County",2,29,2238,1143,1095
050,36,083,"New York","Rensselaer County",2,30,2311,1157,1154
050,36,083,"New York","Rensselaer County",2,31,2254,1111,1143
050,36,083,"New York","Rensselaer County",2,32,2235,1107,1128
050,36,083,"New York","Rensselaer County",2,33,2270,1128,1142
050,36,083,"New York","Rensselaer County",2,34,2243,1101,1142
050,36,083,"New York","Rensselaer County",2,35,2181,1071,1110
050,36,083,"New York","Rensselaer County",2,36,2093,1034,1059
050,36,083,"New York","Rensselaer County",2,37,2085,1042,1043
050,36,083,"New York","Rensselaer County",2,38,2059,1030,1029
050,36,083,"New York","Rensselaer County",2,39,2074,1020,1054
050,36,083,"New York","Rensselaer County",2,40,2000,983,1017
050,36,083,"New York","Rensselaer County",2,41,1900,926,974
050,36,083,"New York","Rensselaer County",2,42,1914,967,947
050,36,083,"New York","Rensselaer County",2,43,1886,974,912
050,36,083,"New York","Rensselaer County",2,44,1764,885,879
050,36,083,"New York","Rensselaer County",2,45,1792,890,902
050,36,083,"New York","Rensselaer County",2,46,1735,867,868
050,36,083,"New York","Rensselaer County",2,47,1786,895,891
050,36,083,"New York","Rensselaer County",2,48,1959,975,984
050,36,083,"New York","Rensselaer County",2,49,2094,1046,1048
050,36,083,"New York","Rensselaer County",2,50,2091,1040,1051
050,36,083,"New York","Rensselaer County",2,51,2131,1062,1069
050,36,083,"New York","Rensselaer County",2,52,2063,1032,1031
050,36,083,"New York","Rensselaer County",2,53,2043,996,1047
050,36,083,"New York","Rensselaer County",2,54,2150,1021,1129
050,36,083,"New York","Rensselaer County",2,55,2277,1089,1188
050,36,083,"New York","Rensselaer County",2,56,2330,1102,1228
050,36,083,"New York","Rensselaer County",2,57,2325,1126,1199
050,36,083,"New York","Rensselaer County",2,58,2344,1156,1188
050,36,083,"New York","Rensselaer County",2,59,2411,1179,1232
050,36,083,"New York","Rensselaer County",2,60,2337,1151,1186
050,36,083,"New York","Rensselaer County",2,61,2311,1136,1175
050,36,083,"New York","Rensselaer County",2,62,2303,1121,1182
050,36,083,"New York","Rensselaer County",2,63,2248,1095,1153
050,36,083,"New York","Rensselaer County",2,64,2095,1008,1087
050,36,083,"New York","Rensselaer County",2,65,2030,1000,1030
050,36,083,"New York","Rensselaer County",2,66,2016,988,1028
050,36,083,"New York","Rensselaer County",2,67,1964,950,1014
050,36,083,"New York","Rensselaer County",2,68,1853,900,953
050,36,083,"New York","Rensselaer County",2,69,1740,872,868
050,36,083,"New York","Rensselaer County",2,70,1646,803,843
050,36,083,"New York","Rensselaer County",2,71,1616,756,860
050,36,083,"New York","Rensselaer County",2,72,1599,759,840
050,36,083,"New York","Rensselaer County",2,73,1700,815,885
050,36,083,"New York","Rensselaer County",2,74,1128,536,592
050,36,083,"New York","Rensselaer County",2,75,1026,484,542
050,36,083,"New York","Rensselaer County",2,76,987,453,534
050,36,083,"New York","Rensselaer County",2,77,1027,467,560
050,36,083,"New York","Rensselaer County",2,78,881,388,493
050,36,083,"New York","Rensselaer County",2,79,746,326,420
050,36,083,"New York","Rensselaer County",2,80,670,287,383
050,36,083,"New York","Rensselaer County",2,81,636,259,377
050,36,083,"New York","Rensselaer County",2,82,587,243,344
050,36,083,"New York","Rensselaer County",2,83,540,225,315
050,36,083,"New York","Rensselaer County",2,84,537,222,315
050,36,083,"New York","Rensselaer County",2,85,3200,1064,2136
050,36,083,"New York","Rensselaer County",3,0,1511,750,761
050,36,083,"New York","Rensselaer County",3,1,1597,798,799
050,36,083,"New York","Rensselaer County",3,2,1587,830,757
050,36,083,"New York","Rensselaer County",3,3,1611,846,765
050,36,083,"New York","Rensselaer County",3,4,1609,864,745
050,36,083,"New York","Rensselaer County",3,5,1674,881,793
050,36,083,"New York","Rensselaer County",3,6,1648,842,806
050,36,083,"New York","Rensselaer County",3,7,1701,848,853
050,36,083,"New York","Rensselaer County",3,8,1707,847,860
050,36,083,"New York","Rensselaer County",3,9,1682,851,831
050,36,083,"New York","Rensselaer County",3,10,1744,911,833
050,36,083,"New York","Rensselaer County",3,11,1771,953,818
050,36,083,"New York","Rensselaer County",3,12,1803,952,851
050,36,083,"New York","Rensselaer County",3,13,1858,966,892
050,36,083,"New York","Rensselaer County",3,14,1858,966,892
050,36,083,"New York","Rensselaer County",3,15,1788,930,858
050,36,083,"New York","Rensselaer County",3,16,1855,967,888
050,36,083,"New York","Rensselaer County",3,17,1869,951,918
050,36,083,"New York","Rensselaer County",3,18,2603,1449,1154
050,36,083,"New York","Rensselaer County",3,19,2824,1708,1116
050,36,083,"New York","Rensselaer County",3,20,2486,1438,1048
050,36,083,"New York","Rensselaer County",3,21,2239,1253,986
050,36,083,"New York","Rensselaer County",3,22,2035,1100,935
050,36,083,"New York","Rensselaer County",3,23,1973,1013,960
050,36,083,"New York","Rensselaer County",3,24,2003,993,1010
050,36,083,"New York","Rensselaer County",3,25,2069,1043,1026
050,36,083,"New York","Rensselaer County",3,26,2137,1101,1036
050,36,083,"New York","Rensselaer County",3,27,2220,1119,1101
050,36,083,"New York","Rensselaer County",3,28,2229,1125,1104
050,36,083,"New York","Rensselaer County",3,29,2256,1162,1094
050,36,083,"New York","Rensselaer County",3,30,2294,1168,1126
050,36,083,"New York","Rensselaer County",3,31,2314,1155,1159
050,36,083,"New York","Rensselaer County",3,32,2208,1100,1108
050,36,083,"New York","Rensselaer County",3,33,2245,1108,1137
050,36,083,"New York","Rensselaer County",3,34,2268,1125,1143
050,36,083,"New York","Rensselaer County",3,35,2275,1115,1160
050,36,083,"New York","Rensselaer County",3,36,2168,1063,1105
050,36,083,"New York","Rensselaer County",3,37,2037,1000,1037
050,36,083,"New York","Rensselaer County",3,38,2089,1029,1060
050,36,083,"New York","Rensselaer County",3,39,2098,1040,1058
050,36,083,"New York","Rensselaer County",3,40,2078,1026,1052
050,36,083,"New York","Rensselaer County",3,41,2003,985,1018
050,36,083,"New York","Rensselaer County",3,42,1911,945,966
050,36,083,"New York","Rensselaer County",3,43,1900,972,928
050,36,083,"New York","Rensselaer County",3,44,1854,943,911
050,36,083,"New York","Rensselaer County",3,45,1755,890,865
050,36,083,"New York","Rensselaer County",3,46,1773,875,898
050,36,083,"New York","Rensselaer County",3,47,1749,871,878
050,36,083,"New York","Rensselaer County",3,48,1778,889,889
050,36,083,"New York","Rensselaer County",3,49,1942,970,972
050,36,083,"New York","Rensselaer County",3,50,2069,1035,1034
050,36,083,"New York","Rensselaer County",3,51,2070,1032,1038
050,36,083,"New York","Rensselaer County",3,52,2130,1064,1066
050,36,083,"New York","Rensselaer County",3,53,2051,1024,1027
050,36,083,"New York","Rensselaer County",3,54,2041,1005,1036
050,36,083,"New York","Rensselaer County",3,55,2135,1025,1110
050,36,083,"New York","Rensselaer County",3,56,2235,1055,1180
050,36,083,"New York","Rensselaer County",3,57,2331,1098,1233
050,36,083,"New York","Rensselaer County",3,58,2315,1130,1185
050,36,083,"New York","Rensselaer County",3,59,2323,1137,1186
050,36,083,"New York","Rensselaer County",3,60,2329,1145,1184
050,36,083,"New York","Rensselaer County",3,61,2299,1122,1177
050,36,083,"New York","Rensselaer County",3,62,2268,1109,1159
050,36,083,"New York","Rensselaer County",3,63,2251,1083,1168
050,36,083,"New York","Rensselaer County",3,64,2201,1063,1138
050,36,083,"New York","Rensselaer County",3,65,2059,997,1062
050,36,083,"New York","Rensselaer County",3,66,1998,972,1026
050,36,083,"New York","Rensselaer County",3,67,1977,971,1006
050,36,083,"New York","Rensselaer County",3,68,1941,940,1001
050,36,083,"New York","Rensselaer County",3,69,1813,872,941
050,36,083,"New York","Rensselaer County",3,70,1707,854,853
050,36,083,"New York","Rensselaer County",3,71,1621,787,834
050,36,083,"New York","Rensselaer County",3,72,1574,737,837
050,36,083,"New York","Rensselaer County",3,73,1555,718,837
050,36,083,"New York","Rensselaer County",3,74,1647,778,869
050,36,083,"New York","Rensselaer County",3,75,1098,522,576
050,36,083,"New York","Rensselaer County",3,76,1001,461,540
050,36,083,"New York","Rensselaer County",3,77,935,443,492
050,36,083,"New York","Rensselaer County",3,78,997,448,549
050,36,083,"New York","Rensselaer County",3,79,826,369,457
050,36,083,"New York","Rensselaer County",3,80,706,303,403
050,36,083,"New York","Rensselaer County",3,81,602,250,352
050,36,083,"New York","Rensselaer County",3,82,592,236,356
050,36,083,"New York","Rensselaer County",3,83,544,233,311
050,36,083,"New York","Rensselaer County",3,84,500,202,298
050,36,083,"New York","Rensselaer County",3,85,3195,1084,2111
050,36,083,"New York","Rensselaer County",4,0,1492,746,746
050,36,083,"New York","Rensselaer County",4,1,1494,781,713
050,36,083,"New York","Rensselaer County",4,2,1570,777,793
050,36,083,"New York","Rensselaer County",4,3,1561,833,728
050,36,083,"New York","Rensselaer County",4,4,1602,840,762
050,36,083,"New York","Rensselaer County",4,5,1609,866,743
050,36,083,"New York","Rensselaer County",4,6,1646,875,771
050,36,083,"New York","Rensselaer County",4,7,1646,842,804
050,36,083,"New York","Rensselaer County",4,8,1685,843,842
050,36,083,"New York","Rensselaer County",4,9,1715,853,862
050,36,083,"New York","Rensselaer County",4,10,1690,861,829
050,36,083,"New York","Rensselaer County",4,11,1710,889,821
050,36,083,"New York","Rensselaer County",4,12,1761,925,836
050,36,083,"New York","Rensselaer County",4,13,1801,944,857
050,36,083,"New York","Rensselaer County",4,14,1881,983,898
050,36,083,"New York","Rensselaer County",4,15,1820,935,885
050,36,083,"New York","Rensselaer County",4,16,1830,950,880
050,36,083,"New York","Rensselaer County",4,17,1840,964,876
050,36,083,"New York","Rensselaer County",4,18,2551,1456,1095
050,36,083,"New York","Rensselaer County",4,19,2732,1653,1079
050,36,083,"New York","Rensselaer County",4,20,2384,1372,1012
050,36,083,"New York","Rensselaer County",4,21,2201,1230,971
050,36,083,"New York","Rensselaer County",4,22,2008,1115,893
050,36,083,"New York","Rensselaer County",4,23,1857,940,917
050,36,083,"New York","Rensselaer County",4,24,2005,1027,978
050,36,083,"New York","Rensselaer County",4,25,1988,964,1024
050,36,083,"New York","Rensselaer County",4,26,2042,1019,1023
050,36,083,"New York","Rensselaer County",4,27,2162,1092,1070
050,36,083,"New York","Rensselaer County",4,28,2203,1129,1074
050,36,083,"New York","Rensselaer County",4,29,2227,1118,1109
050,36,083,"New York","Rensselaer County",4,30,2256,1167,1089
050,36,083,"New York","Rensselaer County",4,31,2297,1159,1138
050,36,083,"New York","Rensselaer County",4,32,2305,1155,1150
050,36,083,"New York","Rensselaer County",4,33,2225,1110,1115
050,36,083,"New York","Rensselaer County",4,34,2254,1117,1137
050,36,083,"New York","Rensselaer County",4,35,2271,1137,1134
050,36,083,"New York","Rensselaer County",4,36,2268,1131,1137
050,36,083,"New York","Rensselaer County",4,37,2141,1064,1077
050,36,083,"New York","Rensselaer County",4,38,2063,1016,1047
050,36,083,"New York","Rensselaer County",4,39,2066,1009,1057
050,36,083,"New York","Rensselaer County",4,40,2055,1009,1046
050,36,083,"New York","Rensselaer County",4,41,2065,1034,1031
050,36,083,"New York","Rensselaer County",4,42,1981,975,1006
050,36,083,"New York","Rensselaer County",4,43,1868,926,942
050,36,083,"New York","Rensselaer County",4,44,1872,941,931
050,36,083,"New York","Rensselaer County",4,45,1849,954,895
050,36,083,"New York","Rensselaer County",4,46,1736,879,857
050,36,083,"New York","Rensselaer County",4,47,1763,877,886
050,36,083,"New York","Rensselaer County",4,48,1734,871,863
050,36,083,"New York","Rensselaer County",4,49,1761,889,872
050,36,083,"New York","Rensselaer County",4,50,1930,952,978
050,36,083,"New York","Rensselaer County",4,51,2078,1048,1030
050,36,083,"New York","Rensselaer County",4,52,2043,1024,1019
050,36,083,"New York","Rensselaer County",4,53,2071,1030,1041
050,36,083,"New York","Rensselaer County",4,54,2043,1019,1024
050,36,083,"New York","Rensselaer County",4,55,2029,1012,1017
050,36,083,"New York","Rensselaer County",4,56,2102,998,1104
050,36,083,"New York","Rensselaer County",4,57,2201,1037,1164
050,36,083,"New York","Rensselaer County",4,58,2317,1093,1224
050,36,083,"New York","Rensselaer County",4,59,2297,1096,1201
050,36,083,"New York","Rensselaer County",4,60,2273,1105,1168
050,36,083,"New York","Rensselaer County",4,61,2279,1112,1167
050,36,083,"New York","Rensselaer County",4,62,2262,1114,1148
050,36,083,"New York","Rensselaer County",4,63,2247,1103,1144
050,36,083,"New York","Rensselaer County",4,64,2229,1069,1160
050,36,083,"New York","Rensselaer County",4,65,2176,1044,1132
050,36,083,"New York","Rensselaer County",4,66,2013,972,1041
050,36,083,"New York","Rensselaer County",4,67,1941,935,1006
050,36,083,"New York","Rensselaer County",4,68,1919,943,976
050,36,083,"New York","Rensselaer County",4,69,1873,894,979
050,36,083,"New York","Rensselaer County",4,70,1762,839,923
050,36,083,"New York","Rensselaer County",4,71,1651,826,825
050,36,083,"New York","Rensselaer County",4,72,1555,775,780
050,36,083,"New York","Rensselaer County",4,73,1531,707,824
050,36,083,"New York","Rensselaer County",4,74,1493,676,817
050,36,083,"New York","Rensselaer County",4,75,1556,720,836
050,36,083,"New York","Rensselaer County",4,76,1064,500,564
050,36,083,"New York","Rensselaer County",4,77,950,432,518
050,36,083,"New York","Rensselaer County",4,78,900,416,484
050,36,083,"New York","Rensselaer County",4,79,931,427,504
050,36,083,"New York","Rensselaer County",4,80,794,347,447
050,36,083,"New York","Rensselaer County",4,81,651,270,381
050,36,083,"New York","Rensselaer County",4,82,568,229,339
050,36,083,"New York","Rensselaer County",4,83,549,219,330
050,36,083,"New York","Rensselaer County",4,84,493,206,287
050,36,083,"New York","Rensselaer County",4,85,3107,1056,2051
050,36,083,"New York","Rensselaer County",5,0,1489,745,744
050,36,083,"New York","Rensselaer County",5,1,1486,750,736
050,36,083,"New York","Rensselaer County",5,2,1505,787,718
050,36,083,"New York","Rensselaer County",5,3,1583,797,786
050,36,083,"New York","Rensselaer County",5,4,1582,842,740
050,36,083,"New York","Rensselaer County",5,5,1593,842,751
050,36,083,"New York","Rensselaer County",5,6,1588,856,732
050,36,083,"New York","Rensselaer County",5,7,1610,845,765
050,36,083,"New York","Rensselaer County",5,8,1642,827,815
050,36,083,"New York","Rensselaer County",5,9,1659,835,824
050,36,083,"New York","Rensselaer County",5,10,1665,812,853
050,36,083,"New York","Rensselaer County",5,11,1694,858,836
050,36,083,"New York","Rensselaer County",5,12,1721,898,823
050,36,083,"New York","Rensselaer County",5,13,1762,927,835
050,36,083,"New York","Rensselaer County",5,14,1827,974,853
050,36,083,"New York","Rensselaer County",5,15,1853,959,894
050,36,083,"New York","Rensselaer County",5,16,1888,973,915
050,36,083,"New York","Rensselaer County",5,17,1831,962,869
050,36,083,"New York","Rensselaer County",5,18,2540,1465,1075
050,36,083,"New York","Rensselaer County",5,19,2741,1676,1065
050,36,083,"New York","Rensselaer County",5,20,2387,1362,1025
050,36,083,"New York","Rensselaer County",5,21,2140,1191,949
050,36,083,"New York","Rensselaer County",5,22,1998,1092,906
050,36,083,"New York","Rensselaer County",5,23,1901,962,939
050,36,083,"New York","Rensselaer County",5,24,1890,929,961
050,36,083,"New York","Rensselaer County",5,25,2057,1061,996
050,36,083,"New York","Rensselaer County",5,26,1991,989,1002
050,36,083,"New York","Rensselaer County",5,27,2109,1053,1056
050,36,083,"New York","Rensselaer County",5,28,2159,1083,1076
050,36,083,"New York","Rensselaer County",5,29,2200,1117,1083
050,36,083,"New York","Rensselaer County",5,30,2290,1153,1137
050,36,083,"New York","Rensselaer County",5,31,2265,1167,1098
050,36,083,"New York","Rensselaer County",5,32,2278,1133,1145
050,36,083,"New York","Rensselaer County",5,33,2280,1142,1138
050,36,083,"New York","Rensselaer County",5,34,2221,1092,1129
050,36,083,"New York","Rensselaer County",5,35,2238,1092,1146
050,36,083,"New York","Rensselaer County",5,36,2310,1156,1154
050,36,083,"New York","Rensselaer County",5,37,2239,1126,1113
050,36,083,"New York","Rensselaer County",5,38,2175,1063,1112
050,36,083,"New York","Rensselaer County",5,39,2085,1037,1048
050,36,083,"New York","Rensselaer County",5,40,2023,987,1036
050,36,083,"New York","Rensselaer County",5,41,2046,1026,1020
050,36,083,"New York","Rensselaer County",5,42,2044,1031,1013
050,36,083,"New York","Rensselaer County",5,43,1982,971,1011
050,36,083,"New York","Rensselaer County",5,44,1876,932,944
050,36,083,"New York","Rensselaer County",5,45,1874,943,931
050,36,083,"New York","Rensselaer County",5,46,1819,927,892
050,36,083,"New York","Rensselaer County",5,47,1749,888,861
050,36,083,"New York","Rensselaer County",5,48,1794,901,893
050,36,083,"New York","Rensselaer County",5,49,1706,859,847
050,36,083,"New York","Rensselaer County",5,50,1752,881,871
050,36,083,"New York","Rensselaer County",5,51,1948,953,995
050,36,083,"New York","Rensselaer County",5,52,2055,1027,1028
050,36,083,"New York","Rensselaer County",5,53,2028,1009,1019
050,36,083,"New York","Rensselaer County",5,54,2085,1037,1048
050,36,083,"New York","Rensselaer County",5,55,2017,1015,1002
050,36,083,"New York","Rensselaer County",5,56,1977,979,998
050,36,083,"New York","Rensselaer County",5,57,2067,986,1081
050,36,083,"New York","Rensselaer County",5,58,2200,1051,1149
050,36,083,"New York","Rensselaer County",5,59,2288,1059,1229
050,36,083,"New York","Rensselaer County",5,60,2253,1080,1173
050,36,083,"New York","Rensselaer County",5,61,2267,1103,1164
050,36,083,"New York","Rensselaer County",5,62,2233,1090,1143
050,36,083,"New York","Rensselaer County",5,63,2245,1102,1143
050,36,083,"New York","Rensselaer County",5,64,2223,1095,1128
050,36,083,"New York","Rensselaer County",5,65,2175,1037,1138
050,36,083,"New York","Rensselaer County",5,66,2134,1014,1120
050,36,083,"New York","Rensselaer County",5,67,1967,943,1024
050,36,083,"New York","Rensselaer County",5,68,1905,918,987
050,36,083,"New York","Rensselaer County",5,69,1881,922,959
050,36,083,"New York","Rensselaer County",5,70,1844,878,966
050,36,083,"New York","Rensselaer County",5,71,1707,814,893
050,36,083,"New York","Rensselaer County",5,72,1610,814,796
050,36,083,"New York","Rensselaer County",5,73,1510,743,767
050,36,083,"New York","Rensselaer County",5,74,1493,683,810
050,36,083,"New York","Rensselaer County",5,75,1449,642,807
050,36,083,"New York","Rensselaer County",5,76,1500,687,813
050,36,083,"New York","Rensselaer County",5,77,1023,483,540
050,36,083,"New York","Rensselaer County",5,78,914,410,504
050,36,083,"New York","Rensselaer County",5,79,844,394,450
050,36,083,"New York","Rensselaer County",5,80,886,397,489
050,36,083,"New York","Rensselaer County",5,81,738,311,427
050,36,083,"New York","Rensselaer County",5,82,622,254,368
050,36,083,"New York","Rensselaer County",5,83,523,208,315
050,36,083,"New York","Rensselaer County",5,84,499,194,305
050,36,083,"New York","Rensselaer County",5,85,3058,1045,2013
050,36,085,"New York","Richmond County",1,0,5254,2697,2557
050,36,085,"New York","Richmond County",1,1,5408,2838,2570
050,36,085,"New York","Richmond County",1,2,5639,2930,2709
050,36,085,"New York","Richmond County",1,3,5820,3053,2767
050,36,085,"New York","Richmond County",1,4,5867,3017,2850
050,36,085,"New York","Richmond County",1,5,5878,2961,2917
050,36,085,"New York","Richmond County",1,6,5816,2969,2847
050,36,085,"New York","Richmond County",1,7,5943,3087,2856
050,36,085,"New York","Richmond County",1,8,5969,3117,2852
050,36,085,"New York","Richmond County",1,9,6164,3182,2982
050,36,085,"New York","Richmond County",1,10,6167,3131,3036
050,36,085,"New York","Richmond County",1,11,6194,3228,2966
050,36,085,"New York","Richmond County",1,12,6455,3344,3111
050,36,085,"New York","Richmond County",1,13,6484,3328,3156
050,36,085,"New York","Richmond County",1,14,6416,3305,3111
050,36,085,"New York","Richmond County",1,15,6548,3292,3256
050,36,085,"New York","Richmond County",1,16,6670,3390,3280
050,36,085,"New York","Richmond County",1,17,6574,3390,3184
050,36,085,"New York","Richmond County",1,18,5842,3035,2807
050,36,085,"New York","Richmond County",1,19,5100,2624,2476
050,36,085,"New York","Richmond County",1,20,5450,2825,2625
050,36,085,"New York","Richmond County",1,21,5624,2877,2747
050,36,085,"New York","Richmond County",1,22,5764,2887,2877
050,36,085,"New York","Richmond County",1,23,5969,2996,2973
050,36,085,"New York","Richmond County",1,24,6191,3127,3064
050,36,085,"New York","Richmond County",1,25,6298,3177,3121
050,36,085,"New York","Richmond County",1,26,6410,3266,3144
050,36,085,"New York","Richmond County",1,27,6499,3274,3225
050,36,085,"New York","Richmond County",1,28,6623,3319,3304
050,36,085,"New York","Richmond County",1,29,7019,3572,3447
050,36,085,"New York","Richmond County",1,30,6940,3466,3474
050,36,085,"New York","Richmond County",1,31,6856,3464,3392
050,36,085,"New York","Richmond County",1,32,6734,3373,3361
050,36,085,"New York","Richmond County",1,33,6494,3250,3244
050,36,085,"New York","Richmond County",1,34,6385,3201,3184
050,36,085,"New York","Richmond County",1,35,6375,3161,3214
050,36,085,"New York","Richmond County",1,36,6315,3169,3146
050,36,085,"New York","Richmond County",1,37,6333,3089,3244
050,36,085,"New York","Richmond County",1,38,6165,3032,3133
050,36,085,"New York","Richmond County",1,39,6058,2993,3065
050,36,085,"New York","Richmond County",1,40,6331,3130,3201
050,36,085,"New York","Richmond County",1,41,6245,3067,3178
050,36,085,"New York","Richmond County",1,42,6285,3061,3224
050,36,085,"New York","Richmond County",1,43,6115,2980,3135
050,36,085,"New York","Richmond County",1,44,6128,3010,3118
050,36,085,"New York","Richmond County",1,45,6316,3108,3208
050,36,085,"New York","Richmond County",1,46,6169,3031,3138
050,36,085,"New York","Richmond County",1,47,6163,2955,3208
050,36,085,"New York","Richmond County",1,48,6599,3242,3357
050,36,085,"New York","Richmond County",1,49,7195,3487,3708
050,36,085,"New York","Richmond County",1,50,7075,3458,3617
050,36,085,"New York","Richmond County",1,51,6813,3279,3534
050,36,085,"New York","Richmond County",1,52,6673,3217,3456
050,36,085,"New York","Richmond County",1,53,6957,3391,3566
050,36,085,"New York","Richmond County",1,54,7034,3441,3593
050,36,085,"New York","Richmond County",1,55,7294,3590,3704
050,36,085,"New York","Richmond County",1,56,7334,3584,3750
050,36,085,"New York","Richmond County",1,57,7290,3465,3825
050,36,085,"New York","Richmond County",1,58,7069,3457,3612
050,36,085,"New York","Richmond County",1,59,7087,3444,3643
050,36,085,"New York","Richmond County",1,60,7097,3434,3663
050,36,085,"New York","Richmond County",1,61,6870,3345,3525
050,36,085,"New York","Richmond County",1,62,6813,3299,3514
050,36,085,"New York","Richmond County",1,63,6553,3142,3411
050,36,085,"New York","Richmond County",1,64,6266,2989,3277
050,36,085,"New York","Richmond County",1,65,6147,2953,3194
050,36,085,"New York","Richmond County",1,66,5595,2669,2926
050,36,085,"New York","Richmond County",1,67,5314,2474,2840
050,36,085,"New York","Richmond County",1,68,5198,2446,2752
050,36,085,"New York","Richmond County",1,69,4939,2260,2679
050,36,085,"New York","Richmond County",1,70,4822,2196,2626
050,36,085,"New York","Richmond County",1,71,4649,2095,2554
050,36,085,"New York","Richmond County",1,72,4708,2157,2551
050,36,085,"New York","Richmond County",1,73,4485,2085,2400
050,36,085,"New York","Richmond County",1,74,3265,1446,1819
050,36,085,"New York","Richmond County",1,75,3238,1401,1837
050,36,085,"New York","Richmond County",1,76,3068,1328,1740
050,36,085,"New York","Richmond County",1,77,2988,1327,1661
050,36,085,"New York","Richmond County",1,78,2530,1110,1420
050,36,085,"New York","Richmond County",1,79,2310,1012,1298
050,36,085,"New York","Richmond County",1,80,2156,964,1192
050,36,085,"New York","Richmond County",1,81,1936,820,1116
050,36,085,"New York","Richmond County",1,82,1772,710,1062
050,36,085,"New York","Richmond County",1,83,1584,594,990
050,36,085,"New York","Richmond County",1,84,1420,558,862
050,36,085,"New York","Richmond County",1,85,9147,3079,6068
050,36,085,"New York","Richmond County",2,0,5255,2703,2552
050,36,085,"New York","Richmond County",2,1,5382,2810,2572
050,36,085,"New York","Richmond County",2,2,5600,2915,2685
050,36,085,"New York","Richmond County",2,3,5767,3019,2748
050,36,085,"New York","Richmond County",2,4,5871,3033,2838
050,36,085,"New York","Richmond County",2,5,5887,2981,2906
050,36,085,"New York","Richmond County",2,6,5849,2980,2869
050,36,085,"New York","Richmond County",2,7,5911,3060,2851
050,36,085,"New York","Richmond County",2,8,5948,3102,2846
050,36,085,"New York","Richmond County",2,9,6125,3173,2952
050,36,085,"New York","Richmond County",2,10,6172,3148,3024
050,36,085,"New York","Richmond County",2,11,6158,3186,2972
050,36,085,"New York","Richmond County",2,12,6423,3332,3091
050,36,085,"New York","Richmond County",2,13,6466,3327,3139
050,36,085,"New York","Richmond County",2,14,6433,3309,3124
050,36,085,"New York","Richmond County",2,15,6532,3305,3227
050,36,085,"New York","Richmond County",2,16,6645,3367,3278
050,36,085,"New York","Richmond County",2,17,6595,3387,3208
050,36,085,"New York","Richmond County",2,18,5828,3025,2803
050,36,085,"New York","Richmond County",2,19,5135,2643,2492
050,36,085,"New York","Richmond County",2,20,5488,2837,2651
050,36,085,"New York","Richmond County",2,21,5646,2887,2759
050,36,085,"New York","Richmond County",2,22,5785,2903,2882
050,36,085,"New York","Richmond County",2,23,5977,2998,2979
050,36,085,"New York","Richmond County",2,24,6149,3096,3053
050,36,085,"New York","Richmond County",2,25,6279,3170,3109
050,36,085,"New York","Richmond County",2,26,6380,3245,3135
050,36,085,"New York","Richmond County",2,27,6464,3275,3189
050,36,085,"New York","Richmond County",2,28,6582,3307,3275
050,36,085,"New York","Richmond County",2,29,6904,3501,3403
050,36,085,"New York","Richmond County",2,30,6988,3500,3488
050,36,085,"New York","Richmond County",2,31,6857,3450,3407
050,36,085,"New York","Richmond County",2,32,6738,3375,3363
050,36,085,"New York","Richmond County",2,33,6527,3268,3259
050,36,085,"New York","Richmond County",2,34,6409,3211,3198
050,36,085,"New York","Richmond County",2,35,6410,3186,3224
050,36,085,"New York","Richmond County",2,36,6282,3134,3148
050,36,085,"New York","Richmond County",2,37,6335,3106,3229
050,36,085,"New York","Richmond County",2,38,6213,3046,3167
050,36,085,"New York","Richmond County",2,39,6056,2985,3071
050,36,085,"New York","Richmond County",2,40,6314,3128,3186
050,36,085,"New York","Richmond County",2,41,6262,3079,3183
050,36,085,"New York","Richmond County",2,42,6239,3046,3193
050,36,085,"New York","Richmond County",2,43,6180,3014,3166
050,36,085,"New York","Richmond County",2,44,6068,2972,3096
050,36,085,"New York","Richmond County",2,45,6300,3106,3194
050,36,085,"New York","Richmond County",2,46,6171,3027,3144
050,36,085,"New York","Richmond County",2,47,6159,2973,3186
050,36,085,"New York","Richmond County",2,48,6488,3167,3321
050,36,085,"New York","Richmond County",2,49,7052,3432,3620
050,36,085,"New York","Richmond County",2,50,7125,3480,3645
050,36,085,"New York","Richmond County",2,51,6845,3300,3545
050,36,085,"New York","Richmond County",2,52,6701,3228,3473
050,36,085,"New York","Richmond County",2,53,6858,3331,3527
050,36,085,"New York","Richmond County",2,54,6981,3410,3571
050,36,085,"New York","Richmond County",2,55,7223,3547,3676
050,36,085,"New York","Richmond County",2,56,7312,3570,3742
050,36,085,"New York","Richmond County",2,57,7293,3491,3802
050,36,085,"New York","Richmond County",2,58,7085,3438,3647
050,36,085,"New York","Richmond County",2,59,7075,3445,3630
050,36,085,"New York","Richmond County",2,60,7085,3426,3659
050,36,085,"New York","Richmond County",2,61,6872,3335,3537
050,36,085,"New York","Richmond County",2,62,6781,3286,3495
050,36,085,"New York","Richmond County",2,63,6609,3175,3434
050,36,085,"New York","Richmond County",2,64,6258,2990,3268
050,36,085,"New York","Richmond County",2,65,6111,2932,3179
050,36,085,"New York","Richmond County",2,66,5677,2704,2973
050,36,085,"New York","Richmond County",2,67,5314,2483,2831
050,36,085,"New York","Richmond County",2,68,5135,2399,2736
050,36,085,"New York","Richmond County",2,69,4971,2277,2694
050,36,085,"New York","Richmond County",2,70,4804,2188,2616
050,36,085,"New York","Richmond County",2,71,4639,2086,2553
050,36,085,"New York","Richmond County",2,72,4564,2081,2483
050,36,085,"New York","Richmond County",2,73,4657,2150,2507
050,36,085,"New York","Richmond County",2,74,3320,1486,1834
050,36,085,"New York","Richmond County",2,75,3205,1383,1822
050,36,085,"New York","Richmond County",2,76,3012,1303,1709
050,36,085,"New York","Richmond County",2,77,2998,1319,1679
050,36,085,"New York","Richmond County",2,78,2542,1112,1430
050,36,085,"New York","Richmond County",2,79,2298,999,1299
050,36,085,"New York","Richmond County",2,80,2123,942,1181
050,36,085,"New York","Richmond County",2,81,1918,822,1096
050,36,085,"New York","Richmond County",2,82,1755,704,1051
050,36,085,"New York","Richmond County",2,83,1566,592,974
050,36,085,"New York","Richmond County",2,84,1403,547,856
050,36,085,"New York","Richmond County",2,85,8799,2967,5832
050,36,085,"New York","Richmond County",3,0,4863,2516,2347
050,36,085,"New York","Richmond County",3,1,5291,2761,2530
050,36,085,"New York","Richmond County",3,2,5399,2814,2585
050,36,085,"New York","Richmond County",3,3,5595,2899,2696
050,36,085,"New York","Richmond County",3,4,5732,3036,2696
050,36,085,"New York","Richmond County",3,5,5910,3039,2871
050,36,085,"New York","Richmond County",3,6,5909,2986,2923
050,36,085,"New York","Richmond County",3,7,5875,3025,2850
050,36,085,"New York","Richmond County",3,8,5910,3028,2882
050,36,085,"New York","Richmond County",3,9,5956,3102,2854
050,36,085,"New York","Richmond County",3,10,6179,3193,2986
050,36,085,"New York","Richmond County",3,11,6174,3132,3042
050,36,085,"New York","Richmond County",3,12,6139,3162,2977
050,36,085,"New York","Richmond County",3,13,6452,3353,3099
050,36,085,"New York","Richmond County",3,14,6495,3382,3113
050,36,085,"New York","Richmond County",3,15,6435,3308,3127
050,36,085,"New York","Richmond County",3,16,6552,3332,3220
050,36,085,"New York","Richmond County",3,17,6667,3372,3295
050,36,085,"New York","Richmond County",3,18,5911,3066,2845
050,36,085,"New York","Richmond County",3,19,5133,2648,2485
050,36,085,"New York","Richmond County",3,20,5469,2804,2665
050,36,085,"New York","Richmond County",3,21,5777,2964,2813
050,36,085,"New York","Richmond County",3,22,5804,2987,2817
050,36,085,"New York","Richmond County",3,23,5916,2975,2941
050,36,085,"New York","Richmond County",3,24,6032,3054,2978
050,36,085,"New York","Richmond County",3,25,6179,3099,3080
050,36,085,"New York","Richmond County",3,26,6183,3125,3058
050,36,085,"New York","Richmond County",3,27,6400,3256,3144
050,36,085,"New York","Richmond County",3,28,6408,3255,3153
050,36,085,"New York","Richmond County",3,29,6550,3320,3230
050,36,085,"New York","Richmond County",3,30,6920,3493,3427
050,36,085,"New York","Richmond County",3,31,6922,3402,3520
050,36,085,"New York","Richmond County",3,32,6887,3486,3401
050,36,085,"New York","Richmond County",3,33,6698,3347,3351
050,36,085,"New York","Richmond County",3,34,6530,3246,3284
050,36,085,"New York","Richmond County",3,35,6395,3244,3151
050,36,085,"New York","Richmond County",3,36,6431,3166,3265
050,36,085,"New York","Richmond County",3,37,6278,3124,3154
050,36,085,"New York","Richmond County",3,38,6346,3113,3233
050,36,085,"New York","Richmond County",3,39,6258,3077,3181
050,36,085,"New York","Richmond County",3,40,6057,2999,3058
050,36,085,"New York","Richmond County",3,41,6275,3107,3168
050,36,085,"New York","Richmond County",3,42,6175,3033,3142
050,36,085,"New York","Richmond County",3,43,6212,3035,3177
050,36,085,"New York","Richmond County",3,44,6125,2953,3172
050,36,085,"New York","Richmond County",3,45,6068,2993,3075
050,36,085,"New York","Richmond County",3,46,6298,3091,3207
050,36,085,"New York","Richmond County",3,47,6182,3028,3154
050,36,085,"New York","Richmond County",3,48,6099,2971,3128
050,36,085,"New York","Richmond County",3,49,6483,3155,3328
050,36,085,"New York","Richmond County",3,50,7010,3412,3598
050,36,085,"New York","Richmond County",3,51,7041,3424,3617
050,36,085,"New York","Richmond County",3,52,6805,3315,3490
050,36,085,"New York","Richmond County",3,53,6659,3208,3451
050,36,085,"New York","Richmond County",3,54,6784,3285,3499
050,36,085,"New York","Richmond County",3,55,6945,3382,3563
050,36,085,"New York","Richmond County",3,56,7124,3505,3619
050,36,085,"New York","Richmond County",3,57,7227,3512,3715
050,36,085,"New York","Richmond County",3,58,7217,3479,3738
050,36,085,"New York","Richmond County",3,59,6967,3359,3608
050,36,085,"New York","Richmond County",3,60,6967,3386,3581
050,36,085,"New York","Richmond County",3,61,7001,3397,3604
050,36,085,"New York","Richmond County",3,62,6749,3247,3502
050,36,085,"New York","Richmond County",3,63,6672,3221,3451
050,36,085,"New York","Richmond County",3,64,6440,3098,3342
050,36,085,"New York","Richmond County",3,65,6140,2907,3233
050,36,085,"New York","Richmond County",3,66,5930,2809,3121
050,36,085,"New York","Richmond County",3,67,5548,2627,2921
050,36,085,"New York","Richmond County",3,68,5149,2401,2748
050,36,085,"New York","Richmond County",3,69,5003,2329,2674
050,36,085,"New York","Richmond County",3,70,4879,2233,2646
050,36,085,"New York","Richmond County",3,71,4669,2130,2539
050,36,085,"New York","Richmond County",3,72,4499,1998,2501
050,36,085,"New York","Richmond County",3,73,4370,1994,2376
050,36,085,"New York","Richmond County",3,74,4493,2061,2432
050,36,085,"New York","Richmond County",3,75,3201,1419,1782
050,36,085,"New York","Richmond County",3,76,3107,1330,1777
050,36,085,"New York","Richmond County",3,77,2860,1224,1636
050,36,085,"New York","Richmond County",3,78,2849,1227,1622
050,36,085,"New York","Richmond County",3,79,2412,1035,1377
050,36,085,"New York","Richmond County",3,80,2178,938,1240
050,36,085,"New York","Richmond County",3,81,1994,878,1116
050,36,085,"New York","Richmond County",3,82,1823,758,1065
050,36,085,"New York","Richmond County",3,83,1640,648,992
050,36,085,"New York","Richmond County",3,84,1433,537,896
050,36,085,"New York","Richmond County",3,85,8828,3001,5827
050,36,085,"New York","Richmond County",4,0,5034,2504,2530
050,36,085,"New York","Richmond County",4,1,4803,2456,2347
050,36,085,"New York","Richmond County",4,2,5324,2781,2543
050,36,085,"New York","Richmond County",4,3,5347,2782,2565
050,36,085,"New York","Richmond County",4,4,5636,2912,2724
050,36,085,"New York","Richmond County",4,5,5794,3031,2763
050,36,085,"New York","Richmond County",4,6,5925,3034,2891
050,36,085,"New York","Richmond County",4,7,5980,3028,2952
050,36,085,"New York","Richmond County",4,8,5870,3002,2868
050,36,085,"New York","Richmond County",4,9,5922,3052,2870
050,36,085,"New York","Richmond County",4,10,5974,3111,2863
050,36,085,"New York","Richmond County",4,11,6171,3189,2982
050,36,085,"New York","Richmond County",4,12,6169,3122,3047
050,36,085,"New York","Richmond County",4,13,6192,3187,3005
050,36,085,"New York","Richmond County",4,14,6437,3344,3093
050,36,085,"New York","Richmond County",4,15,6488,3352,3136
050,36,085,"New York","Richmond County",4,16,6526,3347,3179
050,36,085,"New York","Richmond County",4,17,6579,3326,3253
050,36,085,"New York","Richmond County",4,18,5905,3017,2888
050,36,085,"New York","Richmond County",4,19,5087,2633,2454
050,36,085,"New York","Richmond County",4,20,5360,2756,2604
050,36,085,"New York","Richmond County",4,21,5671,2917,2754
050,36,085,"New York","Richmond County",4,22,5922,3021,2901
050,36,085,"New York","Richmond County",4,23,5922,3041,2881
050,36,085,"New York","Richmond County",4,24,5948,2974,2974
050,36,085,"New York","Richmond County",4,25,6055,3067,2988
050,36,085,"New York","Richmond County",4,26,6117,3109,3008
050,36,085,"New York","Richmond County",4,27,6128,3147,2981
050,36,085,"New York","Richmond County",4,28,6333,3204,3129
050,36,085,"New York","Richmond County",4,29,6227,3197,3030
050,36,085,"New York","Richmond County",4,30,6473,3258,3215
050,36,085,"New York","Richmond County",4,31,6896,3483,3413
050,36,085,"New York","Richmond County",4,32,6818,3343,3475
050,36,085,"New York","Richmond County",4,33,6850,3466,3384
050,36,085,"New York","Richmond County",4,34,6644,3277,3367
050,36,085,"New York","Richmond County",4,35,6528,3270,3258
050,36,085,"New York","Richmond County",4,36,6347,3197,3150
050,36,085,"New York","Richmond County",4,37,6399,3140,3259
050,36,085,"New York","Richmond County",4,38,6210,3075,3135
050,36,085,"New York","Richmond County",4,39,6293,3084,3209
050,36,085,"New York","Richmond County",4,40,6276,3112,3164
050,36,085,"New York","Richmond County",4,41,6042,2991,3051
050,36,085,"New York","Richmond County",4,42,6236,3089,3147
050,36,085,"New York","Richmond County",4,43,6182,3045,3137
050,36,085,"New York","Richmond County",4,44,6179,2983,3196
050,36,085,"New York","Richmond County",4,45,6114,2975,3139
050,36,085,"New York","Richmond County",4,46,6092,2964,3128
050,36,085,"New York","Richmond County",4,47,6317,3112,3205
050,36,085,"New York","Richmond County",4,48,6203,3034,3169
050,36,085,"New York","Richmond County",4,49,6095,2978,3117
050,36,085,"New York","Richmond County",4,50,6450,3170,3280
050,36,085,"New York","Richmond County",4,51,6990,3378,3612
050,36,085,"New York","Richmond County",4,52,7047,3430,3617
050,36,085,"New York","Richmond County",4,53,6798,3298,3500
050,36,085,"New York","Richmond County",4,54,6647,3207,3440
050,36,085,"New York","Richmond County",4,55,6705,3270,3435
050,36,085,"New York","Richmond County",4,56,6853,3317,3536
050,36,085,"New York","Richmond County",4,57,7098,3475,3623
050,36,085,"New York","Richmond County",4,58,7135,3473,3662
050,36,085,"New York","Richmond County",4,59,7141,3455,3686
050,36,085,"New York","Richmond County",4,60,6908,3334,3574
050,36,085,"New York","Richmond County",4,61,6840,3339,3501
050,36,085,"New York","Richmond County",4,62,6864,3311,3553
050,36,085,"New York","Richmond County",4,63,6575,3163,3412
050,36,085,"New York","Richmond County",4,64,6521,3167,3354
050,36,085,"New York","Richmond County",4,65,6314,3012,3302
050,36,085,"New York","Richmond County",4,66,5904,2788,3116
050,36,085,"New York","Richmond County",4,67,5731,2710,3021
050,36,085,"New York","Richmond County",4,68,5332,2512,2820
050,36,085,"New York","Richmond County",4,69,4945,2302,2643
050,36,085,"New York","Richmond County",4,70,4861,2267,2594
050,36,085,"New York","Richmond County",4,71,4669,2130,2539
050,36,085,"New York","Richmond County",4,72,4482,2038,2444
050,36,085,"New York","Richmond County",4,73,4277,1876,2401
050,36,085,"New York","Richmond County",4,74,4166,1883,2283
050,36,085,"New York","Richmond County",4,75,4322,1966,2356
050,36,085,"New York","Richmond County",4,76,3069,1341,1728
050,36,085,"New York","Richmond County",4,77,2960,1266,1694
050,36,085,"New York","Richmond County",4,78,2710,1152,1558
050,36,085,"New York","Richmond County",4,79,2694,1139,1555
050,36,085,"New York","Richmond County",4,80,2256,962,1294
050,36,085,"New York","Richmond County",4,81,2039,867,1172
050,36,085,"New York","Richmond County",4,82,1907,826,1081
050,36,085,"New York","Richmond County",4,83,1712,714,998
050,36,085,"New York","Richmond County",4,84,1503,596,907
050,36,085,"New York","Richmond County",4,85,8893,3001,5892
050,36,085,"New York","Richmond County",5,0,4921,2444,2477
050,36,085,"New York","Richmond County",5,1,5031,2550,2481
050,36,085,"New York","Richmond County",5,2,4847,2512,2335
050,36,085,"New York","Richmond County",5,3,5323,2772,2551
050,36,085,"New York","Richmond County",5,4,5364,2794,2570
050,36,085,"New York","Richmond County",5,5,5703,2918,2785
050,36,085,"New York","Richmond County",5,6,5846,3083,2763
050,36,085,"New York","Richmond County",5,7,5961,3071,2890
050,36,085,"New York","Richmond County",5,8,6044,3073,2971
050,36,085,"New York","Richmond County",5,9,5857,2972,2885
050,36,085,"New York","Richmond County",5,10,6003,3065,2938
050,36,085,"New York","Richmond County",5,11,6036,3133,2903
050,36,085,"New York","Richmond County",5,12,6226,3219,3007
050,36,085,"New York","Richmond County",5,13,6241,3162,3079
050,36,085,"New York","Richmond County",5,14,6231,3225,3006
050,36,085,"New York","Richmond County",5,15,6475,3375,3100
050,36,085,"New York","Richmond County",5,16,6538,3377,3161
050,36,085,"New York","Richmond County",5,17,6612,3390,3222
050,36,085,"New York","Richmond County",5,18,5863,2994,2869
050,36,085,"New York","Richmond County",5,19,5108,2581,2527
050,36,085,"New York","Richmond County",5,20,5453,2799,2654
050,36,085,"New York","Richmond County",5,21,5618,2860,2758
050,36,085,"New York","Richmond County",5,22,5822,2955,2867
050,36,085,"New York","Richmond County",5,23,6179,3164,3015
050,36,085,"New York","Richmond County",5,24,5943,3061,2882
050,36,085,"New York","Richmond County",5,25,5969,3008,2961
050,36,085,"New York","Richmond County",5,26,6018,3051,2967
050,36,085,"New York","Richmond County",5,27,6003,3107,2896
050,36,085,"New York","Richmond County",5,28,6043,3080,2963
050,36,085,"New York","Richmond County",5,29,6225,3146,3079
050,36,085,"New York","Richmond County",5,30,6153,3116,3037
050,36,085,"New York","Richmond County",5,31,6397,3219,3178
050,36,085,"New York","Richmond County",5,32,6815,3414,3401
050,36,085,"New York","Richmond County",5,33,6839,3317,3522
050,36,085,"New York","Richmond County",5,34,6857,3479,3378
050,36,085,"New York","Richmond County",5,35,6664,3302,3362
050,36,085,"New York","Richmond County",5,36,6478,3216,3262
050,36,085,"New York","Richmond County",5,37,6372,3218,3154
050,36,085,"New York","Richmond County",5,38,6427,3164,3263
050,36,085,"New York","Richmond County",5,39,6229,3084,3145
050,36,085,"New York","Richmond County",5,40,6331,3075,3256
050,36,085,"New York","Richmond County",5,41,6303,3128,3175
050,36,085,"New York","Richmond County",5,42,6021,2976,3045
050,36,085,"New York","Richmond County",5,43,6173,3076,3097
050,36,085,"New York","Richmond County",5,44,6155,2995,3160
050,36,085,"New York","Richmond County",5,45,6155,3014,3141
050,36,085,"New York","Richmond County",5,46,6102,2932,3170
050,36,085,"New York","Richmond County",5,47,6097,2967,3130
050,36,085,"New York","Richmond County",5,48,6313,3137,3176
050,36,085,"New York","Richmond County",5,49,6221,3035,3186
050,36,085,"New York","Richmond County",5,50,6131,3008,3123
050,36,085,"New York","Richmond County",5,51,6442,3124,3318
050,36,085,"New York","Richmond County",5,52,6970,3374,3596
050,36,085,"New York","Richmond County",5,53,6972,3403,3569
050,36,085,"New York","Richmond County",5,54,6756,3264,3492
050,36,085,"New York","Richmond County",5,55,6598,3166,3432
050,36,085,"New York","Richmond County",5,56,6653,3236,3417
050,36,085,"New York","Richmond County",5,57,6797,3292,3505
050,36,085,"New York","Richmond County",5,58,7009,3425,3584
050,36,085,"New York","Richmond County",5,59,7069,3438,3631
050,36,085,"New York","Richmond County",5,60,7035,3393,3642
050,36,085,"New York","Richmond County",5,61,6811,3278,3533
050,36,085,"New York","Richmond County",5,62,6704,3269,3435
050,36,085,"New York","Richmond County",5,63,6639,3224,3415
050,36,085,"New York","Richmond County",5,64,6379,3080,3299
050,36,085,"New York","Richmond County",5,65,6411,3097,3314
050,36,085,"New York","Richmond County",5,66,6153,2907,3246
050,36,085,"New York","Richmond County",5,67,5756,2708,3048
050,36,085,"New York","Richmond County",5,68,5528,2593,2935
050,36,085,"New York","Richmond County",5,69,5207,2431,2776
050,36,085,"New York","Richmond County",5,70,4832,2237,2595
050,36,085,"New York","Richmond County",5,71,4738,2201,2537
050,36,085,"New York","Richmond County",5,72,4543,2053,2490
050,36,085,"New York","Richmond County",5,73,4300,1941,2359
050,36,085,"New York","Richmond County",5,74,4117,1802,2315
050,36,085,"New York","Richmond County",5,75,4016,1794,2222
050,36,085,"New York","Richmond County",5,76,4161,1887,2274
050,36,085,"New York","Richmond County",5,77,2927,1267,1660
050,36,085,"New York","Richmond County",5,78,2799,1200,1599
050,36,085,"New York","Richmond County",5,79,2594,1081,1513
050,36,085,"New York","Richmond County",5,80,2555,1072,1483
050,36,085,"New York","Richmond County",5,81,2118,902,1216
050,36,085,"New York","Richmond County",5,82,1950,817,1133
050,36,085,"New York","Richmond County",5,83,1793,784,1009
050,36,085,"New York","Richmond County",5,84,1579,666,913
050,36,085,"New York","Richmond County",5,85,9040,3090,5950
050,36,087,"New York","Rockland County",1,0,5808,2966,2842
050,36,087,"New York","Rockland County",1,1,5812,2938,2874
050,36,087,"New York","Rockland County",1,2,5655,2827,2828
050,36,087,"New York","Rockland County",1,3,5522,2803,2719
050,36,087,"New York","Rockland County",1,4,5475,2834,2641
050,36,087,"New York","Rockland County",1,5,5471,2754,2717
050,36,087,"New York","Rockland County",1,6,5210,2586,2624
050,36,087,"New York","Rockland County",1,7,5071,2575,2496
050,36,087,"New York","Rockland County",1,8,5138,2652,2486
050,36,087,"New York","Rockland County",1,9,5200,2644,2556
050,36,087,"New York","Rockland County",1,10,5417,2774,2643
050,36,087,"New York","Rockland County",1,11,5530,2855,2675
050,36,087,"New York","Rockland County",1,12,5700,2976,2724
050,36,087,"New York","Rockland County",1,13,5532,2804,2728
050,36,087,"New York","Rockland County",1,14,5462,2805,2657
050,36,087,"New York","Rockland County",1,15,5515,2852,2663
050,36,087,"New York","Rockland County",1,16,5523,2817,2706
050,36,087,"New York","Rockland County",1,17,5418,2789,2629
050,36,087,"New York","Rockland County",1,18,4760,2526,2234
050,36,087,"New York","Rockland County",1,19,4094,2153,1941
050,36,087,"New York","Rockland County",1,20,4236,2163,2073
050,36,087,"New York","Rockland County",1,21,4324,2225,2099
050,36,087,"New York","Rockland County",1,22,4433,2235,2198
050,36,087,"New York","Rockland County",1,23,4390,2227,2163
050,36,087,"New York","Rockland County",1,24,4263,2148,2115
050,36,087,"New York","Rockland County",1,25,4111,2068,2043
050,36,087,"New York","Rockland County",1,26,4151,2106,2045
050,36,087,"New York","Rockland County",1,27,4084,2100,1984
050,36,087,"New York","Rockland County",1,28,3937,2002,1935
050,36,087,"New York","Rockland County",1,29,3925,2018,1907
050,36,087,"New York","Rockland County",1,30,3779,1912,1867
050,36,087,"New York","Rockland County",1,31,3624,1872,1752
050,36,087,"New York","Rockland County",1,32,3626,1857,1769
050,36,087,"New York","Rockland County",1,33,3674,1897,1777
050,36,087,"New York","Rockland County",1,34,3738,1916,1822
050,36,087,"New York","Rockland County",1,35,3810,1918,1892
050,36,087,"New York","Rockland County",1,36,3851,1966,1885
050,36,087,"New York","Rockland County",1,37,3903,1975,1928
050,36,087,"New York","Rockland County",1,38,3898,1961,1937
050,36,087,"New York","Rockland County",1,39,3957,2010,1947
050,36,087,"New York","Rockland County",1,40,3909,1962,1947
050,36,087,"New York","Rockland County",1,41,3797,1870,1927
050,36,087,"New York","Rockland County",1,42,3755,1935,1820
050,36,087,"New York","Rockland County",1,43,3676,1865,1811
050,36,087,"New York","Rockland County",1,44,3596,1806,1790
050,36,087,"New York","Rockland County",1,45,3587,1748,1839
050,36,087,"New York","Rockland County",1,46,3531,1763,1768
050,36,087,"New York","Rockland County",1,47,3654,1800,1854
050,36,087,"New York","Rockland County",1,48,3750,1838,1912
050,36,087,"New York","Rockland County",1,49,4087,2025,2062
050,36,087,"New York","Rockland County",1,50,4083,2028,2055
050,36,087,"New York","Rockland County",1,51,4060,2030,2030
050,36,087,"New York","Rockland County",1,52,4046,2001,2045
050,36,087,"New York","Rockland County",1,53,4148,2028,2120
050,36,087,"New York","Rockland County",1,54,4273,2087,2186
050,36,087,"New York","Rockland County",1,55,4379,2128,2251
050,36,087,"New York","Rockland County",1,56,4310,2096,2214
050,36,087,"New York","Rockland County",1,57,4309,2127,2182
050,36,087,"New York","Rockland County",1,58,4380,2196,2184
050,36,087,"New York","Rockland County",1,59,4212,2047,2165
050,36,087,"New York","Rockland County",1,60,4108,1959,2149
050,36,087,"New York","Rockland County",1,61,3959,1918,2041
050,36,087,"New York","Rockland County",1,62,3905,1921,1984
050,36,087,"New York","Rockland County",1,63,3737,1838,1899
050,36,087,"New York","Rockland County",1,64,3598,1746,1852
050,36,087,"New York","Rockland County",1,65,3426,1662,1764
050,36,087,"New York","Rockland County",1,66,3233,1559,1674
050,36,087,"New York","Rockland County",1,67,3197,1553,1644
050,36,087,"New York","Rockland County",1,68,3095,1480,1615
050,36,087,"New York","Rockland County",1,69,2862,1305,1557
050,36,087,"New York","Rockland County",1,70,2756,1262,1494
050,36,087,"New York","Rockland County",1,71,2769,1264,1505
050,36,087,"New York","Rockland County",1,72,2827,1279,1548
050,36,087,"New York","Rockland County",1,73,2854,1281,1573
050,36,087,"New York","Rockland County",1,74,2091,888,1203
050,36,087,"New York","Rockland County",1,75,2038,866,1172
050,36,087,"New York","Rockland County",1,76,2044,866,1178
050,36,087,"New York","Rockland County",1,77,2013,884,1129
050,36,087,"New York","Rockland County",1,78,1794,770,1024
050,36,087,"New York","Rockland County",1,79,1593,692,901
050,36,087,"New York","Rockland County",1,80,1432,627,805
050,36,087,"New York","Rockland County",1,81,1347,535,812
050,36,087,"New York","Rockland County",1,82,1356,542,814
050,36,087,"New York","Rockland County",1,83,1259,519,740
050,36,087,"New York","Rockland County",1,84,1172,472,700
050,36,087,"New York","Rockland County",1,85,7303,2611,4692
050,36,087,"New York","Rockland County",2,0,5755,2963,2792
050,36,087,"New York","Rockland County",2,1,5802,2935,2867
050,36,087,"New York","Rockland County",2,2,5698,2856,2842
050,36,087,"New York","Rockland County",2,3,5539,2808,2731
050,36,087,"New York","Rockland County",2,4,5505,2834,2671
050,36,087,"New York","Rockland County",2,5,5477,2777,2700
050,36,087,"New York","Rockland County",2,6,5289,2636,2653
050,36,087,"New York","Rockland County",2,7,5102,2578,2524
050,36,087,"New York","Rockland County",2,8,5107,2625,2482
050,36,087,"New York","Rockland County",2,9,5188,2648,2540
050,36,087,"New York","Rockland County",2,10,5362,2742,2620
050,36,087,"New York","Rockland County",2,11,5489,2831,2658
050,36,087,"New York","Rockland County",2,12,5690,2961,2729
050,36,087,"New York","Rockland County",2,13,5573,2848,2725
050,36,087,"New York","Rockland County",2,14,5480,2805,2675
050,36,087,"New York","Rockland County",2,15,5513,2845,2668
050,36,087,"New York","Rockland County",2,16,5531,2829,2702
050,36,087,"New York","Rockland County",2,17,5449,2799,2650
050,36,087,"New York","Rockland County",2,18,4752,2511,2241
050,36,087,"New York","Rockland County",2,19,4106,2161,1945
050,36,087,"New York","Rockland County",2,20,4275,2191,2084
050,36,087,"New York","Rockland County",2,21,4311,2211,2100
050,36,087,"New York","Rockland County",2,22,4404,2226,2178
050,36,087,"New York","Rockland County",2,23,4403,2227,2176
050,36,087,"New York","Rockland County",2,24,4259,2149,2110
050,36,087,"New York","Rockland County",2,25,4119,2080,2039
050,36,087,"New York","Rockland County",2,26,4110,2084,2026
050,36,087,"New York","Rockland County",2,27,4073,2089,1984
050,36,087,"New York","Rockland County",2,28,3969,2022,1947
050,36,087,"New York","Rockland County",2,29,3902,1998,1904
050,36,087,"New York","Rockland County",2,30,3820,1945,1875
050,36,087,"New York","Rockland County",2,31,3645,1872,1773
050,36,087,"New York","Rockland County",2,32,3617,1851,1766
050,36,087,"New York","Rockland County",2,33,3648,1883,1765
050,36,087,"New York","Rockland County",2,34,3727,1916,1811
050,36,087,"New York","Rockland County",2,35,3813,1929,1884
050,36,087,"New York","Rockland County",2,36,3818,1940,1878
050,36,087,"New York","Rockland County",2,37,3883,1970,1913
050,36,087,"New York","Rockland County",2,38,3905,1972,1933
050,36,087,"New York","Rockland County",2,39,3928,1989,1939
050,36,087,"New York","Rockland County",2,40,3940,1983,1957
050,36,087,"New York","Rockland County",2,41,3806,1884,1922
050,36,087,"New York","Rockland County",2,42,3743,1909,1834
050,36,087,"New York","Rockland County",2,43,3715,1892,1823
050,36,087,"New York","Rockland County",2,44,3591,1804,1787
050,36,087,"New York","Rockland County",2,45,3605,1767,1838
050,36,087,"New York","Rockland County",2,46,3525,1750,1775
050,36,087,"New York","Rockland County",2,47,3609,1781,1828
050,36,087,"New York","Rockland County",2,48,3717,1826,1891
050,36,087,"New York","Rockland County",2,49,4005,1983,2022
050,36,087,"New York","Rockland County",2,50,4071,2023,2048
050,36,087,"New York","Rockland County",2,51,4036,2013,2023
050,36,087,"New York","Rockland County",2,52,4024,1996,2028
050,36,087,"New York","Rockland County",2,53,4100,2009,2091
050,36,087,"New York","Rockland County",2,54,4212,2056,2156
050,36,087,"New York","Rockland County",2,55,4332,2107,2225
050,36,087,"New York","Rockland County",2,56,4311,2093,2218
050,36,087,"New York","Rockland County",2,57,4279,2105,2174
050,36,087,"New York","Rockland County",2,58,4335,2169,2166
050,36,087,"New York","Rockland County",2,59,4225,2065,2160
050,36,087,"New York","Rockland County",2,60,4096,1957,2139
050,36,087,"New York","Rockland County",2,61,3940,1897,2043
050,36,087,"New York","Rockland County",2,62,3868,1891,1977
050,36,087,"New York","Rockland County",2,63,3755,1843,1912
050,36,087,"New York","Rockland County",2,64,3561,1728,1833
050,36,087,"New York","Rockland County",2,65,3431,1660,1771
050,36,087,"New York","Rockland County",2,66,3240,1557,1683
050,36,087,"New York","Rockland County",2,67,3154,1523,1631
050,36,087,"New York","Rockland County",2,68,3065,1464,1601
050,36,087,"New York","Rockland County",2,69,2900,1336,1564
050,36,087,"New York","Rockland County",2,70,2739,1248,1491
050,36,087,"New York","Rockland County",2,71,2715,1229,1486
050,36,087,"New York","Rockland County",2,72,2731,1228,1503
050,36,087,"New York","Rockland County",2,73,2914,1309,1605
050,36,087,"New York","Rockland County",2,74,2134,923,1211
050,36,087,"New York","Rockland County",2,75,2033,856,1177
050,36,087,"New York","Rockland County",2,76,1979,840,1139
050,36,087,"New York","Rockland County",2,77,2016,880,1136
050,36,087,"New York","Rockland County",2,78,1781,767,1014
050,36,087,"New York","Rockland County",2,79,1586,683,903
050,36,087,"New York","Rockland County",2,80,1430,625,805
050,36,087,"New York","Rockland County",2,81,1328,537,791
050,36,087,"New York","Rockland County",2,82,1308,516,792
050,36,087,"New York","Rockland County",2,83,1226,495,731
050,36,087,"New York","Rockland County",2,84,1150,464,686
050,36,087,"New York","Rockland County",2,85,7070,2549,4521
050,36,087,"New York","Rockland County",3,0,5913,3058,2855
050,36,087,"New York","Rockland County",3,1,5772,3009,2763
050,36,087,"New York","Rockland County",3,2,5864,2962,2902
050,36,087,"New York","Rockland County",3,3,5735,2896,2839
050,36,087,"New York","Rockland County",3,4,5584,2828,2756
050,36,087,"New York","Rockland County",3,5,5585,2879,2706
050,36,087,"New York","Rockland County",3,6,5497,2779,2718
050,36,087,"New York","Rockland County",3,7,5360,2672,2688
050,36,087,"New York","Rockland County",3,8,5133,2579,2554
050,36,087,"New York","Rockland County",3,9,5165,2654,2511
050,36,087,"New York","Rockland County",3,10,5255,2688,2567
050,36,087,"New York","Rockland County",3,11,5414,2769,2645
050,36,087,"New York","Rockland County",3,12,5566,2860,2706
050,36,087,"New York","Rockland County",3,13,5726,2984,2742
050,36,087,"New York","Rockland County",3,14,5582,2867,2715
050,36,087,"New York","Rockland County",3,15,5491,2821,2670
050,36,087,"New York","Rockland County",3,16,5509,2839,2670
050,36,087,"New York","Rockland County",3,17,5560,2828,2732
050,36,087,"New York","Rockland County",3,18,4889,2555,2334
050,36,087,"New York","Rockland County",3,19,4086,2154,1932
050,36,087,"New York","Rockland County",3,20,4330,2236,2094
050,36,087,"New York","Rockland County",3,21,4390,2244,2146
050,36,087,"New York","Rockland County",3,22,4314,2214,2100
050,36,087,"New York","Rockland County",3,23,4419,2252,2167
050,36,087,"New York","Rockland County",3,24,4352,2201,2151
050,36,087,"New York","Rockland County",3,25,4179,2129,2050
050,36,087,"New York","Rockland County",3,26,4086,2056,2030
050,36,087,"New York","Rockland County",3,27,4080,2076,2004
050,36,087,"New York","Rockland County",3,28,4061,2069,1992
050,36,087,"New York","Rockland County",3,29,3953,1990,1963
050,36,087,"New York","Rockland County",3,30,3896,1993,1903
050,36,087,"New York","Rockland County",3,31,3837,1938,1899
050,36,087,"New York","Rockland County",3,32,3680,1864,1816
050,36,087,"New York","Rockland County",3,33,3717,1924,1793
050,36,087,"New York","Rockland County",3,34,3696,1866,1830
050,36,087,"New York","Rockland County",3,35,3780,1901,1879
050,36,087,"New York","Rockland County",3,36,3907,1974,1933
050,36,087,"New York","Rockland County",3,37,3831,1930,1901
050,36,087,"New York","Rockland County",3,38,3958,2020,1938
050,36,087,"New York","Rockland County",3,39,3974,2013,1961
050,36,087,"New York","Rockland County",3,40,3967,2007,1960
050,36,087,"New York","Rockland County",3,41,3999,2008,1991
050,36,087,"New York","Rockland County",3,42,3799,1889,1910
050,36,087,"New York","Rockland County",3,43,3752,1933,1819
050,36,087,"New York","Rockland County",3,44,3737,1900,1837
050,36,087,"New York","Rockland County",3,45,3574,1784,1790
050,36,087,"New York","Rockland County",3,46,3633,1802,1831
050,36,087,"New York","Rockland County",3,47,3560,1766,1794
050,36,087,"New York","Rockland County",3,48,3561,1759,1802
050,36,087,"New York","Rockland County",3,49,3722,1845,1877
050,36,087,"New York","Rockland County",3,50,3982,1975,2007
050,36,087,"New York","Rockland County",3,51,4082,2028,2054
050,36,087,"New York","Rockland County",3,52,3986,2008,1978
050,36,087,"New York","Rockland County",3,53,3988,1978,2010
050,36,087,"New York","Rockland County",3,54,4033,1961,2072
050,36,087,"New York","Rockland County",3,55,4135,2027,2108
050,36,087,"New York","Rockland County",3,56,4265,2069,2196
050,36,087,"New York","Rockland County",3,57,4217,2042,2175
050,36,087,"New York","Rockland County",3,58,4195,2065,2130
050,36,087,"New York","Rockland County",3,59,4242,2119,2123
050,36,087,"New York","Rockland County",3,60,4122,2013,2109
050,36,087,"New York","Rockland County",3,61,4036,1935,2101
050,36,087,"New York","Rockland County",3,62,3862,1855,2007
050,36,087,"New York","Rockland County",3,63,3758,1831,1927
050,36,087,"New York","Rockland County",3,64,3618,1762,1856
050,36,087,"New York","Rockland County",3,65,3477,1701,1776
050,36,087,"New York","Rockland County",3,66,3327,1603,1724
050,36,087,"New York","Rockland County",3,67,3133,1496,1637
050,36,087,"New York","Rockland County",3,68,3017,1446,1571
050,36,087,"New York","Rockland County",3,69,2983,1422,1561
050,36,087,"New York","Rockland County",3,70,2795,1282,1513
050,36,087,"New York","Rockland County",3,71,2630,1186,1444
050,36,087,"New York","Rockland County",3,72,2622,1176,1446
050,36,087,"New York","Rockland County",3,73,2623,1181,1442
050,36,087,"New York","Rockland County",3,74,2837,1253,1584
050,36,087,"New York","Rockland County",3,75,2079,899,1180
050,36,087,"New York","Rockland County",3,76,1944,802,1142
050,36,087,"New York","Rockland County",3,77,1907,811,1096
050,36,087,"New York","Rockland County",3,78,1942,836,1106
050,36,087,"New York","Rockland County",3,79,1705,725,980
050,36,087,"New York","Rockland County",3,80,1508,651,857
050,36,087,"New York","Rockland County",3,81,1397,588,809
050,36,087,"New York","Rockland County",3,82,1275,512,763
050,36,087,"New York","Rockland County",3,83,1212,467,745
050,36,087,"New York","Rockland County",3,84,1146,452,694
050,36,087,"New York","Rockland County",3,85,7276,2623,4653
050,36,087,"New York","Rockland County",4,0,6350,3234,3116
050,36,087,"New York","Rockland County",4,1,5851,3019,2832
050,36,087,"New York","Rockland County",4,2,5822,3019,2803
050,36,087,"New York","Rockland County",4,3,5899,2984,2915
050,36,087,"New York","Rockland County",4,4,5774,2914,2860
050,36,087,"New York","Rockland County",4,5,5615,2842,2773
050,36,087,"New York","Rockland County",4,6,5626,2897,2729
050,36,087,"New York","Rockland County",4,7,5515,2772,2743
050,36,087,"New York","Rockland County",4,8,5437,2719,2718
050,36,087,"New York","Rockland County",4,9,5216,2623,2593
050,36,087,"New York","Rockland County",4,10,5224,2679,2545
050,36,087,"New York","Rockland County",4,11,5302,2714,2588
050,36,087,"New York","Rockland County",4,12,5437,2790,2647
050,36,087,"New York","Rockland County",4,13,5626,2897,2729
050,36,087,"New York","Rockland County",4,14,5760,3004,2756
050,36,087,"New York","Rockland County",4,15,5612,2892,2720
050,36,087,"New York","Rockland County",4,16,5512,2838,2674
050,36,087,"New York","Rockland County",4,17,5553,2853,2700
050,36,087,"New York","Rockland County",4,18,4942,2570,2372
050,36,087,"New York","Rockland County",4,19,4073,2136,1937
050,36,087,"New York","Rockland County",4,20,4240,2196,2044
050,36,087,"New York","Rockland County",4,21,4396,2262,2134
050,36,087,"New York","Rockland County",4,22,4382,2237,2145
050,36,087,"New York","Rockland County",4,23,4353,2251,2102
050,36,087,"New York","Rockland County",4,24,4352,2246,2106
050,36,087,"New York","Rockland County",4,25,4204,2150,2054
050,36,087,"New York","Rockland County",4,26,4009,2051,1958
050,36,087,"New York","Rockland County",4,27,3949,1995,1954
050,36,087,"New York","Rockland County",4,28,3979,2013,1966
050,36,087,"New York","Rockland County",4,29,3954,2017,1937
050,36,087,"New York","Rockland County",4,30,3891,1977,1914
050,36,087,"New York","Rockland County",4,31,3882,1992,1890
050,36,087,"New York","Rockland County",4,32,3824,1936,1888
050,36,087,"New York","Rockland County",4,33,3645,1867,1778
050,36,087,"New York","Rockland County",4,34,3705,1903,1802
050,36,087,"New York","Rockland County",4,35,3719,1851,1868
050,36,087,"New York","Rockland County",4,36,3814,1916,1898
050,36,087,"New York","Rockland County",4,37,3921,1976,1945
050,36,087,"New York","Rockland County",4,38,3811,1934,1877
050,36,087,"New York","Rockland County",4,39,3966,2023,1943
050,36,087,"New York","Rockland County",4,40,3996,2018,1978
050,36,087,"New York","Rockland County",4,41,3948,1989,1959
050,36,087,"New York","Rockland County",4,42,3994,2009,1985
050,36,087,"New York","Rockland County",4,43,3837,1909,1928
050,36,087,"New York","Rockland County",4,44,3793,1957,1836
050,36,087,"New York","Rockland County",4,45,3718,1893,1825
050,36,087,"New York","Rockland County",4,46,3556,1776,1780
050,36,087,"New York","Rockland County",4,47,3614,1790,1824
050,36,087,"New York","Rockland County",4,48,3502,1752,1750
050,36,087,"New York","Rockland County",4,49,3543,1748,1795
050,36,087,"New York","Rockland County",4,50,3715,1849,1866
050,36,087,"New York","Rockland County",4,51,3967,1962,2005
050,36,087,"New York","Rockland County",4,52,4015,1986,2029
050,36,087,"New York","Rockland County",4,53,3950,1988,1962
050,36,087,"New York","Rockland County",4,54,3884,1936,1948
050,36,087,"New York","Rockland County",4,55,3985,1946,2039
050,36,087,"New York","Rockland County",4,56,4058,1994,2064
050,36,087,"New York","Rockland County",4,57,4120,1997,2123
050,36,087,"New York","Rockland County",4,58,4140,2013,2127
050,36,087,"New York","Rockland County",4,59,4058,1968,2090
050,36,087,"New York","Rockland County",4,60,4141,2055,2086
050,36,087,"New York","Rockland County",4,61,4018,1992,2026
050,36,087,"New York","Rockland County",4,62,3910,1885,2025
050,36,087,"New York","Rockland County",4,63,3722,1779,1943
050,36,087,"New York","Rockland County",4,64,3599,1752,1847
050,36,087,"New York","Rockland County",4,65,3489,1704,1785
050,36,087,"New York","Rockland County",4,66,3349,1639,1710
050,36,087,"New York","Rockland County",4,67,3212,1526,1686
050,36,087,"New York","Rockland County",4,68,3008,1439,1569
050,36,087,"New York","Rockland County",4,69,2916,1386,1530
050,36,087,"New York","Rockland County",4,70,2857,1365,1492
050,36,087,"New York","Rockland County",4,71,2667,1215,1452
050,36,087,"New York","Rockland County",4,72,2547,1145,1402
050,36,087,"New York","Rockland County",4,73,2510,1119,1391
050,36,087,"New York","Rockland County",4,74,2543,1138,1405
050,36,087,"New York","Rockland County",4,75,2692,1184,1508
050,36,087,"New York","Rockland County",4,76,1964,831,1133
050,36,087,"New York","Rockland County",4,77,1853,767,1086
050,36,087,"New York","Rockland County",4,78,1827,764,1063
050,36,087,"New York","Rockland County",4,79,1848,778,1070
050,36,087,"New York","Rockland County",4,80,1619,691,928
050,36,087,"New York","Rockland County",4,81,1446,611,835
050,36,087,"New York","Rockland County",4,82,1314,547,767
050,36,087,"New York","Rockland County",4,83,1159,448,711
050,36,087,"New York","Rockland County",4,84,1138,433,705
050,36,087,"New York","Rockland County",4,85,7474,2715,4759
050,36,087,"New York","Rockland County",5,0,6252,3186,3066
050,36,087,"New York","Rockland County",5,1,6392,3250,3142
050,36,087,"New York","Rockland County",5,2,5777,2965,2812
050,36,087,"New York","Rockland County",5,3,5782,3004,2778
050,36,087,"New York","Rockland County",5,4,5831,2944,2887
050,36,087,"New York","Rockland County",5,5,5750,2917,2833
050,36,087,"New York","Rockland County",5,6,5576,2809,2767
050,36,087,"New York","Rockland County",5,7,5658,2888,2770
050,36,087,"New York","Rockland County",5,8,5537,2763,2774
050,36,087,"New York","Rockland County",5,9,5477,2749,2728
050,36,087,"New York","Rockland County",5,10,5229,2651,2578
050,36,087,"New York","Rockland County",5,11,5283,2699,2584
050,36,087,"New York","Rockland County",5,12,5339,2733,2606
050,36,087,"New York","Rockland County",5,13,5502,2829,2673
050,36,087,"New York","Rockland County",5,14,5655,2895,2760
050,36,087,"New York","Rockland County",5,15,5769,3019,2750
050,36,087,"New York","Rockland County",5,16,5601,2895,2706
050,36,087,"New York","Rockland County",5,17,5555,2865,2690
050,36,087,"New York","Rockland County",5,18,4898,2569,2329
050,36,087,"New York","Rockland County",5,19,4194,2173,2021
050,36,087,"New York","Rockland County",5,20,4288,2183,2105
050,36,087,"New York","Rockland County",5,21,4370,2229,2141
050,36,087,"New York","Rockland County",5,22,4468,2278,2190
050,36,087,"New York","Rockland County",5,23,4402,2227,2175
050,36,087,"New York","Rockland County",5,24,4265,2196,2069
050,36,087,"New York","Rockland County",5,25,4172,2153,2019
050,36,087,"New York","Rockland County",5,26,3949,2027,1922
050,36,087,"New York","Rockland County",5,27,3864,1986,1878
050,36,087,"New York","Rockland County",5,28,3813,1926,1887
050,36,087,"New York","Rockland County",5,29,3886,1958,1928
050,36,087,"New York","Rockland County",5,30,3873,2006,1867
050,36,087,"New York","Rockland County",5,31,3825,1927,1898
050,36,087,"New York","Rockland County",5,32,3866,1996,1870
050,36,087,"New York","Rockland County",5,33,3805,1913,1892
050,36,087,"New York","Rockland County",5,34,3633,1881,1752
050,36,087,"New York","Rockland County",5,35,3696,1894,1802
050,36,087,"New York","Rockland County",5,36,3747,1860,1887
050,36,087,"New York","Rockland County",5,37,3816,1922,1894
050,36,087,"New York","Rockland County",5,38,3868,1956,1912
050,36,087,"New York","Rockland County",5,39,3817,1932,1885
050,36,087,"New York","Rockland County",5,40,3986,2028,1958
050,36,087,"New York","Rockland County",5,41,4017,2018,1999
050,36,087,"New York","Rockland County",5,42,3947,1988,1959
050,36,087,"New York","Rockland County",5,43,4006,2034,1972
050,36,087,"New York","Rockland County",5,44,3859,1914,1945
050,36,087,"New York","Rockland County",5,45,3784,1953,1831
050,36,087,"New York","Rockland County",5,46,3681,1863,1818
050,36,087,"New York","Rockland County",5,47,3518,1759,1759
050,36,087,"New York","Rockland County",5,48,3595,1762,1833
050,36,087,"New York","Rockland County",5,49,3454,1724,1730
050,36,087,"New York","Rockland County",5,50,3531,1753,1778
050,36,087,"New York","Rockland County",5,51,3666,1816,1850
050,36,087,"New York","Rockland County",5,52,3925,1954,1971
050,36,087,"New York","Rockland County",5,53,3964,1955,2009
050,36,087,"New York","Rockland County",5,54,3905,1957,1948
050,36,087,"New York","Rockland County",5,55,3822,1907,1915
050,36,087,"New York","Rockland County",5,56,3918,1921,1997
050,36,087,"New York","Rockland County",5,57,3967,1942,2025
050,36,087,"New York","Rockland County",5,58,4072,1978,2094
050,36,087,"New York","Rockland County",5,59,4052,1968,2084
050,36,087,"New York","Rockland County",5,60,3957,1914,2043
050,36,087,"New York","Rockland County",5,61,4044,2020,2024
050,36,087,"New York","Rockland County",5,62,3928,1940,1988
050,36,087,"New York","Rockland County",5,63,3790,1839,1951
050,36,087,"New York","Rockland County",5,64,3575,1694,1881
050,36,087,"New York","Rockland County",5,65,3492,1719,1773
050,36,087,"New York","Rockland County",5,66,3360,1651,1709
050,36,087,"New York","Rockland County",5,67,3247,1564,1683
050,36,087,"New York","Rockland County",5,68,3111,1474,1637
050,36,087,"New York","Rockland County",5,69,2932,1401,1531
050,36,087,"New York","Rockland County",5,70,2835,1355,1480
050,36,087,"New York","Rockland County",5,71,2767,1317,1450
050,36,087,"New York","Rockland County",5,72,2587,1175,1412
050,36,087,"New York","Rockland County",5,73,2468,1103,1365
050,36,087,"New York","Rockland County",5,74,2463,1088,1375
050,36,087,"New York","Rockland County",5,75,2439,1088,1351
050,36,087,"New York","Rockland County",5,76,2587,1127,1460
050,36,087,"New York","Rockland County",5,77,1910,813,1097
050,36,087,"New York","Rockland County",5,78,1814,739,1075
050,36,087,"New York","Rockland County",5,79,1747,718,1029
050,36,087,"New York","Rockland County",5,80,1771,754,1017
050,36,087,"New York","Rockland County",5,81,1549,648,901
050,36,087,"New York","Rockland County",5,82,1369,580,789
050,36,087,"New York","Rockland County",5,83,1194,486,708
050,36,087,"New York","Rockland County",5,84,1073,409,664
050,36,087,"New York","Rockland County",5,85,7649,2799,4850
050,36,089,"New York","St. Lawrence County",1,0,1036,532,504
050,36,089,"New York","St. Lawrence County",1,1,1026,535,491
050,36,089,"New York","St. Lawrence County",1,2,1102,582,520
050,36,089,"New York","St. Lawrence County",1,3,1133,600,533
050,36,089,"New York","St. Lawrence County",1,4,1148,606,542
050,36,089,"New York","St. Lawrence County",1,5,1171,577,594
050,36,089,"New York","St. Lawrence County",1,6,1202,629,573
050,36,089,"New York","St. Lawrence County",1,7,1205,630,575
050,36,089,"New York","St. Lawrence County",1,8,1172,600,572
050,36,089,"New York","St. Lawrence County",1,9,1250,654,596
050,36,089,"New York","St. Lawrence County",1,10,1266,649,617
050,36,089,"New York","St. Lawrence County",1,11,1292,676,616
050,36,089,"New York","St. Lawrence County",1,12,1357,701,656
050,36,089,"New York","St. Lawrence County",1,13,1348,699,649
050,36,089,"New York","St. Lawrence County",1,14,1344,681,663
050,36,089,"New York","St. Lawrence County",1,15,1284,690,594
050,36,089,"New York","St. Lawrence County",1,16,1329,686,643
050,36,089,"New York","St. Lawrence County",1,17,1347,671,676
050,36,089,"New York","St. Lawrence County",1,18,2508,1281,1227
050,36,089,"New York","St. Lawrence County",1,19,3004,1607,1397
050,36,089,"New York","St. Lawrence County",1,20,2619,1369,1250
050,36,089,"New York","St. Lawrence County",1,21,2261,1240,1021
050,36,089,"New York","St. Lawrence County",1,22,1794,1000,794
050,36,089,"New York","St. Lawrence County",1,23,1278,699,579
050,36,089,"New York","St. Lawrence County",1,24,1173,635,538
050,36,089,"New York","St. Lawrence County",1,25,1151,645,506
050,36,089,"New York","St. Lawrence County",1,26,1148,626,522
050,36,089,"New York","St. Lawrence County",1,27,1183,648,535
050,36,089,"New York","St. Lawrence County",1,28,1191,629,562
050,36,089,"New York","St. Lawrence County",1,29,1255,701,554
050,36,089,"New York","St. Lawrence County",1,30,1290,697,593
050,36,089,"New York","St. Lawrence County",1,31,1246,654,592
050,36,089,"New York","St. Lawrence County",1,32,1285,685,600
050,36,089,"New York","St. Lawrence County",1,33,1266,680,586
050,36,089,"New York","St. Lawrence County",1,34,1255,687,568
050,36,089,"New York","St. Lawrence County",1,35,1256,678,578
050,36,089,"New York","St. Lawrence County",1,36,1208,639,569
050,36,089,"New York","St. Lawrence County",1,37,1280,666,614
050,36,089,"New York","St. Lawrence County",1,38,1184,616,568
050,36,089,"New York","St. Lawrence County",1,39,1229,630,599
050,36,089,"New York","St. Lawrence County",1,40,1215,621,594
050,36,089,"New York","St. Lawrence County",1,41,1177,584,593
050,36,089,"New York","St. Lawrence County",1,42,1185,611,574
050,36,089,"New York","St. Lawrence County",1,43,1191,623,568
050,36,089,"New York","St. Lawrence County",1,44,1185,639,546
050,36,089,"New York","St. Lawrence County",1,45,1142,594,548
050,36,089,"New York","St. Lawrence County",1,46,1119,578,541
050,36,089,"New York","St. Lawrence County",1,47,1184,618,566
050,36,089,"New York","St. Lawrence County",1,48,1318,672,646
050,36,089,"New York","St. Lawrence County",1,49,1435,740,695
050,36,089,"New York","St. Lawrence County",1,50,1329,690,639
050,36,089,"New York","St. Lawrence County",1,51,1294,690,604
050,36,089,"New York","St. Lawrence County",1,52,1280,677,603
050,36,089,"New York","St. Lawrence County",1,53,1361,736,625
050,36,089,"New York","St. Lawrence County",1,54,1444,727,717
050,36,089,"New York","St. Lawrence County",1,55,1506,750,756
050,36,089,"New York","St. Lawrence County",1,56,1537,760,777
050,36,089,"New York","St. Lawrence County",1,57,1521,746,775
050,36,089,"New York","St. Lawrence County",1,58,1553,749,804
050,36,089,"New York","St. Lawrence County",1,59,1610,806,804
050,36,089,"New York","St. Lawrence County",1,60,1596,808,788
050,36,089,"New York","St. Lawrence County",1,61,1532,761,771
050,36,089,"New York","St. Lawrence County",1,62,1546,775,771
050,36,089,"New York","St. Lawrence County",1,63,1445,737,708
050,36,089,"New York","St. Lawrence County",1,64,1368,683,685
050,36,089,"New York","St. Lawrence County",1,65,1402,719,683
050,36,089,"New York","St. Lawrence County",1,66,1337,705,632
050,36,089,"New York","St. Lawrence County",1,67,1317,659,658
050,36,089,"New York","St. Lawrence County",1,68,1253,611,642
050,36,089,"New York","St. Lawrence County",1,69,1162,575,587
050,36,089,"New York","St. Lawrence County",1,70,1067,543,524
050,36,089,"New York","St. Lawrence County",1,71,1065,527,538
050,36,089,"New York","St. Lawrence County",1,72,1076,525,551
050,36,089,"New York","St. Lawrence County",1,73,1105,530,575
050,36,089,"New York","St. Lawrence County",1,74,730,352,378
050,36,089,"New York","St. Lawrence County",1,75,735,367,368
050,36,089,"New York","St. Lawrence County",1,76,751,373,378
050,36,089,"New York","St. Lawrence County",1,77,735,349,386
050,36,089,"New York","St. Lawrence County",1,78,624,297,327
050,36,089,"New York","St. Lawrence County",1,79,546,243,303
050,36,089,"New York","St. Lawrence County",1,80,504,219,285
050,36,089,"New York","St. Lawrence County",1,81,507,222,285
050,36,089,"New York","St. Lawrence County",1,82,475,208,267
050,36,089,"New York","St. Lawrence County",1,83,410,175,235
050,36,089,"New York","St. Lawrence County",1,84,382,161,221
050,36,089,"New York","St. Lawrence County",1,85,2169,745,1424
050,36,089,"New York","St. Lawrence County",2,0,1053,545,508
050,36,089,"New York","St. Lawrence County",2,1,1023,533,490
050,36,089,"New York","St. Lawrence County",2,2,1083,571,512
050,36,089,"New York","St. Lawrence County",2,3,1116,590,526
050,36,089,"New York","St. Lawrence County",2,4,1146,605,541
050,36,089,"New York","St. Lawrence County",2,5,1165,585,580
050,36,089,"New York","St. Lawrence County",2,6,1195,616,579
050,36,089,"New York","St. Lawrence County",2,7,1199,627,572
050,36,089,"New York","St. Lawrence County",2,8,1180,609,571
050,36,089,"New York","St. Lawrence County",2,9,1231,641,590
050,36,089,"New York","St. Lawrence County",2,10,1257,648,609
050,36,089,"New York","St. Lawrence County",2,11,1280,667,613
050,36,089,"New York","St. Lawrence County",2,12,1348,699,649
050,36,089,"New York","St. Lawrence County",2,13,1350,701,649
050,36,089,"New York","St. Lawrence County",2,14,1341,683,658
050,36,089,"New York","St. Lawrence County",2,15,1298,688,610
050,36,089,"New York","St. Lawrence County",2,16,1318,684,634
050,36,089,"New York","St. Lawrence County",2,17,1347,675,672
050,36,089,"New York","St. Lawrence County",2,18,2523,1282,1241
050,36,089,"New York","St. Lawrence County",2,19,3038,1627,1411
050,36,089,"New York","St. Lawrence County",2,20,2667,1390,1277
050,36,089,"New York","St. Lawrence County",2,21,2284,1247,1037
050,36,089,"New York","St. Lawrence County",2,22,1800,997,803
050,36,089,"New York","St. Lawrence County",2,23,1268,693,575
050,36,089,"New York","St. Lawrence County",2,24,1161,623,538
050,36,089,"New York","St. Lawrence County",2,25,1143,635,508
050,36,089,"New York","St. Lawrence County",2,26,1137,619,518
050,36,089,"New York","St. Lawrence County",2,27,1160,631,529
050,36,089,"New York","St. Lawrence County",2,28,1168,619,549
050,36,089,"New York","St. Lawrence County",2,29,1231,676,555
050,36,089,"New York","St. Lawrence County",2,30,1269,683,586
050,36,089,"New York","St. Lawrence County",2,31,1247,658,589
050,36,089,"New York","St. Lawrence County",2,32,1265,666,599
050,36,089,"New York","St. Lawrence County",2,33,1257,673,584
050,36,089,"New York","St. Lawrence County",2,34,1252,681,571
050,36,089,"New York","St. Lawrence County",2,35,1255,676,579
050,36,089,"New York","St. Lawrence County",2,36,1209,638,571
050,36,089,"New York","St. Lawrence County",2,37,1261,656,605
050,36,089,"New York","St. Lawrence County",2,38,1203,623,580
050,36,089,"New York","St. Lawrence County",2,39,1213,624,589
050,36,089,"New York","St. Lawrence County",2,40,1219,620,599
050,36,089,"New York","St. Lawrence County",2,41,1174,584,590
050,36,089,"New York","St. Lawrence County",2,42,1176,598,578
050,36,089,"New York","St. Lawrence County",2,43,1193,620,573
050,36,089,"New York","St. Lawrence County",2,44,1173,626,547
050,36,089,"New York","St. Lawrence County",2,45,1156,602,554
050,36,089,"New York","St. Lawrence County",2,46,1112,572,540
050,36,089,"New York","St. Lawrence County",2,47,1156,600,556
050,36,089,"New York","St. Lawrence County",2,48,1281,653,628
050,36,089,"New York","St. Lawrence County",2,49,1413,726,687
050,36,089,"New York","St. Lawrence County",2,50,1354,700,654
050,36,089,"New York","St. Lawrence County",2,51,1293,684,609
050,36,089,"New York","St. Lawrence County",2,52,1275,676,599
050,36,089,"New York","St. Lawrence County",2,53,1336,716,620
050,36,089,"New York","St. Lawrence County",2,54,1420,727,693
050,36,089,"New York","St. Lawrence County",2,55,1486,743,743
050,36,089,"New York","St. Lawrence County",2,56,1535,758,777
050,36,089,"New York","St. Lawrence County",2,57,1524,746,778
050,36,089,"New York","St. Lawrence County",2,58,1538,745,793
050,36,089,"New York","St. Lawrence County",2,59,1603,796,807
050,36,089,"New York","St. Lawrence County",2,60,1595,804,791
050,36,089,"New York","St. Lawrence County",2,61,1542,768,774
050,36,089,"New York","St. Lawrence County",2,62,1542,771,771
050,36,089,"New York","St. Lawrence County",2,63,1481,753,728
050,36,089,"New York","St. Lawrence County",2,64,1379,692,687
050,36,089,"New York","St. Lawrence County",2,65,1388,705,683
050,36,089,"New York","St. Lawrence County",2,66,1354,710,644
050,36,089,"New York","St. Lawrence County",2,67,1309,665,644
050,36,089,"New York","St. Lawrence County",2,68,1256,615,641
050,36,089,"New York","St. Lawrence County",2,69,1187,587,600
050,36,089,"New York","St. Lawrence County",2,70,1080,544,536
050,36,089,"New York","St. Lawrence County",2,71,1063,531,532
050,36,089,"New York","St. Lawrence County",2,72,1048,508,540
050,36,089,"New York","St. Lawrence County",2,73,1147,554,593
050,36,089,"New York","St. Lawrence County",2,74,763,367,396
050,36,089,"New York","St. Lawrence County",2,75,728,360,368
050,36,089,"New York","St. Lawrence County",2,76,733,365,368
050,36,089,"New York","St. Lawrence County",2,77,752,363,389
050,36,089,"New York","St. Lawrence County",2,78,633,300,333
050,36,089,"New York","St. Lawrence County",2,79,557,253,304
050,36,089,"New York","St. Lawrence County",2,80,505,221,284
050,36,089,"New York","St. Lawrence County",2,81,497,217,280
050,36,089,"New York","St. Lawrence County",2,82,476,208,268
050,36,089,"New York","St. Lawrence County",2,83,412,175,237
050,36,089,"New York","St. Lawrence County",2,84,382,161,221
050,36,089,"New York","St. Lawrence County",2,85,2162,753,1409
050,36,089,"New York","St. Lawrence County",3,0,978,488,490
050,36,089,"New York","St. Lawrence County",3,1,1058,542,516
050,36,089,"New York","St. Lawrence County",3,2,1053,543,510
050,36,089,"New York","St. Lawrence County",3,3,1104,583,521
050,36,089,"New York","St. Lawrence County",3,4,1130,597,533
050,36,089,"New York","St. Lawrence County",3,5,1159,616,543
050,36,089,"New York","St. Lawrence County",3,6,1177,595,582
050,36,089,"New York","St. Lawrence County",3,7,1211,620,591
050,36,089,"New York","St. Lawrence County",3,8,1200,629,571
050,36,089,"New York","St. Lawrence County",3,9,1192,613,579
050,36,089,"New York","St. Lawrence County",3,10,1230,636,594
050,36,089,"New York","St. Lawrence County",3,11,1244,636,608
050,36,089,"New York","St. Lawrence County",3,12,1287,676,611
050,36,089,"New York","St. Lawrence County",3,13,1333,689,644
050,36,089,"New York","St. Lawrence County",3,14,1344,696,648
050,36,089,"New York","St. Lawrence County",3,15,1352,686,666
050,36,089,"New York","St. Lawrence County",3,16,1303,682,621
050,36,089,"New York","St. Lawrence County",3,17,1341,698,643
050,36,089,"New York","St. Lawrence County",3,18,2535,1283,1252
050,36,089,"New York","St. Lawrence County",3,19,3039,1633,1406
050,36,089,"New York","St. Lawrence County",3,20,2669,1382,1287
050,36,089,"New York","St. Lawrence County",3,21,2288,1235,1053
050,36,089,"New York","St. Lawrence County",3,22,1825,1014,811
050,36,089,"New York","St. Lawrence County",3,23,1267,712,555
050,36,089,"New York","St. Lawrence County",3,24,1178,634,544
050,36,089,"New York","St. Lawrence County",3,25,1084,592,492
050,36,089,"New York","St. Lawrence County",3,26,1117,611,506
050,36,089,"New York","St. Lawrence County",3,27,1114,610,504
050,36,089,"New York","St. Lawrence County",3,28,1122,609,513
050,36,089,"New York","St. Lawrence County",3,29,1170,610,560
050,36,089,"New York","St. Lawrence County",3,30,1197,643,554
050,36,089,"New York","St. Lawrence County",3,31,1303,689,614
050,36,089,"New York","St. Lawrence County",3,32,1246,648,598
050,36,089,"New York","St. Lawrence County",3,33,1267,665,602
050,36,089,"New York","St. Lawrence County",3,34,1240,655,585
050,36,089,"New York","St. Lawrence County",3,35,1246,676,570
050,36,089,"New York","St. Lawrence County",3,36,1266,681,585
050,36,089,"New York","St. Lawrence County",3,37,1206,636,570
050,36,089,"New York","St. Lawrence County",3,38,1245,639,606
050,36,089,"New York","St. Lawrence County",3,39,1223,650,573
050,36,089,"New York","St. Lawrence County",3,40,1195,599,596
050,36,089,"New York","St. Lawrence County",3,41,1207,617,590
050,36,089,"New York","St. Lawrence County",3,42,1180,591,589
050,36,089,"New York","St. Lawrence County",3,43,1184,593,591
050,36,089,"New York","St. Lawrence County",3,44,1186,619,567
050,36,089,"New York","St. Lawrence County",3,45,1166,610,556
050,36,089,"New York","St. Lawrence County",3,46,1146,599,547
050,36,089,"New York","St. Lawrence County",3,47,1107,567,540
050,36,089,"New York","St. Lawrence County",3,48,1146,584,562
050,36,089,"New York","St. Lawrence County",3,49,1278,652,626
050,36,089,"New York","St. Lawrence County",3,50,1408,719,689
050,36,089,"New York","St. Lawrence County",3,51,1348,695,653
050,36,089,"New York","St. Lawrence County",3,52,1302,682,620
050,36,089,"New York","St. Lawrence County",3,53,1269,673,596
050,36,089,"New York","St. Lawrence County",3,54,1320,698,622
050,36,089,"New York","St. Lawrence County",3,55,1407,721,686
050,36,089,"New York","St. Lawrence County",3,56,1467,726,741
050,36,089,"New York","St. Lawrence County",3,57,1517,746,771
050,36,089,"New York","St. Lawrence County",3,58,1505,727,778
050,36,089,"New York","St. Lawrence County",3,59,1522,741,781
050,36,089,"New York","St. Lawrence County",3,60,1606,795,811
050,36,089,"New York","St. Lawrence County",3,61,1577,783,794
050,36,089,"New York","St. Lawrence County",3,62,1530,765,765
050,36,089,"New York","St. Lawrence County",3,63,1515,757,758
050,36,089,"New York","St. Lawrence County",3,64,1454,730,724
050,36,089,"New York","St. Lawrence County",3,65,1355,672,683
050,36,089,"New York","St. Lawrence County",3,66,1377,702,675
050,36,089,"New York","St. Lawrence County",3,67,1318,693,625
050,36,089,"New York","St. Lawrence County",3,68,1290,656,634
050,36,089,"New York","St. Lawrence County",3,69,1218,591,627
050,36,089,"New York","St. Lawrence County",3,70,1154,565,589
050,36,089,"New York","St. Lawrence County",3,71,1050,535,515
050,36,089,"New York","St. Lawrence County",3,72,1038,508,530
050,36,089,"New York","St. Lawrence County",3,73,1016,487,529
050,36,089,"New York","St. Lawrence County",3,74,1123,533,590
050,36,089,"New York","St. Lawrence County",3,75,726,345,381
050,36,089,"New York","St. Lawrence County",3,76,706,355,351
050,36,089,"New York","St. Lawrence County",3,77,695,342,353
050,36,089,"New York","St. Lawrence County",3,78,711,347,364
050,36,089,"New York","St. Lawrence County",3,79,596,277,319
050,36,089,"New York","St. Lawrence County",3,80,504,215,289
050,36,089,"New York","St. Lawrence County",3,81,472,203,269
050,36,089,"New York","St. Lawrence County",3,82,469,207,262
050,36,089,"New York","St. Lawrence County",3,83,429,191,238
050,36,089,"New York","St. Lawrence County",3,84,385,164,221
050,36,089,"New York","St. Lawrence County",3,85,2106,729,1377
050,36,089,"New York","St. Lawrence County",4,0,1013,499,514
050,36,089,"New York","St. Lawrence County",4,1,970,483,487
050,36,089,"New York","St. Lawrence County",4,2,1059,543,516
050,36,089,"New York","St. Lawrence County",4,3,1063,545,518
050,36,089,"New York","St. Lawrence County",4,4,1124,598,526
050,36,089,"New York","St. Lawrence County",4,5,1132,593,539
050,36,089,"New York","St. Lawrence County",4,6,1156,621,535
050,36,089,"New York","St. Lawrence County",4,7,1179,604,575
050,36,089,"New York","St. Lawrence County",4,8,1216,624,592
050,36,089,"New York","St. Lawrence County",4,9,1180,618,562
050,36,089,"New York","St. Lawrence County",4,10,1186,608,578
050,36,089,"New York","St. Lawrence County",4,11,1225,638,587
050,36,089,"New York","St. Lawrence County",4,12,1230,629,601
050,36,089,"New York","St. Lawrence County",4,13,1303,685,618
050,36,089,"New York","St. Lawrence County",4,14,1344,686,658
050,36,089,"New York","St. Lawrence County",4,15,1352,704,648
050,36,089,"New York","St. Lawrence County",4,16,1359,683,676
050,36,089,"New York","St. Lawrence County",4,17,1347,703,644
050,36,089,"New York","St. Lawrence County",4,18,2473,1280,1193
050,36,089,"New York","St. Lawrence County",4,19,2959,1597,1362
050,36,089,"New York","St. Lawrence County",4,20,2604,1356,1248
050,36,089,"New York","St. Lawrence County",4,21,2318,1237,1081
050,36,089,"New York","St. Lawrence County",4,22,1813,1000,813
050,36,089,"New York","St. Lawrence County",4,23,1316,733,583
050,36,089,"New York","St. Lawrence County",4,24,1143,616,527
050,36,089,"New York","St. Lawrence County",4,25,1101,608,493
050,36,089,"New York","St. Lawrence County",4,26,1073,584,489
050,36,089,"New York","St. Lawrence County",4,27,1091,582,509
050,36,089,"New York","St. Lawrence County",4,28,1062,570,492
050,36,089,"New York","St. Lawrence County",4,29,1128,596,532
050,36,089,"New York","St. Lawrence County",4,30,1143,592,551
050,36,089,"New York","St. Lawrence County",4,31,1165,618,547
050,36,089,"New York","St. Lawrence County",4,32,1287,662,625
050,36,089,"New York","St. Lawrence County",4,33,1219,628,591
050,36,089,"New York","St. Lawrence County",4,34,1276,671,605
050,36,089,"New York","St. Lawrence County",4,35,1238,651,587
050,36,089,"New York","St. Lawrence County",4,36,1264,677,587
050,36,089,"New York","St. Lawrence County",4,37,1265,688,577
050,36,089,"New York","St. Lawrence County",4,38,1191,614,577
050,36,089,"New York","St. Lawrence County",4,39,1269,659,610
050,36,089,"New York","St. Lawrence County",4,40,1214,629,585
050,36,089,"New York","St. Lawrence County",4,41,1191,591,600
050,36,089,"New York","St. Lawrence County",4,42,1212,617,595
050,36,089,"New York","St. Lawrence County",4,43,1190,593,597
050,36,089,"New York","St. Lawrence County",4,44,1185,595,590
050,36,089,"New York","St. Lawrence County",4,45,1177,597,580
050,36,089,"New York","St. Lawrence County",4,46,1159,606,553
050,36,089,"New York","St. Lawrence County",4,47,1137,594,543
050,36,089,"New York","St. Lawrence County",4,48,1073,547,526
050,36,089,"New York","St. Lawrence County",4,49,1144,583,561
050,36,089,"New York","St. Lawrence County",4,50,1284,657,627
050,36,089,"New York","St. Lawrence County",4,51,1406,716,690
050,36,089,"New York","St. Lawrence County",4,52,1349,693,656
050,36,089,"New York","St. Lawrence County",4,53,1301,681,620
050,36,089,"New York","St. Lawrence County",4,54,1249,657,592
050,36,089,"New York","St. Lawrence County",4,55,1298,685,613
050,36,089,"New York","St. Lawrence County",4,56,1397,711,686
050,36,089,"New York","St. Lawrence County",4,57,1448,706,742
050,36,089,"New York","St. Lawrence County",4,58,1505,734,771
050,36,089,"New York","St. Lawrence County",4,59,1508,730,778
050,36,089,"New York","St. Lawrence County",4,60,1513,724,789
050,36,089,"New York","St. Lawrence County",4,61,1596,785,811
050,36,089,"New York","St. Lawrence County",4,62,1571,776,795
050,36,089,"New York","St. Lawrence County",4,63,1504,747,757
050,36,089,"New York","St. Lawrence County",4,64,1487,741,746
050,36,089,"New York","St. Lawrence County",4,65,1418,708,710
050,36,089,"New York","St. Lawrence County",4,66,1335,653,682
050,36,089,"New York","St. Lawrence County",4,67,1337,688,649
050,36,089,"New York","St. Lawrence County",4,68,1291,677,614
050,36,089,"New York","St. Lawrence County",4,69,1268,641,627
050,36,089,"New York","St. Lawrence County",4,70,1193,574,619
050,36,089,"New York","St. Lawrence County",4,71,1126,553,573
050,36,089,"New York","St. Lawrence County",4,72,1034,519,515
050,36,089,"New York","St. Lawrence County",4,73,1003,490,513
050,36,089,"New York","St. Lawrence County",4,74,991,463,528
050,36,089,"New York","St. Lawrence County",4,75,1087,518,569
050,36,089,"New York","St. Lawrence County",4,76,708,333,375
050,36,089,"New York","St. Lawrence County",4,77,668,333,335
050,36,089,"New York","St. Lawrence County",4,78,667,324,343
050,36,089,"New York","St. Lawrence County",4,79,686,332,354
050,36,089,"New York","St. Lawrence County",4,80,544,248,296
050,36,089,"New York","St. Lawrence County",4,81,460,186,274
050,36,089,"New York","St. Lawrence County",4,82,446,199,247
050,36,089,"New York","St. Lawrence County",4,83,417,190,227
050,36,089,"New York","St. Lawrence County",4,84,402,175,227
050,36,089,"New York","St. Lawrence County",4,85,2074,714,1360
050,36,089,"New York","St. Lawrence County",5,0,1008,498,510
050,36,089,"New York","St. Lawrence County",5,1,1039,523,516
050,36,089,"New York","St. Lawrence County",5,2,986,494,492
050,36,089,"New York","St. Lawrence County",5,3,1050,533,517
050,36,089,"New York","St. Lawrence County",5,4,1087,552,535
050,36,089,"New York","St. Lawrence County",5,5,1139,610,529
050,36,089,"New York","St. Lawrence County",5,6,1126,591,535
050,36,089,"New York","St. Lawrence County",5,7,1153,612,541
050,36,089,"New York","St. Lawrence County",5,8,1177,601,576
050,36,089,"New York","St. Lawrence County",5,9,1214,620,594
050,36,089,"New York","St. Lawrence County",5,10,1176,611,565
050,36,089,"New York","St. Lawrence County",5,11,1176,607,569
050,36,089,"New York","St. Lawrence County",5,12,1227,636,591
050,36,089,"New York","St. Lawrence County",5,13,1216,621,595
050,36,089,"New York","St. Lawrence County",5,14,1286,674,612
050,36,089,"New York","St. Lawrence County",5,15,1352,690,662
050,36,089,"New York","St. Lawrence County",5,16,1338,695,643
050,36,089,"New York","St. Lawrence County",5,17,1388,704,684
050,36,089,"New York","St. Lawrence County",5,18,2463,1277,1186
050,36,089,"New York","St. Lawrence County",5,19,2942,1602,1340
050,36,089,"New York","St. Lawrence County",5,20,2598,1363,1235
050,36,089,"New York","St. Lawrence County",5,21,2253,1222,1031
050,36,089,"New York","St. Lawrence County",5,22,1877,1026,851
050,36,089,"New York","St. Lawrence County",5,23,1326,731,595
050,36,089,"New York","St. Lawrence County",5,24,1204,650,554
050,36,089,"New York","St. Lawrence County",5,25,1113,605,508
050,36,089,"New York","St. Lawrence County",5,26,1092,601,491
050,36,089,"New York","St. Lawrence County",5,27,1078,580,498
050,36,089,"New York","St. Lawrence County",5,28,1042,553,489
050,36,089,"New York","St. Lawrence County",5,29,1090,592,498
050,36,089,"New York","St. Lawrence County",5,30,1113,592,521
050,36,089,"New York","St. Lawrence County",5,31,1165,608,557
050,36,089,"New York","St. Lawrence County",5,32,1164,604,560
050,36,089,"New York","St. Lawrence County",5,33,1289,672,617
050,36,089,"New York","St. Lawrence County",5,34,1241,636,605
050,36,089,"New York","St. Lawrence County",5,35,1272,670,602
050,36,089,"New York","St. Lawrence County",5,36,1246,662,584
050,36,089,"New York","St. Lawrence County",5,37,1277,681,596
050,36,089,"New York","St. Lawrence County",5,38,1258,673,585
050,36,089,"New York","St. Lawrence County",5,39,1213,632,581
050,36,089,"New York","St. Lawrence County",5,40,1275,653,622
050,36,089,"New York","St. Lawrence County",5,41,1206,633,573
050,36,089,"New York","St. Lawrence County",5,42,1215,611,604
050,36,089,"New York","St. Lawrence County",5,43,1230,624,606
050,36,089,"New York","St. Lawrence County",5,44,1205,604,601
050,36,089,"New York","St. Lawrence County",5,45,1183,591,592
050,36,089,"New York","St. Lawrence County",5,46,1179,603,576
050,36,089,"New York","St. Lawrence County",5,47,1149,609,540
050,36,089,"New York","St. Lawrence County",5,48,1132,586,546
050,36,089,"New York","St. Lawrence County",5,49,1077,548,529
050,36,089,"New York","St. Lawrence County",5,50,1155,592,563
050,36,089,"New York","St. Lawrence County",5,51,1284,663,621
050,36,089,"New York","St. Lawrence County",5,52,1418,720,698
050,36,089,"New York","St. Lawrence County",5,53,1343,688,655
050,36,089,"New York","St. Lawrence County",5,54,1290,678,612
050,36,089,"New York","St. Lawrence County",5,55,1237,650,587
050,36,089,"New York","St. Lawrence County",5,56,1300,680,620
050,36,089,"New York","St. Lawrence County",5,57,1382,693,689
050,36,089,"New York","St. Lawrence County",5,58,1426,691,735
050,36,089,"New York","St. Lawrence County",5,59,1506,740,766
050,36,089,"New York","St. Lawrence County",5,60,1513,726,787
050,36,089,"New York","St. Lawrence County",5,61,1505,716,789
050,36,089,"New York","St. Lawrence County",5,62,1587,776,811
050,36,089,"New York","St. Lawrence County",5,63,1553,772,781
050,36,089,"New York","St. Lawrence County",5,64,1497,739,758
050,36,089,"New York","St. Lawrence County",5,65,1463,727,736
050,36,089,"New York","St. Lawrence County",5,66,1417,713,704
050,36,089,"New York","St. Lawrence County",5,67,1312,645,667
050,36,089,"New York","St. Lawrence County",5,68,1314,675,639
050,36,089,"New York","St. Lawrence County",5,69,1257,660,597
050,36,089,"New York","St. Lawrence County",5,70,1243,624,619
050,36,089,"New York","St. Lawrence County",5,71,1155,558,597
050,36,089,"New York","St. Lawrence County",5,72,1101,542,559
050,36,089,"New York","St. Lawrence County",5,73,988,496,492
050,36,089,"New York","St. Lawrence County",5,74,980,481,499
050,36,089,"New York","St. Lawrence County",5,75,950,450,500
050,36,089,"New York","St. Lawrence County",5,76,1051,498,553
050,36,089,"New York","St. Lawrence County",5,77,679,317,362
050,36,089,"New York","St. Lawrence County",5,78,641,318,323
050,36,089,"New York","St. Lawrence County",5,79,636,305,331
050,36,089,"New York","St. Lawrence County",5,80,642,304,338
050,36,089,"New York","St. Lawrence County",5,81,503,218,285
050,36,089,"New York","St. Lawrence County",5,82,432,179,253
050,36,089,"New York","St. Lawrence County",5,83,402,182,220
050,36,089,"New York","St. Lawrence County",5,84,389,174,215
050,36,089,"New York","St. Lawrence County",5,85,2084,724,1360
050,36,091,"New York","Saratoga County",1,0,2008,1031,977
050,36,091,"New York","Saratoga County",1,1,2109,1083,1026
050,36,091,"New York","Saratoga County",1,2,2193,1117,1076
050,36,091,"New York","Saratoga County",1,3,2388,1225,1163
050,36,091,"New York","Saratoga County",1,4,2552,1308,1244
050,36,091,"New York","Saratoga County",1,5,2549,1295,1254
050,36,091,"New York","Saratoga County",1,6,2598,1305,1293
050,36,091,"New York","Saratoga County",1,7,2557,1292,1265
050,36,091,"New York","Saratoga County",1,8,2606,1359,1247
050,36,091,"New York","Saratoga County",1,9,2585,1326,1259
050,36,091,"New York","Saratoga County",1,10,2683,1370,1313
050,36,091,"New York","Saratoga County",1,11,2768,1394,1374
050,36,091,"New York","Saratoga County",1,12,2793,1423,1370
050,36,091,"New York","Saratoga County",1,13,2751,1445,1306
050,36,091,"New York","Saratoga County",1,14,2735,1405,1330
050,36,091,"New York","Saratoga County",1,15,2787,1420,1367
050,36,091,"New York","Saratoga County",1,16,2887,1477,1410
050,36,091,"New York","Saratoga County",1,17,2935,1490,1445
050,36,091,"New York","Saratoga County",1,18,2853,1423,1430
050,36,091,"New York","Saratoga County",1,19,2666,1336,1330
050,36,091,"New York","Saratoga County",1,20,2704,1414,1290
050,36,091,"New York","Saratoga County",1,21,2763,1386,1377
050,36,091,"New York","Saratoga County",1,22,2648,1336,1312
050,36,091,"New York","Saratoga County",1,23,2520,1278,1242
050,36,091,"New York","Saratoga County",1,24,2549,1318,1231
050,36,091,"New York","Saratoga County",1,25,2607,1336,1271
050,36,091,"New York","Saratoga County",1,26,2773,1420,1353
050,36,091,"New York","Saratoga County",1,27,2745,1411,1334
050,36,091,"New York","Saratoga County",1,28,2753,1454,1299
050,36,091,"New York","Saratoga County",1,29,2820,1459,1361
050,36,091,"New York","Saratoga County",1,30,2788,1446,1342
050,36,091,"New York","Saratoga County",1,31,2882,1463,1419
050,36,091,"New York","Saratoga County",1,32,2983,1533,1450
050,36,091,"New York","Saratoga County",1,33,2991,1517,1474
050,36,091,"New York","Saratoga County",1,34,3022,1553,1469
050,36,091,"New York","Saratoga County",1,35,2984,1501,1483
050,36,091,"New York","Saratoga County",1,36,2945,1457,1488
050,36,091,"New York","Saratoga County",1,37,3046,1552,1494
050,36,091,"New York","Saratoga County",1,38,3011,1537,1474
050,36,091,"New York","Saratoga County",1,39,3060,1574,1486
050,36,091,"New York","Saratoga County",1,40,2981,1510,1471
050,36,091,"New York","Saratoga County",1,41,2976,1484,1492
050,36,091,"New York","Saratoga County",1,42,2991,1530,1461
050,36,091,"New York","Saratoga County",1,43,2824,1382,1442
050,36,091,"New York","Saratoga County",1,44,2844,1416,1428
050,36,091,"New York","Saratoga County",1,45,2893,1452,1441
050,36,091,"New York","Saratoga County",1,46,2829,1400,1429
050,36,091,"New York","Saratoga County",1,47,3023,1494,1529
050,36,091,"New York","Saratoga County",1,48,3272,1637,1635
050,36,091,"New York","Saratoga County",1,49,3631,1831,1800
050,36,091,"New York","Saratoga County",1,50,3529,1793,1736
050,36,091,"New York","Saratoga County",1,51,3425,1735,1690
050,36,091,"New York","Saratoga County",1,52,3321,1698,1623
050,36,091,"New York","Saratoga County",1,53,3447,1725,1722
050,36,091,"New York","Saratoga County",1,54,3635,1795,1840
050,36,091,"New York","Saratoga County",1,55,3752,1854,1898
050,36,091,"New York","Saratoga County",1,56,3737,1826,1911
050,36,091,"New York","Saratoga County",1,57,3688,1828,1860
050,36,091,"New York","Saratoga County",1,58,3661,1806,1855
050,36,091,"New York","Saratoga County",1,59,3590,1766,1824
050,36,091,"New York","Saratoga County",1,60,3543,1739,1804
050,36,091,"New York","Saratoga County",1,61,3590,1761,1829
050,36,091,"New York","Saratoga County",1,62,3403,1705,1698
050,36,091,"New York","Saratoga County",1,63,3227,1580,1647
050,36,091,"New York","Saratoga County",1,64,3112,1519,1593
050,36,091,"New York","Saratoga County",1,65,3044,1500,1544
050,36,091,"New York","Saratoga County",1,66,2930,1432,1498
050,36,091,"New York","Saratoga County",1,67,2886,1401,1485
050,36,091,"New York","Saratoga County",1,68,2856,1383,1473
050,36,091,"New York","Saratoga County",1,69,2682,1288,1394
050,36,091,"New York","Saratoga County",1,70,2643,1249,1394
050,36,091,"New York","Saratoga County",1,71,2585,1204,1381
050,36,091,"New York","Saratoga County",1,72,2658,1246,1412
050,36,091,"New York","Saratoga County",1,73,2711,1300,1411
050,36,091,"New York","Saratoga County",1,74,1784,842,942
050,36,091,"New York","Saratoga County",1,75,1787,824,963
050,36,091,"New York","Saratoga County",1,76,1814,848,966
050,36,091,"New York","Saratoga County",1,77,1762,836,926
050,36,091,"New York","Saratoga County",1,78,1429,664,765
050,36,091,"New York","Saratoga County",1,79,1252,570,682
050,36,091,"New York","Saratoga County",1,80,1105,487,618
050,36,091,"New York","Saratoga County",1,81,1019,449,570
050,36,091,"New York","Saratoga County",1,82,923,404,519
050,36,091,"New York","Saratoga County",1,83,821,374,447
050,36,091,"New York","Saratoga County",1,84,747,314,433
050,36,091,"New York","Saratoga County",1,85,4543,1619,2924
050,36,091,"New York","Saratoga County",2,0,2035,1043,992
050,36,091,"New York","Saratoga County",2,1,2094,1075,1019
050,36,091,"New York","Saratoga County",2,2,2190,1120,1070
050,36,091,"New York","Saratoga County",2,3,2343,1199,1144
050,36,091,"New York","Saratoga County",2,4,2520,1289,1231
050,36,091,"New York","Saratoga County",2,5,2559,1301,1258
050,36,091,"New York","Saratoga County",2,6,2596,1306,1290
050,36,091,"New York","Saratoga County",2,7,2568,1294,1274
050,36,091,"New York","Saratoga County",2,8,2592,1341,1251
050,36,091,"New York","Saratoga County",2,9,2591,1339,1252
050,36,091,"New York","Saratoga County",2,10,2658,1359,1299
050,36,091,"New York","Saratoga County",2,11,2736,1382,1354
050,36,091,"New York","Saratoga County",2,12,2797,1425,1372
050,36,091,"New York","Saratoga County",2,13,2759,1439,1320
050,36,091,"New York","Saratoga County",2,14,2744,1420,1324
050,36,091,"New York","Saratoga County",2,15,2781,1422,1359
050,36,091,"New York","Saratoga County",2,16,2870,1469,1401
050,36,091,"New York","Saratoga County",2,17,2935,1495,1440
050,36,091,"New York","Saratoga County",2,18,2838,1414,1424
050,36,091,"New York","Saratoga County",2,19,2663,1324,1339
050,36,091,"New York","Saratoga County",2,20,2725,1411,1314
050,36,091,"New York","Saratoga County",2,21,2740,1378,1362
050,36,091,"New York","Saratoga County",2,22,2663,1339,1324
050,36,091,"New York","Saratoga County",2,23,2526,1283,1243
050,36,091,"New York","Saratoga County",2,24,2542,1306,1236
050,36,091,"New York","Saratoga County",2,25,2613,1335,1278
050,36,091,"New York","Saratoga County",2,26,2745,1407,1338
050,36,091,"New York","Saratoga County",2,27,2750,1416,1334
050,36,091,"New York","Saratoga County",2,28,2770,1448,1322
050,36,091,"New York","Saratoga County",2,29,2818,1464,1354
050,36,091,"New York","Saratoga County",2,30,2825,1460,1365
050,36,091,"New York","Saratoga County",2,31,2881,1473,1408
050,36,091,"New York","Saratoga County",2,32,2973,1518,1455
050,36,091,"New York","Saratoga County",2,33,2999,1529,1470
050,36,091,"New York","Saratoga County",2,34,3025,1548,1477
050,36,091,"New York","Saratoga County",2,35,3016,1526,1490
050,36,091,"New York","Saratoga County",2,36,2939,1460,1479
050,36,091,"New York","Saratoga County",2,37,3036,1537,1499
050,36,091,"New York","Saratoga County",2,38,3046,1554,1492
050,36,091,"New York","Saratoga County",2,39,3037,1557,1480
050,36,091,"New York","Saratoga County",2,40,3025,1537,1488
050,36,091,"New York","Saratoga County",2,41,2979,1492,1487
050,36,091,"New York","Saratoga County",2,42,2972,1511,1461
050,36,091,"New York","Saratoga County",2,43,2886,1426,1460
050,36,091,"New York","Saratoga County",2,44,2819,1398,1421
050,36,091,"New York","Saratoga County",2,45,2896,1451,1445
050,36,091,"New York","Saratoga County",2,46,2833,1406,1427
050,36,091,"New York","Saratoga County",2,47,2963,1464,1499
050,36,091,"New York","Saratoga County",2,48,3211,1601,1610
050,36,091,"New York","Saratoga County",2,49,3563,1795,1768
050,36,091,"New York","Saratoga County",2,50,3562,1805,1757
050,36,091,"New York","Saratoga County",2,51,3433,1736,1697
050,36,091,"New York","Saratoga County",2,52,3333,1697,1636
050,36,091,"New York","Saratoga County",2,53,3417,1714,1703
050,36,091,"New York","Saratoga County",2,54,3573,1774,1799
050,36,091,"New York","Saratoga County",2,55,3724,1837,1887
050,36,091,"New York","Saratoga County",2,56,3745,1831,1914
050,36,091,"New York","Saratoga County",2,57,3704,1828,1876
050,36,091,"New York","Saratoga County",2,58,3671,1813,1858
050,36,091,"New York","Saratoga County",2,59,3622,1782,1840
050,36,091,"New York","Saratoga County",2,60,3542,1739,1803
050,36,091,"New York","Saratoga County",2,61,3568,1749,1819
050,36,091,"New York","Saratoga County",2,62,3433,1710,1723
050,36,091,"New York","Saratoga County",2,63,3298,1624,1674
050,36,091,"New York","Saratoga County",2,64,3121,1525,1596
050,36,091,"New York","Saratoga County",2,65,3061,1506,1555
050,36,091,"New York","Saratoga County",2,66,2964,1453,1511
050,36,091,"New York","Saratoga County",2,67,2897,1405,1492
050,36,091,"New York","Saratoga County",2,68,2843,1378,1465
050,36,091,"New York","Saratoga County",2,69,2746,1319,1427
050,36,091,"New York","Saratoga County",2,70,2641,1250,1391
050,36,091,"New York","Saratoga County",2,71,2600,1213,1387
050,36,091,"New York","Saratoga County",2,72,2600,1217,1383
050,36,091,"New York","Saratoga County",2,73,2818,1345,1473
050,36,091,"New York","Saratoga County",2,74,1880,892,988
050,36,091,"New York","Saratoga County",2,75,1786,830,956
050,36,091,"New York","Saratoga County",2,76,1781,825,956
050,36,091,"New York","Saratoga County",2,77,1807,857,950
050,36,091,"New York","Saratoga County",2,78,1463,684,779
050,36,091,"New York","Saratoga County",2,79,1273,582,691
050,36,091,"New York","Saratoga County",2,80,1123,497,626
050,36,091,"New York","Saratoga County",2,81,1018,448,570
050,36,091,"New York","Saratoga County",2,82,941,414,527
050,36,091,"New York","Saratoga County",2,83,827,374,453
050,36,091,"New York","Saratoga County",2,84,746,321,425
050,36,091,"New York","Saratoga County",2,85,4547,1612,2935
050,36,091,"New York","Saratoga County",3,0,2004,1032,972
050,36,091,"New York","Saratoga County",3,1,2119,1062,1057
050,36,091,"New York","Saratoga County",3,2,2176,1118,1058
050,36,091,"New York","Saratoga County",3,3,2271,1170,1101
050,36,091,"New York","Saratoga County",3,4,2363,1207,1156
050,36,091,"New York","Saratoga County",3,5,2545,1280,1265
050,36,091,"New York","Saratoga County",3,6,2566,1310,1256
050,36,091,"New York","Saratoga County",3,7,2621,1317,1304
050,36,091,"New York","Saratoga County",3,8,2599,1320,1279
050,36,091,"New York","Saratoga County",3,9,2633,1355,1278
050,36,091,"New York","Saratoga County",3,10,2599,1350,1249
050,36,091,"New York","Saratoga County",3,11,2671,1374,1297
050,36,091,"New York","Saratoga County",3,12,2776,1418,1358
050,36,091,"New York","Saratoga County",3,13,2811,1437,1374
050,36,091,"New York","Saratoga County",3,14,2770,1438,1332
050,36,091,"New York","Saratoga County",3,15,2744,1392,1352
050,36,091,"New York","Saratoga County",3,16,2791,1437,1354
050,36,091,"New York","Saratoga County",3,17,2857,1466,1391
050,36,091,"New York","Saratoga County",3,18,2849,1418,1431
050,36,091,"New York","Saratoga County",3,19,2630,1274,1356
050,36,091,"New York","Saratoga County",3,20,2704,1394,1310
050,36,091,"New York","Saratoga County",3,21,2778,1405,1373
050,36,091,"New York","Saratoga County",3,22,2747,1399,1348
050,36,091,"New York","Saratoga County",3,23,2660,1374,1286
050,36,091,"New York","Saratoga County",3,24,2541,1272,1269
050,36,091,"New York","Saratoga County",3,25,2656,1357,1299
050,36,091,"New York","Saratoga County",3,26,2702,1391,1311
050,36,091,"New York","Saratoga County",3,27,2810,1424,1386
050,36,091,"New York","Saratoga County",3,28,2882,1469,1413
050,36,091,"New York","Saratoga County",3,29,2835,1460,1375
050,36,091,"New York","Saratoga County",3,30,2856,1486,1370
050,36,091,"New York","Saratoga County",3,31,2942,1498,1444
050,36,091,"New York","Saratoga County",3,32,2965,1489,1476
050,36,091,"New York","Saratoga County",3,33,3064,1571,1493
050,36,091,"New York","Saratoga County",3,34,3137,1585,1552
050,36,091,"New York","Saratoga County",3,35,3153,1616,1537
050,36,091,"New York","Saratoga County",3,36,3045,1517,1528
050,36,091,"New York","Saratoga County",3,37,3042,1517,1525
050,36,091,"New York","Saratoga County",3,38,3078,1561,1517
050,36,091,"New York","Saratoga County",3,39,3091,1571,1520
050,36,091,"New York","Saratoga County",3,40,3072,1595,1477
050,36,091,"New York","Saratoga County",3,41,3094,1577,1517
050,36,091,"New York","Saratoga County",3,42,3008,1517,1491
050,36,091,"New York","Saratoga County",3,43,2987,1510,1477
050,36,091,"New York","Saratoga County",3,44,2945,1446,1499
050,36,091,"New York","Saratoga County",3,45,2822,1409,1413
050,36,091,"New York","Saratoga County",3,46,2874,1428,1446
050,36,091,"New York","Saratoga County",3,47,2834,1417,1417
050,36,091,"New York","Saratoga County",3,48,2978,1484,1494
050,36,091,"New York","Saratoga County",3,49,3220,1602,1618
050,36,091,"New York","Saratoga County",3,50,3596,1820,1776
050,36,091,"New York","Saratoga County",3,51,3538,1789,1749
050,36,091,"New York","Saratoga County",3,52,3444,1748,1696
050,36,091,"New York","Saratoga County",3,53,3324,1670,1654
050,36,091,"New York","Saratoga County",3,54,3456,1732,1724
050,36,091,"New York","Saratoga County",3,55,3540,1759,1781
050,36,091,"New York","Saratoga County",3,56,3731,1847,1884
050,36,091,"New York","Saratoga County",3,57,3734,1810,1924
050,36,091,"New York","Saratoga County",3,58,3726,1846,1880
050,36,091,"New York","Saratoga County",3,59,3652,1818,1834
050,36,091,"New York","Saratoga County",3,60,3642,1787,1855
050,36,091,"New York","Saratoga County",3,61,3565,1740,1825
050,36,091,"New York","Saratoga County",3,62,3524,1690,1834
050,36,091,"New York","Saratoga County",3,63,3419,1706,1713
050,36,091,"New York","Saratoga County",3,64,3261,1611,1650
050,36,091,"New York","Saratoga County",3,65,3102,1513,1589
050,36,091,"New York","Saratoga County",3,66,3062,1497,1565
050,36,091,"New York","Saratoga County",3,67,2917,1420,1497
050,36,091,"New York","Saratoga County",3,68,2865,1384,1481
050,36,091,"New York","Saratoga County",3,69,2805,1358,1447
050,36,091,"New York","Saratoga County",3,70,2742,1308,1434
050,36,091,"New York","Saratoga County",3,71,2599,1224,1375
050,36,091,"New York","Saratoga County",3,72,2551,1186,1365
050,36,091,"New York","Saratoga County",3,73,2545,1195,1350
050,36,091,"New York","Saratoga County",3,74,2772,1310,1462
050,36,091,"New York","Saratoga County",3,75,1834,853,981
050,36,091,"New York","Saratoga County",3,76,1724,792,932
050,36,091,"New York","Saratoga County",3,77,1719,790,929
050,36,091,"New York","Saratoga County",3,78,1739,821,918
050,36,091,"New York","Saratoga County",3,79,1419,665,754
050,36,091,"New York","Saratoga County",3,80,1205,543,662
050,36,091,"New York","Saratoga County",3,81,1063,473,590
050,36,091,"New York","Saratoga County",3,82,952,416,536
050,36,091,"New York","Saratoga County",3,83,884,389,495
050,36,091,"New York","Saratoga County",3,84,772,344,428
050,36,091,"New York","Saratoga County",3,85,4506,1648,2858
050,36,091,"New York","Saratoga County",4,0,2118,1086,1032
050,36,091,"New York","Saratoga County",4,1,2090,1068,1022
050,36,091,"New York","Saratoga County",4,2,2195,1106,1089
050,36,091,"New York","Saratoga County",4,3,2241,1140,1101
050,36,091,"New York","Saratoga County",4,4,2323,1204,1119
050,36,091,"New York","Saratoga County",4,5,2383,1224,1159
050,36,091,"New York","Saratoga County",4,6,2591,1306,1285
050,36,091,"New York","Saratoga County",4,7,2606,1344,1262
050,36,091,"New York","Saratoga County",4,8,2662,1347,1315
050,36,091,"New York","Saratoga County",4,9,2593,1311,1282
050,36,091,"New York","Saratoga County",4,10,2631,1360,1271
050,36,091,"New York","Saratoga County",4,11,2629,1350,1279
050,36,091,"New York","Saratoga County",4,12,2684,1399,1285
050,36,091,"New York","Saratoga County",4,13,2771,1426,1345
050,36,091,"New York","Saratoga County",4,14,2809,1440,1369
050,36,091,"New York","Saratoga County",4,15,2745,1423,1322
050,36,091,"New York","Saratoga County",4,16,2755,1397,1358
050,36,091,"New York","Saratoga County",4,17,2784,1426,1358
050,36,091,"New York","Saratoga County",4,18,2759,1398,1361
050,36,091,"New York","Saratoga County",4,19,2550,1250,1300
050,36,091,"New York","Saratoga County",4,20,2608,1309,1299
050,36,091,"New York","Saratoga County",4,21,2709,1376,1333
050,36,091,"New York","Saratoga County",4,22,2746,1388,1358
050,36,091,"New York","Saratoga County",4,23,2646,1376,1270
050,36,091,"New York","Saratoga County",4,24,2557,1293,1264
050,36,091,"New York","Saratoga County",4,25,2493,1268,1225
050,36,091,"New York","Saratoga County",4,26,2683,1379,1304
050,36,091,"New York","Saratoga County",4,27,2736,1412,1324
050,36,091,"New York","Saratoga County",4,28,2871,1444,1427
050,36,091,"New York","Saratoga County",4,29,2915,1503,1412
050,36,091,"New York","Saratoga County",4,30,2844,1460,1384
050,36,091,"New York","Saratoga County",4,31,2935,1541,1394
050,36,091,"New York","Saratoga County",4,32,2972,1486,1486
050,36,091,"New York","Saratoga County",4,33,3036,1530,1506
050,36,091,"New York","Saratoga County",4,34,3126,1592,1534
050,36,091,"New York","Saratoga County",4,35,3178,1596,1582
050,36,091,"New York","Saratoga County",4,36,3193,1621,1572
050,36,091,"New York","Saratoga County",4,37,3088,1535,1553
050,36,091,"New York","Saratoga County",4,38,3102,1540,1562
050,36,091,"New York","Saratoga County",4,39,3108,1575,1533
050,36,091,"New York","Saratoga County",4,40,3112,1593,1519
050,36,091,"New York","Saratoga County",4,41,3072,1583,1489
050,36,091,"New York","Saratoga County",4,42,3089,1594,1495
050,36,091,"New York","Saratoga County",4,43,3017,1522,1495
050,36,091,"New York","Saratoga County",4,44,3059,1557,1502
050,36,091,"New York","Saratoga County",4,45,2967,1468,1499
050,36,091,"New York","Saratoga County",4,46,2843,1427,1416
050,36,091,"New York","Saratoga County",4,47,2894,1443,1451
050,36,091,"New York","Saratoga County",4,48,2833,1417,1416
050,36,091,"New York","Saratoga County",4,49,2956,1463,1493
050,36,091,"New York","Saratoga County",4,50,3203,1593,1610
050,36,091,"New York","Saratoga County",4,51,3536,1779,1757
050,36,091,"New York","Saratoga County",4,52,3522,1767,1755
050,36,091,"New York","Saratoga County",4,53,3390,1710,1680
050,36,091,"New York","Saratoga County",4,54,3311,1676,1635
050,36,091,"New York","Saratoga County",4,55,3425,1729,1696
050,36,091,"New York","Saratoga County",4,56,3527,1761,1766
050,36,091,"New York","Saratoga County",4,57,3690,1834,1856
050,36,091,"New York","Saratoga County",4,58,3722,1800,1922
050,36,091,"New York","Saratoga County",4,59,3696,1832,1864
050,36,091,"New York","Saratoga County",4,60,3611,1779,1832
050,36,091,"New York","Saratoga County",4,61,3632,1774,1858
050,36,091,"New York","Saratoga County",4,62,3522,1708,1814
050,36,091,"New York","Saratoga County",4,63,3510,1674,1836
050,36,091,"New York","Saratoga County",4,64,3393,1683,1710
050,36,091,"New York","Saratoga County",4,65,3238,1599,1639
050,36,091,"New York","Saratoga County",4,66,3100,1496,1604
050,36,091,"New York","Saratoga County",4,67,3034,1461,1573
050,36,091,"New York","Saratoga County",4,68,2884,1392,1492
050,36,091,"New York","Saratoga County",4,69,2860,1380,1480
050,36,091,"New York","Saratoga County",4,70,2794,1355,1439
050,36,091,"New York","Saratoga County",4,71,2697,1282,1415
050,36,091,"New York","Saratoga County",4,72,2554,1193,1361
050,36,091,"New York","Saratoga County",4,73,2501,1150,1351
050,36,091,"New York","Saratoga County",4,74,2511,1189,1322
050,36,091,"New York","Saratoga County",4,75,2737,1283,1454
050,36,091,"New York","Saratoga County",4,76,1790,827,963
050,36,091,"New York","Saratoga County",4,77,1673,771,902
050,36,091,"New York","Saratoga County",4,78,1663,754,909
050,36,091,"New York","Saratoga County",4,79,1689,805,884
050,36,091,"New York","Saratoga County",4,80,1355,624,731
050,36,091,"New York","Saratoga County",4,81,1136,518,618
050,36,091,"New York","Saratoga County",4,82,1005,439,566
050,36,091,"New York","Saratoga County",4,83,879,379,500
050,36,091,"New York","Saratoga County",4,84,833,360,473
050,36,091,"New York","Saratoga County",4,85,4538,1686,2852
050,36,091,"New York","Saratoga County",5,0,2121,1086,1035
050,36,091,"New York","Saratoga County",5,1,2160,1112,1048
050,36,091,"New York","Saratoga County",5,2,2095,1092,1003
050,36,091,"New York","Saratoga County",5,3,2244,1125,1119
050,36,091,"New York","Saratoga County",5,4,2277,1160,1117
050,36,091,"New York","Saratoga County",5,5,2390,1233,1157
050,36,091,"New York","Saratoga County",5,6,2366,1224,1142
050,36,091,"New York","Saratoga County",5,7,2595,1301,1294
050,36,091,"New York","Saratoga County",5,8,2609,1341,1268
050,36,091,"New York","Saratoga County",5,9,2650,1316,1334
050,36,091,"New York","Saratoga County",5,10,2602,1315,1287
050,36,091,"New York","Saratoga County",5,11,2620,1375,1245
050,36,091,"New York","Saratoga County",5,12,2601,1336,1265
050,36,091,"New York","Saratoga County",5,13,2686,1397,1289
050,36,091,"New York","Saratoga County",5,14,2794,1431,1363
050,36,091,"New York","Saratoga County",5,15,2802,1433,1369
050,36,091,"New York","Saratoga County",5,16,2748,1426,1322
050,36,091,"New York","Saratoga County",5,17,2725,1386,1339
050,36,091,"New York","Saratoga County",5,18,2672,1343,1329
050,36,091,"New York","Saratoga County",5,19,2493,1230,1263
050,36,091,"New York","Saratoga County",5,20,2617,1328,1289
050,36,091,"New York","Saratoga County",5,21,2663,1322,1341
050,36,091,"New York","Saratoga County",5,22,2710,1367,1343
050,36,091,"New York","Saratoga County",5,23,2628,1374,1254
050,36,091,"New York","Saratoga County",5,24,2573,1328,1245
050,36,091,"New York","Saratoga County",5,25,2519,1292,1227
050,36,091,"New York","Saratoga County",5,26,2542,1279,1263
050,36,091,"New York","Saratoga County",5,27,2660,1387,1273
050,36,091,"New York","Saratoga County",5,28,2727,1426,1301
050,36,091,"New York","Saratoga County",5,29,2908,1459,1449
050,36,091,"New York","Saratoga County",5,30,2940,1495,1445
050,36,091,"New York","Saratoga County",5,31,2868,1462,1406
050,36,091,"New York","Saratoga County",5,32,3019,1564,1455
050,36,091,"New York","Saratoga County",5,33,3027,1526,1501
050,36,091,"New York","Saratoga County",5,34,3111,1575,1536
050,36,091,"New York","Saratoga County",5,35,3183,1612,1571
050,36,091,"New York","Saratoga County",5,36,3231,1609,1622
050,36,091,"New York","Saratoga County",5,37,3203,1635,1568
050,36,091,"New York","Saratoga County",5,38,3120,1561,1559
050,36,091,"New York","Saratoga County",5,39,3147,1545,1602
050,36,091,"New York","Saratoga County",5,40,3130,1602,1528
050,36,091,"New York","Saratoga County",5,41,3131,1593,1538
050,36,091,"New York","Saratoga County",5,42,3052,1559,1493
050,36,091,"New York","Saratoga County",5,43,3097,1598,1499
050,36,091,"New York","Saratoga County",5,44,3069,1554,1515
050,36,091,"New York","Saratoga County",5,45,3036,1558,1478
050,36,091,"New York","Saratoga County",5,46,2933,1440,1493
050,36,091,"New York","Saratoga County",5,47,2812,1421,1391
050,36,091,"New York","Saratoga County",5,48,2867,1421,1446
050,36,091,"New York","Saratoga County",5,49,2817,1408,1409
050,36,091,"New York","Saratoga County",5,50,2950,1472,1478
050,36,091,"New York","Saratoga County",5,51,3168,1577,1591
050,36,091,"New York","Saratoga County",5,52,3511,1766,1745
050,36,091,"New York","Saratoga County",5,53,3466,1718,1748
050,36,091,"New York","Saratoga County",5,54,3398,1730,1668
050,36,091,"New York","Saratoga County",5,55,3272,1663,1609
050,36,091,"New York","Saratoga County",5,56,3434,1732,1702
050,36,091,"New York","Saratoga County",5,57,3511,1758,1753
050,36,091,"New York","Saratoga County",5,58,3651,1813,1838
050,36,091,"New York","Saratoga County",5,59,3701,1807,1894
050,36,091,"New York","Saratoga County",5,60,3660,1787,1873
050,36,091,"New York","Saratoga County",5,61,3585,1780,1805
050,36,091,"New York","Saratoga County",5,62,3553,1731,1822
050,36,091,"New York","Saratoga County",5,63,3464,1655,1809
050,36,091,"New York","Saratoga County",5,64,3500,1669,1831
050,36,091,"New York","Saratoga County",5,65,3388,1688,1700
050,36,091,"New York","Saratoga County",5,66,3224,1588,1636
050,36,091,"New York","Saratoga County",5,67,3068,1478,1590
050,36,091,"New York","Saratoga County",5,68,3027,1451,1576
050,36,091,"New York","Saratoga County",5,69,2868,1380,1488
050,36,091,"New York","Saratoga County",5,70,2852,1359,1493
050,36,091,"New York","Saratoga County",5,71,2756,1338,1418
050,36,091,"New York","Saratoga County",5,72,2663,1259,1404
050,36,091,"New York","Saratoga County",5,73,2507,1160,1347
050,36,091,"New York","Saratoga County",5,74,2473,1135,1338
050,36,091,"New York","Saratoga County",5,75,2454,1159,1295
050,36,091,"New York","Saratoga County",5,76,2673,1251,1422
050,36,091,"New York","Saratoga County",5,77,1735,801,934
050,36,091,"New York","Saratoga County",5,78,1622,739,883
050,36,091,"New York","Saratoga County",5,79,1609,738,871
050,36,091,"New York","Saratoga County",5,80,1615,763,852
050,36,091,"New York","Saratoga County",5,81,1275,592,683
050,36,091,"New York","Saratoga County",5,82,1068,487,581
050,36,091,"New York","Saratoga County",5,83,928,408,520
050,36,091,"New York","Saratoga County",5,84,838,358,480
050,36,091,"New York","Saratoga County",5,85,4654,1748,2906
050,36,093,"New York","Schenectady County",1,0,1836,933,903
050,36,093,"New York","Schenectady County",1,1,1862,948,914
050,36,093,"New York","Schenectady County",1,2,1905,984,921
050,36,093,"New York","Schenectady County",1,3,1847,1001,846
050,36,093,"New York","Schenectady County",1,4,1913,990,923
050,36,093,"New York","Schenectady County",1,5,1892,956,936
050,36,093,"New York","Schenectady County",1,6,1855,951,904
050,36,093,"New York","Schenectady County",1,7,1919,977,942
050,36,093,"New York","Schenectady County",1,8,1881,992,889
050,36,093,"New York","Schenectady County",1,9,1900,980,920
050,36,093,"New York","Schenectady County",1,10,1956,1005,951
050,36,093,"New York","Schenectady County",1,11,1899,994,905
050,36,093,"New York","Schenectady County",1,12,1920,985,935
050,36,093,"New York","Schenectady County",1,13,1982,1014,968
050,36,093,"New York","Schenectady County",1,14,1984,1022,962
050,36,093,"New York","Schenectady County",1,15,1975,1036,939
050,36,093,"New York","Schenectady County",1,16,2061,1062,999
050,36,093,"New York","Schenectady County",1,17,2002,1016,986
050,36,093,"New York","Schenectady County",1,18,1936,995,941
050,36,093,"New York","Schenectady County",1,19,1938,977,961
050,36,093,"New York","Schenectady County",1,20,2075,1063,1012
050,36,093,"New York","Schenectady County",1,21,2025,1044,981
050,36,093,"New York","Schenectady County",1,22,1925,987,938
050,36,093,"New York","Schenectady County",1,23,1833,902,931
050,36,093,"New York","Schenectady County",1,24,1933,968,965
050,36,093,"New York","Schenectady County",1,25,1973,1006,967
050,36,093,"New York","Schenectady County",1,26,2065,1001,1064
050,36,093,"New York","Schenectady County",1,27,2020,999,1021
050,36,093,"New York","Schenectady County",1,28,2047,999,1048
050,36,093,"New York","Schenectady County",1,29,2071,1057,1014
050,36,093,"New York","Schenectady County",1,30,2169,1079,1090
050,36,093,"New York","Schenectady County",1,31,2106,1053,1053
050,36,093,"New York","Schenectady County",1,32,2153,1089,1064
050,36,093,"New York","Schenectady County",1,33,2123,1075,1048
050,36,093,"New York","Schenectady County",1,34,2164,1096,1068
050,36,093,"New York","Schenectady County",1,35,2109,1076,1033
050,36,093,"New York","Schenectady County",1,36,1993,988,1005
050,36,093,"New York","Schenectady County",1,37,2045,1010,1035
050,36,093,"New York","Schenectady County",1,38,2092,1010,1082
050,36,093,"New York","Schenectady County",1,39,2071,1007,1064
050,36,093,"New York","Schenectady County",1,40,2037,1039,998
050,36,093,"New York","Schenectady County",1,41,1934,967,967
050,36,093,"New York","Schenectady County",1,42,1911,934,977
050,36,093,"New York","Schenectady County",1,43,1871,949,922
050,36,093,"New York","Schenectady County",1,44,1748,848,900
050,36,093,"New York","Schenectady County",1,45,1780,888,892
050,36,093,"New York","Schenectady County",1,46,1769,882,887
050,36,093,"New York","Schenectady County",1,47,1834,915,919
050,36,093,"New York","Schenectady County",1,48,1992,994,998
050,36,093,"New York","Schenectady County",1,49,2089,1050,1039
050,36,093,"New York","Schenectady County",1,50,2011,991,1020
050,36,093,"New York","Schenectady County",1,51,2006,1016,990
050,36,093,"New York","Schenectady County",1,52,1987,992,995
050,36,093,"New York","Schenectady County",1,53,2063,961,1102
050,36,093,"New York","Schenectady County",1,54,2093,966,1127
050,36,093,"New York","Schenectady County",1,55,2221,1097,1124
050,36,093,"New York","Schenectady County",1,56,2309,1136,1173
050,36,093,"New York","Schenectady County",1,57,2288,1094,1194
050,36,093,"New York","Schenectady County",1,58,2208,1042,1166
050,36,093,"New York","Schenectady County",1,59,2225,1071,1154
050,36,093,"New York","Schenectady County",1,60,2230,1071,1159
050,36,093,"New York","Schenectady County",1,61,2195,1071,1124
050,36,093,"New York","Schenectady County",1,62,2188,1069,1119
050,36,093,"New York","Schenectady County",1,63,2045,1006,1039
050,36,093,"New York","Schenectady County",1,64,1971,951,1020
050,36,093,"New York","Schenectady County",1,65,1981,971,1010
050,36,093,"New York","Schenectady County",1,66,1844,889,955
050,36,093,"New York","Schenectady County",1,67,1747,843,904
050,36,093,"New York","Schenectady County",1,68,1735,827,908
050,36,093,"New York","Schenectady County",1,69,1582,741,841
050,36,093,"New York","Schenectady County",1,70,1565,739,826
050,36,093,"New York","Schenectady County",1,71,1501,703,798
050,36,093,"New York","Schenectady County",1,72,1471,686,785
050,36,093,"New York","Schenectady County",1,73,1447,674,773
050,36,093,"New York","Schenectady County",1,74,1014,476,538
050,36,093,"New York","Schenectady County",1,75,1025,481,544
050,36,093,"New York","Schenectady County",1,76,1026,462,564
050,36,093,"New York","Schenectady County",1,77,1015,441,574
050,36,093,"New York","Schenectady County",1,78,866,377,489
050,36,093,"New York","Schenectady County",1,79,748,308,440
050,36,093,"New York","Schenectady County",1,80,713,288,425
050,36,093,"New York","Schenectady County",1,81,657,255,402
050,36,093,"New York","Schenectady County",1,82,584,247,337
050,36,093,"New York","Schenectady County",1,83,525,202,323
050,36,093,"New York","Schenectady County",1,84,564,210,354
050,36,093,"New York","Schenectady County",1,85,3982,1295,2687
050,36,093,"New York","Schenectady County",2,0,1828,945,883
050,36,093,"New York","Schenectady County",2,1,1849,941,908
050,36,093,"New York","Schenectady County",2,2,1894,978,916
050,36,093,"New York","Schenectady County",2,3,1864,997,867
050,36,093,"New York","Schenectady County",2,4,1895,991,904
050,36,093,"New York","Schenectady County",2,5,1896,964,932
050,36,093,"New York","Schenectady County",2,6,1868,955,913
050,36,093,"New York","Schenectady County",2,7,1901,967,934
050,36,093,"New York","Schenectady County",2,8,1879,981,898
050,36,093,"New York","Schenectady County",2,9,1894,984,910
050,36,093,"New York","Schenectady County",2,10,1935,997,938
050,36,093,"New York","Schenectady County",2,11,1899,988,911
050,36,093,"New York","Schenectady County",2,12,1924,991,933
050,36,093,"New York","Schenectady County",2,13,1963,1005,958
050,36,093,"New York","Schenectady County",2,14,1976,1018,958
050,36,093,"New York","Schenectady County",2,15,1980,1035,945
050,36,093,"New York","Schenectady County",2,16,2044,1057,987
050,36,093,"New York","Schenectady County",2,17,2011,1021,990
050,36,093,"New York","Schenectady County",2,18,2156,1104,1052
050,36,093,"New York","Schenectady County",2,19,2294,1156,1138
050,36,093,"New York","Schenectady County",2,20,2491,1269,1222
050,36,093,"New York","Schenectady County",2,21,2306,1198,1108
050,36,093,"New York","Schenectady County",2,22,2051,1063,988
050,36,093,"New York","Schenectady County",2,23,1864,924,940
050,36,093,"New York","Schenectady County",2,24,1913,955,958
050,36,093,"New York","Schenectady County",2,25,1972,1000,972
050,36,093,"New York","Schenectady County",2,26,2060,1015,1045
050,36,093,"New York","Schenectady County",2,27,2042,1006,1036
050,36,093,"New York","Schenectady County",2,28,2053,1004,1049
050,36,093,"New York","Schenectady County",2,29,2080,1048,1032
050,36,093,"New York","Schenectady County",2,30,2165,1086,1079
050,36,093,"New York","Schenectady County",2,31,2108,1057,1051
050,36,093,"New York","Schenectady County",2,32,2138,1078,1060
050,36,093,"New York","Schenectady County",2,33,2133,1083,1050
050,36,093,"New York","Schenectady County",2,34,2144,1086,1058
050,36,093,"New York","Schenectady County",2,35,2134,1089,1045
050,36,093,"New York","Schenectady County",2,36,2002,1002,1000
050,36,093,"New York","Schenectady County",2,37,2036,1006,1030
050,36,093,"New York","Schenectady County",2,38,2091,1010,1081
050,36,093,"New York","Schenectady County",2,39,2069,1003,1066
050,36,093,"New York","Schenectady County",2,40,2061,1041,1020
050,36,093,"New York","Schenectady County",2,41,1949,976,973
050,36,093,"New York","Schenectady County",2,42,1900,933,967
050,36,093,"New York","Schenectady County",2,43,1885,948,937
050,36,093,"New York","Schenectady County",2,44,1753,859,894
050,36,093,"New York","Schenectady County",2,45,1773,875,898
050,36,093,"New York","Schenectady County",2,46,1757,873,884
050,36,093,"New York","Schenectady County",2,47,1820,910,910
050,36,093,"New York","Schenectady County",2,48,1948,973,975
050,36,093,"New York","Schenectady County",2,49,2069,1037,1032
050,36,093,"New York","Schenectady County",2,50,2030,1005,1025
050,36,093,"New York","Schenectady County",2,51,2000,1006,994
050,36,093,"New York","Schenectady County",2,52,1977,991,986
050,36,093,"New York","Schenectady County",2,53,2039,966,1073
050,36,093,"New York","Schenectady County",2,54,2077,963,1114
050,36,093,"New York","Schenectady County",2,55,2185,1064,1121
050,36,093,"New York","Schenectady County",2,56,2283,1123,1160
050,36,093,"New York","Schenectady County",2,57,2291,1103,1188
050,36,093,"New York","Schenectady County",2,58,2221,1052,1169
050,36,093,"New York","Schenectady County",2,59,2223,1066,1157
050,36,093,"New York","Schenectady County",2,60,2219,1063,1156
050,36,093,"New York","Schenectady County",2,61,2192,1064,1128
050,36,093,"New York","Schenectady County",2,62,2179,1067,1112
050,36,093,"New York","Schenectady County",2,63,2085,1023,1062
050,36,093,"New York","Schenectady County",2,64,1962,951,1011
050,36,093,"New York","Schenectady County",2,65,1967,960,1007
050,36,093,"New York","Schenectady County",2,66,1870,904,966
050,36,093,"New York","Schenectady County",2,67,1754,847,907
050,36,093,"New York","Schenectady County",2,68,1722,822,900
050,36,093,"New York","Schenectady County",2,69,1615,761,854
050,36,093,"New York","Schenectady County",2,70,1556,735,821
050,36,093,"New York","Schenectady County",2,71,1509,706,803
050,36,093,"New York","Schenectady County",2,72,1449,673,776
050,36,093,"New York","Schenectady County",2,73,1518,708,810
050,36,093,"New York","Schenectady County",2,74,1038,485,553
050,36,093,"New York","Schenectady County",2,75,1004,468,536
050,36,093,"New York","Schenectady County",2,76,1008,459,549
050,36,093,"New York","Schenectady County",2,77,1029,451,578
050,36,093,"New York","Schenectady County",2,78,868,375,493
050,36,093,"New York","Schenectady County",2,79,760,322,438
050,36,093,"New York","Schenectady County",2,80,709,286,423
050,36,093,"New York","Schenectady County",2,81,663,260,403
050,36,093,"New York","Schenectady County",2,82,591,244,347
050,36,093,"New York","Schenectady County",2,83,518,206,312
050,36,093,"New York","Schenectady County",2,84,548,202,346
050,36,093,"New York","Schenectady County",2,85,3913,1274,2639
050,36,093,"New York","Schenectady County",3,0,1765,919,846
050,36,093,"New York","Schenectady County",3,1,1852,963,889
050,36,093,"New York","Schenectady County",3,2,1855,949,906
050,36,093,"New York","Schenectady County",3,3,1935,1002,933
050,36,093,"New York","Schenectady County",3,4,1838,979,859
050,36,093,"New York","Schenectady County",3,5,1916,1006,910
050,36,093,"New York","Schenectady County",3,6,1887,939,948
050,36,093,"New York","Schenectady County",3,7,1877,964,913
050,36,093,"New York","Schenectady County",3,8,1894,964,930
050,36,093,"New York","Schenectady County",3,9,1900,1001,899
050,36,093,"New York","Schenectady County",3,10,1929,1001,928
050,36,093,"New York","Schenectady County",3,11,1941,995,946
050,36,093,"New York","Schenectady County",3,12,1911,979,932
050,36,093,"New York","Schenectady County",3,13,1914,969,945
050,36,093,"New York","Schenectady County",3,14,1945,1004,941
050,36,093,"New York","Schenectady County",3,15,1980,1025,955
050,36,093,"New York","Schenectady County",3,16,2003,1048,955
050,36,093,"New York","Schenectady County",3,17,2053,1042,1011
050,36,093,"New York","Schenectady County",3,18,2290,1177,1113
050,36,093,"New York","Schenectady County",3,19,2360,1205,1155
050,36,093,"New York","Schenectady County",3,20,2583,1308,1275
050,36,093,"New York","Schenectady County",3,21,2403,1241,1162
050,36,093,"New York","Schenectady County",3,22,2072,1069,1003
050,36,093,"New York","Schenectady County",3,23,1910,945,965
050,36,093,"New York","Schenectady County",3,24,1908,942,966
050,36,093,"New York","Schenectady County",3,25,1984,1006,978
050,36,093,"New York","Schenectady County",3,26,2102,1053,1049
050,36,093,"New York","Schenectady County",3,27,2124,1064,1060
050,36,093,"New York","Schenectady County",3,28,2069,995,1074
050,36,093,"New York","Schenectady County",3,29,2127,1051,1076
050,36,093,"New York","Schenectady County",3,30,2144,1054,1090
050,36,093,"New York","Schenectady County",3,31,2212,1105,1107
050,36,093,"New York","Schenectady County",3,32,2123,1071,1052
050,36,093,"New York","Schenectady County",3,33,2193,1108,1085
050,36,093,"New York","Schenectady County",3,34,2110,1046,1064
050,36,093,"New York","Schenectady County",3,35,2172,1106,1066
050,36,093,"New York","Schenectady County",3,36,2190,1100,1090
050,36,093,"New York","Schenectady County",3,37,2041,1025,1016
050,36,093,"New York","Schenectady County",3,38,2032,995,1037
050,36,093,"New York","Schenectady County",3,39,2080,995,1085
050,36,093,"New York","Schenectady County",3,40,2070,1033,1037
050,36,093,"New York","Schenectady County",3,41,2080,1045,1035
050,36,093,"New York","Schenectady County",3,42,1900,936,964
050,36,093,"New York","Schenectady County",3,43,1921,953,968
050,36,093,"New York","Schenectady County",3,44,1877,955,922
050,36,093,"New York","Schenectady County",3,45,1759,858,901
050,36,093,"New York","Schenectady County",3,46,1770,871,899
050,36,093,"New York","Schenectady County",3,47,1762,888,874
050,36,093,"New York","Schenectady County",3,48,1796,894,902
050,36,093,"New York","Schenectady County",3,49,1921,972,949
050,36,093,"New York","Schenectady County",3,50,2066,1031,1035
050,36,093,"New York","Schenectady County",3,51,1988,982,1006
050,36,093,"New York","Schenectady County",3,52,1954,979,975
050,36,093,"New York","Schenectady County",3,53,1968,983,985
050,36,093,"New York","Schenectady County",3,54,2012,952,1060
050,36,093,"New York","Schenectady County",3,55,2040,949,1091
050,36,093,"New York","Schenectady County",3,56,2127,1036,1091
050,36,093,"New York","Schenectady County",3,57,2267,1112,1155
050,36,093,"New York","Schenectady County",3,58,2269,1091,1178
050,36,093,"New York","Schenectady County",3,59,2154,1026,1128
050,36,093,"New York","Schenectady County",3,60,2182,1035,1147
050,36,093,"New York","Schenectady County",3,61,2173,1056,1117
050,36,093,"New York","Schenectady County",3,62,2125,1035,1090
050,36,093,"New York","Schenectady County",3,63,2127,1049,1078
050,36,093,"New York","Schenectady County",3,64,2039,995,1044
050,36,093,"New York","Schenectady County",3,65,1920,936,984
050,36,093,"New York","Schenectady County",3,66,1931,942,989
050,36,093,"New York","Schenectady County",3,67,1808,867,941
050,36,093,"New York","Schenectady County",3,68,1711,824,887
050,36,093,"New York","Schenectady County",3,69,1698,811,887
050,36,093,"New York","Schenectady County",3,70,1568,732,836
050,36,093,"New York","Schenectady County",3,71,1517,701,816
050,36,093,"New York","Schenectady County",3,72,1460,675,785
050,36,093,"New York","Schenectady County",3,73,1387,641,746
050,36,093,"New York","Schenectady County",3,74,1463,681,782
050,36,093,"New York","Schenectady County",3,75,1006,469,537
050,36,093,"New York","Schenectady County",3,76,989,462,527
050,36,093,"New York","Schenectady County",3,77,954,430,524
050,36,093,"New York","Schenectady County",3,78,994,435,559
050,36,093,"New York","Schenectady County",3,79,813,346,467
050,36,093,"New York","Schenectady County",3,80,725,301,424
050,36,093,"New York","Schenectady County",3,81,690,268,422
050,36,093,"New York","Schenectady County",3,82,606,236,370
050,36,093,"New York","Schenectady County",3,83,536,220,316
050,36,093,"New York","Schenectady County",3,84,492,191,301
050,36,093,"New York","Schenectady County",3,85,3807,1246,2561
050,36,093,"New York","Schenectady County",4,0,1831,985,846
050,36,093,"New York","Schenectady County",4,1,1775,918,857
050,36,093,"New York","Schenectady County",4,2,1848,960,888
050,36,093,"New York","Schenectady County",4,3,1888,953,935
050,36,093,"New York","Schenectady County",4,4,1915,997,918
050,36,093,"New York","Schenectady County",4,5,1829,970,859
050,36,093,"New York","Schenectady County",4,6,1906,987,919
050,36,093,"New York","Schenectady County",4,7,1888,970,918
050,36,093,"New York","Schenectady County",4,8,1864,964,900
050,36,093,"New York","Schenectady County",4,9,1899,980,919
050,36,093,"New York","Schenectady County",4,10,1896,986,910
050,36,093,"New York","Schenectady County",4,11,1913,1006,907
050,36,093,"New York","Schenectady County",4,12,1945,997,948
050,36,093,"New York","Schenectady County",4,13,1950,1019,931
050,36,093,"New York","Schenectady County",4,14,1933,986,947
050,36,093,"New York","Schenectady County",4,15,1951,1006,945
050,36,093,"New York","Schenectady County",4,16,1989,1032,957
050,36,093,"New York","Schenectady County",4,17,1999,1034,965
050,36,093,"New York","Schenectady County",4,18,2294,1168,1126
050,36,093,"New York","Schenectady County",4,19,2354,1213,1141
050,36,093,"New York","Schenectady County",4,20,2463,1254,1209
050,36,093,"New York","Schenectady County",4,21,2347,1212,1135
050,36,093,"New York","Schenectady County",4,22,2058,1061,997
050,36,093,"New York","Schenectady County",4,23,1830,922,908
050,36,093,"New York","Schenectady County",4,24,1900,940,960
050,36,093,"New York","Schenectady County",4,25,1912,948,964
050,36,093,"New York","Schenectady County",4,26,2017,1020,997
050,36,093,"New York","Schenectady County",4,27,2094,1050,1044
050,36,093,"New York","Schenectady County",4,28,2169,1088,1081
050,36,093,"New York","Schenectady County",4,29,2121,1011,1110
050,36,093,"New York","Schenectady County",4,30,2221,1098,1123
050,36,093,"New York","Schenectady County",4,31,2144,1049,1095
050,36,093,"New York","Schenectady County",4,32,2253,1144,1109
050,36,093,"New York","Schenectady County",4,33,2199,1104,1095
050,36,093,"New York","Schenectady County",4,34,2169,1091,1078
050,36,093,"New York","Schenectady County",4,35,2155,1067,1088
050,36,093,"New York","Schenectady County",4,36,2100,1067,1033
050,36,093,"New York","Schenectady County",4,37,2205,1108,1097
050,36,093,"New York","Schenectady County",4,38,2041,1023,1018
050,36,093,"New York","Schenectady County",4,39,1981,962,1019
050,36,093,"New York","Schenectady County",4,40,2077,1030,1047
050,36,093,"New York","Schenectady County",4,41,2083,1021,1062
050,36,093,"New York","Schenectady County",4,42,2051,1026,1025
050,36,093,"New York","Schenectady County",4,43,1916,956,960
050,36,093,"New York","Schenectady County",4,44,1906,932,974
050,36,093,"New York","Schenectady County",4,45,1866,942,924
050,36,093,"New York","Schenectady County",4,46,1754,835,919
050,36,093,"New York","Schenectady County",4,47,1805,893,912
050,36,093,"New York","Schenectady County",4,48,1761,893,868
050,36,093,"New York","Schenectady County",4,49,1796,901,895
050,36,093,"New York","Schenectady County",4,50,1899,953,946
050,36,093,"New York","Schenectady County",4,51,2060,1031,1029
050,36,093,"New York","Schenectady County",4,52,1957,963,994
050,36,093,"New York","Schenectady County",4,53,1971,981,990
050,36,093,"New York","Schenectady County",4,54,1958,979,979
050,36,093,"New York","Schenectady County",4,55,1989,947,1042
050,36,093,"New York","Schenectady County",4,56,2003,927,1076
050,36,093,"New York","Schenectady County",4,57,2094,1018,1076
050,36,093,"New York","Schenectady County",4,58,2238,1102,1136
050,36,093,"New York","Schenectady County",4,59,2228,1085,1143
050,36,093,"New York","Schenectady County",4,60,2096,993,1103
050,36,093,"New York","Schenectady County",4,61,2122,1006,1116
050,36,093,"New York","Schenectady County",4,62,2132,1036,1096
050,36,093,"New York","Schenectady County",4,63,2077,1015,1062
050,36,093,"New York","Schenectady County",4,64,2077,1028,1049
050,36,093,"New York","Schenectady County",4,65,1980,960,1020
050,36,093,"New York","Schenectady County",4,66,1875,905,970
050,36,093,"New York","Schenectady County",4,67,1878,918,960
050,36,093,"New York","Schenectady County",4,68,1764,852,912
050,36,093,"New York","Schenectady County",4,69,1664,799,865
050,36,093,"New York","Schenectady County",4,70,1626,767,859
050,36,093,"New York","Schenectady County",4,71,1521,703,818
050,36,093,"New York","Schenectady County",4,72,1466,677,789
050,36,093,"New York","Schenectady County",4,73,1439,660,779
050,36,093,"New York","Schenectady County",4,74,1338,614,724
050,36,093,"New York","Schenectady County",4,75,1387,647,740
050,36,093,"New York","Schenectady County",4,76,971,451,520
050,36,093,"New York","Schenectady County",4,77,945,436,509
050,36,093,"New York","Schenectady County",4,78,920,412,508
050,36,093,"New York","Schenectady County",4,79,931,407,524
050,36,093,"New York","Schenectady County",4,80,776,326,450
050,36,093,"New York","Schenectady County",4,81,696,283,413
050,36,093,"New York","Schenectady County",4,82,639,250,389
050,36,093,"New York","Schenectady County",4,83,546,216,330
050,36,093,"New York","Schenectady County",4,84,508,206,302
050,36,093,"New York","Schenectady County",4,85,3662,1193,2469
050,36,093,"New York","Schenectady County",5,0,1831,984,847
050,36,093,"New York","Schenectady County",5,1,1786,944,842
050,36,093,"New York","Schenectady County",5,2,1829,931,898
050,36,093,"New York","Schenectady County",5,3,1854,958,896
050,36,093,"New York","Schenectady County",5,4,1856,940,916
050,36,093,"New York","Schenectady County",5,5,1910,990,920
050,36,093,"New York","Schenectady County",5,6,1871,992,879
050,36,093,"New York","Schenectady County",5,7,1935,1021,914
050,36,093,"New York","Schenectady County",5,8,1883,973,910
050,36,093,"New York","Schenectady County",5,9,1885,996,889
050,36,093,"New York","Schenectady County",5,10,1873,970,903
050,36,093,"New York","Schenectady County",5,11,1909,993,916
050,36,093,"New York","Schenectady County",5,12,1918,996,922
050,36,093,"New York","Schenectady County",5,13,1960,1023,937
050,36,093,"New York","Schenectady County",5,14,1955,1009,946
050,36,093,"New York","Schenectady County",5,15,1918,987,931
050,36,093,"New York","Schenectady County",5,16,1978,1026,952
050,36,093,"New York","Schenectady County",5,17,1973,1014,959
050,36,093,"New York","Schenectady County",5,18,2252,1178,1074
050,36,093,"New York","Schenectady County",5,19,2414,1230,1184
050,36,093,"New York","Schenectady County",5,20,2539,1312,1227
050,36,093,"New York","Schenectady County",5,21,2250,1169,1081
050,36,093,"New York","Schenectady County",5,22,2046,1061,985
050,36,093,"New York","Schenectady County",5,23,1838,932,906
050,36,093,"New York","Schenectady County",5,24,1842,922,920
050,36,093,"New York","Schenectady County",5,25,1892,934,958
050,36,093,"New York","Schenectady County",5,26,1915,959,956
050,36,093,"New York","Schenectady County",5,27,2029,1025,1004
050,36,093,"New York","Schenectady County",5,28,2111,1039,1072
050,36,093,"New York","Schenectady County",5,29,2157,1080,1077
050,36,093,"New York","Schenectady County",5,30,2172,1030,1142
050,36,093,"New York","Schenectady County",5,31,2213,1102,1111
050,36,093,"New York","Schenectady County",5,32,2233,1121,1112
050,36,093,"New York","Schenectady County",5,33,2282,1167,1115
050,36,093,"New York","Schenectady County",5,34,2193,1116,1077
050,36,093,"New York","Schenectady County",5,35,2184,1096,1088
050,36,093,"New York","Schenectady County",5,36,2163,1065,1098
050,36,093,"New York","Schenectady County",5,37,2119,1077,1042
050,36,093,"New York","Schenectady County",5,38,2227,1106,1121
050,36,093,"New York","Schenectady County",5,39,2048,1026,1022
050,36,093,"New York","Schenectady County",5,40,2031,1012,1019
050,36,093,"New York","Schenectady County",5,41,2113,1035,1078
050,36,093,"New York","Schenectady County",5,42,2063,1004,1059
050,36,093,"New York","Schenectady County",5,43,2044,1046,998
050,36,093,"New York","Schenectady County",5,44,1908,935,973
050,36,093,"New York","Schenectady County",5,45,1882,918,964
050,36,093,"New York","Schenectady County",5,46,1830,911,919
050,36,093,"New York","Schenectady County",5,47,1787,854,933
050,36,093,"New York","Schenectady County",5,48,1780,879,901
050,36,093,"New York","Schenectady County",5,49,1730,875,855
050,36,093,"New York","Schenectady County",5,50,1791,906,885
050,36,093,"New York","Schenectady County",5,51,1899,943,956
050,36,093,"New York","Schenectady County",5,52,2022,1005,1017
050,36,093,"New York","Schenectady County",5,53,1940,958,982
050,36,093,"New York","Schenectady County",5,54,1966,975,991
050,36,093,"New York","Schenectady County",5,55,1948,983,965
050,36,093,"New York","Schenectady County",5,56,1961,939,1022
050,36,093,"New York","Schenectady County",5,57,1989,927,1062
050,36,093,"New York","Schenectady County",5,58,2085,1010,1075
050,36,093,"New York","Schenectady County",5,59,2211,1087,1124
050,36,093,"New York","Schenectady County",5,60,2187,1060,1127
050,36,093,"New York","Schenectady County",5,61,2078,985,1093
050,36,093,"New York","Schenectady County",5,62,2097,991,1106
050,36,093,"New York","Schenectady County",5,63,2115,1033,1082
050,36,093,"New York","Schenectady County",5,64,2021,986,1035
050,36,093,"New York","Schenectady County",5,65,2056,1015,1041
050,36,093,"New York","Schenectady County",5,66,1926,934,992
050,36,093,"New York","Schenectady County",5,67,1824,877,947
050,36,093,"New York","Schenectady County",5,68,1851,902,949
050,36,093,"New York","Schenectady County",5,69,1732,833,899
050,36,093,"New York","Schenectady County",5,70,1612,771,841
050,36,093,"New York","Schenectady County",5,71,1584,741,843
050,36,093,"New York","Schenectady County",5,72,1496,681,815
050,36,093,"New York","Schenectady County",5,73,1422,649,773
050,36,093,"New York","Schenectady County",5,74,1389,629,760
050,36,093,"New York","Schenectady County",5,75,1298,583,715
050,36,093,"New York","Schenectady County",5,76,1346,623,723
050,36,093,"New York","Schenectady County",5,77,927,421,506
050,36,093,"New York","Schenectady County",5,78,916,427,489
050,36,093,"New York","Schenectady County",5,79,862,387,475
050,36,093,"New York","Schenectady County",5,80,879,380,499
050,36,093,"New York","Schenectady County",5,81,742,306,436
050,36,093,"New York","Schenectady County",5,82,639,257,382
050,36,093,"New York","Schenectady County",5,83,582,233,349
050,36,093,"New York","Schenectady County",5,84,523,197,326
050,36,093,"New York","Schenectady County",5,85,3575,1175,2400
050,36,095,"New York","Schoharie County",1,0,258,131,127
050,36,095,"New York","Schoharie County",1,1,249,126,123
050,36,095,"New York","Schoharie County",1,2,278,132,146
050,36,095,"New York","Schoharie County",1,3,251,127,124
050,36,095,"New York","Schoharie County",1,4,262,138,124
050,36,095,"New York","Schoharie County",1,5,250,139,111
050,36,095,"New York","Schoharie County",1,6,275,140,135
050,36,095,"New York","Schoharie County",1,7,277,135,142
050,36,095,"New York","Schoharie County",1,8,295,161,134
050,36,095,"New York","Schoharie County",1,9,315,164,151
050,36,095,"New York","Schoharie County",1,10,330,169,161
050,36,095,"New York","Schoharie County",1,11,322,156,166
050,36,095,"New York","Schoharie County",1,12,318,175,143
050,36,095,"New York","Schoharie County",1,13,291,159,132
050,36,095,"New York","Schoharie County",1,14,307,157,150
050,36,095,"New York","Schoharie County",1,15,334,169,165
050,36,095,"New York","Schoharie County",1,16,338,173,165
050,36,095,"New York","Schoharie County",1,17,335,168,167
050,36,095,"New York","Schoharie County",1,18,524,255,269
050,36,095,"New York","Schoharie County",1,19,612,301,311
050,36,095,"New York","Schoharie County",1,20,492,250,242
050,36,095,"New York","Schoharie County",1,21,388,201,187
050,36,095,"New York","Schoharie County",1,22,346,182,164
050,36,095,"New York","Schoharie County",1,23,314,164,150
050,36,095,"New York","Schoharie County",1,24,314,161,153
050,36,095,"New York","Schoharie County",1,25,311,155,156
050,36,095,"New York","Schoharie County",1,26,306,147,159
050,36,095,"New York","Schoharie County",1,27,307,153,154
050,36,095,"New York","Schoharie County",1,28,308,156,152
050,36,095,"New York","Schoharie County",1,29,316,162,154
050,36,095,"New York","Schoharie County",1,30,312,158,154
050,36,095,"New York","Schoharie County",1,31,312,168,144
050,36,095,"New York","Schoharie County",1,32,304,148,156
050,36,095,"New York","Schoharie County",1,33,314,170,144
050,36,095,"New York","Schoharie County",1,34,311,160,151
050,36,095,"New York","Schoharie County",1,35,309,157,152
050,36,095,"New York","Schoharie County",1,36,335,178,157
050,36,095,"New York","Schoharie County",1,37,347,167,180
050,36,095,"New York","Schoharie County",1,38,311,150,161
050,36,095,"New York","Schoharie County",1,39,320,165,155
050,36,095,"New York","Schoharie County",1,40,310,179,131
050,36,095,"New York","Schoharie County",1,41,309,160,149
050,36,095,"New York","Schoharie County",1,42,299,143,156
050,36,095,"New York","Schoharie County",1,43,303,151,152
050,36,095,"New York","Schoharie County",1,44,328,156,172
050,36,095,"New York","Schoharie County",1,45,299,147,152
050,36,095,"New York","Schoharie County",1,46,312,163,149
050,36,095,"New York","Schoharie County",1,47,337,170,167
050,36,095,"New York","Schoharie County",1,48,343,171,172
050,36,095,"New York","Schoharie County",1,49,400,210,190
050,36,095,"New York","Schoharie County",1,50,388,205,183
050,36,095,"New York","Schoharie County",1,51,384,200,184
050,36,095,"New York","Schoharie County",1,52,393,195,198
050,36,095,"New York","Schoharie County",1,53,426,215,211
050,36,095,"New York","Schoharie County",1,54,433,224,209
050,36,095,"New York","Schoharie County",1,55,436,215,221
050,36,095,"New York","Schoharie County",1,56,469,240,229
050,36,095,"New York","Schoharie County",1,57,470,225,245
050,36,095,"New York","Schoharie County",1,58,491,238,253
050,36,095,"New York","Schoharie County",1,59,493,251,242
050,36,095,"New York","Schoharie County",1,60,483,231,252
050,36,095,"New York","Schoharie County",1,61,477,243,234
050,36,095,"New York","Schoharie County",1,62,478,247,231
050,36,095,"New York","Schoharie County",1,63,471,228,243
050,36,095,"New York","Schoharie County",1,64,455,233,222
050,36,095,"New York","Schoharie County",1,65,460,234,226
050,36,095,"New York","Schoharie County",1,66,461,230,231
050,36,095,"New York","Schoharie County",1,67,433,209,224
050,36,095,"New York","Schoharie County",1,68,436,218,218
050,36,095,"New York","Schoharie County",1,69,399,185,214
050,36,095,"New York","Schoharie County",1,70,391,193,198
050,36,095,"New York","Schoharie County",1,71,404,198,206
050,36,095,"New York","Schoharie County",1,72,404,208,196
050,36,095,"New York","Schoharie County",1,73,393,205,188
050,36,095,"New York","Schoharie County",1,74,268,136,132
050,36,095,"New York","Schoharie County",1,75,270,133,137
050,36,095,"New York","Schoharie County",1,76,299,149,150
050,36,095,"New York","Schoharie County",1,77,281,133,148
050,36,095,"New York","Schoharie County",1,78,220,107,113
050,36,095,"New York","Schoharie County",1,79,201,108,93
050,36,095,"New York","Schoharie County",1,80,170,90,80
050,36,095,"New York","Schoharie County",1,81,153,70,83
050,36,095,"New York","Schoharie County",1,82,143,70,73
050,36,095,"New York","Schoharie County",1,83,132,66,66
050,36,095,"New York","Schoharie County",1,84,124,58,66
050,36,095,"New York","Schoharie County",1,85,691,288,403
050,36,095,"New York","Schoharie County",2,0,253,128,125
050,36,095,"New York","Schoharie County",2,1,253,126,127
050,36,095,"New York","Schoharie County",2,2,272,130,142
050,36,095,"New York","Schoharie County",2,3,259,129,130
050,36,095,"New York","Schoharie County",2,4,262,134,128
050,36,095,"New York","Schoharie County",2,5,255,139,116
050,36,095,"New York","Schoharie County",2,6,272,140,132
050,36,095,"New York","Schoharie County",2,7,277,137,140
050,36,095,"New York","Schoharie County",2,8,289,155,134
050,36,095,"New York","Schoharie County",2,9,309,163,146
050,36,095,"New York","Schoharie County",2,10,325,165,160
050,36,095,"New York","Schoharie County",2,11,324,160,164
050,36,095,"New York","Schoharie County",2,12,323,173,150
050,36,095,"New York","Schoharie County",2,13,297,164,133
050,36,095,"New York","Schoharie County",2,14,304,159,145
050,36,095,"New York","Schoharie County",2,15,330,168,162
050,36,095,"New York","Schoharie County",2,16,337,172,165
050,36,095,"New York","Schoharie County",2,17,333,169,164
050,36,095,"New York","Schoharie County",2,18,525,258,267
050,36,095,"New York","Schoharie County",2,19,611,300,311
050,36,095,"New York","Schoharie County",2,20,494,247,247
050,36,095,"New York","Schoharie County",2,21,391,201,190
050,36,095,"New York","Schoharie County",2,22,342,183,159
050,36,095,"New York","Schoharie County",2,23,320,166,154
050,36,095,"New York","Schoharie County",2,24,315,162,153
050,36,095,"New York","Schoharie County",2,25,312,156,156
050,36,095,"New York","Schoharie County",2,26,310,153,157
050,36,095,"New York","Schoharie County",2,27,307,152,155
050,36,095,"New York","Schoharie County",2,28,311,156,155
050,36,095,"New York","Schoharie County",2,29,314,162,152
050,36,095,"New York","Schoharie County",2,30,316,160,156
050,36,095,"New York","Schoharie County",2,31,312,164,148
050,36,095,"New York","Schoharie County",2,32,307,154,153
050,36,095,"New York","Schoharie County",2,33,314,165,149
050,36,095,"New York","Schoharie County",2,34,314,163,151
050,36,095,"New York","Schoharie County",2,35,310,158,152
050,36,095,"New York","Schoharie County",2,36,325,171,154
050,36,095,"New York","Schoharie County",2,37,348,173,175
050,36,095,"New York","Schoharie County",2,38,322,156,166
050,36,095,"New York","Schoharie County",2,39,316,161,155
050,36,095,"New York","Schoharie County",2,40,315,176,139
050,36,095,"New York","Schoharie County",2,41,310,165,145
050,36,095,"New York","Schoharie County",2,42,298,145,153
050,36,095,"New York","Schoharie County",2,43,304,150,154
050,36,095,"New York","Schoharie County",2,44,318,152,166
050,36,095,"New York","Schoharie County",2,45,307,149,158
050,36,095,"New York","Schoharie County",2,46,309,159,150
050,36,095,"New York","Schoharie County",2,47,330,167,163
050,36,095,"New York","Schoharie County",2,48,343,172,171
050,36,095,"New York","Schoharie County",2,49,386,200,186
050,36,095,"New York","Schoharie County",2,50,390,206,184
050,36,095,"New York","Schoharie County",2,51,383,200,183
050,36,095,"New York","Schoharie County",2,52,392,197,195
050,36,095,"New York","Schoharie County",2,53,417,209,208
050,36,095,"New York","Schoharie County",2,54,429,220,209
050,36,095,"New York","Schoharie County",2,55,436,219,217
050,36,095,"New York","Schoharie County",2,56,461,235,226
050,36,095,"New York","Schoharie County",2,57,470,229,241
050,36,095,"New York","Schoharie County",2,58,481,233,248
050,36,095,"New York","Schoharie County",2,59,492,248,244
050,36,095,"New York","Schoharie County",2,60,484,236,248
050,36,095,"New York","Schoharie County",2,61,477,239,238
050,36,095,"New York","Schoharie County",2,62,479,246,233
050,36,095,"New York","Schoharie County",2,63,476,235,241
050,36,095,"New York","Schoharie County",2,64,454,229,225
050,36,095,"New York","Schoharie County",2,65,460,234,226
050,36,095,"New York","Schoharie County",2,66,463,234,229
050,36,095,"New York","Schoharie County",2,67,442,216,226
050,36,095,"New York","Schoharie County",2,68,433,215,218
050,36,095,"New York","Schoharie County",2,69,413,195,218
050,36,095,"New York","Schoharie County",2,70,391,190,201
050,36,095,"New York","Schoharie County",2,71,403,198,205
050,36,095,"New York","Schoharie County",2,72,395,200,195
050,36,095,"New York","Schoharie County",2,73,413,216,197
050,36,095,"New York","Schoharie County",2,74,279,142,137
050,36,095,"New York","Schoharie County",2,75,270,133,137
050,36,095,"New York","Schoharie County",2,76,287,144,143
050,36,095,"New York","Schoharie County",2,77,291,139,152
050,36,095,"New York","Schoharie County",2,78,228,109,119
050,36,095,"New York","Schoharie County",2,79,203,107,96
050,36,095,"New York","Schoharie County",2,80,178,96,82
050,36,095,"New York","Schoharie County",2,81,156,73,83
050,36,095,"New York","Schoharie County",2,82,142,68,74
050,36,095,"New York","Schoharie County",2,83,133,66,67
050,36,095,"New York","Schoharie County",2,84,123,58,65
050,36,095,"New York","Schoharie County",2,85,699,290,409
050,36,095,"New York","Schoharie County",3,0,257,132,125
050,36,095,"New York","Schoharie County",3,1,256,130,126
050,36,095,"New York","Schoharie County",3,2,260,134,126
050,36,095,"New York","Schoharie County",3,3,278,130,148
050,36,095,"New York","Schoharie County",3,4,270,142,128
050,36,095,"New York","Schoharie County",3,5,264,134,130
050,36,095,"New York","Schoharie County",3,6,261,136,125
050,36,095,"New York","Schoharie County",3,7,282,148,134
050,36,095,"New York","Schoharie County",3,8,294,146,148
050,36,095,"New York","Schoharie County",3,9,293,155,138
050,36,095,"New York","Schoharie County",3,10,317,168,149
050,36,095,"New York","Schoharie County",3,11,326,168,158
050,36,095,"New York","Schoharie County",3,12,319,162,157
050,36,095,"New York","Schoharie County",3,13,334,184,150
050,36,095,"New York","Schoharie County",3,14,294,154,140
050,36,095,"New York","Schoharie County",3,15,308,163,145
050,36,095,"New York","Schoharie County",3,16,322,160,162
050,36,095,"New York","Schoharie County",3,17,339,168,171
050,36,095,"New York","Schoharie County",3,18,570,282,288
050,36,095,"New York","Schoharie County",3,19,664,325,339
050,36,095,"New York","Schoharie County",3,20,524,261,263
050,36,095,"New York","Schoharie County",3,21,423,214,209
050,36,095,"New York","Schoharie County",3,22,351,188,163
050,36,095,"New York","Schoharie County",3,23,328,172,156
050,36,095,"New York","Schoharie County",3,24,317,168,149
050,36,095,"New York","Schoharie County",3,25,298,152,146
050,36,095,"New York","Schoharie County",3,26,318,164,154
050,36,095,"New York","Schoharie County",3,27,315,151,164
050,36,095,"New York","Schoharie County",3,28,313,154,159
050,36,095,"New York","Schoharie County",3,29,313,156,157
050,36,095,"New York","Schoharie County",3,30,323,159,164
050,36,095,"New York","Schoharie County",3,31,328,171,157
050,36,095,"New York","Schoharie County",3,32,331,174,157
050,36,095,"New York","Schoharie County",3,33,313,154,159
050,36,095,"New York","Schoharie County",3,34,317,168,149
050,36,095,"New York","Schoharie County",3,35,337,179,158
050,36,095,"New York","Schoharie County",3,36,318,169,149
050,36,095,"New York","Schoharie County",3,37,333,172,161
050,36,095,"New York","Schoharie County",3,38,346,169,177
050,36,095,"New York","Schoharie County",3,39,341,169,172
050,36,095,"New York","Schoharie County",3,40,319,160,159
050,36,095,"New York","Schoharie County",3,41,318,175,143
050,36,095,"New York","Schoharie County",3,42,313,169,144
050,36,095,"New York","Schoharie County",3,43,305,147,158
050,36,095,"New York","Schoharie County",3,44,314,152,162
050,36,095,"New York","Schoharie County",3,45,322,154,168
050,36,095,"New York","Schoharie County",3,46,303,148,155
050,36,095,"New York","Schoharie County",3,47,319,169,150
050,36,095,"New York","Schoharie County",3,48,327,170,157
050,36,095,"New York","Schoharie County",3,49,333,168,165
050,36,095,"New York","Schoharie County",3,50,379,192,187
050,36,095,"New York","Schoharie County",3,51,385,203,182
050,36,095,"New York","Schoharie County",3,52,392,205,187
050,36,095,"New York","Schoharie County",3,53,388,198,190
050,36,095,"New York","Schoharie County",3,54,427,216,211
050,36,095,"New York","Schoharie County",3,55,434,220,214
050,36,095,"New York","Schoharie County",3,56,442,226,216
050,36,095,"New York","Schoharie County",3,57,464,237,227
050,36,095,"New York","Schoharie County",3,58,472,231,241
050,36,095,"New York","Schoharie County",3,59,470,226,244
050,36,095,"New York","Schoharie County",3,60,491,255,236
050,36,095,"New York","Schoharie County",3,61,494,239,255
050,36,095,"New York","Schoharie County",3,62,483,249,234
050,36,095,"New York","Schoharie County",3,63,482,248,234
050,36,095,"New York","Schoharie County",3,64,484,238,246
050,36,095,"New York","Schoharie County",3,65,448,228,220
050,36,095,"New York","Schoharie County",3,66,460,238,222
050,36,095,"New York","Schoharie County",3,67,467,231,236
050,36,095,"New York","Schoharie County",3,68,440,215,225
050,36,095,"New York","Schoharie County",3,69,422,205,217
050,36,095,"New York","Schoharie County",3,70,403,187,216
050,36,095,"New York","Schoharie County",3,71,390,189,201
050,36,095,"New York","Schoharie County",3,72,392,195,197
050,36,095,"New York","Schoharie County",3,73,381,190,191
050,36,095,"New York","Schoharie County",3,74,404,209,195
050,36,095,"New York","Schoharie County",3,75,276,138,138
050,36,095,"New York","Schoharie County",3,76,254,127,127
050,36,095,"New York","Schoharie County",3,77,280,136,144
050,36,095,"New York","Schoharie County",3,78,280,137,143
050,36,095,"New York","Schoharie County",3,79,212,102,110
050,36,095,"New York","Schoharie County",3,80,201,106,95
050,36,095,"New York","Schoharie County",3,81,177,96,81
050,36,095,"New York","Schoharie County",3,82,142,62,80
050,36,095,"New York","Schoharie County",3,83,132,63,69
050,36,095,"New York","Schoharie County",3,84,122,59,63
050,36,095,"New York","Schoharie County",3,85,694,297,397
050,36,095,"New York","Schoharie County",4,0,265,123,142
050,36,095,"New York","Schoharie County",4,1,271,138,133
050,36,095,"New York","Schoharie County",4,2,266,138,128
050,36,095,"New York","Schoharie County",4,3,254,132,122
050,36,095,"New York","Schoharie County",4,4,290,137,153
050,36,095,"New York","Schoharie County",4,5,285,148,137
050,36,095,"New York","Schoharie County",4,6,273,138,135
050,36,095,"New York","Schoharie County",4,7,277,141,136
050,36,095,"New York","Schoharie County",4,8,272,141,131
050,36,095,"New York","Schoharie County",4,9,290,148,142
050,36,095,"New York","Schoharie County",4,10,289,153,136
050,36,095,"New York","Schoharie County",4,11,308,160,148
050,36,095,"New York","Schoharie County",4,12,322,168,154
050,36,095,"New York","Schoharie County",4,13,321,157,164
050,36,095,"New York","Schoharie County",4,14,320,177,143
050,36,095,"New York","Schoharie County",4,15,292,154,138
050,36,095,"New York","Schoharie County",4,16,296,154,142
050,36,095,"New York","Schoharie County",4,17,320,165,155
050,36,095,"New York","Schoharie County",4,18,582,294,288
050,36,095,"New York","Schoharie County",4,19,683,332,351
050,36,095,"New York","Schoharie County",4,20,518,258,260
050,36,095,"New York","Schoharie County",4,21,422,210,212
050,36,095,"New York","Schoharie County",4,22,362,194,168
050,36,095,"New York","Schoharie County",4,23,328,168,160
050,36,095,"New York","Schoharie County",4,24,312,164,148
050,36,095,"New York","Schoharie County",4,25,285,153,132
050,36,095,"New York","Schoharie County",4,26,315,153,162
050,36,095,"New York","Schoharie County",4,27,315,166,149
050,36,095,"New York","Schoharie County",4,28,320,157,163
050,36,095,"New York","Schoharie County",4,29,320,163,157
050,36,095,"New York","Schoharie County",4,30,319,161,158
050,36,095,"New York","Schoharie County",4,31,320,157,163
050,36,095,"New York","Schoharie County",4,32,339,175,164
050,36,095,"New York","Schoharie County",4,33,328,167,161
050,36,095,"New York","Schoharie County",4,34,330,166,164
050,36,095,"New York","Schoharie County",4,35,317,165,152
050,36,095,"New York","Schoharie County",4,36,329,179,150
050,36,095,"New York","Schoharie County",4,37,335,180,155
050,36,095,"New York","Schoharie County",4,38,351,192,159
050,36,095,"New York","Schoharie County",4,39,356,170,186
050,36,095,"New York","Schoharie County",4,40,344,169,175
050,36,095,"New York","Schoharie County",4,41,328,163,165
050,36,095,"New York","Schoharie County",4,42,321,172,149
050,36,095,"New York","Schoharie County",4,43,320,174,146
050,36,095,"New York","Schoharie County",4,44,297,140,157
050,36,095,"New York","Schoharie County",4,45,309,152,157
050,36,095,"New York","Schoharie County",4,46,322,153,169
050,36,095,"New York","Schoharie County",4,47,309,152,157
050,36,095,"New York","Schoharie County",4,48,317,165,152
050,36,095,"New York","Schoharie County",4,49,325,168,157
050,36,095,"New York","Schoharie County",4,50,332,166,166
050,36,095,"New York","Schoharie County",4,51,377,193,184
050,36,095,"New York","Schoharie County",4,52,378,199,179
050,36,095,"New York","Schoharie County",4,53,392,201,191
050,36,095,"New York","Schoharie County",4,54,379,190,189
050,36,095,"New York","Schoharie County",4,55,425,213,212
050,36,095,"New York","Schoharie County",4,56,427,214,213
050,36,095,"New York","Schoharie County",4,57,426,223,203
050,36,095,"New York","Schoharie County",4,58,456,236,220
050,36,095,"New York","Schoharie County",4,59,453,220,233
050,36,095,"New York","Schoharie County",4,60,466,226,240
050,36,095,"New York","Schoharie County",4,61,494,253,241
050,36,095,"New York","Schoharie County",4,62,472,226,246
050,36,095,"New York","Schoharie County",4,63,489,254,235
050,36,095,"New York","Schoharie County",4,64,478,240,238
050,36,095,"New York","Schoharie County",4,65,487,239,248
050,36,095,"New York","Schoharie County",4,66,443,221,222
050,36,095,"New York","Schoharie County",4,67,468,236,232
050,36,095,"New York","Schoharie County",4,68,459,222,237
050,36,095,"New York","Schoharie County",4,69,436,214,222
050,36,095,"New York","Schoharie County",4,70,405,193,212
050,36,095,"New York","Schoharie County",4,71,398,185,213
050,36,095,"New York","Schoharie County",4,72,382,183,199
050,36,095,"New York","Schoharie County",4,73,375,185,190
050,36,095,"New York","Schoharie County",4,74,356,171,185
050,36,095,"New York","Schoharie County",4,75,397,208,189
050,36,095,"New York","Schoharie County",4,76,259,128,131
050,36,095,"New York","Schoharie County",4,77,243,119,124
050,36,095,"New York","Schoharie County",4,78,275,131,144
050,36,095,"New York","Schoharie County",4,79,275,131,144
050,36,095,"New York","Schoharie County",4,80,208,102,106
050,36,095,"New York","Schoharie County",4,81,192,99,93
050,36,095,"New York","Schoharie County",4,82,165,87,78
050,36,095,"New York","Schoharie County",4,83,128,60,68
050,36,095,"New York","Schoharie County",4,84,122,55,67
050,36,095,"New York","Schoharie County",4,85,685,306,379
050,36,095,"New York","Schoharie County",5,0,265,123,142
050,36,095,"New York","Schoharie County",5,1,268,126,142
050,36,095,"New York","Schoharie County",5,2,268,135,133
050,36,095,"New York","Schoharie County",5,3,269,133,136
050,36,095,"New York","Schoharie County",5,4,258,133,125
050,36,095,"New York","Schoharie County",5,5,292,152,140
050,36,095,"New York","Schoharie County",5,6,293,150,143
050,36,095,"New York","Schoharie County",5,7,281,141,140
050,36,095,"New York","Schoharie County",5,8,274,146,128
050,36,095,"New York","Schoharie County",5,9,274,137,137
050,36,095,"New York","Schoharie County",5,10,284,147,137
050,36,095,"New York","Schoharie County",5,11,296,157,139
050,36,095,"New York","Schoharie County",5,12,304,154,150
050,36,095,"New York","Schoharie County",5,13,315,166,149
050,36,095,"New York","Schoharie County",5,14,319,152,167
050,36,095,"New York","Schoharie County",5,15,323,183,140
050,36,095,"New York","Schoharie County",5,16,299,160,139
050,36,095,"New York","Schoharie County",5,17,304,154,150
050,36,095,"New York","Schoharie County",5,18,569,283,286
050,36,095,"New York","Schoharie County",5,19,682,344,338
050,36,095,"New York","Schoharie County",5,20,509,254,255
050,36,095,"New York","Schoharie County",5,21,401,197,204
050,36,095,"New York","Schoharie County",5,22,333,175,158
050,36,095,"New York","Schoharie County",5,23,335,174,161
050,36,095,"New York","Schoharie County",5,24,324,162,162
050,36,095,"New York","Schoharie County",5,25,276,145,131
050,36,095,"New York","Schoharie County",5,26,298,158,140
050,36,095,"New York","Schoharie County",5,27,311,153,158
050,36,095,"New York","Schoharie County",5,28,312,164,148
050,36,095,"New York","Schoharie County",5,29,323,160,163
050,36,095,"New York","Schoharie County",5,30,327,169,158
050,36,095,"New York","Schoharie County",5,31,335,163,172
050,36,095,"New York","Schoharie County",5,32,321,160,161
050,36,095,"New York","Schoharie County",5,33,342,176,166
050,36,095,"New York","Schoharie County",5,34,322,165,157
050,36,095,"New York","Schoharie County",5,35,334,167,167
050,36,095,"New York","Schoharie County",5,36,321,168,153
050,36,095,"New York","Schoharie County",5,37,337,184,153
050,36,095,"New York","Schoharie County",5,38,335,178,157
050,36,095,"New York","Schoharie County",5,39,351,200,151
050,36,095,"New York","Schoharie County",5,40,358,171,187
050,36,095,"New York","Schoharie County",5,41,335,159,176
050,36,095,"New York","Schoharie County",5,42,322,160,162
050,36,095,"New York","Schoharie County",5,43,326,182,144
050,36,095,"New York","Schoharie County",5,44,324,176,148
050,36,095,"New York","Schoharie County",5,45,305,144,161
050,36,095,"New York","Schoharie County",5,46,306,147,159
050,36,095,"New York","Schoharie County",5,47,331,159,172
050,36,095,"New York","Schoharie County",5,48,308,151,157
050,36,095,"New York","Schoharie County",5,49,314,164,150
050,36,095,"New York","Schoharie County",5,50,326,165,161
050,36,095,"New York","Schoharie County",5,51,323,159,164
050,36,095,"New York","Schoharie County",5,52,375,197,178
050,36,095,"New York","Schoharie County",5,53,377,195,182
050,36,095,"New York","Schoharie County",5,54,392,201,191
050,36,095,"New York","Schoharie County",5,55,369,187,182
050,36,095,"New York","Schoharie County",5,56,426,211,215
050,36,095,"New York","Schoharie County",5,57,423,212,211
050,36,095,"New York","Schoharie County",5,58,427,219,208
050,36,095,"New York","Schoharie County",5,59,462,241,221
050,36,095,"New York","Schoharie County",5,60,445,215,230
050,36,095,"New York","Schoharie County",5,61,456,224,232
050,36,095,"New York","Schoharie County",5,62,482,242,240
050,36,095,"New York","Schoharie County",5,63,483,229,254
050,36,095,"New York","Schoharie County",5,64,488,252,236
050,36,095,"New York","Schoharie County",5,65,475,236,239
050,36,095,"New York","Schoharie County",5,66,491,243,248
050,36,095,"New York","Schoharie County",5,67,448,222,226
050,36,095,"New York","Schoharie County",5,68,465,237,228
050,36,095,"New York","Schoharie County",5,69,452,221,231
050,36,095,"New York","Schoharie County",5,70,430,212,218
050,36,095,"New York","Schoharie County",5,71,415,199,216
050,36,095,"New York","Schoharie County",5,72,395,183,212
050,36,095,"New York","Schoharie County",5,73,378,182,196
050,36,095,"New York","Schoharie County",5,74,366,180,186
050,36,095,"New York","Schoharie County",5,75,354,169,185
050,36,095,"New York","Schoharie County",5,76,379,201,178
050,36,095,"New York","Schoharie County",5,77,255,124,131
050,36,095,"New York","Schoharie County",5,78,240,119,121
050,36,095,"New York","Schoharie County",5,79,273,132,141
050,36,095,"New York","Schoharie County",5,80,258,123,135
050,36,095,"New York","Schoharie County",5,81,201,102,99
050,36,095,"New York","Schoharie County",5,82,184,94,90
050,36,095,"New York","Schoharie County",5,83,158,84,74
050,36,095,"New York","Schoharie County",5,84,120,55,65
050,36,095,"New York","Schoharie County",5,85,701,320,381
050,36,097,"New York","Schuyler County",1,0,174,90,84
050,36,097,"New York","Schuyler County",1,1,178,89,89
050,36,097,"New York","Schuyler County",1,2,141,74,67
050,36,097,"New York","Schuyler County",1,3,176,93,83
050,36,097,"New York","Schuyler County",1,4,200,111,89
050,36,097,"New York","Schuyler County",1,5,195,102,93
050,36,097,"New York","Schuyler County",1,6,190,99,91
050,36,097,"New York","Schuyler County",1,7,176,85,91
050,36,097,"New York","Schuyler County",1,8,187,90,97
050,36,097,"New York","Schuyler County",1,9,200,102,98
050,36,097,"New York","Schuyler County",1,10,189,101,88
050,36,097,"New York","Schuyler County",1,11,204,101,103
050,36,097,"New York","Schuyler County",1,12,202,103,99
050,36,097,"New York","Schuyler County",1,13,192,96,96
050,36,097,"New York","Schuyler County",1,14,193,95,98
050,36,097,"New York","Schuyler County",1,15,201,112,89
050,36,097,"New York","Schuyler County",1,16,198,111,87
050,36,097,"New York","Schuyler County",1,17,195,105,90
050,36,097,"New York","Schuyler County",1,18,181,90,91
050,36,097,"New York","Schuyler County",1,19,153,78,75
050,36,097,"New York","Schuyler County",1,20,161,84,77
050,36,097,"New York","Schuyler County",1,21,163,85,78
050,36,097,"New York","Schuyler County",1,22,166,76,90
050,36,097,"New York","Schuyler County",1,23,167,85,82
050,36,097,"New York","Schuyler County",1,24,167,81,86
050,36,097,"New York","Schuyler County",1,25,203,106,97
050,36,097,"New York","Schuyler County",1,26,197,110,87
050,36,097,"New York","Schuyler County",1,27,194,99,95
050,36,097,"New York","Schuyler County",1,28,198,105,93
050,36,097,"New York","Schuyler County",1,29,192,99,93
050,36,097,"New York","Schuyler County",1,30,204,111,93
050,36,097,"New York","Schuyler County",1,31,197,97,100
050,36,097,"New York","Schuyler County",1,32,192,100,92
050,36,097,"New York","Schuyler County",1,33,186,84,102
050,36,097,"New York","Schuyler County",1,34,203,101,102
050,36,097,"New York","Schuyler County",1,35,193,101,92
050,36,097,"New York","Schuyler County",1,36,213,106,107
050,36,097,"New York","Schuyler County",1,37,215,96,119
050,36,097,"New York","Schuyler County",1,38,209,96,113
050,36,097,"New York","Schuyler County",1,39,202,99,103
050,36,097,"New York","Schuyler County",1,40,199,94,105
050,36,097,"New York","Schuyler County",1,41,208,95,113
050,36,097,"New York","Schuyler County",1,42,199,99,100
050,36,097,"New York","Schuyler County",1,43,211,103,108
050,36,097,"New York","Schuyler County",1,44,202,99,103
050,36,097,"New York","Schuyler County",1,45,203,99,104
050,36,097,"New York","Schuyler County",1,46,196,95,101
050,36,097,"New York","Schuyler County",1,47,192,100,92
050,36,097,"New York","Schuyler County",1,48,227,119,108
050,36,097,"New York","Schuyler County",1,49,267,145,122
050,36,097,"New York","Schuyler County",1,50,278,142,136
050,36,097,"New York","Schuyler County",1,51,253,130,123
050,36,097,"New York","Schuyler County",1,52,250,131,119
050,36,097,"New York","Schuyler County",1,53,278,149,129
050,36,097,"New York","Schuyler County",1,54,259,140,119
050,36,097,"New York","Schuyler County",1,55,297,158,139
050,36,097,"New York","Schuyler County",1,56,287,145,142
050,36,097,"New York","Schuyler County",1,57,289,137,152
050,36,097,"New York","Schuyler County",1,58,294,142,152
050,36,097,"New York","Schuyler County",1,59,318,161,157
050,36,097,"New York","Schuyler County",1,60,303,159,144
050,36,097,"New York","Schuyler County",1,61,308,149,159
050,36,097,"New York","Schuyler County",1,62,313,157,156
050,36,097,"New York","Schuyler County",1,63,311,162,149
050,36,097,"New York","Schuyler County",1,64,293,140,153
050,36,097,"New York","Schuyler County",1,65,294,148,146
050,36,097,"New York","Schuyler County",1,66,271,135,136
050,36,097,"New York","Schuyler County",1,67,280,153,127
050,36,097,"New York","Schuyler County",1,68,269,136,133
050,36,097,"New York","Schuyler County",1,69,262,128,134
050,36,097,"New York","Schuyler County",1,70,241,129,112
050,36,097,"New York","Schuyler County",1,71,233,119,114
050,36,097,"New York","Schuyler County",1,72,228,114,114
050,36,097,"New York","Schuyler County",1,73,212,104,108
050,36,097,"New York","Schuyler County",1,74,138,65,73
050,36,097,"New York","Schuyler County",1,75,147,69,78
050,36,097,"New York","Schuyler County",1,76,161,80,81
050,36,097,"New York","Schuyler County",1,77,134,66,68
050,36,097,"New York","Schuyler County",1,78,124,64,60
050,36,097,"New York","Schuyler County",1,79,119,63,56
050,36,097,"New York","Schuyler County",1,80,96,46,50
050,36,097,"New York","Schuyler County",1,81,80,37,43
050,36,097,"New York","Schuyler County",1,82,80,40,40
050,36,097,"New York","Schuyler County",1,83,63,32,31
050,36,097,"New York","Schuyler County",1,84,73,31,42
050,36,097,"New York","Schuyler County",1,85,407,132,275
050,36,097,"New York","Schuyler County",2,0,172,81,91
050,36,097,"New York","Schuyler County",2,1,175,88,87
050,36,097,"New York","Schuyler County",2,2,150,79,71
050,36,097,"New York","Schuyler County",2,3,169,90,79
050,36,097,"New York","Schuyler County",2,4,195,107,88
050,36,097,"New York","Schuyler County",2,5,199,106,93
050,36,097,"New York","Schuyler County",2,6,192,100,92
050,36,097,"New York","Schuyler County",2,7,180,89,91
050,36,097,"New York","Schuyler County",2,8,185,90,95
050,36,097,"New York","Schuyler County",2,9,194,99,95
050,36,097,"New York","Schuyler County",2,10,191,101,90
050,36,097,"New York","Schuyler County",2,11,199,100,99
050,36,097,"New York","Schuyler County",2,12,201,102,99
050,36,097,"New York","Schuyler County",2,13,193,97,96
050,36,097,"New York","Schuyler County",2,14,192,95,97
050,36,097,"New York","Schuyler County",2,15,200,109,91
050,36,097,"New York","Schuyler County",2,16,200,111,89
050,36,097,"New York","Schuyler County",2,17,196,105,91
050,36,097,"New York","Schuyler County",2,18,173,90,83
050,36,097,"New York","Schuyler County",2,19,151,77,74
050,36,097,"New York","Schuyler County",2,20,162,85,77
050,36,097,"New York","Schuyler County",2,21,165,86,79
050,36,097,"New York","Schuyler County",2,22,167,79,88
050,36,097,"New York","Schuyler County",2,23,168,84,84
050,36,097,"New York","Schuyler County",2,24,168,82,86
050,36,097,"New York","Schuyler County",2,25,196,102,94
050,36,097,"New York","Schuyler County",2,26,194,107,87
050,36,097,"New York","Schuyler County",2,27,191,101,90
050,36,097,"New York","Schuyler County",2,28,194,101,93
050,36,097,"New York","Schuyler County",2,29,193,100,93
050,36,097,"New York","Schuyler County",2,30,204,109,95
050,36,097,"New York","Schuyler County",2,31,198,100,98
050,36,097,"New York","Schuyler County",2,32,193,100,93
050,36,097,"New York","Schuyler County",2,33,185,86,99
050,36,097,"New York","Schuyler County",2,34,198,97,101
050,36,097,"New York","Schuyler County",2,35,200,103,97
050,36,097,"New York","Schuyler County",2,36,207,105,102
050,36,097,"New York","Schuyler County",2,37,214,98,116
050,36,097,"New York","Schuyler County",2,38,210,97,113
050,36,097,"New York","Schuyler County",2,39,202,98,104
050,36,097,"New York","Schuyler County",2,40,201,96,105
050,36,097,"New York","Schuyler County",2,41,205,94,111
050,36,097,"New York","Schuyler County",2,42,200,99,101
050,36,097,"New York","Schuyler County",2,43,209,103,106
050,36,097,"New York","Schuyler County",2,44,203,99,104
050,36,097,"New York","Schuyler County",2,45,206,101,105
050,36,097,"New York","Schuyler County",2,46,194,94,100
050,36,097,"New York","Schuyler County",2,47,196,100,96
050,36,097,"New York","Schuyler County",2,48,219,115,104
050,36,097,"New York","Schuyler County",2,49,260,142,118
050,36,097,"New York","Schuyler County",2,50,271,139,132
050,36,097,"New York","Schuyler County",2,51,258,133,125
050,36,097,"New York","Schuyler County",2,52,252,132,120
050,36,097,"New York","Schuyler County",2,53,271,145,126
050,36,097,"New York","Schuyler County",2,54,262,141,121
050,36,097,"New York","Schuyler County",2,55,291,155,136
050,36,097,"New York","Schuyler County",2,56,289,148,141
050,36,097,"New York","Schuyler County",2,57,290,139,151
050,36,097,"New York","Schuyler County",2,58,292,141,151
050,36,097,"New York","Schuyler County",2,59,312,155,157
050,36,097,"New York","Schuyler County",2,60,304,157,147
050,36,097,"New York","Schuyler County",2,61,305,150,155
050,36,097,"New York","Schuyler County",2,62,311,156,155
050,36,097,"New York","Schuyler County",2,63,316,162,154
050,36,097,"New York","Schuyler County",2,64,293,142,151
050,36,097,"New York","Schuyler County",2,65,292,145,147
050,36,097,"New York","Schuyler County",2,66,276,137,139
050,36,097,"New York","Schuyler County",2,67,278,150,128
050,36,097,"New York","Schuyler County",2,68,268,137,131
050,36,097,"New York","Schuyler County",2,69,265,130,135
050,36,097,"New York","Schuyler County",2,70,244,127,117
050,36,097,"New York","Schuyler County",2,71,233,121,112
050,36,097,"New York","Schuyler County",2,72,223,111,112
050,36,097,"New York","Schuyler County",2,73,224,111,113
050,36,097,"New York","Schuyler County",2,74,145,69,76
050,36,097,"New York","Schuyler County",2,75,142,67,75
050,36,097,"New York","Schuyler County",2,76,155,77,78
050,36,097,"New York","Schuyler County",2,77,142,70,72
050,36,097,"New York","Schuyler County",2,78,124,63,61
050,36,097,"New York","Schuyler County",2,79,117,62,55
050,36,097,"New York","Schuyler County",2,80,101,50,51
050,36,097,"New York","Schuyler County",2,81,79,37,42
050,36,097,"New York","Schuyler County",2,82,81,40,41
050,36,097,"New York","Schuyler County",2,83,66,34,32
050,36,097,"New York","Schuyler County",2,84,71,31,40
050,36,097,"New York","Schuyler County",2,85,412,134,278
050,36,097,"New York","Schuyler County",3,0,169,89,80
050,36,097,"New York","Schuyler County",3,1,174,82,92
050,36,097,"New York","Schuyler County",3,2,173,86,87
050,36,097,"New York","Schuyler County",3,3,162,78,84
050,36,097,"New York","Schuyler County",3,4,177,92,85
050,36,097,"New York","Schuyler County",3,5,200,106,94
050,36,097,"New York","Schuyler County",3,6,197,101,96
050,36,097,"New York","Schuyler County",3,7,192,107,85
050,36,097,"New York","Schuyler County",3,8,185,91,94
050,36,097,"New York","Schuyler County",3,9,187,96,91
050,36,097,"New York","Schuyler County",3,10,201,105,96
050,36,097,"New York","Schuyler County",3,11,199,105,94
050,36,097,"New York","Schuyler County",3,12,197,102,95
050,36,097,"New York","Schuyler County",3,13,198,100,98
050,36,097,"New York","Schuyler County",3,14,188,97,91
050,36,097,"New York","Schuyler County",3,15,194,98,96
050,36,097,"New York","Schuyler County",3,16,193,105,88
050,36,097,"New York","Schuyler County",3,17,201,105,96
050,36,097,"New York","Schuyler County",3,18,164,89,75
050,36,097,"New York","Schuyler County",3,19,139,74,65
050,36,097,"New York","Schuyler County",3,20,163,82,81
050,36,097,"New York","Schuyler County",3,21,167,90,77
050,36,097,"New York","Schuyler County",3,22,157,79,78
050,36,097,"New York","Schuyler County",3,23,172,91,81
050,36,097,"New York","Schuyler County",3,24,173,83,90
050,36,097,"New York","Schuyler County",3,25,178,94,84
050,36,097,"New York","Schuyler County",3,26,178,86,92
050,36,097,"New York","Schuyler County",3,27,189,111,78
050,36,097,"New York","Schuyler County",3,28,195,104,91
050,36,097,"New York","Schuyler County",3,29,186,99,87
050,36,097,"New York","Schuyler County",3,30,194,97,97
050,36,097,"New York","Schuyler County",3,31,203,101,102
050,36,097,"New York","Schuyler County",3,32,215,116,99
050,36,097,"New York","Schuyler County",3,33,195,93,102
050,36,097,"New York","Schuyler County",3,34,191,89,102
050,36,097,"New York","Schuyler County",3,35,194,96,98
050,36,097,"New York","Schuyler County",3,36,208,106,102
050,36,097,"New York","Schuyler County",3,37,211,108,103
050,36,097,"New York","Schuyler County",3,38,208,99,109
050,36,097,"New York","Schuyler County",3,39,211,102,109
050,36,097,"New York","Schuyler County",3,40,206,102,104
050,36,097,"New York","Schuyler County",3,41,196,86,110
050,36,097,"New York","Schuyler County",3,42,205,102,103
050,36,097,"New York","Schuyler County",3,43,201,94,107
050,36,097,"New York","Schuyler County",3,44,206,95,111
050,36,097,"New York","Schuyler County",3,45,202,101,101
050,36,097,"New York","Schuyler County",3,46,197,98,99
050,36,097,"New York","Schuyler County",3,47,197,93,104
050,36,097,"New York","Schuyler County",3,48,193,97,96
050,36,097,"New York","Schuyler County",3,49,230,124,106
050,36,097,"New York","Schuyler County",3,50,246,135,111
050,36,097,"New York","Schuyler County",3,51,279,145,134
050,36,097,"New York","Schuyler County",3,52,261,131,130
050,36,097,"New York","Schuyler County",3,53,249,130,119
050,36,097,"New York","Schuyler County",3,54,264,137,127
050,36,097,"New York","Schuyler County",3,55,271,147,124
050,36,097,"New York","Schuyler County",3,56,295,155,140
050,36,097,"New York","Schuyler County",3,57,290,150,140
050,36,097,"New York","Schuyler County",3,58,278,139,139
050,36,097,"New York","Schuyler County",3,59,291,139,152
050,36,097,"New York","Schuyler County",3,60,314,153,161
050,36,097,"New York","Schuyler County",3,61,299,151,148
050,36,097,"New York","Schuyler County",3,62,314,158,156
050,36,097,"New York","Schuyler County",3,63,316,160,156
050,36,097,"New York","Schuyler County",3,64,305,155,150
050,36,097,"New York","Schuyler County",3,65,287,138,149
050,36,097,"New York","Schuyler County",3,66,294,141,153
050,36,097,"New York","Schuyler County",3,67,271,136,135
050,36,097,"New York","Schuyler County",3,68,266,143,123
050,36,097,"New York","Schuyler County",3,69,260,133,127
050,36,097,"New York","Schuyler County",3,70,261,128,133
050,36,097,"New York","Schuyler County",3,71,242,126,116
050,36,097,"New York","Schuyler County",3,72,222,113,109
050,36,097,"New York","Schuyler County",3,73,213,107,106
050,36,097,"New York","Schuyler County",3,74,215,103,112
050,36,097,"New York","Schuyler County",3,75,141,67,74
050,36,097,"New York","Schuyler County",3,76,133,64,69
050,36,097,"New York","Schuyler County",3,77,148,75,73
050,36,097,"New York","Schuyler County",3,78,135,68,67
050,36,097,"New York","Schuyler County",3,79,120,62,58
050,36,097,"New York","Schuyler County",3,80,106,54,52
050,36,097,"New York","Schuyler County",3,81,94,46,48
050,36,097,"New York","Schuyler County",3,82,68,32,36
050,36,097,"New York","Schuyler County",3,83,70,35,35
050,36,097,"New York","Schuyler County",3,84,59,27,32
050,36,097,"New York","Schuyler County",3,85,401,135,266
050,36,097,"New York","Schuyler County",4,0,174,94,80
050,36,097,"New York","Schuyler County",4,1,177,89,88
050,36,097,"New York","Schuyler County",4,2,180,88,92
050,36,097,"New York","Schuyler County",4,3,178,87,91
050,36,097,"New York","Schuyler County",4,4,160,81,79
050,36,097,"New York","Schuyler County",4,5,181,96,85
050,36,097,"New York","Schuyler County",4,6,194,99,95
050,36,097,"New York","Schuyler County",4,7,200,100,100
050,36,097,"New York","Schuyler County",4,8,185,98,87
050,36,097,"New York","Schuyler County",4,9,186,91,95
050,36,097,"New York","Schuyler County",4,10,186,89,97
050,36,097,"New York","Schuyler County",4,11,187,97,90
050,36,097,"New York","Schuyler County",4,12,191,97,94
050,36,097,"New York","Schuyler County",4,13,193,99,94
050,36,097,"New York","Schuyler County",4,14,202,103,99
050,36,097,"New York","Schuyler County",4,15,186,99,87
050,36,097,"New York","Schuyler County",4,16,193,96,97
050,36,097,"New York","Schuyler County",4,17,191,100,91
050,36,097,"New York","Schuyler County",4,18,166,92,74
050,36,097,"New York","Schuyler County",4,19,119,66,53
050,36,097,"New York","Schuyler County",4,20,149,81,68
050,36,097,"New York","Schuyler County",4,21,167,91,76
050,36,097,"New York","Schuyler County",4,22,169,89,80
050,36,097,"New York","Schuyler County",4,23,156,73,83
050,36,097,"New York","Schuyler County",4,24,168,87,81
050,36,097,"New York","Schuyler County",4,25,179,94,85
050,36,097,"New York","Schuyler County",4,26,165,81,84
050,36,097,"New York","Schuyler County",4,27,173,88,85
050,36,097,"New York","Schuyler County",4,28,197,112,85
050,36,097,"New York","Schuyler County",4,29,207,104,103
050,36,097,"New York","Schuyler County",4,30,191,105,86
050,36,097,"New York","Schuyler County",4,31,195,95,100
050,36,097,"New York","Schuyler County",4,32,203,106,97
050,36,097,"New York","Schuyler County",4,33,201,99,102
050,36,097,"New York","Schuyler County",4,34,194,99,95
050,36,097,"New York","Schuyler County",4,35,188,90,98
050,36,097,"New York","Schuyler County",4,36,208,103,105
050,36,097,"New York","Schuyler County",4,37,203,103,100
050,36,097,"New York","Schuyler County",4,38,206,101,105
050,36,097,"New York","Schuyler County",4,39,200,95,105
050,36,097,"New York","Schuyler County",4,40,208,102,106
050,36,097,"New York","Schuyler County",4,41,197,93,104
050,36,097,"New York","Schuyler County",4,42,191,86,105
050,36,097,"New York","Schuyler County",4,43,212,105,107
050,36,097,"New York","Schuyler County",4,44,204,94,110
050,36,097,"New York","Schuyler County",4,45,201,102,99
050,36,097,"New York","Schuyler County",4,46,189,97,92
050,36,097,"New York","Schuyler County",4,47,196,97,99
050,36,097,"New York","Schuyler County",4,48,193,93,100
050,36,097,"New York","Schuyler County",4,49,204,107,97
050,36,097,"New York","Schuyler County",4,50,210,112,98
050,36,097,"New York","Schuyler County",4,51,243,137,106
050,36,097,"New York","Schuyler County",4,52,282,144,138
050,36,097,"New York","Schuyler County",4,53,261,133,128
050,36,097,"New York","Schuyler County",4,54,246,123,123
050,36,097,"New York","Schuyler County",4,55,261,138,123
050,36,097,"New York","Schuyler County",4,56,258,140,118
050,36,097,"New York","Schuyler County",4,57,312,160,152
050,36,097,"New York","Schuyler County",4,58,291,156,135
050,36,097,"New York","Schuyler County",4,59,277,135,142
050,36,097,"New York","Schuyler County",4,60,281,136,145
050,36,097,"New York","Schuyler County",4,61,311,147,164
050,36,097,"New York","Schuyler County",4,62,309,161,148
050,36,097,"New York","Schuyler County",4,63,318,160,158
050,36,097,"New York","Schuyler County",4,64,304,152,152
050,36,097,"New York","Schuyler County",4,65,299,154,145
050,36,097,"New York","Schuyler County",4,66,277,124,153
050,36,097,"New York","Schuyler County",4,67,283,141,142
050,36,097,"New York","Schuyler County",4,68,266,137,129
050,36,097,"New York","Schuyler County",4,69,266,143,123
050,36,097,"New York","Schuyler County",4,70,260,133,127
050,36,097,"New York","Schuyler County",4,71,253,123,130
050,36,097,"New York","Schuyler County",4,72,235,125,110
050,36,097,"New York","Schuyler County",4,73,214,109,105
050,36,097,"New York","Schuyler County",4,74,209,107,102
050,36,097,"New York","Schuyler County",4,75,206,94,112
050,36,097,"New York","Schuyler County",4,76,132,61,71
050,36,097,"New York","Schuyler County",4,77,122,62,60
050,36,097,"New York","Schuyler County",4,78,146,75,71
050,36,097,"New York","Schuyler County",4,79,130,68,62
050,36,097,"New York","Schuyler County",4,80,110,53,57
050,36,097,"New York","Schuyler County",4,81,99,49,50
050,36,097,"New York","Schuyler County",4,82,96,49,47
050,36,097,"New York","Schuyler County",4,83,60,27,33
050,36,097,"New York","Schuyler County",4,84,67,31,36
050,36,097,"New York","Schuyler County",4,85,372,135,237
050,36,097,"New York","Schuyler County",5,0,174,94,80
050,36,097,"New York","Schuyler County",5,1,165,86,79
050,36,097,"New York","Schuyler County",5,2,190,99,91
050,36,097,"New York","Schuyler County",5,3,173,89,84
050,36,097,"New York","Schuyler County",5,4,168,81,87
050,36,097,"New York","Schuyler County",5,5,168,84,84
050,36,097,"New York","Schuyler County",5,6,187,94,93
050,36,097,"New York","Schuyler County",5,7,203,104,99
050,36,097,"New York","Schuyler County",5,8,191,93,98
050,36,097,"New York","Schuyler County",5,9,186,102,84
050,36,097,"New York","Schuyler County",5,10,190,88,102
050,36,097,"New York","Schuyler County",5,11,177,90,87
050,36,097,"New York","Schuyler County",5,12,188,100,88
050,36,097,"New York","Schuyler County",5,13,186,94,92
050,36,097,"New York","Schuyler County",5,14,191,99,92
050,36,097,"New York","Schuyler County",5,15,193,97,96
050,36,097,"New York","Schuyler County",5,16,184,98,86
050,36,097,"New York","Schuyler County",5,17,201,101,100
050,36,097,"New York","Schuyler County",5,18,156,83,73
050,36,097,"New York","Schuyler County",5,19,130,74,56
050,36,097,"New York","Schuyler County",5,20,135,76,59
050,36,097,"New York","Schuyler County",5,21,159,84,75
050,36,097,"New York","Schuyler County",5,22,160,87,73
050,36,097,"New York","Schuyler County",5,23,181,92,89
050,36,097,"New York","Schuyler County",5,24,158,80,78
050,36,097,"New York","Schuyler County",5,25,166,85,81
050,36,097,"New York","Schuyler County",5,26,174,90,84
050,36,097,"New York","Schuyler County",5,27,163,83,80
050,36,097,"New York","Schuyler County",5,28,179,84,95
050,36,097,"New York","Schuyler County",5,29,196,118,78
050,36,097,"New York","Schuyler County",5,30,213,109,104
050,36,097,"New York","Schuyler County",5,31,192,104,88
050,36,097,"New York","Schuyler County",5,32,202,102,100
050,36,097,"New York","Schuyler County",5,33,204,101,103
050,36,097,"New York","Schuyler County",5,34,213,96,117
050,36,097,"New York","Schuyler County",5,35,202,106,96
050,36,097,"New York","Schuyler County",5,36,191,90,101
050,36,097,"New York","Schuyler County",5,37,225,108,117
050,36,097,"New York","Schuyler County",5,38,197,98,99
050,36,097,"New York","Schuyler County",5,39,206,104,102
050,36,097,"New York","Schuyler County",5,40,201,102,99
050,36,097,"New York","Schuyler County",5,41,208,102,106
050,36,097,"New York","Schuyler County",5,42,195,92,103
050,36,097,"New York","Schuyler County",5,43,190,81,109
050,36,097,"New York","Schuyler County",5,44,208,103,105
050,36,097,"New York","Schuyler County",5,45,201,95,106
050,36,097,"New York","Schuyler County",5,46,191,99,92
050,36,097,"New York","Schuyler County",5,47,201,101,100
050,36,097,"New York","Schuyler County",5,48,187,92,95
050,36,097,"New York","Schuyler County",5,49,194,97,97
050,36,097,"New York","Schuyler County",5,50,192,95,97
050,36,097,"New York","Schuyler County",5,51,217,118,99
050,36,097,"New York","Schuyler County",5,52,245,135,110
050,36,097,"New York","Schuyler County",5,53,278,142,136
050,36,097,"New York","Schuyler County",5,54,257,129,128
050,36,097,"New York","Schuyler County",5,55,247,123,124
050,36,097,"New York","Schuyler County",5,56,253,129,124
050,36,097,"New York","Schuyler County",5,57,271,145,126
050,36,097,"New York","Schuyler County",5,58,307,162,145
050,36,097,"New York","Schuyler County",5,59,288,156,132
050,36,097,"New York","Schuyler County",5,60,275,135,140
050,36,097,"New York","Schuyler County",5,61,276,131,145
050,36,097,"New York","Schuyler County",5,62,312,145,167
050,36,097,"New York","Schuyler County",5,63,307,157,150
050,36,097,"New York","Schuyler County",5,64,303,146,157
050,36,097,"New York","Schuyler County",5,65,300,150,150
050,36,097,"New York","Schuyler County",5,66,297,145,152
050,36,097,"New York","Schuyler County",5,67,274,126,148
050,36,097,"New York","Schuyler County",5,68,275,136,139
050,36,097,"New York","Schuyler County",5,69,260,132,128
050,36,097,"New York","Schuyler County",5,70,260,141,119
050,36,097,"New York","Schuyler County",5,71,254,128,126
050,36,097,"New York","Schuyler County",5,72,246,122,124
050,36,097,"New York","Schuyler County",5,73,230,124,106
050,36,097,"New York","Schuyler County",5,74,208,107,101
050,36,097,"New York","Schuyler County",5,75,200,99,101
050,36,097,"New York","Schuyler County",5,76,194,90,104
050,36,097,"New York","Schuyler County",5,77,120,57,63
050,36,097,"New York","Schuyler County",5,78,115,57,58
050,36,097,"New York","Schuyler County",5,79,136,73,63
050,36,097,"New York","Schuyler County",5,80,115,57,58
050,36,097,"New York","Schuyler County",5,81,101,48,53
050,36,097,"New York","Schuyler County",5,82,96,48,48
050,36,097,"New York","Schuyler County",5,83,86,44,42
050,36,097,"New York","Schuyler County",5,84,55,22,33
050,36,097,"New York","Schuyler County",5,85,364,139,225
050,36,099,"New York","Seneca County",1,0,373,193,180
050,36,099,"New York","Seneca County",1,1,370,200,170
050,36,099,"New York","Seneca County",1,2,375,200,175
050,36,099,"New York","Seneca County",1,3,348,190,158
050,36,099,"New York","Seneca County",1,4,347,184,163
050,36,099,"New York","Seneca County",1,5,390,210,180
050,36,099,"New York","Seneca County",1,6,393,203,190
050,36,099,"New York","Seneca County",1,7,361,177,184
050,36,099,"New York","Seneca County",1,8,371,189,182
050,36,099,"New York","Seneca County",1,9,361,186,175
050,36,099,"New York","Seneca County",1,10,387,197,190
050,36,099,"New York","Seneca County",1,11,402,215,187
050,36,099,"New York","Seneca County",1,12,428,243,185
050,36,099,"New York","Seneca County",1,13,399,199,200
050,36,099,"New York","Seneca County",1,14,415,207,208
050,36,099,"New York","Seneca County",1,15,379,185,194
050,36,099,"New York","Seneca County",1,16,389,195,194
050,36,099,"New York","Seneca County",1,17,418,215,203
050,36,099,"New York","Seneca County",1,18,344,191,153
050,36,099,"New York","Seneca County",1,19,298,168,130
050,36,099,"New York","Seneca County",1,20,341,189,152
050,36,099,"New York","Seneca County",1,21,381,226,155
050,36,099,"New York","Seneca County",1,22,399,231,168
050,36,099,"New York","Seneca County",1,23,438,242,196
050,36,099,"New York","Seneca County",1,24,467,269,198
050,36,099,"New York","Seneca County",1,25,451,256,195
050,36,099,"New York","Seneca County",1,26,461,262,199
050,36,099,"New York","Seneca County",1,27,434,248,186
050,36,099,"New York","Seneca County",1,28,445,258,187
050,36,099,"New York","Seneca County",1,29,472,281,191
050,36,099,"New York","Seneca County",1,30,442,237,205
050,36,099,"New York","Seneca County",1,31,421,230,191
050,36,099,"New York","Seneca County",1,32,431,235,196
050,36,099,"New York","Seneca County",1,33,438,242,196
050,36,099,"New York","Seneca County",1,34,438,254,184
050,36,099,"New York","Seneca County",1,35,453,259,194
050,36,099,"New York","Seneca County",1,36,402,223,179
050,36,099,"New York","Seneca County",1,37,402,215,187
050,36,099,"New York","Seneca County",1,38,404,214,190
050,36,099,"New York","Seneca County",1,39,416,220,196
050,36,099,"New York","Seneca County",1,40,384,203,181
050,36,099,"New York","Seneca County",1,41,373,215,158
050,36,099,"New York","Seneca County",1,42,382,217,165
050,36,099,"New York","Seneca County",1,43,328,185,143
050,36,099,"New York","Seneca County",1,44,335,178,157
050,36,099,"New York","Seneca County",1,45,359,196,163
050,36,099,"New York","Seneca County",1,46,377,199,178
050,36,099,"New York","Seneca County",1,47,362,180,182
050,36,099,"New York","Seneca County",1,48,396,211,185
050,36,099,"New York","Seneca County",1,49,445,239,206
050,36,099,"New York","Seneca County",1,50,430,227,203
050,36,099,"New York","Seneca County",1,51,414,211,203
050,36,099,"New York","Seneca County",1,52,418,217,201
050,36,099,"New York","Seneca County",1,53,432,209,223
050,36,099,"New York","Seneca County",1,54,433,232,201
050,36,099,"New York","Seneca County",1,55,456,239,217
050,36,099,"New York","Seneca County",1,56,478,238,240
050,36,099,"New York","Seneca County",1,57,517,256,261
050,36,099,"New York","Seneca County",1,58,523,284,239
050,36,099,"New York","Seneca County",1,59,497,255,242
050,36,099,"New York","Seneca County",1,60,520,263,257
050,36,099,"New York","Seneca County",1,61,560,278,282
050,36,099,"New York","Seneca County",1,62,550,277,273
050,36,099,"New York","Seneca County",1,63,519,267,252
050,36,099,"New York","Seneca County",1,64,507,267,240
050,36,099,"New York","Seneca County",1,65,488,249,239
050,36,099,"New York","Seneca County",1,66,453,226,227
050,36,099,"New York","Seneca County",1,67,461,237,224
050,36,099,"New York","Seneca County",1,68,455,234,221
050,36,099,"New York","Seneca County",1,69,407,187,220
050,36,099,"New York","Seneca County",1,70,375,169,206
050,36,099,"New York","Seneca County",1,71,372,184,188
050,36,099,"New York","Seneca County",1,72,398,204,194
050,36,099,"New York","Seneca County",1,73,420,198,222
050,36,099,"New York","Seneca County",1,74,279,134,145
050,36,099,"New York","Seneca County",1,75,265,137,128
050,36,099,"New York","Seneca County",1,76,257,119,138
050,36,099,"New York","Seneca County",1,77,255,120,135
050,36,099,"New York","Seneca County",1,78,218,98,120
050,36,099,"New York","Seneca County",1,79,184,85,99
050,36,099,"New York","Seneca County",1,80,174,86,88
050,36,099,"New York","Seneca County",1,81,170,79,91
050,36,099,"New York","Seneca County",1,82,146,70,76
050,36,099,"New York","Seneca County",1,83,119,54,65
050,36,099,"New York","Seneca County",1,84,124,56,68
050,36,099,"New York","Seneca County",1,85,717,270,447
050,36,099,"New York","Seneca County",2,0,372,186,186
050,36,099,"New York","Seneca County",2,1,368,198,170
050,36,099,"New York","Seneca County",2,2,371,200,171
050,36,099,"New York","Seneca County",2,3,353,190,163
050,36,099,"New York","Seneca County",2,4,350,187,163
050,36,099,"New York","Seneca County",2,5,379,206,173
050,36,099,"New York","Seneca County",2,6,394,206,188
050,36,099,"New York","Seneca County",2,7,366,183,183
050,36,099,"New York","Seneca County",2,8,368,185,183
050,36,099,"New York","Seneca County",2,9,365,186,179
050,36,099,"New York","Seneca County",2,10,379,194,185
050,36,099,"New York","Seneca County",2,11,399,212,187
050,36,099,"New York","Seneca County",2,12,427,238,189
050,36,099,"New York","Seneca County",2,13,407,210,197
050,36,099,"New York","Seneca County",2,14,409,203,206
050,36,099,"New York","Seneca County",2,15,386,190,196
050,36,099,"New York","Seneca County",2,16,388,193,195
050,36,099,"New York","Seneca County",2,17,407,207,200
050,36,099,"New York","Seneca County",2,18,340,188,152
050,36,099,"New York","Seneca County",2,19,293,165,128
050,36,099,"New York","Seneca County",2,20,332,182,150
050,36,099,"New York","Seneca County",2,21,369,211,158
050,36,099,"New York","Seneca County",2,22,404,228,176
050,36,099,"New York","Seneca County",2,23,437,241,196
050,36,099,"New York","Seneca County",2,24,453,257,196
050,36,099,"New York","Seneca County",2,25,437,245,192
050,36,099,"New York","Seneca County",2,26,448,246,202
050,36,099,"New York","Seneca County",2,27,430,241,189
050,36,099,"New York","Seneca County",2,28,432,246,186
050,36,099,"New York","Seneca County",2,29,450,260,190
050,36,099,"New York","Seneca County",2,30,436,234,202
050,36,099,"New York","Seneca County",2,31,416,223,193
050,36,099,"New York","Seneca County",2,32,421,226,195
050,36,099,"New York","Seneca County",2,33,431,233,198
050,36,099,"New York","Seneca County",2,34,427,239,188
050,36,099,"New York","Seneca County",2,35,445,252,193
050,36,099,"New York","Seneca County",2,36,401,219,182
050,36,099,"New York","Seneca County",2,37,394,208,186
050,36,099,"New York","Seneca County",2,38,400,209,191
050,36,099,"New York","Seneca County",2,39,407,214,193
050,36,099,"New York","Seneca County",2,40,384,199,185
050,36,099,"New York","Seneca County",2,41,369,206,163
050,36,099,"New York","Seneca County",2,42,366,207,159
050,36,099,"New York","Seneca County",2,43,339,189,150
050,36,099,"New York","Seneca County",2,44,324,172,152
050,36,099,"New York","Seneca County",2,45,350,188,162
050,36,099,"New York","Seneca County",2,46,363,191,172
050,36,099,"New York","Seneca County",2,47,357,177,180
050,36,099,"New York","Seneca County",2,48,380,196,184
050,36,099,"New York","Seneca County",2,49,430,229,201
050,36,099,"New York","Seneca County",2,50,429,224,205
050,36,099,"New York","Seneca County",2,51,410,208,202
050,36,099,"New York","Seneca County",2,52,412,212,200
050,36,099,"New York","Seneca County",2,53,424,207,217
050,36,099,"New York","Seneca County",2,54,428,224,204
050,36,099,"New York","Seneca County",2,55,447,235,212
050,36,099,"New York","Seneca County",2,56,471,235,236
050,36,099,"New York","Seneca County",2,57,505,251,254
050,36,099,"New York","Seneca County",2,58,519,274,245
050,36,099,"New York","Seneca County",2,59,500,257,243
050,36,099,"New York","Seneca County",2,60,513,261,252
050,36,099,"New York","Seneca County",2,61,553,276,277
050,36,099,"New York","Seneca County",2,62,551,276,275
050,36,099,"New York","Seneca County",2,63,532,271,261
050,36,099,"New York","Seneca County",2,64,503,261,242
050,36,099,"New York","Seneca County",2,65,489,251,238
050,36,099,"New York","Seneca County",2,66,462,232,230
050,36,099,"New York","Seneca County",2,67,457,234,223
050,36,099,"New York","Seneca County",2,68,452,233,219
050,36,099,"New York","Seneca County",2,69,419,199,220
050,36,099,"New York","Seneca County",2,70,380,173,207
050,36,099,"New York","Seneca County",2,71,369,178,191
050,36,099,"New York","Seneca County",2,72,383,194,189
050,36,099,"New York","Seneca County",2,73,433,206,227
050,36,099,"New York","Seneca County",2,74,292,138,154
050,36,099,"New York","Seneca County",2,75,268,138,130
050,36,099,"New York","Seneca County",2,76,255,122,133
050,36,099,"New York","Seneca County",2,77,260,123,137
050,36,099,"New York","Seneca County",2,78,218,101,117
050,36,099,"New York","Seneca County",2,79,190,87,103
050,36,099,"New York","Seneca County",2,80,175,85,90
050,36,099,"New York","Seneca County",2,81,167,79,88
050,36,099,"New York","Seneca County",2,82,147,70,77
050,36,099,"New York","Seneca County",2,83,121,55,66
050,36,099,"New York","Seneca County",2,84,121,55,66
050,36,099,"New York","Seneca County",2,85,708,267,441
050,36,099,"New York","Seneca County",3,0,347,174,173
050,36,099,"New York","Seneca County",3,1,378,181,197
050,36,099,"New York","Seneca County",3,2,372,197,175
050,36,099,"New York","Seneca County",3,3,373,201,172
050,36,099,"New York","Seneca County",3,4,348,187,161
050,36,099,"New York","Seneca County",3,5,349,193,156
050,36,099,"New York","Seneca County",3,6,369,198,171
050,36,099,"New York","Seneca County",3,7,381,200,181
050,36,099,"New York","Seneca County",3,8,370,188,182
050,36,099,"New York","Seneca County",3,9,379,196,183
050,36,099,"New York","Seneca County",3,10,369,188,181
050,36,099,"New York","Seneca County",3,11,373,194,179
050,36,099,"New York","Seneca County",3,12,396,213,183
050,36,099,"New York","Seneca County",3,13,431,240,191
050,36,099,"New York","Seneca County",3,14,402,203,199
050,36,099,"New York","Seneca County",3,15,410,205,205
050,36,099,"New York","Seneca County",3,16,392,191,201
050,36,099,"New York","Seneca County",3,17,384,192,192
050,36,099,"New York","Seneca County",3,18,353,195,158
050,36,099,"New York","Seneca County",3,19,305,176,129
050,36,099,"New York","Seneca County",3,20,327,191,136
050,36,099,"New York","Seneca County",3,21,386,217,169
050,36,099,"New York","Seneca County",3,22,401,224,177
050,36,099,"New York","Seneca County",3,23,429,244,185
050,36,099,"New York","Seneca County",3,24,446,262,184
050,36,099,"New York","Seneca County",3,25,431,241,190
050,36,099,"New York","Seneca County",3,26,412,221,191
050,36,099,"New York","Seneca County",3,27,459,256,203
050,36,099,"New York","Seneca County",3,28,442,253,189
050,36,099,"New York","Seneca County",3,29,441,257,184
050,36,099,"New York","Seneca County",3,30,423,243,180
050,36,099,"New York","Seneca County",3,31,452,240,212
050,36,099,"New York","Seneca County",3,32,418,232,186
050,36,099,"New York","Seneca County",3,33,447,239,208
050,36,099,"New York","Seneca County",3,34,426,221,205
050,36,099,"New York","Seneca County",3,35,425,238,187
050,36,099,"New York","Seneca County",3,36,424,241,183
050,36,099,"New York","Seneca County",3,37,411,221,190
050,36,099,"New York","Seneca County",3,38,396,207,189
050,36,099,"New York","Seneca County",3,39,412,220,192
050,36,099,"New York","Seneca County",3,40,395,208,187
050,36,099,"New York","Seneca County",3,41,384,204,180
050,36,099,"New York","Seneca County",3,42,365,197,168
050,36,099,"New York","Seneca County",3,43,373,213,160
050,36,099,"New York","Seneca County",3,44,329,193,136
050,36,099,"New York","Seneca County",3,45,331,181,150
050,36,099,"New York","Seneca County",3,46,355,189,166
050,36,099,"New York","Seneca County",3,47,361,186,175
050,36,099,"New York","Seneca County",3,48,349,166,183
050,36,099,"New York","Seneca County",3,49,377,195,182
050,36,099,"New York","Seneca County",3,50,438,236,202
050,36,099,"New York","Seneca County",3,51,426,219,207
050,36,099,"New York","Seneca County",3,52,416,211,205
050,36,099,"New York","Seneca County",3,53,391,196,195
050,36,099,"New York","Seneca County",3,54,408,199,209
050,36,099,"New York","Seneca County",3,55,437,235,202
050,36,099,"New York","Seneca County",3,56,427,224,203
050,36,099,"New York","Seneca County",3,57,467,233,234
050,36,099,"New York","Seneca County",3,58,498,247,251
050,36,099,"New York","Seneca County",3,59,507,260,247
050,36,099,"New York","Seneca County",3,60,496,253,243
050,36,099,"New York","Seneca County",3,61,503,256,247
050,36,099,"New York","Seneca County",3,62,543,268,275
050,36,099,"New York","Seneca County",3,63,538,266,272
050,36,099,"New York","Seneca County",3,64,526,265,261
050,36,099,"New York","Seneca County",3,65,498,260,238
050,36,099,"New York","Seneca County",3,66,484,250,234
050,36,099,"New York","Seneca County",3,67,442,219,223
050,36,099,"New York","Seneca County",3,68,445,231,214
050,36,099,"New York","Seneca County",3,69,442,225,217
050,36,099,"New York","Seneca County",3,70,408,193,215
050,36,099,"New York","Seneca County",3,71,370,175,195
050,36,099,"New York","Seneca County",3,72,364,173,191
050,36,099,"New York","Seneca County",3,73,367,180,187
050,36,099,"New York","Seneca County",3,74,426,201,225
050,36,099,"New York","Seneca County",3,75,277,130,147
050,36,099,"New York","Seneca County",3,76,261,134,127
050,36,099,"New York","Seneca County",3,77,245,112,133
050,36,099,"New York","Seneca County",3,78,239,116,123
050,36,099,"New York","Seneca County",3,79,208,92,116
050,36,099,"New York","Seneca County",3,80,179,82,97
050,36,099,"New York","Seneca County",3,81,167,78,89
050,36,099,"New York","Seneca County",3,82,150,70,80
050,36,099,"New York","Seneca County",3,83,137,63,74
050,36,099,"New York","Seneca County",3,84,112,47,65
050,36,099,"New York","Seneca County",3,85,664,253,411
050,36,099,"New York","Seneca County",4,0,341,176,165
050,36,099,"New York","Seneca County",4,1,349,179,170
050,36,099,"New York","Seneca County",4,2,380,186,194
050,36,099,"New York","Seneca County",4,3,371,198,173
050,36,099,"New York","Seneca County",4,4,368,194,174
050,36,099,"New York","Seneca County",4,5,346,186,160
050,36,099,"New York","Seneca County",4,6,357,196,161
050,36,099,"New York","Seneca County",4,7,373,200,173
050,36,099,"New York","Seneca County",4,8,385,194,191
050,36,099,"New York","Seneca County",4,9,372,187,185
050,36,099,"New York","Seneca County",4,10,388,202,186
050,36,099,"New York","Seneca County",4,11,368,190,178
050,36,099,"New York","Seneca County",4,12,379,203,176
050,36,099,"New York","Seneca County",4,13,398,215,183
050,36,099,"New York","Seneca County",4,14,430,236,194
050,36,099,"New York","Seneca County",4,15,402,205,197
050,36,099,"New York","Seneca County",4,16,397,196,201
050,36,099,"New York","Seneca County",4,17,395,194,201
050,36,099,"New York","Seneca County",4,18,327,175,152
050,36,099,"New York","Seneca County",4,19,277,157,120
050,36,099,"New York","Seneca County",4,20,300,170,130
050,36,099,"New York","Seneca County",4,21,325,192,133
050,36,099,"New York","Seneca County",4,22,385,200,185
050,36,099,"New York","Seneca County",4,23,391,206,185
050,36,099,"New York","Seneca County",4,24,391,222,169
050,36,099,"New York","Seneca County",4,25,385,226,159
050,36,099,"New York","Seneca County",4,26,388,210,178
050,36,099,"New York","Seneca County",4,27,379,198,181
050,36,099,"New York","Seneca County",4,28,393,204,189
050,36,099,"New York","Seneca County",4,29,411,226,185
050,36,099,"New York","Seneca County",4,30,407,224,183
050,36,099,"New York","Seneca County",4,31,413,233,180
050,36,099,"New York","Seneca County",4,32,432,221,211
050,36,099,"New York","Seneca County",4,33,418,222,196
050,36,099,"New York","Seneca County",4,34,403,201,202
050,36,099,"New York","Seneca County",4,35,412,212,200
050,36,099,"New York","Seneca County",4,36,404,222,182
050,36,099,"New York","Seneca County",4,37,426,231,195
050,36,099,"New York","Seneca County",4,38,404,207,197
050,36,099,"New York","Seneca County",4,39,395,205,190
050,36,099,"New York","Seneca County",4,40,398,204,194
050,36,099,"New York","Seneca County",4,41,367,187,180
050,36,099,"New York","Seneca County",4,42,378,196,182
050,36,099,"New York","Seneca County",4,43,349,183,166
050,36,099,"New York","Seneca County",4,44,362,203,159
050,36,099,"New York","Seneca County",4,45,326,188,138
050,36,099,"New York","Seneca County",4,46,317,165,152
050,36,099,"New York","Seneca County",4,47,332,164,168
050,36,099,"New York","Seneca County",4,48,346,174,172
050,36,099,"New York","Seneca County",4,49,348,169,179
050,36,099,"New York","Seneca County",4,50,365,186,179
050,36,099,"New York","Seneca County",4,51,428,222,206
050,36,099,"New York","Seneca County",4,52,421,218,203
050,36,099,"New York","Seneca County",4,53,392,196,196
050,36,099,"New York","Seneca County",4,54,392,197,195
050,36,099,"New York","Seneca County",4,55,399,187,212
050,36,099,"New York","Seneca County",4,56,424,225,199
050,36,099,"New York","Seneca County",4,57,420,223,197
050,36,099,"New York","Seneca County",4,58,464,230,234
050,36,099,"New York","Seneca County",4,59,489,235,254
050,36,099,"New York","Seneca County",4,60,500,258,242
050,36,099,"New York","Seneca County",4,61,484,241,243
050,36,099,"New York","Seneca County",4,62,497,248,249
050,36,099,"New York","Seneca County",4,63,537,275,262
050,36,099,"New York","Seneca County",4,64,529,256,273
050,36,099,"New York","Seneca County",4,65,520,259,261
050,36,099,"New York","Seneca County",4,66,490,248,242
050,36,099,"New York","Seneca County",4,67,475,243,232
050,36,099,"New York","Seneca County",4,68,434,216,218
050,36,099,"New York","Seneca County",4,69,442,224,218
050,36,099,"New York","Seneca County",4,70,436,222,214
050,36,099,"New York","Seneca County",4,71,398,188,210
050,36,099,"New York","Seneca County",4,72,365,173,192
050,36,099,"New York","Seneca County",4,73,344,159,185
050,36,099,"New York","Seneca County",4,74,364,176,188
050,36,099,"New York","Seneca County",4,75,406,191,215
050,36,099,"New York","Seneca County",4,76,262,124,138
050,36,099,"New York","Seneca County",4,77,257,127,130
050,36,099,"New York","Seneca County",4,78,235,107,128
050,36,099,"New York","Seneca County",4,79,225,110,115
050,36,099,"New York","Seneca County",4,80,192,87,105
050,36,099,"New York","Seneca County",4,81,170,76,94
050,36,099,"New York","Seneca County",4,82,141,67,74
050,36,099,"New York","Seneca County",4,83,140,65,75
050,36,099,"New York","Seneca County",4,84,128,53,75
050,36,099,"New York","Seneca County",4,85,633,246,387
050,36,099,"New York","Seneca County",5,0,340,176,164
050,36,099,"New York","Seneca County",5,1,336,170,166
050,36,099,"New York","Seneca County",5,2,352,179,173
050,36,099,"New York","Seneca County",5,3,374,182,192
050,36,099,"New York","Seneca County",5,4,366,202,164
050,36,099,"New York","Seneca County",5,5,352,189,163
050,36,099,"New York","Seneca County",5,6,343,182,161
050,36,099,"New York","Seneca County",5,7,345,191,154
050,36,099,"New York","Seneca County",5,8,396,209,187
050,36,099,"New York","Seneca County",5,9,379,197,182
050,36,099,"New York","Seneca County",5,10,370,186,184
050,36,099,"New York","Seneca County",5,11,387,196,191
050,36,099,"New York","Seneca County",5,12,365,185,180
050,36,099,"New York","Seneca County",5,13,380,199,181
050,36,099,"New York","Seneca County",5,14,396,213,183
050,36,099,"New York","Seneca County",5,15,427,236,191
050,36,099,"New York","Seneca County",5,16,387,200,187
050,36,099,"New York","Seneca County",5,17,394,195,199
050,36,099,"New York","Seneca County",5,18,333,175,158
050,36,099,"New York","Seneca County",5,19,270,149,121
050,36,099,"New York","Seneca County",5,20,312,182,130
050,36,099,"New York","Seneca County",5,21,352,195,157
050,36,099,"New York","Seneca County",5,22,374,210,164
050,36,099,"New York","Seneca County",5,23,413,218,195
050,36,099,"New York","Seneca County",5,24,387,219,168
050,36,099,"New York","Seneca County",5,25,373,214,159
050,36,099,"New York","Seneca County",5,26,372,206,166
050,36,099,"New York","Seneca County",5,27,386,211,175
050,36,099,"New York","Seneca County",5,28,358,190,168
050,36,099,"New York","Seneca County",5,29,402,207,195
050,36,099,"New York","Seneca County",5,30,389,210,179
050,36,099,"New York","Seneca County",5,31,426,240,186
050,36,099,"New York","Seneca County",5,32,409,229,180
050,36,099,"New York","Seneca County",5,33,430,230,200
050,36,099,"New York","Seneca County",5,34,405,215,190
050,36,099,"New York","Seneca County",5,35,411,217,194
050,36,099,"New York","Seneca County",5,36,390,192,198
050,36,099,"New York","Seneca County",5,37,395,217,178
050,36,099,"New York","Seneca County",5,38,428,236,192
050,36,099,"New York","Seneca County",5,39,400,212,188
050,36,099,"New York","Seneca County",5,40,389,204,185
050,36,099,"New York","Seneca County",5,41,380,190,190
050,36,099,"New York","Seneca County",5,42,363,187,176
050,36,099,"New York","Seneca County",5,43,375,200,175
050,36,099,"New York","Seneca County",5,44,342,182,160
050,36,099,"New York","Seneca County",5,45,364,205,159
050,36,099,"New York","Seneca County",5,46,320,178,142
050,36,099,"New York","Seneca County",5,47,305,155,150
050,36,099,"New York","Seneca County",5,48,319,153,166
050,36,099,"New York","Seneca County",5,49,346,172,174
050,36,099,"New York","Seneca County",5,50,347,173,174
050,36,099,"New York","Seneca County",5,51,362,193,169
050,36,099,"New York","Seneca County",5,52,415,212,203
050,36,099,"New York","Seneca County",5,53,412,217,195
050,36,099,"New York","Seneca County",5,54,391,199,192
050,36,099,"New York","Seneca County",5,55,371,187,184
050,36,099,"New York","Seneca County",5,56,380,175,205
050,36,099,"New York","Seneca County",5,57,437,229,208
050,36,099,"New York","Seneca County",5,58,425,228,197
050,36,099,"New York","Seneca County",5,59,452,221,231
050,36,099,"New York","Seneca County",5,60,479,230,249
050,36,099,"New York","Seneca County",5,61,506,258,248
050,36,099,"New York","Seneca County",5,62,489,236,253
050,36,099,"New York","Seneca County",5,63,492,249,243
050,36,099,"New York","Seneca County",5,64,531,274,257
050,36,099,"New York","Seneca County",5,65,523,252,271
050,36,099,"New York","Seneca County",5,66,514,255,259
050,36,099,"New York","Seneca County",5,67,483,243,240
050,36,099,"New York","Seneca County",5,68,468,241,227
050,36,099,"New York","Seneca County",5,69,418,205,213
050,36,099,"New York","Seneca County",5,70,430,217,213
050,36,099,"New York","Seneca County",5,71,424,215,209
050,36,099,"New York","Seneca County",5,72,384,179,205
050,36,099,"New York","Seneca County",5,73,347,163,184
050,36,099,"New York","Seneca County",5,74,343,158,185
050,36,099,"New York","Seneca County",5,75,354,169,185
050,36,099,"New York","Seneca County",5,76,392,186,206
050,36,099,"New York","Seneca County",5,77,258,116,142
050,36,099,"New York","Seneca County",5,78,243,122,121
050,36,099,"New York","Seneca County",5,79,227,104,123
050,36,099,"New York","Seneca County",5,80,212,104,108
050,36,099,"New York","Seneca County",5,81,187,84,103
050,36,099,"New York","Seneca County",5,82,149,69,80
050,36,099,"New York","Seneca County",5,83,132,60,72
050,36,099,"New York","Seneca County",5,84,131,58,73
050,36,099,"New York","Seneca County",5,85,634,242,392
050,36,101,"New York","Steuben County",1,0,996,508,488
050,36,101,"New York","Steuben County",1,1,1027,521,506
050,36,101,"New York","Steuben County",1,2,1023,505,518
050,36,101,"New York","Steuben County",1,3,1022,519,503
050,36,101,"New York","Steuben County",1,4,1083,580,503
050,36,101,"New York","Steuben County",1,5,1095,574,521
050,36,101,"New York","Steuben County",1,6,1048,556,492
050,36,101,"New York","Steuben County",1,7,1105,548,557
050,36,101,"New York","Steuben County",1,8,1158,587,571
050,36,101,"New York","Steuben County",1,9,1161,597,564
050,36,101,"New York","Steuben County",1,10,1169,604,565
050,36,101,"New York","Steuben County",1,11,1140,589,551
050,36,101,"New York","Steuben County",1,12,1229,633,596
050,36,101,"New York","Steuben County",1,13,1228,617,611
050,36,101,"New York","Steuben County",1,14,1202,620,582
050,36,101,"New York","Steuben County",1,15,1207,609,598
050,36,101,"New York","Steuben County",1,16,1225,643,582
050,36,101,"New York","Steuben County",1,17,1244,678,566
050,36,101,"New York","Steuben County",1,18,1059,574,485
050,36,101,"New York","Steuben County",1,19,884,461,423
050,36,101,"New York","Steuben County",1,20,929,472,457
050,36,101,"New York","Steuben County",1,21,948,478,470
050,36,101,"New York","Steuben County",1,22,960,483,477
050,36,101,"New York","Steuben County",1,23,995,505,490
050,36,101,"New York","Steuben County",1,24,1040,544,496
050,36,101,"New York","Steuben County",1,25,1086,552,534
050,36,101,"New York","Steuben County",1,26,1068,545,523
050,36,101,"New York","Steuben County",1,27,1052,543,509
050,36,101,"New York","Steuben County",1,28,1075,542,533
050,36,101,"New York","Steuben County",1,29,1128,551,577
050,36,101,"New York","Steuben County",1,30,1163,572,591
050,36,101,"New York","Steuben County",1,31,1084,556,528
050,36,101,"New York","Steuben County",1,32,1077,547,530
050,36,101,"New York","Steuben County",1,33,1080,560,520
050,36,101,"New York","Steuben County",1,34,1061,549,512
050,36,101,"New York","Steuben County",1,35,1095,547,548
050,36,101,"New York","Steuben County",1,36,1075,545,530
050,36,101,"New York","Steuben County",1,37,1096,549,547
050,36,101,"New York","Steuben County",1,38,1122,567,555
050,36,101,"New York","Steuben County",1,39,1162,595,567
050,36,101,"New York","Steuben County",1,40,1122,562,560
050,36,101,"New York","Steuben County",1,41,1091,558,533
050,36,101,"New York","Steuben County",1,42,1083,564,519
050,36,101,"New York","Steuben County",1,43,1016,517,499
050,36,101,"New York","Steuben County",1,44,974,490,484
050,36,101,"New York","Steuben County",1,45,1014,515,499
050,36,101,"New York","Steuben County",1,46,998,489,509
050,36,101,"New York","Steuben County",1,47,1089,546,543
050,36,101,"New York","Steuben County",1,48,1161,577,584
050,36,101,"New York","Steuben County",1,49,1277,621,656
050,36,101,"New York","Steuben County",1,50,1290,650,640
050,36,101,"New York","Steuben County",1,51,1270,648,622
050,36,101,"New York","Steuben County",1,52,1204,624,580
050,36,101,"New York","Steuben County",1,53,1279,650,629
050,36,101,"New York","Steuben County",1,54,1315,650,665
050,36,101,"New York","Steuben County",1,55,1414,713,701
050,36,101,"New York","Steuben County",1,56,1447,718,729
050,36,101,"New York","Steuben County",1,57,1399,707,692
050,36,101,"New York","Steuben County",1,58,1428,729,699
050,36,101,"New York","Steuben County",1,59,1479,730,749
050,36,101,"New York","Steuben County",1,60,1462,735,727
050,36,101,"New York","Steuben County",1,61,1490,769,721
050,36,101,"New York","Steuben County",1,62,1437,737,700
050,36,101,"New York","Steuben County",1,63,1386,708,678
050,36,101,"New York","Steuben County",1,64,1301,661,640
050,36,101,"New York","Steuben County",1,65,1258,641,617
050,36,101,"New York","Steuben County",1,66,1253,623,630
050,36,101,"New York","Steuben County",1,67,1235,629,606
050,36,101,"New York","Steuben County",1,68,1231,607,624
050,36,101,"New York","Steuben County",1,69,1125,562,563
050,36,101,"New York","Steuben County",1,70,1079,532,547
050,36,101,"New York","Steuben County",1,71,1037,493,544
050,36,101,"New York","Steuben County",1,72,1006,478,528
050,36,101,"New York","Steuben County",1,73,1025,475,550
050,36,101,"New York","Steuben County",1,74,720,340,380
050,36,101,"New York","Steuben County",1,75,735,372,363
050,36,101,"New York","Steuben County",1,76,717,327,390
050,36,101,"New York","Steuben County",1,77,711,345,366
050,36,101,"New York","Steuben County",1,78,602,284,318
050,36,101,"New York","Steuben County",1,79,538,254,284
050,36,101,"New York","Steuben County",1,80,501,231,270
050,36,101,"New York","Steuben County",1,81,460,203,257
050,36,101,"New York","Steuben County",1,82,430,194,236
050,36,101,"New York","Steuben County",1,83,387,163,224
050,36,101,"New York","Steuben County",1,84,358,158,200
050,36,101,"New York","Steuben County",1,85,2136,783,1353
050,36,101,"New York","Steuben County",2,0,992,504,488
050,36,101,"New York","Steuben County",2,1,1014,516,498
050,36,101,"New York","Steuben County",2,2,1028,511,517
050,36,101,"New York","Steuben County",2,3,1023,517,506
050,36,101,"New York","Steuben County",2,4,1074,568,506
050,36,101,"New York","Steuben County",2,5,1090,574,516
050,36,101,"New York","Steuben County",2,6,1061,561,500
050,36,101,"New York","Steuben County",2,7,1093,551,542
050,36,101,"New York","Steuben County",2,8,1138,574,564
050,36,101,"New York","Steuben County",2,9,1159,592,567
050,36,101,"New York","Steuben County",2,10,1167,600,567
050,36,101,"New York","Steuben County",2,11,1145,591,554
050,36,101,"New York","Steuben County",2,12,1216,626,590
050,36,101,"New York","Steuben County",2,13,1227,622,605
050,36,101,"New York","Steuben County",2,14,1202,619,583
050,36,101,"New York","Steuben County",2,15,1201,610,591
050,36,101,"New York","Steuben County",2,16,1218,635,583
050,36,101,"New York","Steuben County",2,17,1236,669,567
050,36,101,"New York","Steuben County",2,18,1044,572,472
050,36,101,"New York","Steuben County",2,19,862,453,409
050,36,101,"New York","Steuben County",2,20,923,470,453
050,36,101,"New York","Steuben County",2,21,938,472,466
050,36,101,"New York","Steuben County",2,22,966,485,481
050,36,101,"New York","Steuben County",2,23,999,506,493
050,36,101,"New York","Steuben County",2,24,1034,539,495
050,36,101,"New York","Steuben County",2,25,1068,546,522
050,36,101,"New York","Steuben County",2,26,1066,544,522
050,36,101,"New York","Steuben County",2,27,1050,541,509
050,36,101,"New York","Steuben County",2,28,1071,542,529
050,36,101,"New York","Steuben County",2,29,1123,552,571
050,36,101,"New York","Steuben County",2,30,1164,573,591
050,36,101,"New York","Steuben County",2,31,1101,556,545
050,36,101,"New York","Steuben County",2,32,1080,548,532
050,36,101,"New York","Steuben County",2,33,1073,554,519
050,36,101,"New York","Steuben County",2,34,1064,547,517
050,36,101,"New York","Steuben County",2,35,1093,552,541
050,36,101,"New York","Steuben County",2,36,1069,542,527
050,36,101,"New York","Steuben County",2,37,1091,547,544
050,36,101,"New York","Steuben County",2,38,1117,565,552
050,36,101,"New York","Steuben County",2,39,1148,586,562
050,36,101,"New York","Steuben County",2,40,1134,572,562
050,36,101,"New York","Steuben County",2,41,1093,557,536
050,36,101,"New York","Steuben County",2,42,1077,558,519
050,36,101,"New York","Steuben County",2,43,1040,535,505
050,36,101,"New York","Steuben County",2,44,971,489,482
050,36,101,"New York","Steuben County",2,45,1005,509,496
050,36,101,"New York","Steuben County",2,46,990,488,502
050,36,101,"New York","Steuben County",2,47,1064,531,533
050,36,101,"New York","Steuben County",2,48,1136,562,574
050,36,101,"New York","Steuben County",2,49,1255,613,642
050,36,101,"New York","Steuben County",2,50,1291,646,645
050,36,101,"New York","Steuben County",2,51,1274,649,625
050,36,101,"New York","Steuben County",2,52,1213,626,587
050,36,101,"New York","Steuben County",2,53,1265,646,619
050,36,101,"New York","Steuben County",2,54,1296,644,652
050,36,101,"New York","Steuben County",2,55,1384,697,687
050,36,101,"New York","Steuben County",2,56,1442,719,723
050,36,101,"New York","Steuben County",2,57,1405,707,698
050,36,101,"New York","Steuben County",2,58,1420,722,698
050,36,101,"New York","Steuben County",2,59,1475,734,741
050,36,101,"New York","Steuben County",2,60,1455,724,731
050,36,101,"New York","Steuben County",2,61,1476,760,716
050,36,101,"New York","Steuben County",2,62,1445,741,704
050,36,101,"New York","Steuben County",2,63,1409,721,688
050,36,101,"New York","Steuben County",2,64,1306,664,642
050,36,101,"New York","Steuben County",2,65,1259,641,618
050,36,101,"New York","Steuben County",2,66,1249,626,623
050,36,101,"New York","Steuben County",2,67,1230,623,607
050,36,101,"New York","Steuben County",2,68,1216,604,612
050,36,101,"New York","Steuben County",2,69,1152,573,579
050,36,101,"New York","Steuben County",2,70,1082,535,547
050,36,101,"New York","Steuben County",2,71,1037,495,542
050,36,101,"New York","Steuben County",2,72,989,470,519
050,36,101,"New York","Steuben County",2,73,1058,493,565
050,36,101,"New York","Steuben County",2,74,737,343,394
050,36,101,"New York","Steuben County",2,75,725,365,360
050,36,101,"New York","Steuben County",2,76,705,329,376
050,36,101,"New York","Steuben County",2,77,722,347,375
050,36,101,"New York","Steuben County",2,78,606,285,321
050,36,101,"New York","Steuben County",2,79,538,254,284
050,36,101,"New York","Steuben County",2,80,502,233,269
050,36,101,"New York","Steuben County",2,81,462,206,256
050,36,101,"New York","Steuben County",2,82,425,190,235
050,36,101,"New York","Steuben County",2,83,385,163,222
050,36,101,"New York","Steuben County",2,84,356,154,202
050,36,101,"New York","Steuben County",2,85,2125,783,1342
050,36,101,"New York","Steuben County",3,0,953,514,439
050,36,101,"New York","Steuben County",3,1,1029,522,507
050,36,101,"New York","Steuben County",3,2,1027,530,497
050,36,101,"New York","Steuben County",3,3,1057,522,535
050,36,101,"New York","Steuben County",3,4,1021,518,503
050,36,101,"New York","Steuben County",3,5,1096,577,519
050,36,101,"New York","Steuben County",3,6,1092,580,512
050,36,101,"New York","Steuben County",3,7,1070,548,522
050,36,101,"New York","Steuben County",3,8,1117,564,553
050,36,101,"New York","Steuben County",3,9,1147,587,560
050,36,101,"New York","Steuben County",3,10,1158,584,574
050,36,101,"New York","Steuben County",3,11,1153,589,564
050,36,101,"New York","Steuben County",3,12,1158,609,549
050,36,101,"New York","Steuben County",3,13,1215,625,590
050,36,101,"New York","Steuben County",3,14,1217,624,593
050,36,101,"New York","Steuben County",3,15,1200,612,588
050,36,101,"New York","Steuben County",3,16,1193,613,580
050,36,101,"New York","Steuben County",3,17,1215,632,583
050,36,101,"New York","Steuben County",3,18,1066,595,471
050,36,101,"New York","Steuben County",3,19,828,438,390
050,36,101,"New York","Steuben County",3,20,935,492,443
050,36,101,"New York","Steuben County",3,21,962,485,477
050,36,101,"New York","Steuben County",3,22,1005,500,505
050,36,101,"New York","Steuben County",3,23,1040,532,508
050,36,101,"New York","Steuben County",3,24,1002,519,483
050,36,101,"New York","Steuben County",3,25,1051,564,487
050,36,101,"New York","Steuben County",3,26,1068,537,531
050,36,101,"New York","Steuben County",3,27,1062,534,528
050,36,101,"New York","Steuben County",3,28,1075,539,536
050,36,101,"New York","Steuben County",3,29,1059,547,512
050,36,101,"New York","Steuben County",3,30,1120,545,575
050,36,101,"New York","Steuben County",3,31,1177,573,604
050,36,101,"New York","Steuben County",3,32,1119,559,560
050,36,101,"New York","Steuben County",3,33,1093,555,538
050,36,101,"New York","Steuben County",3,34,1068,545,523
050,36,101,"New York","Steuben County",3,35,1076,554,522
050,36,101,"New York","Steuben County",3,36,1085,538,547
050,36,101,"New York","Steuben County",3,37,1074,546,528
050,36,101,"New York","Steuben County",3,38,1102,557,545
050,36,101,"New York","Steuben County",3,39,1104,550,554
050,36,101,"New York","Steuben County",3,40,1140,581,559
050,36,101,"New York","Steuben County",3,41,1133,563,570
050,36,101,"New York","Steuben County",3,42,1089,558,531
050,36,101,"New York","Steuben County",3,43,1069,558,511
050,36,101,"New York","Steuben County",3,44,1049,548,501
050,36,101,"New York","Steuben County",3,45,974,492,482
050,36,101,"New York","Steuben County",3,46,995,496,499
050,36,101,"New York","Steuben County",3,47,1005,506,499
050,36,101,"New York","Steuben County",3,48,1052,518,534
050,36,101,"New York","Steuben County",3,49,1126,558,568
050,36,101,"New York","Steuben County",3,50,1256,614,642
050,36,101,"New York","Steuben County",3,51,1267,629,638
050,36,101,"New York","Steuben County",3,52,1239,621,618
050,36,101,"New York","Steuben County",3,53,1211,628,583
050,36,101,"New York","Steuben County",3,54,1257,639,618
050,36,101,"New York","Steuben County",3,55,1304,652,652
050,36,101,"New York","Steuben County",3,56,1376,692,684
050,36,101,"New York","Steuben County",3,57,1406,697,709
050,36,101,"New York","Steuben County",3,58,1405,704,701
050,36,101,"New York","Steuben County",3,59,1389,716,673
050,36,101,"New York","Steuben County",3,60,1449,712,737
050,36,101,"New York","Steuben County",3,61,1447,723,724
050,36,101,"New York","Steuben County",3,62,1426,735,691
050,36,101,"New York","Steuben County",3,63,1433,736,697
050,36,101,"New York","Steuben County",3,64,1382,702,680
050,36,101,"New York","Steuben County",3,65,1280,642,638
050,36,101,"New York","Steuben County",3,66,1226,619,607
050,36,101,"New York","Steuben County",3,67,1233,617,616
050,36,101,"New York","Steuben County",3,68,1197,600,597
050,36,101,"New York","Steuben County",3,69,1190,595,595
050,36,101,"New York","Steuben County",3,70,1118,552,566
050,36,101,"New York","Steuben County",3,71,1052,516,536
050,36,101,"New York","Steuben County",3,72,990,476,514
050,36,101,"New York","Steuben County",3,73,939,451,488
050,36,101,"New York","Steuben County",3,74,1025,469,556
050,36,101,"New York","Steuben County",3,75,704,327,377
050,36,101,"New York","Steuben County",3,76,693,343,350
050,36,101,"New York","Steuben County",3,77,678,320,358
050,36,101,"New York","Steuben County",3,78,700,331,369
050,36,101,"New York","Steuben County",3,79,585,269,316
050,36,101,"New York","Steuben County",3,80,508,230,278
050,36,101,"New York","Steuben County",3,81,461,212,249
050,36,101,"New York","Steuben County",3,82,428,193,235
050,36,101,"New York","Steuben County",3,83,405,169,236
050,36,101,"New York","Steuben County",3,84,373,157,216
050,36,101,"New York","Steuben County",3,85,2134,797,1337
050,36,101,"New York","Steuben County",4,0,983,538,445
050,36,101,"New York","Steuben County",4,1,958,503,455
050,36,101,"New York","Steuben County",4,2,1021,518,503
050,36,101,"New York","Steuben County",4,3,1023,534,489
050,36,101,"New York","Steuben County",4,4,1047,522,525
050,36,101,"New York","Steuben County",4,5,1013,521,492
050,36,101,"New York","Steuben County",4,6,1104,580,524
050,36,101,"New York","Steuben County",4,7,1087,582,505
050,36,101,"New York","Steuben County",4,8,1087,561,526
050,36,101,"New York","Steuben County",4,9,1105,565,540
050,36,101,"New York","Steuben County",4,10,1144,581,563
050,36,101,"New York","Steuben County",4,11,1159,575,584
050,36,101,"New York","Steuben County",4,12,1162,590,572
050,36,101,"New York","Steuben County",4,13,1151,600,551
050,36,101,"New York","Steuben County",4,14,1228,639,589
050,36,101,"New York","Steuben County",4,15,1225,630,595
050,36,101,"New York","Steuben County",4,16,1189,603,586
050,36,101,"New York","Steuben County",4,17,1186,613,573
050,36,101,"New York","Steuben County",4,18,1019,545,474
050,36,101,"New York","Steuben County",4,19,823,458,365
050,36,101,"New York","Steuben County",4,20,876,463,413
050,36,101,"New York","Steuben County",4,21,932,486,446
050,36,101,"New York","Steuben County",4,22,1015,509,506
050,36,101,"New York","Steuben County",4,23,1055,532,523
050,36,101,"New York","Steuben County",4,24,1050,546,504
050,36,101,"New York","Steuben County",4,25,980,508,472
050,36,101,"New York","Steuben County",4,26,992,531,461
050,36,101,"New York","Steuben County",4,27,1049,522,527
050,36,101,"New York","Steuben County",4,28,1069,543,526
050,36,101,"New York","Steuben County",4,29,1078,543,535
050,36,101,"New York","Steuben County",4,30,1063,535,528
050,36,101,"New York","Steuben County",4,31,1135,553,582
050,36,101,"New York","Steuben County",4,32,1183,580,603
050,36,101,"New York","Steuben County",4,33,1119,560,559
050,36,101,"New York","Steuben County",4,34,1105,556,549
050,36,101,"New York","Steuben County",4,35,1081,550,531
050,36,101,"New York","Steuben County",4,36,1062,541,521
050,36,101,"New York","Steuben County",4,37,1106,558,548
050,36,101,"New York","Steuben County",4,38,1088,558,530
050,36,101,"New York","Steuben County",4,39,1112,553,559
050,36,101,"New York","Steuben County",4,40,1095,546,549
050,36,101,"New York","Steuben County",4,41,1136,570,566
050,36,101,"New York","Steuben County",4,42,1123,566,557
050,36,101,"New York","Steuben County",4,43,1097,564,533
050,36,101,"New York","Steuben County",4,44,1062,551,511
050,36,101,"New York","Steuben County",4,45,1050,552,498
050,36,101,"New York","Steuben County",4,46,968,482,486
050,36,101,"New York","Steuben County",4,47,1015,512,503
050,36,101,"New York","Steuben County",4,48,987,488,499
050,36,101,"New York","Steuben County",4,49,1048,511,537
050,36,101,"New York","Steuben County",4,50,1140,567,573
050,36,101,"New York","Steuben County",4,51,1250,615,635
050,36,101,"New York","Steuben County",4,52,1235,609,626
050,36,101,"New York","Steuben County",4,53,1240,625,615
050,36,101,"New York","Steuben County",4,54,1197,618,579
050,36,101,"New York","Steuben County",4,55,1258,639,619
050,36,101,"New York","Steuben County",4,56,1293,640,653
050,36,101,"New York","Steuben County",4,57,1360,681,679
050,36,101,"New York","Steuben County",4,58,1406,688,718
050,36,101,"New York","Steuben County",4,59,1383,702,681
050,36,101,"New York","Steuben County",4,60,1348,682,666
050,36,101,"New York","Steuben County",4,61,1441,715,726
050,36,101,"New York","Steuben County",4,62,1431,714,717
050,36,101,"New York","Steuben County",4,63,1389,706,683
050,36,101,"New York","Steuben County",4,64,1412,724,688
050,36,101,"New York","Steuben County",4,65,1358,686,672
050,36,101,"New York","Steuben County",4,66,1235,621,614
050,36,101,"New York","Steuben County",4,67,1208,613,595
050,36,101,"New York","Steuben County",4,68,1200,589,611
050,36,101,"New York","Steuben County",4,69,1162,579,583
050,36,101,"New York","Steuben County",4,70,1159,574,585
050,36,101,"New York","Steuben County",4,71,1103,541,562
050,36,101,"New York","Steuben County",4,72,1006,491,515
050,36,101,"New York","Steuben County",4,73,961,452,509
050,36,101,"New York","Steuben County",4,74,913,441,472
050,36,101,"New York","Steuben County",4,75,980,450,530
050,36,101,"New York","Steuben County",4,76,670,309,361
050,36,101,"New York","Steuben County",4,77,665,337,328
050,36,101,"New York","Steuben County",4,78,651,300,351
050,36,101,"New York","Steuben County",4,79,659,301,358
050,36,101,"New York","Steuben County",4,80,544,239,305
050,36,101,"New York","Steuben County",4,81,462,208,254
050,36,101,"New York","Steuben County",4,82,414,192,222
050,36,101,"New York","Steuben County",4,83,420,174,246
050,36,101,"New York","Steuben County",4,84,385,159,226
050,36,101,"New York","Steuben County",4,85,2122,802,1320
050,36,101,"New York","Steuben County",5,0,985,541,444
050,36,101,"New York","Steuben County",5,1,971,537,434
050,36,101,"New York","Steuben County",5,2,955,512,443
050,36,101,"New York","Steuben County",5,3,1050,524,526
050,36,101,"New York","Steuben County",5,4,1048,537,511
050,36,101,"New York","Steuben County",5,5,1065,531,534
050,36,101,"New York","Steuben County",5,6,1027,533,494
050,36,101,"New York","Steuben County",5,7,1093,576,517
050,36,101,"New York","Steuben County",5,8,1096,583,513
050,36,101,"New York","Steuben County",5,9,1085,560,525
050,36,101,"New York","Steuben County",5,10,1112,564,548
050,36,101,"New York","Steuben County",5,11,1145,588,557
050,36,101,"New York","Steuben County",5,12,1155,582,573
050,36,101,"New York","Steuben County",5,13,1161,593,568
050,36,101,"New York","Steuben County",5,14,1157,598,559
050,36,101,"New York","Steuben County",5,15,1233,649,584
050,36,101,"New York","Steuben County",5,16,1215,612,603
050,36,101,"New York","Steuben County",5,17,1186,607,579
050,36,101,"New York","Steuben County",5,18,1022,543,479
050,36,101,"New York","Steuben County",5,19,799,425,374
050,36,101,"New York","Steuben County",5,20,894,489,405
050,36,101,"New York","Steuben County",5,21,919,477,442
050,36,101,"New York","Steuben County",5,22,976,501,475
050,36,101,"New York","Steuben County",5,23,1049,526,523
050,36,101,"New York","Steuben County",5,24,1043,527,516
050,36,101,"New York","Steuben County",5,25,1045,546,499
050,36,101,"New York","Steuben County",5,26,992,519,473
050,36,101,"New York","Steuben County",5,27,1010,538,472
050,36,101,"New York","Steuben County",5,28,1037,514,523
050,36,101,"New York","Steuben County",5,29,1053,524,529
050,36,101,"New York","Steuben County",5,30,1066,546,520
050,36,101,"New York","Steuben County",5,31,1071,538,533
050,36,101,"New York","Steuben County",5,32,1162,569,593
050,36,101,"New York","Steuben County",5,33,1175,582,593
050,36,101,"New York","Steuben County",5,34,1122,556,566
050,36,101,"New York","Steuben County",5,35,1111,578,533
050,36,101,"New York","Steuben County",5,36,1066,534,532
050,36,101,"New York","Steuben County",5,37,1043,521,522
050,36,101,"New York","Steuben County",5,38,1103,559,544
050,36,101,"New York","Steuben County",5,39,1063,538,525
050,36,101,"New York","Steuben County",5,40,1117,555,562
050,36,101,"New York","Steuben County",5,41,1106,540,566
050,36,101,"New York","Steuben County",5,42,1139,576,563
050,36,101,"New York","Steuben County",5,43,1115,561,554
050,36,101,"New York","Steuben County",5,44,1094,560,534
050,36,101,"New York","Steuben County",5,45,1042,537,505
050,36,101,"New York","Steuben County",5,46,1048,545,503
050,36,101,"New York","Steuben County",5,47,985,496,489
050,36,101,"New York","Steuben County",5,48,1008,501,507
050,36,101,"New York","Steuben County",5,49,983,481,502
050,36,101,"New York","Steuben County",5,50,1047,518,529
050,36,101,"New York","Steuben County",5,51,1125,562,563
050,36,101,"New York","Steuben County",5,52,1229,595,634
050,36,101,"New York","Steuben County",5,53,1249,615,634
050,36,101,"New York","Steuben County",5,54,1225,620,605
050,36,101,"New York","Steuben County",5,55,1175,600,575
050,36,101,"New York","Steuben County",5,56,1248,625,623
050,36,101,"New York","Steuben County",5,57,1285,639,646
050,36,101,"New York","Steuben County",5,58,1358,678,680
050,36,101,"New York","Steuben County",5,59,1389,682,707
050,36,101,"New York","Steuben County",5,60,1333,668,665
050,36,101,"New York","Steuben County",5,61,1344,686,658
050,36,101,"New York","Steuben County",5,62,1418,696,722
050,36,101,"New York","Steuben County",5,63,1415,700,715
050,36,101,"New York","Steuben County",5,64,1370,691,679
050,36,101,"New York","Steuben County",5,65,1388,708,680
050,36,101,"New York","Steuben County",5,66,1322,668,654
050,36,101,"New York","Steuben County",5,67,1218,625,593
050,36,101,"New York","Steuben County",5,68,1184,593,591
050,36,101,"New York","Steuben County",5,69,1176,580,596
050,36,101,"New York","Steuben County",5,70,1145,571,574
050,36,101,"New York","Steuben County",5,71,1143,554,589
050,36,101,"New York","Steuben County",5,72,1072,523,549
050,36,101,"New York","Steuben County",5,73,974,467,507
050,36,101,"New York","Steuben County",5,74,925,434,491
050,36,101,"New York","Steuben County",5,75,866,421,445
050,36,101,"New York","Steuben County",5,76,954,438,516
050,36,101,"New York","Steuben County",5,77,650,300,350
050,36,101,"New York","Steuben County",5,78,642,320,322
050,36,101,"New York","Steuben County",5,79,616,273,343
050,36,101,"New York","Steuben County",5,80,621,271,350
050,36,101,"New York","Steuben County",5,81,499,220,279
050,36,101,"New York","Steuben County",5,82,414,191,223
050,36,101,"New York","Steuben County",5,83,408,175,233
050,36,101,"New York","Steuben County",5,84,400,164,236
050,36,101,"New York","Steuben County",5,85,2138,831,1307
050,36,103,"New York","Suffolk County",1,0,15681,7997,7684
050,36,103,"New York","Suffolk County",1,1,16019,8155,7864
050,36,103,"New York","Suffolk County",1,2,16462,8396,8066
050,36,103,"New York","Suffolk County",1,3,16601,8407,8194
050,36,103,"New York","Suffolk County",1,4,17058,8745,8313
050,36,103,"New York","Suffolk County",1,5,17045,8511,8534
050,36,103,"New York","Suffolk County",1,6,16753,8473,8280
050,36,103,"New York","Suffolk County",1,7,16895,8616,8279
050,36,103,"New York","Suffolk County",1,8,17444,8885,8559
050,36,103,"New York","Suffolk County",1,9,17633,9058,8575
050,36,103,"New York","Suffolk County",1,10,18031,9225,8806
050,36,103,"New York","Suffolk County",1,11,18263,9333,8930
050,36,103,"New York","Suffolk County",1,12,19288,9891,9397
050,36,103,"New York","Suffolk County",1,13,19537,10124,9413
050,36,103,"New York","Suffolk County",1,14,19696,10182,9514
050,36,103,"New York","Suffolk County",1,15,20144,10315,9829
050,36,103,"New York","Suffolk County",1,16,20775,10754,10021
050,36,103,"New York","Suffolk County",1,17,20647,10578,10069
050,36,103,"New York","Suffolk County",1,18,19743,10348,9395
050,36,103,"New York","Suffolk County",1,19,17947,9310,8637
050,36,103,"New York","Suffolk County",1,20,18697,9511,9186
050,36,103,"New York","Suffolk County",1,21,19458,9781,9677
050,36,103,"New York","Suffolk County",1,22,19334,9801,9533
050,36,103,"New York","Suffolk County",1,23,19314,9775,9539
050,36,103,"New York","Suffolk County",1,24,19471,9893,9578
050,36,103,"New York","Suffolk County",1,25,19424,9869,9555
050,36,103,"New York","Suffolk County",1,26,19213,9835,9378
050,36,103,"New York","Suffolk County",1,27,18932,9719,9213
050,36,103,"New York","Suffolk County",1,28,18458,9521,8937
050,36,103,"New York","Suffolk County",1,29,18421,9576,8845
050,36,103,"New York","Suffolk County",1,30,18109,9301,8808
050,36,103,"New York","Suffolk County",1,31,17466,8945,8521
050,36,103,"New York","Suffolk County",1,32,17557,8954,8603
050,36,103,"New York","Suffolk County",1,33,17756,9087,8669
050,36,103,"New York","Suffolk County",1,34,17605,9022,8583
050,36,103,"New York","Suffolk County",1,35,17474,8952,8522
050,36,103,"New York","Suffolk County",1,36,17322,8774,8548
050,36,103,"New York","Suffolk County",1,37,17782,9009,8773
050,36,103,"New York","Suffolk County",1,38,17965,9186,8779
050,36,103,"New York","Suffolk County",1,39,18436,9402,9034
050,36,103,"New York","Suffolk County",1,40,18650,9570,9080
050,36,103,"New York","Suffolk County",1,41,18231,9264,8967
050,36,103,"New York","Suffolk County",1,42,18359,9190,9169
050,36,103,"New York","Suffolk County",1,43,18229,9147,9082
050,36,103,"New York","Suffolk County",1,44,18325,9252,9073
050,36,103,"New York","Suffolk County",1,45,18949,9538,9411
050,36,103,"New York","Suffolk County",1,46,18535,9333,9202
050,36,103,"New York","Suffolk County",1,47,19175,9525,9650
050,36,103,"New York","Suffolk County",1,48,20717,10265,10452
050,36,103,"New York","Suffolk County",1,49,22644,11217,11427
050,36,103,"New York","Suffolk County",1,50,22696,11457,11239
050,36,103,"New York","Suffolk County",1,51,22529,11228,11301
050,36,103,"New York","Suffolk County",1,52,22614,11224,11390
050,36,103,"New York","Suffolk County",1,53,23436,11668,11768
050,36,103,"New York","Suffolk County",1,54,23963,11907,12056
050,36,103,"New York","Suffolk County",1,55,25066,12417,12649
050,36,103,"New York","Suffolk County",1,56,24791,12382,12409
050,36,103,"New York","Suffolk County",1,57,24178,12053,12125
050,36,103,"New York","Suffolk County",1,58,24340,12239,12101
050,36,103,"New York","Suffolk County",1,59,24214,12061,12153
050,36,103,"New York","Suffolk County",1,60,23470,11664,11806
050,36,103,"New York","Suffolk County",1,61,22283,11096,11187
050,36,103,"New York","Suffolk County",1,62,21606,10731,10875
050,36,103,"New York","Suffolk County",1,63,20263,10010,10253
050,36,103,"New York","Suffolk County",1,64,19185,9424,9761
050,36,103,"New York","Suffolk County",1,65,18355,9013,9342
050,36,103,"New York","Suffolk County",1,66,17041,8213,8828
050,36,103,"New York","Suffolk County",1,67,16333,7879,8454
050,36,103,"New York","Suffolk County",1,68,15603,7539,8064
050,36,103,"New York","Suffolk County",1,69,14583,6889,7694
050,36,103,"New York","Suffolk County",1,70,14414,6693,7721
050,36,103,"New York","Suffolk County",1,71,14081,6556,7525
050,36,103,"New York","Suffolk County",1,72,14316,6653,7663
050,36,103,"New York","Suffolk County",1,73,14470,6724,7746
050,36,103,"New York","Suffolk County",1,74,10395,4685,5710
050,36,103,"New York","Suffolk County",1,75,10358,4625,5733
050,36,103,"New York","Suffolk County",1,76,10299,4559,5740
050,36,103,"New York","Suffolk County",1,77,10261,4520,5741
050,36,103,"New York","Suffolk County",1,78,8629,3760,4869
050,36,103,"New York","Suffolk County",1,79,7677,3317,4360
050,36,103,"New York","Suffolk County",1,80,6903,2928,3975
050,36,103,"New York","Suffolk County",1,81,6666,2842,3824
050,36,103,"New York","Suffolk County",1,82,6121,2591,3530
050,36,103,"New York","Suffolk County",1,83,5444,2206,3238
050,36,103,"New York","Suffolk County",1,84,5005,1984,3021
050,36,103,"New York","Suffolk County",1,85,32636,11334,21302
050,36,103,"New York","Suffolk County",2,0,15755,8008,7747
050,36,103,"New York","Suffolk County",2,1,15967,8129,7838
050,36,103,"New York","Suffolk County",2,2,16400,8364,8036
050,36,103,"New York","Suffolk County",2,3,16549,8401,8148
050,36,103,"New York","Suffolk County",2,4,16997,8682,8315
050,36,103,"New York","Suffolk County",2,5,17075,8587,8488
050,36,103,"New York","Suffolk County",2,6,16857,8508,8349
050,36,103,"New York","Suffolk County",2,7,16858,8574,8284
050,36,103,"New York","Suffolk County",2,8,17250,8789,8461
050,36,103,"New York","Suffolk County",2,9,17589,9024,8565
050,36,103,"New York","Suffolk County",2,10,17929,9173,8756
050,36,103,"New York","Suffolk County",2,11,18136,9273,8863
050,36,103,"New York","Suffolk County",2,12,19126,9795,9331
050,36,103,"New York","Suffolk County",2,13,19456,10060,9396
050,36,103,"New York","Suffolk County",2,14,19658,10163,9495
050,36,103,"New York","Suffolk County",2,15,20051,10290,9761
050,36,103,"New York","Suffolk County",2,16,20636,10656,9980
050,36,103,"New York","Suffolk County",2,17,20677,10614,10063
050,36,103,"New York","Suffolk County",2,18,19612,10274,9338
050,36,103,"New York","Suffolk County",2,19,17959,9329,8630
050,36,103,"New York","Suffolk County",2,20,18865,9585,9280
050,36,103,"New York","Suffolk County",2,21,19367,9727,9640
050,36,103,"New York","Suffolk County",2,22,19308,9748,9560
050,36,103,"New York","Suffolk County",2,23,19310,9789,9521
050,36,103,"New York","Suffolk County",2,24,19349,9836,9513
050,36,103,"New York","Suffolk County",2,25,19407,9864,9543
050,36,103,"New York","Suffolk County",2,26,19232,9826,9406
050,36,103,"New York","Suffolk County",2,27,18917,9704,9213
050,36,103,"New York","Suffolk County",2,28,18586,9590,8996
050,36,103,"New York","Suffolk County",2,29,18395,9522,8873
050,36,103,"New York","Suffolk County",2,30,18285,9406,8879
050,36,103,"New York","Suffolk County",2,31,17553,8990,8563
050,36,103,"New York","Suffolk County",2,32,17549,8950,8599
050,36,103,"New York","Suffolk County",2,33,17699,9044,8655
050,36,103,"New York","Suffolk County",2,34,17674,9061,8613
050,36,103,"New York","Suffolk County",2,35,17624,9031,8593
050,36,103,"New York","Suffolk County",2,36,17290,8781,8509
050,36,103,"New York","Suffolk County",2,37,17705,8969,8736
050,36,103,"New York","Suffolk County",2,38,18012,9185,8827
050,36,103,"New York","Suffolk County",2,39,18264,9320,8944
050,36,103,"New York","Suffolk County",2,40,18747,9612,9135
050,36,103,"New York","Suffolk County",2,41,18263,9290,8973
050,36,103,"New York","Suffolk County",2,42,18244,9173,9071
050,36,103,"New York","Suffolk County",2,43,18363,9209,9154
050,36,103,"New York","Suffolk County",2,44,18155,9151,9004
050,36,103,"New York","Suffolk County",2,45,18880,9501,9379
050,36,103,"New York","Suffolk County",2,46,18577,9355,9222
050,36,103,"New York","Suffolk County",2,47,18967,9449,9518
050,36,103,"New York","Suffolk County",2,48,20323,10087,10236
050,36,103,"New York","Suffolk County",2,49,22229,11015,11214
050,36,103,"New York","Suffolk County",2,50,22662,11393,11269
050,36,103,"New York","Suffolk County",2,51,22451,11223,11228
050,36,103,"New York","Suffolk County",2,52,22512,11184,11328
050,36,103,"New York","Suffolk County",2,53,23168,11518,11650
050,36,103,"New York","Suffolk County",2,54,23710,11784,11926
050,36,103,"New York","Suffolk County",2,55,24730,12251,12479
050,36,103,"New York","Suffolk County",2,56,24836,12371,12465
050,36,103,"New York","Suffolk County",2,57,24242,12087,12155
050,36,103,"New York","Suffolk County",2,58,24200,12141,12059
050,36,103,"New York","Suffolk County",2,59,24214,12073,12141
050,36,103,"New York","Suffolk County",2,60,23489,11668,11821
050,36,103,"New York","Suffolk County",2,61,22406,11137,11269
050,36,103,"New York","Suffolk County",2,62,21581,10716,10865
050,36,103,"New York","Suffolk County",2,63,20633,10192,10441
050,36,103,"New York","Suffolk County",2,64,19214,9431,9783
050,36,103,"New York","Suffolk County",2,65,18396,9011,9385
050,36,103,"New York","Suffolk County",2,66,17239,8335,8904
050,36,103,"New York","Suffolk County",2,67,16328,7862,8466
050,36,103,"New York","Suffolk County",2,68,15536,7486,8050
050,36,103,"New York","Suffolk County",2,69,14783,7005,7778
050,36,103,"New York","Suffolk County",2,70,14297,6660,7637
050,36,103,"New York","Suffolk County",2,71,14037,6511,7526
050,36,103,"New York","Suffolk County",2,72,13905,6446,7459
050,36,103,"New York","Suffolk County",2,73,14939,6930,8009
050,36,103,"New York","Suffolk County",2,74,10613,4801,5812
050,36,103,"New York","Suffolk County",2,75,10267,4584,5683
050,36,103,"New York","Suffolk County",2,76,10077,4457,5620
050,36,103,"New York","Suffolk County",2,77,10328,4541,5787
050,36,103,"New York","Suffolk County",2,78,8702,3784,4918
050,36,103,"New York","Suffolk County",2,79,7693,3329,4364
050,36,103,"New York","Suffolk County",2,80,6925,2942,3983
050,36,103,"New York","Suffolk County",2,81,6525,2772,3753
050,36,103,"New York","Suffolk County",2,82,6110,2583,3527
050,36,103,"New York","Suffolk County",2,83,5374,2196,3178
050,36,103,"New York","Suffolk County",2,84,4920,1941,2979
050,36,103,"New York","Suffolk County",2,85,31346,10946,20400
050,36,103,"New York","Suffolk County",3,0,15139,7704,7435
050,36,103,"New York","Suffolk County",3,1,15940,8130,7810
050,36,103,"New York","Suffolk County",3,2,16275,8317,7958
050,36,103,"New York","Suffolk County",3,3,16609,8454,8155
050,36,103,"New York","Suffolk County",3,4,16819,8507,8312
050,36,103,"New York","Suffolk County",3,5,17180,8767,8413
050,36,103,"New York","Suffolk County",3,6,17252,8681,8571
050,36,103,"New York","Suffolk County",3,7,17043,8602,8441
050,36,103,"New York","Suffolk County",3,8,17014,8634,8380
050,36,103,"New York","Suffolk County",3,9,17313,8841,8472
050,36,103,"New York","Suffolk County",3,10,17701,9082,8619
050,36,103,"New York","Suffolk County",3,11,17992,9221,8771
050,36,103,"New York","Suffolk County",3,12,18251,9331,8920
050,36,103,"New York","Suffolk County",3,13,19186,9825,9361
050,36,103,"New York","Suffolk County",3,14,19495,10074,9421
050,36,103,"New York","Suffolk County",3,15,19789,10196,9593
050,36,103,"New York","Suffolk County",3,16,20030,10293,9737
050,36,103,"New York","Suffolk County",3,17,20674,10659,10015
050,36,103,"New York","Suffolk County",3,18,20509,10784,9725
050,36,103,"New York","Suffolk County",3,19,18924,9914,9010
050,36,103,"New York","Suffolk County",3,20,19813,10085,9728
050,36,103,"New York","Suffolk County",3,21,20358,10171,10187
050,36,103,"New York","Suffolk County",3,22,19788,9924,9864
050,36,103,"New York","Suffolk County",3,23,19637,10016,9621
050,36,103,"New York","Suffolk County",3,24,19467,9967,9500
050,36,103,"New York","Suffolk County",3,25,19430,9879,9551
050,36,103,"New York","Suffolk County",3,26,19466,9927,9539
050,36,103,"New York","Suffolk County",3,27,19324,9917,9407
050,36,103,"New York","Suffolk County",3,28,19025,9763,9262
050,36,103,"New York","Suffolk County",3,29,18880,9723,9157
050,36,103,"New York","Suffolk County",3,30,18860,9738,9122
050,36,103,"New York","Suffolk County",3,31,18669,9520,9149
050,36,103,"New York","Suffolk County",3,32,18212,9361,8851
050,36,103,"New York","Suffolk County",3,33,18098,9229,8869
050,36,103,"New York","Suffolk County",3,34,18105,9216,8889
050,36,103,"New York","Suffolk County",3,35,18209,9350,8859
050,36,103,"New York","Suffolk County",3,36,18043,9258,8785
050,36,103,"New York","Suffolk County",3,37,17603,8908,8695
050,36,103,"New York","Suffolk County",3,38,18079,9186,8893
050,36,103,"New York","Suffolk County",3,39,18350,9356,8994
050,36,103,"New York","Suffolk County",3,40,18555,9486,9069
050,36,103,"New York","Suffolk County",3,41,18967,9721,9246
050,36,103,"New York","Suffolk County",3,42,18469,9405,9064
050,36,103,"New York","Suffolk County",3,43,18424,9272,9152
050,36,103,"New York","Suffolk County",3,44,18509,9257,9252
050,36,103,"New York","Suffolk County",3,45,18257,9195,9062
050,36,103,"New York","Suffolk County",3,46,18891,9558,9333
050,36,103,"New York","Suffolk County",3,47,18623,9400,9223
050,36,103,"New York","Suffolk County",3,48,19058,9540,9518
050,36,103,"New York","Suffolk County",3,49,20305,10090,10215
050,36,103,"New York","Suffolk County",3,50,22215,11011,11204
050,36,103,"New York","Suffolk County",3,51,22608,11376,11232
050,36,103,"New York","Suffolk County",3,52,22336,11156,11180
050,36,103,"New York","Suffolk County",3,53,22371,11090,11281
050,36,103,"New York","Suffolk County",3,54,23065,11464,11601
050,36,103,"New York","Suffolk County",3,55,23542,11696,11846
050,36,103,"New York","Suffolk County",3,56,24469,12130,12339
050,36,103,"New York","Suffolk County",3,57,24556,12189,12367
050,36,103,"New York","Suffolk County",3,58,24010,11956,12054
050,36,103,"New York","Suffolk County",3,59,23891,11933,11958
050,36,103,"New York","Suffolk County",3,60,23842,11907,11935
050,36,103,"New York","Suffolk County",3,61,23106,11435,11671
050,36,103,"New York","Suffolk County",3,62,22017,10911,11106
050,36,103,"New York","Suffolk County",3,63,21163,10485,10678
050,36,103,"New York","Suffolk County",3,64,20219,9946,10273
050,36,103,"New York","Suffolk County",3,65,18963,9318,9645
050,36,103,"New York","Suffolk County",3,66,17981,8761,9220
050,36,103,"New York","Suffolk County",3,67,16877,8118,8759
050,36,103,"New York","Suffolk County",3,68,15925,7648,8277
050,36,103,"New York","Suffolk County",3,69,15232,7306,7926
050,36,103,"New York","Suffolk County",3,70,14471,6818,7653
050,36,103,"New York","Suffolk County",3,71,13955,6428,7527
050,36,103,"New York","Suffolk County",3,72,13656,6297,7359
050,36,103,"New York","Suffolk County",3,73,13561,6307,7254
050,36,103,"New York","Suffolk County",3,74,14536,6672,7864
050,36,103,"New York","Suffolk County",3,75,10351,4647,5704
050,36,103,"New York","Suffolk County",3,76,9859,4371,5488
050,36,103,"New York","Suffolk County",3,77,9701,4252,5449
050,36,103,"New York","Suffolk County",3,78,9968,4325,5643
050,36,103,"New York","Suffolk County",3,79,8364,3606,4758
050,36,103,"New York","Suffolk County",3,80,7304,3151,4153
050,36,103,"New York","Suffolk County",3,81,6640,2751,3889
050,36,103,"New York","Suffolk County",3,82,6131,2575,3556
050,36,103,"New York","Suffolk County",3,83,5718,2377,3341
050,36,103,"New York","Suffolk County",3,84,5033,1999,3034
050,36,103,"New York","Suffolk County",3,85,31570,10945,20625
050,36,103,"New York","Suffolk County",4,0,16129,8247,7882
050,36,103,"New York","Suffolk County",4,1,15358,7793,7565
050,36,103,"New York","Suffolk County",4,2,16109,8240,7869
050,36,103,"New York","Suffolk County",4,3,16333,8272,8061
050,36,103,"New York","Suffolk County",4,4,16663,8478,8185
050,36,103,"New York","Suffolk County",4,5,17010,8624,8386
050,36,103,"New York","Suffolk County",4,6,17275,8827,8448
050,36,103,"New York","Suffolk County",4,7,17344,8705,8639
050,36,103,"New York","Suffolk County",4,8,17066,8608,8458
050,36,103,"New York","Suffolk County",4,9,16996,8672,8324
050,36,103,"New York","Suffolk County",4,10,17378,8866,8512
050,36,103,"New York","Suffolk County",4,11,17756,9148,8608
050,36,103,"New York","Suffolk County",4,12,18073,9252,8821
050,36,103,"New York","Suffolk County",4,13,18285,9341,8944
050,36,103,"New York","Suffolk County",4,14,19266,9871,9395
050,36,103,"New York","Suffolk County",4,15,19536,10069,9467
050,36,103,"New York","Suffolk County",4,16,19756,10161,9595
050,36,103,"New York","Suffolk County",4,17,20073,10258,9815
050,36,103,"New York","Suffolk County",4,18,20303,10719,9584
050,36,103,"New York","Suffolk County",4,19,18530,9759,8771
050,36,103,"New York","Suffolk County",4,20,19237,9889,9348
050,36,103,"New York","Suffolk County",4,21,20119,10069,10050
050,36,103,"New York","Suffolk County",4,22,19805,9901,9904
050,36,103,"New York","Suffolk County",4,23,19479,9897,9582
050,36,103,"New York","Suffolk County",4,24,19234,9933,9301
050,36,103,"New York","Suffolk County",4,25,19054,9758,9296
050,36,103,"New York","Suffolk County",4,26,18935,9626,9309
050,36,103,"New York","Suffolk County",4,27,18866,9645,9221
050,36,103,"New York","Suffolk County",4,28,18901,9664,9237
050,36,103,"New York","Suffolk County",4,29,18548,9405,9143
050,36,103,"New York","Suffolk County",4,30,18765,9651,9114
050,36,103,"New York","Suffolk County",4,31,18838,9681,9157
050,36,103,"New York","Suffolk County",4,32,18891,9685,9206
050,36,103,"New York","Suffolk County",4,33,18368,9412,8956
050,36,103,"New York","Suffolk County",4,34,18267,9348,8919
050,36,103,"New York","Suffolk County",4,35,18256,9315,8941
050,36,103,"New York","Suffolk County",4,36,18255,9354,8901
050,36,103,"New York","Suffolk County",4,37,18048,9222,8826
050,36,103,"New York","Suffolk County",4,38,17736,8989,8747
050,36,103,"New York","Suffolk County",4,39,18193,9207,8986
050,36,103,"New York","Suffolk County",4,40,18470,9422,9048
050,36,103,"New York","Suffolk County",4,41,18546,9482,9064
050,36,103,"New York","Suffolk County",4,42,18902,9716,9186
050,36,103,"New York","Suffolk County",4,43,18453,9381,9072
050,36,103,"New York","Suffolk County",4,44,18441,9269,9172
050,36,103,"New York","Suffolk County",4,45,18501,9236,9265
050,36,103,"New York","Suffolk County",4,46,18205,9177,9028
050,36,103,"New York","Suffolk County",4,47,18803,9501,9302
050,36,103,"New York","Suffolk County",4,48,18563,9398,9165
050,36,103,"New York","Suffolk County",4,49,18926,9448,9478
050,36,103,"New York","Suffolk County",4,50,20083,10015,10068
050,36,103,"New York","Suffolk County",4,51,22110,10947,11163
050,36,103,"New York","Suffolk County",4,52,22370,11276,11094
050,36,103,"New York","Suffolk County",4,53,22136,11066,11070
050,36,103,"New York","Suffolk County",4,54,22163,10998,11165
050,36,103,"New York","Suffolk County",4,55,22729,11325,11404
050,36,103,"New York","Suffolk County",4,56,23173,11505,11668
050,36,103,"New York","Suffolk County",4,57,24080,11942,12138
050,36,103,"New York","Suffolk County",4,58,24132,11994,12138
050,36,103,"New York","Suffolk County",4,59,23528,11664,11864
050,36,103,"New York","Suffolk County",4,60,23365,11685,11680
050,36,103,"New York","Suffolk County",4,61,23335,11616,11719
050,36,103,"New York","Suffolk County",4,62,22571,11161,11410
050,36,103,"New York","Suffolk County",4,63,21507,10634,10873
050,36,103,"New York","Suffolk County",4,64,20641,10163,10478
050,36,103,"New York","Suffolk County",4,65,19789,9711,10078
050,36,103,"New York","Suffolk County",4,66,18404,8997,9407
050,36,103,"New York","Suffolk County",4,67,17575,8535,9040
050,36,103,"New York","Suffolk County",4,68,16380,7801,8579
050,36,103,"New York","Suffolk County",4,69,15539,7423,8116
050,36,103,"New York","Suffolk County",4,70,14901,7092,7809
050,36,103,"New York","Suffolk County",4,71,14103,6628,7475
050,36,103,"New York","Suffolk County",4,72,13590,6217,7373
050,36,103,"New York","Suffolk County",4,73,13252,6104,7148
050,36,103,"New York","Suffolk County",4,74,13134,6061,7073
050,36,103,"New York","Suffolk County",4,75,14069,6424,7645
050,36,103,"New York","Suffolk County",4,76,9996,4470,5526
050,36,103,"New York","Suffolk County",4,77,9501,4196,5305
050,36,103,"New York","Suffolk County",4,78,9368,4076,5292
050,36,103,"New York","Suffolk County",4,79,9536,4103,5433
050,36,103,"New York","Suffolk County",4,80,7942,3401,4541
050,36,103,"New York","Suffolk County",4,81,7022,2980,4042
050,36,103,"New York","Suffolk County",4,82,6303,2598,3705
050,36,103,"New York","Suffolk County",4,83,5717,2389,3328
050,36,103,"New York","Suffolk County",4,84,5313,2158,3155
050,36,103,"New York","Suffolk County",4,85,31773,11011,20762
050,36,103,"New York","Suffolk County",5,0,16112,8246,7866
050,36,103,"New York","Suffolk County",5,1,16163,8220,7943
050,36,103,"New York","Suffolk County",5,2,15536,7899,7637
050,36,103,"New York","Suffolk County",5,3,16143,8250,7893
050,36,103,"New York","Suffolk County",5,4,16328,8285,8043
050,36,103,"New York","Suffolk County",5,5,16793,8574,8219
050,36,103,"New York","Suffolk County",5,6,17004,8634,8370
050,36,103,"New York","Suffolk County",5,7,17281,8828,8453
050,36,103,"New York","Suffolk County",5,8,17331,8702,8629
050,36,103,"New York","Suffolk County",5,9,17019,8580,8439
050,36,103,"New York","Suffolk County",5,10,16999,8647,8352
050,36,103,"New York","Suffolk County",5,11,17322,8884,8438
050,36,103,"New York","Suffolk County",5,12,17746,9158,8588
050,36,103,"New York","Suffolk County",5,13,18063,9251,8812
050,36,103,"New York","Suffolk County",5,14,18261,9326,8935
050,36,103,"New York","Suffolk County",5,15,19286,9869,9417
050,36,103,"New York","Suffolk County",5,16,19570,10078,9492
050,36,103,"New York","Suffolk County",5,17,19826,10176,9650
050,36,103,"New York","Suffolk County",5,18,19709,10341,9368
050,36,103,"New York","Suffolk County",5,19,18584,9848,8736
050,36,103,"New York","Suffolk County",5,20,19128,9829,9299
050,36,103,"New York","Suffolk County",5,21,19725,9932,9793
050,36,103,"New York","Suffolk County",5,22,19544,9765,9779
050,36,103,"New York","Suffolk County",5,23,19549,9884,9665
050,36,103,"New York","Suffolk County",5,24,19061,9805,9256
050,36,103,"New York","Suffolk County",5,25,18839,9727,9112
050,36,103,"New York","Suffolk County",5,26,18596,9553,9043
050,36,103,"New York","Suffolk County",5,27,18393,9315,9078
050,36,103,"New York","Suffolk County",5,28,18503,9428,9075
050,36,103,"New York","Suffolk County",5,29,18726,9483,9243
050,36,103,"New York","Suffolk County",5,30,18513,9348,9165
050,36,103,"New York","Suffolk County",5,31,18673,9615,9058
050,36,103,"New York","Suffolk County",5,32,18853,9683,9170
050,36,103,"New York","Suffolk County",5,33,18938,9715,9223
050,36,103,"New York","Suffolk County",5,34,18475,9460,9015
050,36,103,"New York","Suffolk County",5,35,18280,9375,8905
050,36,103,"New York","Suffolk County",5,36,18274,9316,8958
050,36,103,"New York","Suffolk County",5,37,18230,9308,8922
050,36,103,"New York","Suffolk County",5,38,18120,9247,8873
050,36,103,"New York","Suffolk County",5,39,17798,8990,8808
050,36,103,"New York","Suffolk County",5,40,18235,9226,9009
050,36,103,"New York","Suffolk County",5,41,18356,9373,8983
050,36,103,"New York","Suffolk County",5,42,18449,9429,9020
050,36,103,"New York","Suffolk County",5,43,18782,9640,9142
050,36,103,"New York","Suffolk County",5,44,18384,9332,9052
050,36,103,"New York","Suffolk County",5,45,18491,9302,9189
050,36,103,"New York","Suffolk County",5,46,18384,9170,9214
050,36,103,"New York","Suffolk County",5,47,18233,9159,9074
050,36,103,"New York","Suffolk County",5,48,18769,9505,9264
050,36,103,"New York","Suffolk County",5,49,18441,9314,9127
050,36,103,"New York","Suffolk County",5,50,18753,9379,9374
050,36,103,"New York","Suffolk County",5,51,19967,9959,10008
050,36,103,"New York","Suffolk County",5,52,22000,10852,11148
050,36,103,"New York","Suffolk County",5,53,22157,11157,11000
050,36,103,"New York","Suffolk County",5,54,21957,10992,10965
050,36,103,"New York","Suffolk County",5,55,21894,10885,11009
050,36,103,"New York","Suffolk County",5,56,22329,11144,11185
050,36,103,"New York","Suffolk County",5,57,22830,11343,11487
050,36,103,"New York","Suffolk County",5,58,23745,11768,11977
050,36,103,"New York","Suffolk County",5,59,23709,11778,11931
050,36,103,"New York","Suffolk County",5,60,23073,11440,11633
050,36,103,"New York","Suffolk County",5,61,22925,11450,11475
050,36,103,"New York","Suffolk County",5,62,22857,11339,11518
050,36,103,"New York","Suffolk County",5,63,22141,10928,11213
050,36,103,"New York","Suffolk County",5,64,21056,10393,10663
050,36,103,"New York","Suffolk County",5,65,20213,9907,10306
050,36,103,"New York","Suffolk County",5,66,19312,9454,9858
050,36,103,"New York","Suffolk County",5,67,18064,8804,9260
050,36,103,"New York","Suffolk County",5,68,17171,8281,8890
050,36,103,"New York","Suffolk County",5,69,16055,7621,8434
050,36,103,"New York","Suffolk County",5,70,15161,7224,7937
050,36,103,"New York","Suffolk County",5,71,14564,6905,7659
050,36,103,"New York","Suffolk County",5,72,13765,6427,7338
050,36,103,"New York","Suffolk County",5,73,13282,6087,7195
050,36,103,"New York","Suffolk County",5,74,12868,5899,6969
050,36,103,"New York","Suffolk County",5,75,12826,5912,6914
050,36,103,"New York","Suffolk County",5,76,13655,6181,7474
050,36,103,"New York","Suffolk County",5,77,9684,4314,5370
050,36,103,"New York","Suffolk County",5,78,9243,4031,5212
050,36,103,"New York","Suffolk County",5,79,9029,3885,5144
050,36,103,"New York","Suffolk County",5,80,9099,3908,5191
050,36,103,"New York","Suffolk County",5,81,7637,3212,4425
050,36,103,"New York","Suffolk County",5,82,6680,2818,3862
050,36,103,"New York","Suffolk County",5,83,5889,2407,3482
050,36,103,"New York","Suffolk County",5,84,5356,2199,3157
050,36,103,"New York","Suffolk County",5,85,32406,11307,21099
050,36,105,"New York","Sullivan County",1,0,879,451,428
050,36,105,"New York","Sullivan County",1,1,924,487,437
050,36,105,"New York","Sullivan County",1,2,927,481,446
050,36,105,"New York","Sullivan County",1,3,946,488,458
050,36,105,"New York","Sullivan County",1,4,946,507,439
050,36,105,"New York","Sullivan County",1,5,935,496,439
050,36,105,"New York","Sullivan County",1,6,895,464,431
050,36,105,"New York","Sullivan County",1,7,926,459,467
050,36,105,"New York","Sullivan County",1,8,888,461,427
050,36,105,"New York","Sullivan County",1,9,889,459,430
050,36,105,"New York","Sullivan County",1,10,920,479,441
050,36,105,"New York","Sullivan County",1,11,913,476,437
050,36,105,"New York","Sullivan County",1,12,961,501,460
050,36,105,"New York","Sullivan County",1,13,1006,520,486
050,36,105,"New York","Sullivan County",1,14,932,463,469
050,36,105,"New York","Sullivan County",1,15,968,508,460
050,36,105,"New York","Sullivan County",1,16,973,525,448
050,36,105,"New York","Sullivan County",1,17,956,494,462
050,36,105,"New York","Sullivan County",1,18,928,511,417
050,36,105,"New York","Sullivan County",1,19,840,445,395
050,36,105,"New York","Sullivan County",1,20,1011,485,526
050,36,105,"New York","Sullivan County",1,21,984,525,459
050,36,105,"New York","Sullivan County",1,22,869,477,392
050,36,105,"New York","Sullivan County",1,23,950,512,438
050,36,105,"New York","Sullivan County",1,24,895,438,457
050,36,105,"New York","Sullivan County",1,25,892,445,447
050,36,105,"New York","Sullivan County",1,26,914,481,433
050,36,105,"New York","Sullivan County",1,27,954,513,441
050,36,105,"New York","Sullivan County",1,28,935,495,440
050,36,105,"New York","Sullivan County",1,29,958,498,460
050,36,105,"New York","Sullivan County",1,30,958,527,431
050,36,105,"New York","Sullivan County",1,31,950,526,424
050,36,105,"New York","Sullivan County",1,32,923,508,415
050,36,105,"New York","Sullivan County",1,33,913,472,441
050,36,105,"New York","Sullivan County",1,34,950,496,454
050,36,105,"New York","Sullivan County",1,35,927,505,422
050,36,105,"New York","Sullivan County",1,36,928,470,458
050,36,105,"New York","Sullivan County",1,37,977,494,483
050,36,105,"New York","Sullivan County",1,38,953,495,458
050,36,105,"New York","Sullivan County",1,39,946,501,445
050,36,105,"New York","Sullivan County",1,40,953,530,423
050,36,105,"New York","Sullivan County",1,41,932,500,432
050,36,105,"New York","Sullivan County",1,42,915,477,438
050,36,105,"New York","Sullivan County",1,43,878,472,406
050,36,105,"New York","Sullivan County",1,44,862,494,368
050,36,105,"New York","Sullivan County",1,45,905,504,401
050,36,105,"New York","Sullivan County",1,46,886,497,389
050,36,105,"New York","Sullivan County",1,47,921,522,399
050,36,105,"New York","Sullivan County",1,48,1006,564,442
050,36,105,"New York","Sullivan County",1,49,1075,577,498
050,36,105,"New York","Sullivan County",1,50,1038,553,485
050,36,105,"New York","Sullivan County",1,51,1073,569,504
050,36,105,"New York","Sullivan County",1,52,1032,541,491
050,36,105,"New York","Sullivan County",1,53,1127,611,516
050,36,105,"New York","Sullivan County",1,54,1204,640,564
050,36,105,"New York","Sullivan County",1,55,1256,667,589
050,36,105,"New York","Sullivan County",1,56,1223,625,598
050,36,105,"New York","Sullivan County",1,57,1183,589,594
050,36,105,"New York","Sullivan County",1,58,1190,620,570
050,36,105,"New York","Sullivan County",1,59,1219,636,583
050,36,105,"New York","Sullivan County",1,60,1182,621,561
050,36,105,"New York","Sullivan County",1,61,1153,598,555
050,36,105,"New York","Sullivan County",1,62,1142,593,549
050,36,105,"New York","Sullivan County",1,63,1090,587,503
050,36,105,"New York","Sullivan County",1,64,1088,557,531
050,36,105,"New York","Sullivan County",1,65,1002,496,506
050,36,105,"New York","Sullivan County",1,66,974,496,478
050,36,105,"New York","Sullivan County",1,67,1019,519,500
050,36,105,"New York","Sullivan County",1,68,979,484,495
050,36,105,"New York","Sullivan County",1,69,903,446,457
050,36,105,"New York","Sullivan County",1,70,907,447,460
050,36,105,"New York","Sullivan County",1,71,887,428,459
050,36,105,"New York","Sullivan County",1,72,867,415,452
050,36,105,"New York","Sullivan County",1,73,856,438,418
050,36,105,"New York","Sullivan County",1,74,630,311,319
050,36,105,"New York","Sullivan County",1,75,605,294,311
050,36,105,"New York","Sullivan County",1,76,608,296,312
050,36,105,"New York","Sullivan County",1,77,582,274,308
050,36,105,"New York","Sullivan County",1,78,521,259,262
050,36,105,"New York","Sullivan County",1,79,462,241,221
050,36,105,"New York","Sullivan County",1,80,418,212,206
050,36,105,"New York","Sullivan County",1,81,370,188,182
050,36,105,"New York","Sullivan County",1,82,357,171,186
050,36,105,"New York","Sullivan County",1,83,274,127,147
050,36,105,"New York","Sullivan County",1,84,231,109,122
050,36,105,"New York","Sullivan County",1,85,1289,525,764
050,36,105,"New York","Sullivan County",2,0,874,458,416
050,36,105,"New York","Sullivan County",2,1,914,480,434
050,36,105,"New York","Sullivan County",2,2,934,484,450
050,36,105,"New York","Sullivan County",2,3,945,489,456
050,36,105,"New York","Sullivan County",2,4,955,508,447
050,36,105,"New York","Sullivan County",2,5,939,500,439
050,36,105,"New York","Sullivan County",2,6,913,478,435
050,36,105,"New York","Sullivan County",2,7,924,462,462
050,36,105,"New York","Sullivan County",2,8,893,458,435
050,36,105,"New York","Sullivan County",2,9,889,459,430
050,36,105,"New York","Sullivan County",2,10,914,476,438
050,36,105,"New York","Sullivan County",2,11,913,478,435
050,36,105,"New York","Sullivan County",2,12,959,501,458
050,36,105,"New York","Sullivan County",2,13,992,511,481
050,36,105,"New York","Sullivan County",2,14,947,475,472
050,36,105,"New York","Sullivan County",2,15,962,498,464
050,36,105,"New York","Sullivan County",2,16,982,525,457
050,36,105,"New York","Sullivan County",2,17,963,498,465
050,36,105,"New York","Sullivan County",2,18,912,504,408
050,36,105,"New York","Sullivan County",2,19,838,444,394
050,36,105,"New York","Sullivan County",2,20,1026,486,540
050,36,105,"New York","Sullivan County",2,21,983,527,456
050,36,105,"New York","Sullivan County",2,22,866,469,397
050,36,105,"New York","Sullivan County",2,23,946,511,435
050,36,105,"New York","Sullivan County",2,24,899,442,457
050,36,105,"New York","Sullivan County",2,25,891,447,444
050,36,105,"New York","Sullivan County",2,26,913,477,436
050,36,105,"New York","Sullivan County",2,27,937,500,437
050,36,105,"New York","Sullivan County",2,28,942,502,440
050,36,105,"New York","Sullivan County",2,29,949,495,454
050,36,105,"New York","Sullivan County",2,30,965,523,442
050,36,105,"New York","Sullivan County",2,31,948,520,428
050,36,105,"New York","Sullivan County",2,32,927,509,418
050,36,105,"New York","Sullivan County",2,33,909,475,434
050,36,105,"New York","Sullivan County",2,34,939,490,449
050,36,105,"New York","Sullivan County",2,35,936,503,433
050,36,105,"New York","Sullivan County",2,36,921,469,452
050,36,105,"New York","Sullivan County",2,37,980,497,483
050,36,105,"New York","Sullivan County",2,38,954,492,462
050,36,105,"New York","Sullivan County",2,39,941,494,447
050,36,105,"New York","Sullivan County",2,40,964,532,432
050,36,105,"New York","Sullivan County",2,41,928,499,429
050,36,105,"New York","Sullivan County",2,42,914,480,434
050,36,105,"New York","Sullivan County",2,43,879,465,414
050,36,105,"New York","Sullivan County",2,44,871,494,377
050,36,105,"New York","Sullivan County",2,45,889,494,395
050,36,105,"New York","Sullivan County",2,46,886,497,389
050,36,105,"New York","Sullivan County",2,47,907,514,393
050,36,105,"New York","Sullivan County",2,48,986,555,431
050,36,105,"New York","Sullivan County",2,49,1054,571,483
050,36,105,"New York","Sullivan County",2,50,1048,557,491
050,36,105,"New York","Sullivan County",2,51,1050,557,493
050,36,105,"New York","Sullivan County",2,52,1028,537,491
050,36,105,"New York","Sullivan County",2,53,1104,593,511
050,36,105,"New York","Sullivan County",2,54,1177,627,550
050,36,105,"New York","Sullivan County",2,55,1242,658,584
050,36,105,"New York","Sullivan County",2,56,1228,629,599
050,36,105,"New York","Sullivan County",2,57,1191,597,594
050,36,105,"New York","Sullivan County",2,58,1184,609,575
050,36,105,"New York","Sullivan County",2,59,1208,629,579
050,36,105,"New York","Sullivan County",2,60,1182,618,564
050,36,105,"New York","Sullivan County",2,61,1153,600,553
050,36,105,"New York","Sullivan County",2,62,1138,591,547
050,36,105,"New York","Sullivan County",2,63,1109,590,519
050,36,105,"New York","Sullivan County",2,64,1075,557,518
050,36,105,"New York","Sullivan County",2,65,1012,503,509
050,36,105,"New York","Sullivan County",2,66,982,498,484
050,36,105,"New York","Sullivan County",2,67,1011,516,495
050,36,105,"New York","Sullivan County",2,68,976,486,490
050,36,105,"New York","Sullivan County",2,69,921,454,467
050,36,105,"New York","Sullivan County",2,70,895,439,456
050,36,105,"New York","Sullivan County",2,71,884,428,456
050,36,105,"New York","Sullivan County",2,72,839,402,437
050,36,105,"New York","Sullivan County",2,73,892,448,444
050,36,105,"New York","Sullivan County",2,74,636,317,319
050,36,105,"New York","Sullivan County",2,75,606,299,307
050,36,105,"New York","Sullivan County",2,76,592,288,304
050,36,105,"New York","Sullivan County",2,77,594,281,313
050,36,105,"New York","Sullivan County",2,78,516,252,264
050,36,105,"New York","Sullivan County",2,79,465,239,226
050,36,105,"New York","Sullivan County",2,80,416,209,207
050,36,105,"New York","Sullivan County",2,81,369,190,179
050,36,105,"New York","Sullivan County",2,82,353,170,183
050,36,105,"New York","Sullivan County",2,83,276,128,148
050,36,105,"New York","Sullivan County",2,84,230,111,119
050,36,105,"New York","Sullivan County",2,85,1259,517,742
050,36,105,"New York","Sullivan County",3,0,894,442,452
050,36,105,"New York","Sullivan County",3,1,925,495,430
050,36,105,"New York","Sullivan County",3,2,947,486,461
050,36,105,"New York","Sullivan County",3,3,935,483,452
050,36,105,"New York","Sullivan County",3,4,963,482,481
050,36,105,"New York","Sullivan County",3,5,956,499,457
050,36,105,"New York","Sullivan County",3,6,972,515,457
050,36,105,"New York","Sullivan County",3,7,939,499,440
050,36,105,"New York","Sullivan County",3,8,925,458,467
050,36,105,"New York","Sullivan County",3,9,889,448,441
050,36,105,"New York","Sullivan County",3,10,934,483,451
050,36,105,"New York","Sullivan County",3,11,917,488,429
050,36,105,"New York","Sullivan County",3,12,933,497,436
050,36,105,"New York","Sullivan County",3,13,976,508,468
050,36,105,"New York","Sullivan County",3,14,986,495,491
050,36,105,"New York","Sullivan County",3,15,968,485,483
050,36,105,"New York","Sullivan County",3,16,992,509,483
050,36,105,"New York","Sullivan County",3,17,991,522,469
050,36,105,"New York","Sullivan County",3,18,893,501,392
050,36,105,"New York","Sullivan County",3,19,818,448,370
050,36,105,"New York","Sullivan County",3,20,1040,478,562
050,36,105,"New York","Sullivan County",3,21,1017,552,465
050,36,105,"New York","Sullivan County",3,22,851,467,384
050,36,105,"New York","Sullivan County",3,23,960,514,446
050,36,105,"New York","Sullivan County",3,24,902,459,443
050,36,105,"New York","Sullivan County",3,25,861,436,425
050,36,105,"New York","Sullivan County",3,26,941,487,454
050,36,105,"New York","Sullivan County",3,27,927,486,441
050,36,105,"New York","Sullivan County",3,28,938,500,438
050,36,105,"New York","Sullivan County",3,29,969,498,471
050,36,105,"New York","Sullivan County",3,30,1020,547,473
050,36,105,"New York","Sullivan County",3,31,1007,541,466
050,36,105,"New York","Sullivan County",3,32,1040,590,450
050,36,105,"New York","Sullivan County",3,33,987,519,468
050,36,105,"New York","Sullivan County",3,34,972,517,455
050,36,105,"New York","Sullivan County",3,35,988,505,483
050,36,105,"New York","Sullivan County",3,36,968,511,457
050,36,105,"New York","Sullivan County",3,37,996,511,485
050,36,105,"New York","Sullivan County",3,38,1011,512,499
050,36,105,"New York","Sullivan County",3,39,975,497,478
050,36,105,"New York","Sullivan County",3,40,1010,534,476
050,36,105,"New York","Sullivan County",3,41,990,534,456
050,36,105,"New York","Sullivan County",3,42,972,529,443
050,36,105,"New York","Sullivan County",3,43,922,471,451
050,36,105,"New York","Sullivan County",3,44,927,509,418
050,36,105,"New York","Sullivan County",3,45,893,496,397
050,36,105,"New York","Sullivan County",3,46,915,523,392
050,36,105,"New York","Sullivan County",3,47,901,501,400
050,36,105,"New York","Sullivan County",3,48,936,533,403
050,36,105,"New York","Sullivan County",3,49,973,545,428
050,36,105,"New York","Sullivan County",3,50,1083,579,504
050,36,105,"New York","Sullivan County",3,51,1071,578,493
050,36,105,"New York","Sullivan County",3,52,1028,530,498
050,36,105,"New York","Sullivan County",3,53,1040,547,493
050,36,105,"New York","Sullivan County",3,54,1118,591,527
050,36,105,"New York","Sullivan County",3,55,1175,615,560
050,36,105,"New York","Sullivan County",3,56,1232,640,592
050,36,105,"New York","Sullivan County",3,57,1221,620,601
050,36,105,"New York","Sullivan County",3,58,1195,613,582
050,36,105,"New York","Sullivan County",3,59,1172,604,568
050,36,105,"New York","Sullivan County",3,60,1214,628,586
050,36,105,"New York","Sullivan County",3,61,1165,623,542
050,36,105,"New York","Sullivan County",3,62,1160,602,558
050,36,105,"New York","Sullivan County",3,63,1129,589,540
050,36,105,"New York","Sullivan County",3,64,1104,577,527
050,36,105,"New York","Sullivan County",3,65,1062,546,516
050,36,105,"New York","Sullivan County",3,66,994,504,490
050,36,105,"New York","Sullivan County",3,67,969,490,479
050,36,105,"New York","Sullivan County",3,68,977,493,484
050,36,105,"New York","Sullivan County",3,69,958,473,485
050,36,105,"New York","Sullivan County",3,70,896,438,458
050,36,105,"New York","Sullivan County",3,71,881,438,443
050,36,105,"New York","Sullivan County",3,72,851,411,440
050,36,105,"New York","Sullivan County",3,73,811,390,421
050,36,105,"New York","Sullivan County",3,74,858,430,428
050,36,105,"New York","Sullivan County",3,75,610,302,308
050,36,105,"New York","Sullivan County",3,76,576,287,289
050,36,105,"New York","Sullivan County",3,77,553,268,285
050,36,105,"New York","Sullivan County",3,78,574,264,310
050,36,105,"New York","Sullivan County",3,79,487,239,248
050,36,105,"New York","Sullivan County",3,80,443,226,217
050,36,105,"New York","Sullivan County",3,81,398,198,200
050,36,105,"New York","Sullivan County",3,82,334,172,162
050,36,105,"New York","Sullivan County",3,83,313,146,167
050,36,105,"New York","Sullivan County",3,84,258,123,135
050,36,105,"New York","Sullivan County",3,85,1230,524,706
050,36,105,"New York","Sullivan County",4,0,1008,505,503
050,36,105,"New York","Sullivan County",4,1,965,513,452
050,36,105,"New York","Sullivan County",4,2,947,501,446
050,36,105,"New York","Sullivan County",4,3,944,492,452
050,36,105,"New York","Sullivan County",4,4,925,464,461
050,36,105,"New York","Sullivan County",4,5,946,471,475
050,36,105,"New York","Sullivan County",4,6,964,493,471
050,36,105,"New York","Sullivan County",4,7,973,518,455
050,36,105,"New York","Sullivan County",4,8,929,481,448
050,36,105,"New York","Sullivan County",4,9,931,459,472
050,36,105,"New York","Sullivan County",4,10,895,453,442
050,36,105,"New York","Sullivan County",4,11,913,482,431
050,36,105,"New York","Sullivan County",4,12,903,481,422
050,36,105,"New York","Sullivan County",4,13,922,491,431
050,36,105,"New York","Sullivan County",4,14,961,493,468
050,36,105,"New York","Sullivan County",4,15,979,500,479
050,36,105,"New York","Sullivan County",4,16,986,497,489
050,36,105,"New York","Sullivan County",4,17,1006,507,499
050,36,105,"New York","Sullivan County",4,18,956,543,413
050,36,105,"New York","Sullivan County",4,19,783,431,352
050,36,105,"New York","Sullivan County",4,20,1004,473,531
050,36,105,"New York","Sullivan County",4,21,1014,524,490
050,36,105,"New York","Sullivan County",4,22,869,474,395
050,36,105,"New York","Sullivan County",4,23,915,491,424
050,36,105,"New York","Sullivan County",4,24,907,473,434
050,36,105,"New York","Sullivan County",4,25,889,468,421
050,36,105,"New York","Sullivan County",4,26,868,446,422
050,36,105,"New York","Sullivan County",4,27,959,495,464
050,36,105,"New York","Sullivan County",4,28,933,492,441
050,36,105,"New York","Sullivan County",4,29,914,477,437
050,36,105,"New York","Sullivan County",4,30,994,522,472
050,36,105,"New York","Sullivan County",4,31,1041,550,491
050,36,105,"New York","Sullivan County",4,32,1046,564,482
050,36,105,"New York","Sullivan County",4,33,1044,578,466
050,36,105,"New York","Sullivan County",4,34,1009,544,465
050,36,105,"New York","Sullivan County",4,35,960,515,445
050,36,105,"New York","Sullivan County",4,36,972,486,486
050,36,105,"New York","Sullivan County",4,37,1016,544,472
050,36,105,"New York","Sullivan County",4,38,970,508,462
050,36,105,"New York","Sullivan County",4,39,1029,528,501
050,36,105,"New York","Sullivan County",4,40,1016,547,469
050,36,105,"New York","Sullivan County",4,41,992,513,479
050,36,105,"New York","Sullivan County",4,42,1018,549,469
050,36,105,"New York","Sullivan County",4,43,953,510,443
050,36,105,"New York","Sullivan County",4,44,961,508,453
050,36,105,"New York","Sullivan County",4,45,897,496,401
050,36,105,"New York","Sullivan County",4,46,890,502,388
050,36,105,"New York","Sullivan County",4,47,905,523,382
050,36,105,"New York","Sullivan County",4,48,925,519,406
050,36,105,"New York","Sullivan County",4,49,922,529,393
050,36,105,"New York","Sullivan County",4,50,1002,553,449
050,36,105,"New York","Sullivan County",4,51,1091,593,498
050,36,105,"New York","Sullivan County",4,52,1035,546,489
050,36,105,"New York","Sullivan County",4,53,1023,526,497
050,36,105,"New York","Sullivan County",4,54,1048,557,491
050,36,105,"New York","Sullivan County",4,55,1105,586,519
050,36,105,"New York","Sullivan County",4,56,1139,588,551
050,36,105,"New York","Sullivan County",4,57,1199,619,580
050,36,105,"New York","Sullivan County",4,58,1212,620,592
050,36,105,"New York","Sullivan County",4,59,1157,596,561
050,36,105,"New York","Sullivan County",4,60,1157,594,563
050,36,105,"New York","Sullivan County",4,61,1183,614,569
050,36,105,"New York","Sullivan County",4,62,1132,597,535
050,36,105,"New York","Sullivan County",4,63,1137,598,539
050,36,105,"New York","Sullivan County",4,64,1109,574,535
050,36,105,"New York","Sullivan County",4,65,1079,570,509
050,36,105,"New York","Sullivan County",4,66,1040,539,501
050,36,105,"New York","Sullivan County",4,67,982,505,477
050,36,105,"New York","Sullivan County",4,68,923,460,463
050,36,105,"New York","Sullivan County",4,69,956,478,478
050,36,105,"New York","Sullivan County",4,70,923,455,468
050,36,105,"New York","Sullivan County",4,71,881,436,445
050,36,105,"New York","Sullivan County",4,72,858,427,431
050,36,105,"New York","Sullivan County",4,73,819,398,421
050,36,105,"New York","Sullivan County",4,74,789,376,413
050,36,105,"New York","Sullivan County",4,75,824,411,413
050,36,105,"New York","Sullivan County",4,76,583,289,294
050,36,105,"New York","Sullivan County",4,77,554,275,279
050,36,105,"New York","Sullivan County",4,78,530,261,269
050,36,105,"New York","Sullivan County",4,79,541,241,300
050,36,105,"New York","Sullivan County",4,80,448,216,232
050,36,105,"New York","Sullivan County",4,81,425,217,208
050,36,105,"New York","Sullivan County",4,82,375,188,187
050,36,105,"New York","Sullivan County",4,83,297,153,144
050,36,105,"New York","Sullivan County",4,84,285,134,151
050,36,105,"New York","Sullivan County",4,85,1226,531,695
050,36,105,"New York","Sullivan County",5,0,1007,505,502
050,36,105,"New York","Sullivan County",5,1,1014,509,505
050,36,105,"New York","Sullivan County",5,2,961,503,458
050,36,105,"New York","Sullivan County",5,3,953,490,463
050,36,105,"New York","Sullivan County",5,4,937,482,455
050,36,105,"New York","Sullivan County",5,5,919,479,440
050,36,105,"New York","Sullivan County",5,6,970,480,490
050,36,105,"New York","Sullivan County",5,7,947,471,476
050,36,105,"New York","Sullivan County",5,8,947,511,436
050,36,105,"New York","Sullivan County",5,9,929,472,457
050,36,105,"New York","Sullivan County",5,10,948,472,476
050,36,105,"New York","Sullivan County",5,11,909,459,450
050,36,105,"New York","Sullivan County",5,12,930,491,439
050,36,105,"New York","Sullivan County",5,13,921,486,435
050,36,105,"New York","Sullivan County",5,14,930,484,446
050,36,105,"New York","Sullivan County",5,15,964,493,471
050,36,105,"New York","Sullivan County",5,16,1023,518,505
050,36,105,"New York","Sullivan County",5,17,1016,506,510
050,36,105,"New York","Sullivan County",5,18,929,499,430
050,36,105,"New York","Sullivan County",5,19,827,463,364
050,36,105,"New York","Sullivan County",5,20,988,461,527
050,36,105,"New York","Sullivan County",5,21,976,523,453
050,36,105,"New York","Sullivan County",5,22,884,456,428
050,36,105,"New York","Sullivan County",5,23,936,513,423
050,36,105,"New York","Sullivan County",5,24,863,432,431
050,36,105,"New York","Sullivan County",5,25,863,464,399
050,36,105,"New York","Sullivan County",5,26,869,467,402
050,36,105,"New York","Sullivan County",5,27,858,449,409
050,36,105,"New York","Sullivan County",5,28,943,490,453
050,36,105,"New York","Sullivan County",5,29,919,481,438
050,36,105,"New York","Sullivan County",5,30,953,505,448
050,36,105,"New York","Sullivan County",5,31,1016,524,492
050,36,105,"New York","Sullivan County",5,32,1035,557,478
050,36,105,"New York","Sullivan County",5,33,1026,545,481
050,36,105,"New York","Sullivan County",5,34,1059,581,478
050,36,105,"New York","Sullivan County",5,35,1013,543,470
050,36,105,"New York","Sullivan County",5,36,976,501,475
050,36,105,"New York","Sullivan County",5,37,1035,534,501
050,36,105,"New York","Sullivan County",5,38,1010,535,475
050,36,105,"New York","Sullivan County",5,39,991,506,485
050,36,105,"New York","Sullivan County",5,40,1044,548,496
050,36,105,"New York","Sullivan County",5,41,1000,526,474
050,36,105,"New York","Sullivan County",5,42,1005,525,480
050,36,105,"New York","Sullivan County",5,43,977,510,467
050,36,105,"New York","Sullivan County",5,44,1009,559,450
050,36,105,"New York","Sullivan County",5,45,944,483,461
050,36,105,"New York","Sullivan County",5,46,931,517,414
050,36,105,"New York","Sullivan County",5,47,887,500,387
050,36,105,"New York","Sullivan County",5,48,921,533,388
050,36,105,"New York","Sullivan County",5,49,890,497,393
050,36,105,"New York","Sullivan County",5,50,940,534,406
050,36,105,"New York","Sullivan County",5,51,1006,576,430
050,36,105,"New York","Sullivan County",5,52,1053,560,493
050,36,105,"New York","Sullivan County",5,53,1036,546,490
050,36,105,"New York","Sullivan County",5,54,1040,529,511
050,36,105,"New York","Sullivan County",5,55,1038,552,486
050,36,105,"New York","Sullivan County",5,56,1083,570,513
050,36,105,"New York","Sullivan County",5,57,1107,569,538
050,36,105,"New York","Sullivan County",5,58,1202,620,582
050,36,105,"New York","Sullivan County",5,59,1238,634,604
050,36,105,"New York","Sullivan County",5,60,1139,591,548
050,36,105,"New York","Sullivan County",5,61,1147,586,561
050,36,105,"New York","Sullivan County",5,62,1156,601,555
050,36,105,"New York","Sullivan County",5,63,1119,594,525
050,36,105,"New York","Sullivan County",5,64,1119,583,536
050,36,105,"New York","Sullivan County",5,65,1088,554,534
050,36,105,"New York","Sullivan County",5,66,1052,554,498
050,36,105,"New York","Sullivan County",5,67,1028,534,494
050,36,105,"New York","Sullivan County",5,68,948,478,470
050,36,105,"New York","Sullivan County",5,69,890,436,454
050,36,105,"New York","Sullivan County",5,70,926,457,469
050,36,105,"New York","Sullivan County",5,71,902,444,458
050,36,105,"New York","Sullivan County",5,72,848,425,423
050,36,105,"New York","Sullivan County",5,73,837,424,413
050,36,105,"New York","Sullivan County",5,74,791,381,410
050,36,105,"New York","Sullivan County",5,75,766,369,397
050,36,105,"New York","Sullivan County",5,76,796,401,395
050,36,105,"New York","Sullivan County",5,77,562,280,282
050,36,105,"New York","Sullivan County",5,78,541,264,277
050,36,105,"New York","Sullivan County",5,79,507,246,261
050,36,105,"New York","Sullivan County",5,80,506,223,283
050,36,105,"New York","Sullivan County",5,81,425,196,229
050,36,105,"New York","Sullivan County",5,82,398,198,200
050,36,105,"New York","Sullivan County",5,83,334,171,163
050,36,105,"New York","Sullivan County",5,84,279,142,137
050,36,105,"New York","Sullivan County",5,85,1271,566,705
050,36,107,"New York","Tioga County",1,0,422,215,207
050,36,107,"New York","Tioga County",1,1,436,227,209
050,36,107,"New York","Tioga County",1,2,467,247,220
050,36,107,"New York","Tioga County",1,3,460,229,231
050,36,107,"New York","Tioga County",1,4,508,256,252
050,36,107,"New York","Tioga County",1,5,552,261,291
050,36,107,"New York","Tioga County",1,6,522,268,254
050,36,107,"New York","Tioga County",1,7,557,292,265
050,36,107,"New York","Tioga County",1,8,546,283,263
050,36,107,"New York","Tioga County",1,9,568,302,266
050,36,107,"New York","Tioga County",1,10,564,302,262
050,36,107,"New York","Tioga County",1,11,625,334,291
050,36,107,"New York","Tioga County",1,12,634,329,305
050,36,107,"New York","Tioga County",1,13,645,339,306
050,36,107,"New York","Tioga County",1,14,630,326,304
050,36,107,"New York","Tioga County",1,15,631,321,310
050,36,107,"New York","Tioga County",1,16,650,329,321
050,36,107,"New York","Tioga County",1,17,658,337,321
050,36,107,"New York","Tioga County",1,18,550,296,254
050,36,107,"New York","Tioga County",1,19,447,237,210
050,36,107,"New York","Tioga County",1,20,490,251,239
050,36,107,"New York","Tioga County",1,21,500,276,224
050,36,107,"New York","Tioga County",1,22,516,270,246
050,36,107,"New York","Tioga County",1,23,525,264,261
050,36,107,"New York","Tioga County",1,24,521,255,266
050,36,107,"New York","Tioga County",1,25,489,258,231
050,36,107,"New York","Tioga County",1,26,510,267,243
050,36,107,"New York","Tioga County",1,27,506,264,242
050,36,107,"New York","Tioga County",1,28,515,275,240
050,36,107,"New York","Tioga County",1,29,556,280,276
050,36,107,"New York","Tioga County",1,30,500,246,254
050,36,107,"New York","Tioga County",1,31,518,261,257
050,36,107,"New York","Tioga County",1,32,526,281,245
050,36,107,"New York","Tioga County",1,33,534,263,271
050,36,107,"New York","Tioga County",1,34,572,278,294
050,36,107,"New York","Tioga County",1,35,551,269,282
050,36,107,"New York","Tioga County",1,36,559,274,285
050,36,107,"New York","Tioga County",1,37,587,299,288
050,36,107,"New York","Tioga County",1,38,554,292,262
050,36,107,"New York","Tioga County",1,39,588,301,287
050,36,107,"New York","Tioga County",1,40,599,307,292
050,36,107,"New York","Tioga County",1,41,563,287,276
050,36,107,"New York","Tioga County",1,42,543,283,260
050,36,107,"New York","Tioga County",1,43,552,289,263
050,36,107,"New York","Tioga County",1,44,537,268,269
050,36,107,"New York","Tioga County",1,45,546,267,279
050,36,107,"New York","Tioga County",1,46,519,256,263
050,36,107,"New York","Tioga County",1,47,524,270,254
050,36,107,"New York","Tioga County",1,48,569,292,277
050,36,107,"New York","Tioga County",1,49,608,299,309
050,36,107,"New York","Tioga County",1,50,630,312,318
050,36,107,"New York","Tioga County",1,51,645,325,320
050,36,107,"New York","Tioga County",1,52,621,314,307
050,36,107,"New York","Tioga County",1,53,649,327,322
050,36,107,"New York","Tioga County",1,54,691,349,342
050,36,107,"New York","Tioga County",1,55,709,348,361
050,36,107,"New York","Tioga County",1,56,770,359,411
050,36,107,"New York","Tioga County",1,57,816,406,410
050,36,107,"New York","Tioga County",1,58,819,417,402
050,36,107,"New York","Tioga County",1,59,820,405,415
050,36,107,"New York","Tioga County",1,60,856,415,441
050,36,107,"New York","Tioga County",1,61,838,411,427
050,36,107,"New York","Tioga County",1,62,823,410,413
050,36,107,"New York","Tioga County",1,63,766,398,368
050,36,107,"New York","Tioga County",1,64,745,384,361
050,36,107,"New York","Tioga County",1,65,705,359,346
050,36,107,"New York","Tioga County",1,66,634,315,319
050,36,107,"New York","Tioga County",1,67,611,316,295
050,36,107,"New York","Tioga County",1,68,577,303,274
050,36,107,"New York","Tioga County",1,69,583,294,289
050,36,107,"New York","Tioga County",1,70,539,256,283
050,36,107,"New York","Tioga County",1,71,546,259,287
050,36,107,"New York","Tioga County",1,72,569,267,302
050,36,107,"New York","Tioga County",1,73,576,287,289
050,36,107,"New York","Tioga County",1,74,396,186,210
050,36,107,"New York","Tioga County",1,75,390,184,206
050,36,107,"New York","Tioga County",1,76,407,199,208
050,36,107,"New York","Tioga County",1,77,401,191,210
050,36,107,"New York","Tioga County",1,78,314,160,154
050,36,107,"New York","Tioga County",1,79,316,153,163
050,36,107,"New York","Tioga County",1,80,272,126,146
050,36,107,"New York","Tioga County",1,81,238,111,127
050,36,107,"New York","Tioga County",1,82,250,118,132
050,36,107,"New York","Tioga County",1,83,228,98,130
050,36,107,"New York","Tioga County",1,84,234,94,140
050,36,107,"New York","Tioga County",1,85,1219,459,760
050,36,107,"New York","Tioga County",2,0,437,221,216
050,36,107,"New York","Tioga County",2,1,432,224,208
050,36,107,"New York","Tioga County",2,2,458,241,217
050,36,107,"New York","Tioga County",2,3,461,232,229
050,36,107,"New York","Tioga County",2,4,500,252,248
050,36,107,"New York","Tioga County",2,5,540,259,281
050,36,107,"New York","Tioga County",2,6,533,268,265
050,36,107,"New York","Tioga County",2,7,550,286,264
050,36,107,"New York","Tioga County",2,8,552,286,266
050,36,107,"New York","Tioga County",2,9,562,298,264
050,36,107,"New York","Tioga County",2,10,567,305,262
050,36,107,"New York","Tioga County",2,11,610,326,284
050,36,107,"New York","Tioga County",2,12,635,330,305
050,36,107,"New York","Tioga County",2,13,638,334,304
050,36,107,"New York","Tioga County",2,14,634,328,306
050,36,107,"New York","Tioga County",2,15,630,320,310
050,36,107,"New York","Tioga County",2,16,648,327,321
050,36,107,"New York","Tioga County",2,17,658,337,321
050,36,107,"New York","Tioga County",2,18,546,293,253
050,36,107,"New York","Tioga County",2,19,453,240,213
050,36,107,"New York","Tioga County",2,20,486,250,236
050,36,107,"New York","Tioga County",2,21,501,273,228
050,36,107,"New York","Tioga County",2,22,518,274,244
050,36,107,"New York","Tioga County",2,23,524,265,259
050,36,107,"New York","Tioga County",2,24,517,255,262
050,36,107,"New York","Tioga County",2,25,495,253,242
050,36,107,"New York","Tioga County",2,26,504,264,240
050,36,107,"New York","Tioga County",2,27,510,265,245
050,36,107,"New York","Tioga County",2,28,516,276,240
050,36,107,"New York","Tioga County",2,29,545,277,268
050,36,107,"New York","Tioga County",2,30,518,256,262
050,36,107,"New York","Tioga County",2,31,517,260,257
050,36,107,"New York","Tioga County",2,32,526,276,250
050,36,107,"New York","Tioga County",2,33,536,269,267
050,36,107,"New York","Tioga County",2,34,559,272,287
050,36,107,"New York","Tioga County",2,35,562,275,287
050,36,107,"New York","Tioga County",2,36,551,270,281
050,36,107,"New York","Tioga County",2,37,582,296,286
050,36,107,"New York","Tioga County",2,38,561,292,269
050,36,107,"New York","Tioga County",2,39,576,295,281
050,36,107,"New York","Tioga County",2,40,597,306,291
050,36,107,"New York","Tioga County",2,41,572,292,280
050,36,107,"New York","Tioga County",2,42,546,282,264
050,36,107,"New York","Tioga County",2,43,553,290,263
050,36,107,"New York","Tioga County",2,44,536,272,264
050,36,107,"New York","Tioga County",2,45,543,266,277
050,36,107,"New York","Tioga County",2,46,521,259,262
050,36,107,"New York","Tioga County",2,47,520,265,255
050,36,107,"New York","Tioga County",2,48,556,285,271
050,36,107,"New York","Tioga County",2,49,606,301,305
050,36,107,"New York","Tioga County",2,50,624,308,316
050,36,107,"New York","Tioga County",2,51,644,324,320
050,36,107,"New York","Tioga County",2,52,621,314,307
050,36,107,"New York","Tioga County",2,53,644,324,320
050,36,107,"New York","Tioga County",2,54,676,340,336
050,36,107,"New York","Tioga County",2,55,701,349,352
050,36,107,"New York","Tioga County",2,56,758,359,399
050,36,107,"New York","Tioga County",2,57,805,395,410
050,36,107,"New York","Tioga County",2,58,817,414,403
050,36,107,"New York","Tioga County",2,59,825,410,415
050,36,107,"New York","Tioga County",2,60,838,408,430
050,36,107,"New York","Tioga County",2,61,834,407,427
050,36,107,"New York","Tioga County",2,62,820,405,415
050,36,107,"New York","Tioga County",2,63,783,403,380
050,36,107,"New York","Tioga County",2,64,744,387,357
050,36,107,"New York","Tioga County",2,65,712,366,346
050,36,107,"New York","Tioga County",2,66,655,328,327
050,36,107,"New York","Tioga County",2,67,616,316,300
050,36,107,"New York","Tioga County",2,68,580,304,276
050,36,107,"New York","Tioga County",2,69,582,296,286
050,36,107,"New York","Tioga County",2,70,545,264,281
050,36,107,"New York","Tioga County",2,71,542,256,286
050,36,107,"New York","Tioga County",2,72,546,257,289
050,36,107,"New York","Tioga County",2,73,599,294,305
050,36,107,"New York","Tioga County",2,74,410,196,214
050,36,107,"New York","Tioga County",2,75,390,183,207
050,36,107,"New York","Tioga County",2,76,396,192,204
050,36,107,"New York","Tioga County",2,77,408,195,213
050,36,107,"New York","Tioga County",2,78,321,162,159
050,36,107,"New York","Tioga County",2,79,309,150,159
050,36,107,"New York","Tioga County",2,80,279,130,149
050,36,107,"New York","Tioga County",2,81,240,112,128
050,36,107,"New York","Tioga County",2,82,236,112,124
050,36,107,"New York","Tioga County",2,83,224,98,126
050,36,107,"New York","Tioga County",2,84,222,91,131
050,36,107,"New York","Tioga County",2,85,1204,450,754
050,36,107,"New York","Tioga County",3,0,429,232,197
050,36,107,"New York","Tioga County",3,1,459,227,232
050,36,107,"New York","Tioga County",3,2,443,229,214
050,36,107,"New York","Tioga County",3,3,468,254,214
050,36,107,"New York","Tioga County",3,4,456,227,229
050,36,107,"New York","Tioga County",3,5,507,249,258
050,36,107,"New York","Tioga County",3,6,533,254,279
050,36,107,"New York","Tioga County",3,7,532,271,261
050,36,107,"New York","Tioga County",3,8,541,283,258
050,36,107,"New York","Tioga County",3,9,541,275,266
050,36,107,"New York","Tioga County",3,10,544,290,254
050,36,107,"New York","Tioga County",3,11,555,294,261
050,36,107,"New York","Tioga County",3,12,625,332,293
050,36,107,"New York","Tioga County",3,13,631,331,300
050,36,107,"New York","Tioga County",3,14,654,338,316
050,36,107,"New York","Tioga County",3,15,620,318,302
050,36,107,"New York","Tioga County",3,16,618,318,300
050,36,107,"New York","Tioga County",3,17,645,325,320
050,36,107,"New York","Tioga County",3,18,552,297,255
050,36,107,"New York","Tioga County",3,19,448,246,202
050,36,107,"New York","Tioga County",3,20,465,244,221
050,36,107,"New York","Tioga County",3,21,508,258,250
050,36,107,"New York","Tioga County",3,22,494,258,236
050,36,107,"New York","Tioga County",3,23,504,269,235
050,36,107,"New York","Tioga County",3,24,531,280,251
050,36,107,"New York","Tioga County",3,25,511,260,251
050,36,107,"New York","Tioga County",3,26,517,268,249
050,36,107,"New York","Tioga County",3,27,528,262,266
050,36,107,"New York","Tioga County",3,28,491,266,225
050,36,107,"New York","Tioga County",3,29,519,271,248
050,36,107,"New York","Tioga County",3,30,532,264,268
050,36,107,"New York","Tioga County",3,31,536,275,261
050,36,107,"New York","Tioga County",3,32,524,265,259
050,36,107,"New York","Tioga County",3,33,527,269,258
050,36,107,"New York","Tioga County",3,34,553,281,272
050,36,107,"New York","Tioga County",3,35,568,279,289
050,36,107,"New York","Tioga County",3,36,562,268,294
050,36,107,"New York","Tioga County",3,37,563,280,283
050,36,107,"New York","Tioga County",3,38,603,307,296
050,36,107,"New York","Tioga County",3,39,562,290,272
050,36,107,"New York","Tioga County",3,40,572,305,267
050,36,107,"New York","Tioga County",3,41,598,316,282
050,36,107,"New York","Tioga County",3,42,581,297,284
050,36,107,"New York","Tioga County",3,43,538,279,259
050,36,107,"New York","Tioga County",3,44,552,293,259
050,36,107,"New York","Tioga County",3,45,545,272,273
050,36,107,"New York","Tioga County",3,46,556,276,280
050,36,107,"New York","Tioga County",3,47,507,255,252
050,36,107,"New York","Tioga County",3,48,521,270,251
050,36,107,"New York","Tioga County",3,49,565,284,281
050,36,107,"New York","Tioga County",3,50,599,298,301
050,36,107,"New York","Tioga County",3,51,625,317,308
050,36,107,"New York","Tioga County",3,52,632,315,317
050,36,107,"New York","Tioga County",3,53,607,302,305
050,36,107,"New York","Tioga County",3,54,632,311,321
050,36,107,"New York","Tioga County",3,55,683,352,331
050,36,107,"New York","Tioga County",3,56,676,334,342
050,36,107,"New York","Tioga County",3,57,760,363,397
050,36,107,"New York","Tioga County",3,58,807,397,410
050,36,107,"New York","Tioga County",3,59,801,404,397
050,36,107,"New York","Tioga County",3,60,807,398,409
050,36,107,"New York","Tioga County",3,61,821,398,423
050,36,107,"New York","Tioga County",3,62,824,399,425
050,36,107,"New York","Tioga County",3,63,805,403,402
050,36,107,"New York","Tioga County",3,64,763,391,372
050,36,107,"New York","Tioga County",3,65,733,380,353
050,36,107,"New York","Tioga County",3,66,703,356,347
050,36,107,"New York","Tioga County",3,67,639,315,324
050,36,107,"New York","Tioga County",3,68,610,317,293
050,36,107,"New York","Tioga County",3,69,575,297,278
050,36,107,"New York","Tioga County",3,70,567,284,283
050,36,107,"New York","Tioga County",3,71,525,257,268
050,36,107,"New York","Tioga County",3,72,530,248,282
050,36,107,"New York","Tioga County",3,73,535,256,279
050,36,107,"New York","Tioga County",3,74,573,284,289
050,36,107,"New York","Tioga County",3,75,391,185,206
050,36,107,"New York","Tioga County",3,76,381,174,207
050,36,107,"New York","Tioga County",3,77,385,188,197
050,36,107,"New York","Tioga County",3,78,378,182,196
050,36,107,"New York","Tioga County",3,79,315,158,157
050,36,107,"New York","Tioga County",3,80,295,143,152
050,36,107,"New York","Tioga County",3,81,261,124,137
050,36,107,"New York","Tioga County",3,82,228,110,118
050,36,107,"New York","Tioga County",3,83,216,98,118
050,36,107,"New York","Tioga County",3,84,216,93,123
050,36,107,"New York","Tioga County",3,85,1248,465,783
050,36,107,"New York","Tioga County",4,0,459,264,195
050,36,107,"New York","Tioga County",4,1,430,222,208
050,36,107,"New York","Tioga County",4,2,479,233,246
050,36,107,"New York","Tioga County",4,3,467,238,229
050,36,107,"New York","Tioga County",4,4,472,262,210
050,36,107,"New York","Tioga County",4,5,480,234,246
050,36,107,"New York","Tioga County",4,6,505,249,256
050,36,107,"New York","Tioga County",4,7,540,258,282
050,36,107,"New York","Tioga County",4,8,533,268,265
050,36,107,"New York","Tioga County",4,9,546,291,255
050,36,107,"New York","Tioga County",4,10,551,283,268
050,36,107,"New York","Tioga County",4,11,543,287,256
050,36,107,"New York","Tioga County",4,12,548,283,265
050,36,107,"New York","Tioga County",4,13,611,328,283
050,36,107,"New York","Tioga County",4,14,618,329,289
050,36,107,"New York","Tioga County",4,15,636,338,298
050,36,107,"New York","Tioga County",4,16,614,315,299
050,36,107,"New York","Tioga County",4,17,610,311,299
050,36,107,"New York","Tioga County",4,18,547,289,258
050,36,107,"New York","Tioga County",4,19,430,232,198
050,36,107,"New York","Tioga County",4,20,451,247,204
050,36,107,"New York","Tioga County",4,21,490,258,232
050,36,107,"New York","Tioga County",4,22,518,263,255
050,36,107,"New York","Tioga County",4,23,516,274,242
050,36,107,"New York","Tioga County",4,24,519,274,245
050,36,107,"New York","Tioga County",4,25,520,278,242
050,36,107,"New York","Tioga County",4,26,496,248,248
050,36,107,"New York","Tioga County",4,27,531,266,265
050,36,107,"New York","Tioga County",4,28,517,257,260
050,36,107,"New York","Tioga County",4,29,495,264,231
050,36,107,"New York","Tioga County",4,30,527,276,251
050,36,107,"New York","Tioga County",4,31,556,273,283
050,36,107,"New York","Tioga County",4,32,543,275,268
050,36,107,"New York","Tioga County",4,33,534,269,265
050,36,107,"New York","Tioga County",4,34,536,270,266
050,36,107,"New York","Tioga County",4,35,554,287,267
050,36,107,"New York","Tioga County",4,36,574,279,295
050,36,107,"New York","Tioga County",4,37,583,283,300
050,36,107,"New York","Tioga County",4,38,568,278,290
050,36,107,"New York","Tioga County",4,39,611,310,301
050,36,107,"New York","Tioga County",4,40,568,294,274
050,36,107,"New York","Tioga County",4,41,558,297,261
050,36,107,"New York","Tioga County",4,42,608,316,292
050,36,107,"New York","Tioga County",4,43,581,306,275
050,36,107,"New York","Tioga County",4,44,533,280,253
050,36,107,"New York","Tioga County",4,45,540,282,258
050,36,107,"New York","Tioga County",4,46,550,280,270
050,36,107,"New York","Tioga County",4,47,538,260,278
050,36,107,"New York","Tioga County",4,48,508,254,254
050,36,107,"New York","Tioga County",4,49,515,270,245
050,36,107,"New York","Tioga County",4,50,560,281,279
050,36,107,"New York","Tioga County",4,51,598,305,293
050,36,107,"New York","Tioga County",4,52,611,308,303
050,36,107,"New York","Tioga County",4,53,617,311,306
050,36,107,"New York","Tioga County",4,54,595,293,302
050,36,107,"New York","Tioga County",4,55,626,311,315
050,36,107,"New York","Tioga County",4,56,658,332,326
050,36,107,"New York","Tioga County",4,57,664,327,337
050,36,107,"New York","Tioga County",4,58,759,362,397
050,36,107,"New York","Tioga County",4,59,791,386,405
050,36,107,"New York","Tioga County",4,60,787,395,392
050,36,107,"New York","Tioga County",4,61,787,388,399
050,36,107,"New York","Tioga County",4,62,806,392,414
050,36,107,"New York","Tioga County",4,63,800,388,412
050,36,107,"New York","Tioga County",4,64,777,388,389
050,36,107,"New York","Tioga County",4,65,753,380,373
050,36,107,"New York","Tioga County",4,66,707,363,344
050,36,107,"New York","Tioga County",4,67,690,349,341
050,36,107,"New York","Tioga County",4,68,644,317,327
050,36,107,"New York","Tioga County",4,69,607,315,292
050,36,107,"New York","Tioga County",4,70,570,294,276
050,36,107,"New York","Tioga County",4,71,545,278,267
050,36,107,"New York","Tioga County",4,72,502,238,264
050,36,107,"New York","Tioga County",4,73,509,240,269
050,36,107,"New York","Tioga County",4,74,530,252,278
050,36,107,"New York","Tioga County",4,75,557,272,285
050,36,107,"New York","Tioga County",4,76,382,177,205
050,36,107,"New York","Tioga County",4,77,372,167,205
050,36,107,"New York","Tioga County",4,78,348,167,181
050,36,107,"New York","Tioga County",4,79,370,176,194
050,36,107,"New York","Tioga County",4,80,298,153,145
050,36,107,"New York","Tioga County",4,81,273,132,141
050,36,107,"New York","Tioga County",4,82,249,120,129
050,36,107,"New York","Tioga County",4,83,205,94,111
050,36,107,"New York","Tioga County",4,84,197,85,112
050,36,107,"New York","Tioga County",4,85,1265,468,797
050,36,107,"New York","Tioga County",5,0,459,264,195
050,36,107,"New York","Tioga County",5,1,477,273,204
050,36,107,"New York","Tioga County",5,2,442,235,207
050,36,107,"New York","Tioga County",5,3,470,229,241
050,36,107,"New York","Tioga County",5,4,467,243,224
050,36,107,"New York","Tioga County",5,5,487,274,213
050,36,107,"New York","Tioga County",5,6,479,233,246
050,36,107,"New York","Tioga County",5,7,515,262,253
050,36,107,"New York","Tioga County",5,8,544,265,279
050,36,107,"New York","Tioga County",5,9,545,275,270
050,36,107,"New York","Tioga County",5,10,543,281,262
050,36,107,"New York","Tioga County",5,11,569,282,287
050,36,107,"New York","Tioga County",5,12,545,288,257
050,36,107,"New York","Tioga County",5,13,548,277,271
050,36,107,"New York","Tioga County",5,14,622,330,292
050,36,107,"New York","Tioga County",5,15,618,323,295
050,36,107,"New York","Tioga County",5,16,640,336,304
050,36,107,"New York","Tioga County",5,17,630,327,303
050,36,107,"New York","Tioga County",5,18,508,271,237
050,36,107,"New York","Tioga County",5,19,433,227,206
050,36,107,"New York","Tioga County",5,20,446,236,210
050,36,107,"New York","Tioga County",5,21,491,270,221
050,36,107,"New York","Tioga County",5,22,509,265,244
050,36,107,"New York","Tioga County",5,23,522,261,261
050,36,107,"New York","Tioga County",5,24,525,281,244
050,36,107,"New York","Tioga County",5,25,532,285,247
050,36,107,"New York","Tioga County",5,26,493,270,223
050,36,107,"New York","Tioga County",5,27,496,237,259
050,36,107,"New York","Tioga County",5,28,493,245,248
050,36,107,"New York","Tioga County",5,29,523,254,269
050,36,107,"New York","Tioga County",5,30,509,273,236
050,36,107,"New York","Tioga County",5,31,562,297,265
050,36,107,"New York","Tioga County",5,32,568,279,289
050,36,107,"New York","Tioga County",5,33,564,277,287
050,36,107,"New York","Tioga County",5,34,542,267,275
050,36,107,"New York","Tioga County",5,35,541,277,264
050,36,107,"New York","Tioga County",5,36,557,288,269
050,36,107,"New York","Tioga County",5,37,583,293,290
050,36,107,"New York","Tioga County",5,38,603,289,314
050,36,107,"New York","Tioga County",5,39,563,269,294
050,36,107,"New York","Tioga County",5,40,595,306,289
050,36,107,"New York","Tioga County",5,41,571,293,278
050,36,107,"New York","Tioga County",5,42,551,284,267
050,36,107,"New York","Tioga County",5,43,611,316,295
050,36,107,"New York","Tioga County",5,44,583,310,273
050,36,107,"New York","Tioga County",5,45,528,273,255
050,36,107,"New York","Tioga County",5,46,536,278,258
050,36,107,"New York","Tioga County",5,47,549,277,272
050,36,107,"New York","Tioga County",5,48,526,265,261
050,36,107,"New York","Tioga County",5,49,511,249,262
050,36,107,"New York","Tioga County",5,50,497,255,242
050,36,107,"New York","Tioga County",5,51,572,292,280
050,36,107,"New York","Tioga County",5,52,594,298,296
050,36,107,"New York","Tioga County",5,53,598,293,305
050,36,107,"New York","Tioga County",5,54,619,313,306
050,36,107,"New York","Tioga County",5,55,602,292,310
050,36,107,"New York","Tioga County",5,56,604,299,305
050,36,107,"New York","Tioga County",5,57,654,330,324
050,36,107,"New York","Tioga County",5,58,667,324,343
050,36,107,"New York","Tioga County",5,59,748,360,388
050,36,107,"New York","Tioga County",5,60,773,380,393
050,36,107,"New York","Tioga County",5,61,780,396,384
050,36,107,"New York","Tioga County",5,62,779,380,399
050,36,107,"New York","Tioga County",5,63,781,381,400
050,36,107,"New York","Tioga County",5,64,781,381,400
050,36,107,"New York","Tioga County",5,65,766,381,385
050,36,107,"New York","Tioga County",5,66,740,379,361
050,36,107,"New York","Tioga County",5,67,705,358,347
050,36,107,"New York","Tioga County",5,68,678,346,332
050,36,107,"New York","Tioga County",5,69,642,313,329
050,36,107,"New York","Tioga County",5,70,589,307,282
050,36,107,"New York","Tioga County",5,71,555,288,267
050,36,107,"New York","Tioga County",5,72,523,263,260
050,36,107,"New York","Tioga County",5,73,495,236,259
050,36,107,"New York","Tioga County",5,74,505,237,268
050,36,107,"New York","Tioga County",5,75,524,245,279
050,36,107,"New York","Tioga County",5,76,549,264,285
050,36,107,"New York","Tioga County",5,77,377,174,203
050,36,107,"New York","Tioga County",5,78,348,155,193
050,36,107,"New York","Tioga County",5,79,343,167,176
050,36,107,"New York","Tioga County",5,80,356,172,184
050,36,107,"New York","Tioga County",5,81,278,140,138
050,36,107,"New York","Tioga County",5,82,266,129,137
050,36,107,"New York","Tioga County",5,83,227,109,118
050,36,107,"New York","Tioga County",5,84,190,81,109
050,36,107,"New York","Tioga County",5,85,1286,470,816
050,36,109,"New York","Tompkins County",1,0,749,385,364
050,36,109,"New York","Tompkins County",1,1,732,394,338
050,36,109,"New York","Tompkins County",1,2,769,402,367
050,36,109,"New York","Tompkins County",1,3,822,433,389
050,36,109,"New York","Tompkins County",1,4,797,377,420
050,36,109,"New York","Tompkins County",1,5,844,411,433
050,36,109,"New York","Tompkins County",1,6,878,455,423
050,36,109,"New York","Tompkins County",1,7,924,474,450
050,36,109,"New York","Tompkins County",1,8,899,449,450
050,36,109,"New York","Tompkins County",1,9,839,413,426
050,36,109,"New York","Tompkins County",1,10,844,425,419
050,36,109,"New York","Tompkins County",1,11,874,449,425
050,36,109,"New York","Tompkins County",1,12,929,481,448
050,36,109,"New York","Tompkins County",1,13,840,435,405
050,36,109,"New York","Tompkins County",1,14,826,431,395
050,36,109,"New York","Tompkins County",1,15,907,477,430
050,36,109,"New York","Tompkins County",1,16,952,502,450
050,36,109,"New York","Tompkins County",1,17,1006,509,497
050,36,109,"New York","Tompkins County",1,18,3638,1667,1971
050,36,109,"New York","Tompkins County",1,19,5888,2932,2956
050,36,109,"New York","Tompkins County",1,20,5739,2894,2845
050,36,109,"New York","Tompkins County",1,21,5324,2673,2651
050,36,109,"New York","Tompkins County",1,22,3604,1861,1743
050,36,109,"New York","Tompkins County",1,23,2080,1152,928
050,36,109,"New York","Tompkins County",1,24,1796,961,835
050,36,109,"New York","Tompkins County",1,25,1717,870,847
050,36,109,"New York","Tompkins County",1,26,1459,763,696
050,36,109,"New York","Tompkins County",1,27,1347,708,639
050,36,109,"New York","Tompkins County",1,28,1343,690,653
050,36,109,"New York","Tompkins County",1,29,1373,667,706
050,36,109,"New York","Tompkins County",1,30,1231,592,639
050,36,109,"New York","Tompkins County",1,31,1202,613,589
050,36,109,"New York","Tompkins County",1,32,1155,578,577
050,36,109,"New York","Tompkins County",1,33,1159,589,570
050,36,109,"New York","Tompkins County",1,34,1167,556,611
050,36,109,"New York","Tompkins County",1,35,1171,567,604
050,36,109,"New York","Tompkins County",1,36,1122,526,596
050,36,109,"New York","Tompkins County",1,37,1164,583,581
050,36,109,"New York","Tompkins County",1,38,1211,590,621
050,36,109,"New York","Tompkins County",1,39,1206,568,638
050,36,109,"New York","Tompkins County",1,40,1192,581,611
050,36,109,"New York","Tompkins County",1,41,1068,509,559
050,36,109,"New York","Tompkins County",1,42,1107,549,558
050,36,109,"New York","Tompkins County",1,43,1043,525,518
050,36,109,"New York","Tompkins County",1,44,1011,500,511
050,36,109,"New York","Tompkins County",1,45,1010,504,506
050,36,109,"New York","Tompkins County",1,46,946,457,489
050,36,109,"New York","Tompkins County",1,47,962,486,476
050,36,109,"New York","Tompkins County",1,48,963,485,478
050,36,109,"New York","Tompkins County",1,49,1071,515,556
050,36,109,"New York","Tompkins County",1,50,1111,544,567
050,36,109,"New York","Tompkins County",1,51,1054,537,517
050,36,109,"New York","Tompkins County",1,52,1077,535,542
050,36,109,"New York","Tompkins County",1,53,1087,538,549
050,36,109,"New York","Tompkins County",1,54,1068,516,552
050,36,109,"New York","Tompkins County",1,55,1111,541,570
050,36,109,"New York","Tompkins County",1,56,1167,581,586
050,36,109,"New York","Tompkins County",1,57,1171,561,610
050,36,109,"New York","Tompkins County",1,58,1110,527,583
050,36,109,"New York","Tompkins County",1,59,1131,526,605
050,36,109,"New York","Tompkins County",1,60,1183,574,609
050,36,109,"New York","Tompkins County",1,61,1194,580,614
050,36,109,"New York","Tompkins County",1,62,1190,571,619
050,36,109,"New York","Tompkins County",1,63,1146,541,605
050,36,109,"New York","Tompkins County",1,64,1140,534,606
050,36,109,"New York","Tompkins County",1,65,1164,556,608
050,36,109,"New York","Tompkins County",1,66,1120,560,560
050,36,109,"New York","Tompkins County",1,67,1159,560,599
050,36,109,"New York","Tompkins County",1,68,1110,518,592
050,36,109,"New York","Tompkins County",1,69,973,462,511
050,36,109,"New York","Tompkins County",1,70,957,475,482
050,36,109,"New York","Tompkins County",1,71,884,432,452
050,36,109,"New York","Tompkins County",1,72,914,421,493
050,36,109,"New York","Tompkins County",1,73,938,452,486
050,36,109,"New York","Tompkins County",1,74,618,295,323
050,36,109,"New York","Tompkins County",1,75,600,288,312
050,36,109,"New York","Tompkins County",1,76,582,279,303
050,36,109,"New York","Tompkins County",1,77,563,260,303
050,36,109,"New York","Tompkins County",1,78,478,210,268
050,36,109,"New York","Tompkins County",1,79,442,187,255
050,36,109,"New York","Tompkins County",1,80,368,161,207
050,36,109,"New York","Tompkins County",1,81,358,175,183
050,36,109,"New York","Tompkins County",1,82,319,136,183
050,36,109,"New York","Tompkins County",1,83,268,118,150
050,36,109,"New York","Tompkins County",1,84,263,105,158
050,36,109,"New York","Tompkins County",1,85,1819,640,1179
050,36,109,"New York","Tompkins County",2,0,735,367,368
050,36,109,"New York","Tompkins County",2,1,731,390,341
050,36,109,"New York","Tompkins County",2,2,756,400,356
050,36,109,"New York","Tompkins County",2,3,807,426,381
050,36,109,"New York","Tompkins County",2,4,803,391,412
050,36,109,"New York","Tompkins County",2,5,831,401,430
050,36,109,"New York","Tompkins County",2,6,869,445,424
050,36,109,"New York","Tompkins County",2,7,910,468,442
050,36,109,"New York","Tompkins County",2,8,897,450,447
050,36,109,"New York","Tompkins County",2,9,852,422,430
050,36,109,"New York","Tompkins County",2,10,839,421,418
050,36,109,"New York","Tompkins County",2,11,864,443,421
050,36,109,"New York","Tompkins County",2,12,918,476,442
050,36,109,"New York","Tompkins County",2,13,861,449,412
050,36,109,"New York","Tompkins County",2,14,832,433,399
050,36,109,"New York","Tompkins County",2,15,896,472,424
050,36,109,"New York","Tompkins County",2,16,943,496,447
050,36,109,"New York","Tompkins County",2,17,975,497,478
050,36,109,"New York","Tompkins County",2,18,2413,1127,1286
050,36,109,"New York","Tompkins County",2,19,3783,1909,1874
050,36,109,"New York","Tompkins County",2,20,4382,2205,2177
050,36,109,"New York","Tompkins County",2,21,4595,2263,2332
050,36,109,"New York","Tompkins County",2,22,3355,1702,1653
050,36,109,"New York","Tompkins County",2,23,2024,1114,910
050,36,109,"New York","Tompkins County",2,24,1770,951,819
050,36,109,"New York","Tompkins County",2,25,1659,838,821
050,36,109,"New York","Tompkins County",2,26,1457,760,697
050,36,109,"New York","Tompkins County",2,27,1315,688,627
050,36,109,"New York","Tompkins County",2,28,1327,682,645
050,36,109,"New York","Tompkins County",2,29,1335,655,680
050,36,109,"New York","Tompkins County",2,30,1258,606,652
050,36,109,"New York","Tompkins County",2,31,1184,592,592
050,36,109,"New York","Tompkins County",2,32,1144,577,567
050,36,109,"New York","Tompkins County",2,33,1147,580,567
050,36,109,"New York","Tompkins County",2,34,1161,563,598
050,36,109,"New York","Tompkins County",2,35,1173,563,610
050,36,109,"New York","Tompkins County",2,36,1120,528,592
050,36,109,"New York","Tompkins County",2,37,1158,571,587
050,36,109,"New York","Tompkins County",2,38,1202,587,615
050,36,109,"New York","Tompkins County",2,39,1201,569,632
050,36,109,"New York","Tompkins County",2,40,1199,582,617
050,36,109,"New York","Tompkins County",2,41,1097,525,572
050,36,109,"New York","Tompkins County",2,42,1088,535,553
050,36,109,"New York","Tompkins County",2,43,1065,534,531
050,36,109,"New York","Tompkins County",2,44,1006,502,504
050,36,109,"New York","Tompkins County",2,45,1016,506,510
050,36,109,"New York","Tompkins County",2,46,959,469,490
050,36,109,"New York","Tompkins County",2,47,955,478,477
050,36,109,"New York","Tompkins County",2,48,960,485,475
050,36,109,"New York","Tompkins County",2,49,1047,513,534
050,36,109,"New York","Tompkins County",2,50,1103,539,564
050,36,109,"New York","Tompkins County",2,51,1061,536,525
050,36,109,"New York","Tompkins County",2,52,1064,530,534
050,36,109,"New York","Tompkins County",2,53,1084,536,548
050,36,109,"New York","Tompkins County",2,54,1067,518,549
050,36,109,"New York","Tompkins County",2,55,1097,534,563
050,36,109,"New York","Tompkins County",2,56,1149,568,581
050,36,109,"New York","Tompkins County",2,57,1168,565,603
050,36,109,"New York","Tompkins County",2,58,1119,532,587
050,36,109,"New York","Tompkins County",2,59,1126,528,598
050,36,109,"New York","Tompkins County",2,60,1171,565,606
050,36,109,"New York","Tompkins County",2,61,1178,571,607
050,36,109,"New York","Tompkins County",2,62,1185,571,614
050,36,109,"New York","Tompkins County",2,63,1161,551,610
050,36,109,"New York","Tompkins County",2,64,1129,530,599
050,36,109,"New York","Tompkins County",2,65,1158,551,607
050,36,109,"New York","Tompkins County",2,66,1125,557,568
050,36,109,"New York","Tompkins County",2,67,1139,554,585
050,36,109,"New York","Tompkins County",2,68,1110,524,586
050,36,109,"New York","Tompkins County",2,69,1012,479,533
050,36,109,"New York","Tompkins County",2,70,956,467,489
050,36,109,"New York","Tompkins County",2,71,899,440,459
050,36,109,"New York","Tompkins County",2,72,883,414,469
050,36,109,"New York","Tompkins County",2,73,973,466,507
050,36,109,"New York","Tompkins County",2,74,650,312,338
050,36,109,"New York","Tompkins County",2,75,602,289,313
050,36,109,"New York","Tompkins County",2,76,578,275,303
050,36,109,"New York","Tompkins County",2,77,580,271,309
050,36,109,"New York","Tompkins County",2,78,484,215,269
050,36,109,"New York","Tompkins County",2,79,443,188,255
050,36,109,"New York","Tompkins County",2,80,388,167,221
050,36,109,"New York","Tompkins County",2,81,358,173,185
050,36,109,"New York","Tompkins County",2,82,328,145,183
050,36,109,"New York","Tompkins County",2,83,272,117,155
050,36,109,"New York","Tompkins County",2,84,257,105,152
050,36,109,"New York","Tompkins County",2,85,1841,644,1197
050,36,109,"New York","Tompkins County",3,0,643,361,282
050,36,109,"New York","Tompkins County",3,1,777,406,371
050,36,109,"New York","Tompkins County",3,2,744,392,352
050,36,109,"New York","Tompkins County",3,3,744,396,348
050,36,109,"New York","Tompkins County",3,4,811,427,384
050,36,109,"New York","Tompkins County",3,5,781,393,388
050,36,109,"New York","Tompkins County",3,6,823,400,423
050,36,109,"New York","Tompkins County",3,7,858,434,424
050,36,109,"New York","Tompkins County",3,8,903,464,439
050,36,109,"New York","Tompkins County",3,9,884,448,436
050,36,109,"New York","Tompkins County",3,10,831,413,418
050,36,109,"New York","Tompkins County",3,11,839,432,407
050,36,109,"New York","Tompkins County",3,12,857,438,419
050,36,109,"New York","Tompkins County",3,13,908,461,447
050,36,109,"New York","Tompkins County",3,14,849,447,402
050,36,109,"New York","Tompkins County",3,15,857,449,408
050,36,109,"New York","Tompkins County",3,16,930,485,445
050,36,109,"New York","Tompkins County",3,17,963,493,470
050,36,109,"New York","Tompkins County",3,18,3812,1738,2074
050,36,109,"New York","Tompkins County",3,19,6064,3005,3059
050,36,109,"New York","Tompkins County",3,20,5827,2941,2886
050,36,109,"New York","Tompkins County",3,21,5298,2657,2641
050,36,109,"New York","Tompkins County",3,22,3559,1818,1741
050,36,109,"New York","Tompkins County",3,23,2000,1093,907
050,36,109,"New York","Tompkins County",3,24,1803,989,814
050,36,109,"New York","Tompkins County",3,25,1665,838,827
050,36,109,"New York","Tompkins County",3,26,1443,733,710
050,36,109,"New York","Tompkins County",3,27,1330,671,659
050,36,109,"New York","Tompkins County",3,28,1291,689,602
050,36,109,"New York","Tompkins County",3,29,1320,693,627
050,36,109,"New York","Tompkins County",3,30,1294,635,659
050,36,109,"New York","Tompkins County",3,31,1232,609,623
050,36,109,"New York","Tompkins County",3,32,1118,564,554
050,36,109,"New York","Tompkins County",3,33,1138,560,578
050,36,109,"New York","Tompkins County",3,34,1114,552,562
050,36,109,"New York","Tompkins County",3,35,1195,605,590
050,36,109,"New York","Tompkins County",3,36,1171,540,631
050,36,109,"New York","Tompkins County",3,37,1143,534,609
050,36,109,"New York","Tompkins County",3,38,1155,570,585
050,36,109,"New York","Tompkins County",3,39,1208,592,616
050,36,109,"New York","Tompkins County",3,40,1229,584,645
050,36,109,"New York","Tompkins County",3,41,1218,583,635
050,36,109,"New York","Tompkins County",3,42,1086,522,564
050,36,109,"New York","Tompkins County",3,43,1083,524,559
050,36,109,"New York","Tompkins County",3,44,1078,537,541
050,36,109,"New York","Tompkins County",3,45,1021,514,507
050,36,109,"New York","Tompkins County",3,46,1019,498,521
050,36,109,"New York","Tompkins County",3,47,985,485,500
050,36,109,"New York","Tompkins County",3,48,940,473,467
050,36,109,"New York","Tompkins County",3,49,964,490,474
050,36,109,"New York","Tompkins County",3,50,1040,505,535
050,36,109,"New York","Tompkins County",3,51,1078,534,544
050,36,109,"New York","Tompkins County",3,52,1061,530,531
050,36,109,"New York","Tompkins County",3,53,1060,524,536
050,36,109,"New York","Tompkins County",3,54,1082,534,548
050,36,109,"New York","Tompkins County",3,55,1062,515,547
050,36,109,"New York","Tompkins County",3,56,1089,517,572
050,36,109,"New York","Tompkins County",3,57,1161,558,603
050,36,109,"New York","Tompkins County",3,58,1154,566,588
050,36,109,"New York","Tompkins County",3,59,1114,530,584
050,36,109,"New York","Tompkins County",3,60,1124,532,592
050,36,109,"New York","Tompkins County",3,61,1151,552,599
050,36,109,"New York","Tompkins County",3,62,1152,557,595
050,36,109,"New York","Tompkins County",3,63,1193,574,619
050,36,109,"New York","Tompkins County",3,64,1120,528,592
050,36,109,"New York","Tompkins County",3,65,1106,512,594
050,36,109,"New York","Tompkins County",3,66,1135,544,591
050,36,109,"New York","Tompkins County",3,67,1106,545,561
050,36,109,"New York","Tompkins County",3,68,1130,549,581
050,36,109,"New York","Tompkins County",3,69,1095,510,585
050,36,109,"New York","Tompkins County",3,70,997,470,527
050,36,109,"New York","Tompkins County",3,71,924,446,478
050,36,109,"New York","Tompkins County",3,72,875,423,452
050,36,109,"New York","Tompkins County",3,73,875,397,478
050,36,109,"New York","Tompkins County",3,74,949,460,489
050,36,109,"New York","Tompkins County",3,75,634,303,331
050,36,109,"New York","Tompkins County",3,76,586,281,305
050,36,109,"New York","Tompkins County",3,77,567,275,292
050,36,109,"New York","Tompkins County",3,78,548,250,298
050,36,109,"New York","Tompkins County",3,79,466,207,259
050,36,109,"New York","Tompkins County",3,80,430,181,249
050,36,109,"New York","Tompkins County",3,81,376,168,208
050,36,109,"New York","Tompkins County",3,82,345,162,183
050,36,109,"New York","Tompkins County",3,83,295,123,172
050,36,109,"New York","Tompkins County",3,84,255,108,147
050,36,109,"New York","Tompkins County",3,85,1826,641,1185
050,36,109,"New York","Tompkins County",4,0,702,364,338
050,36,109,"New York","Tompkins County",4,1,638,357,281
050,36,109,"New York","Tompkins County",4,2,742,382,360
050,36,109,"New York","Tompkins County",4,3,725,380,345
050,36,109,"New York","Tompkins County",4,4,718,380,338
050,36,109,"New York","Tompkins County",4,5,802,420,382
050,36,109,"New York","Tompkins County",4,6,767,381,386
050,36,109,"New York","Tompkins County",4,7,816,397,419
050,36,109,"New York","Tompkins County",4,8,849,429,420
050,36,109,"New York","Tompkins County",4,9,885,466,419
050,36,109,"New York","Tompkins County",4,10,863,431,432
050,36,109,"New York","Tompkins County",4,11,837,418,419
050,36,109,"New York","Tompkins County",4,12,825,430,395
050,36,109,"New York","Tompkins County",4,13,851,441,410
050,36,109,"New York","Tompkins County",4,14,922,474,448
050,36,109,"New York","Tompkins County",4,15,890,470,420
050,36,109,"New York","Tompkins County",4,16,905,455,450
050,36,109,"New York","Tompkins County",4,17,980,499,481
050,36,109,"New York","Tompkins County",4,18,3603,1640,1963
050,36,109,"New York","Tompkins County",4,19,5807,2872,2935
050,36,109,"New York","Tompkins County",4,20,5621,2851,2770
050,36,109,"New York","Tompkins County",4,21,5252,2655,2597
050,36,109,"New York","Tompkins County",4,22,3521,1819,1702
050,36,109,"New York","Tompkins County",4,23,1928,1076,852
050,36,109,"New York","Tompkins County",4,24,1733,905,828
050,36,109,"New York","Tompkins County",4,25,1567,819,748
050,36,109,"New York","Tompkins County",4,26,1442,741,701
050,36,109,"New York","Tompkins County",4,27,1305,637,668
050,36,109,"New York","Tompkins County",4,28,1327,661,666
050,36,109,"New York","Tompkins County",4,29,1217,645,572
050,36,109,"New York","Tompkins County",4,30,1285,676,609
050,36,109,"New York","Tompkins County",4,31,1190,567,623
050,36,109,"New York","Tompkins County",4,32,1135,568,567
050,36,109,"New York","Tompkins County",4,33,1105,560,545
050,36,109,"New York","Tompkins County",4,34,1078,532,546
050,36,109,"New York","Tompkins County",4,35,1059,518,541
050,36,109,"New York","Tompkins County",4,36,1134,557,577
050,36,109,"New York","Tompkins County",4,37,1128,515,613
050,36,109,"New York","Tompkins County",4,38,1118,518,600
050,36,109,"New York","Tompkins County",4,39,1146,551,595
050,36,109,"New York","Tompkins County",4,40,1196,590,606
050,36,109,"New York","Tompkins County",4,41,1221,585,636
050,36,109,"New York","Tompkins County",4,42,1207,579,628
050,36,109,"New York","Tompkins County",4,43,1095,531,564
050,36,109,"New York","Tompkins County",4,44,1063,522,541
050,36,109,"New York","Tompkins County",4,45,1071,526,545
050,36,109,"New York","Tompkins County",4,46,991,493,498
050,36,109,"New York","Tompkins County",4,47,1010,489,521
050,36,109,"New York","Tompkins County",4,48,942,450,492
050,36,109,"New York","Tompkins County",4,49,920,469,451
050,36,109,"New York","Tompkins County",4,50,970,485,485
050,36,109,"New York","Tompkins County",4,51,1023,507,516
050,36,109,"New York","Tompkins County",4,52,1069,512,557
050,36,109,"New York","Tompkins County",4,53,1037,521,516
050,36,109,"New York","Tompkins County",4,54,1047,522,525
050,36,109,"New York","Tompkins County",4,55,1074,530,544
050,36,109,"New York","Tompkins County",4,56,1060,516,544
050,36,109,"New York","Tompkins County",4,57,1079,519,560
050,36,109,"New York","Tompkins County",4,58,1114,534,580
050,36,109,"New York","Tompkins County",4,59,1138,550,588
050,36,109,"New York","Tompkins County",4,60,1096,520,576
050,36,109,"New York","Tompkins County",4,61,1080,509,571
050,36,109,"New York","Tompkins County",4,62,1139,546,593
050,36,109,"New York","Tompkins County",4,63,1128,546,582
050,36,109,"New York","Tompkins County",4,64,1162,551,611
050,36,109,"New York","Tompkins County",4,65,1104,521,583
050,36,109,"New York","Tompkins County",4,66,1094,513,581
050,36,109,"New York","Tompkins County",4,67,1096,518,578
050,36,109,"New York","Tompkins County",4,68,1086,536,550
050,36,109,"New York","Tompkins County",4,69,1116,534,582
050,36,109,"New York","Tompkins County",4,70,1068,494,574
050,36,109,"New York","Tompkins County",4,71,964,451,513
050,36,109,"New York","Tompkins County",4,72,906,435,471
050,36,109,"New York","Tompkins County",4,73,848,401,447
050,36,109,"New York","Tompkins County",4,74,839,385,454
050,36,109,"New York","Tompkins County",4,75,912,439,473
050,36,109,"New York","Tompkins County",4,76,606,281,325
050,36,109,"New York","Tompkins County",4,77,583,284,299
050,36,109,"New York","Tompkins County",4,78,536,255,281
050,36,109,"New York","Tompkins County",4,79,527,242,285
050,36,109,"New York","Tompkins County",4,80,453,200,253
050,36,109,"New York","Tompkins County",4,81,424,187,237
050,36,109,"New York","Tompkins County",4,82,354,159,195
050,36,109,"New York","Tompkins County",4,83,316,153,163
050,36,109,"New York","Tompkins County",4,84,275,110,165
050,36,109,"New York","Tompkins County",4,85,1842,662,1180
050,36,109,"New York","Tompkins County",5,0,700,363,337
050,36,109,"New York","Tompkins County",5,1,683,373,310
050,36,109,"New York","Tompkins County",5,2,633,344,289
050,36,109,"New York","Tompkins County",5,3,730,382,348
050,36,109,"New York","Tompkins County",5,4,710,366,344
050,36,109,"New York","Tompkins County",5,5,699,360,339
050,36,109,"New York","Tompkins County",5,6,786,410,376
050,36,109,"New York","Tompkins County",5,7,758,366,392
050,36,109,"New York","Tompkins County",5,8,812,389,423
050,36,109,"New York","Tompkins County",5,9,838,416,422
050,36,109,"New York","Tompkins County",5,10,848,455,393
050,36,109,"New York","Tompkins County",5,11,839,417,422
050,36,109,"New York","Tompkins County",5,12,830,408,422
050,36,109,"New York","Tompkins County",5,13,829,432,397
050,36,109,"New York","Tompkins County",5,14,851,445,406
050,36,109,"New York","Tompkins County",5,15,978,516,462
050,36,109,"New York","Tompkins County",5,16,947,482,465
050,36,109,"New York","Tompkins County",5,17,974,474,500
050,36,109,"New York","Tompkins County",5,18,3616,1642,1974
050,36,109,"New York","Tompkins County",5,19,5833,2897,2936
050,36,109,"New York","Tompkins County",5,20,5666,2866,2800
050,36,109,"New York","Tompkins County",5,21,5175,2606,2569
050,36,109,"New York","Tompkins County",5,22,3541,1829,1712
050,36,109,"New York","Tompkins County",5,23,1916,1063,853
050,36,109,"New York","Tompkins County",5,24,1696,900,796
050,36,109,"New York","Tompkins County",5,25,1550,757,793
050,36,109,"New York","Tompkins County",5,26,1401,740,661
050,36,109,"New York","Tompkins County",5,27,1272,641,631
050,36,109,"New York","Tompkins County",5,28,1249,611,638
050,36,109,"New York","Tompkins County",5,29,1249,615,634
050,36,109,"New York","Tompkins County",5,30,1137,599,538
050,36,109,"New York","Tompkins County",5,31,1187,613,574
050,36,109,"New York","Tompkins County",5,32,1141,533,608
050,36,109,"New York","Tompkins County",5,33,1123,560,563
050,36,109,"New York","Tompkins County",5,34,1061,548,513
050,36,109,"New York","Tompkins County",5,35,1054,522,532
050,36,109,"New York","Tompkins County",5,36,1043,502,541
050,36,109,"New York","Tompkins County",5,37,1123,545,578
050,36,109,"New York","Tompkins County",5,38,1110,503,607
050,36,109,"New York","Tompkins County",5,39,1080,499,581
050,36,109,"New York","Tompkins County",5,40,1123,543,580
050,36,109,"New York","Tompkins County",5,41,1180,590,590
050,36,109,"New York","Tompkins County",5,42,1191,577,614
050,36,109,"New York","Tompkins County",5,43,1210,580,630
050,36,109,"New York","Tompkins County",5,44,1075,524,551
050,36,109,"New York","Tompkins County",5,45,1050,512,538
050,36,109,"New York","Tompkins County",5,46,1046,520,526
050,36,109,"New York","Tompkins County",5,47,963,480,483
050,36,109,"New York","Tompkins County",5,48,995,493,502
050,36,109,"New York","Tompkins County",5,49,910,440,470
050,36,109,"New York","Tompkins County",5,50,933,476,457
050,36,109,"New York","Tompkins County",5,51,951,481,470
050,36,109,"New York","Tompkins County",5,52,1017,492,525
050,36,109,"New York","Tompkins County",5,53,1048,499,549
050,36,109,"New York","Tompkins County",5,54,1017,505,512
050,36,109,"New York","Tompkins County",5,55,1009,491,518
050,36,109,"New York","Tompkins County",5,56,1063,526,537
050,36,109,"New York","Tompkins County",5,57,1041,508,533
050,36,109,"New York","Tompkins County",5,58,1057,503,554
050,36,109,"New York","Tompkins County",5,59,1103,512,591
050,36,109,"New York","Tompkins County",5,60,1138,545,593
050,36,109,"New York","Tompkins County",5,61,1045,501,544
050,36,109,"New York","Tompkins County",5,62,1059,491,568
050,36,109,"New York","Tompkins County",5,63,1132,542,590
050,36,109,"New York","Tompkins County",5,64,1086,528,558
050,36,109,"New York","Tompkins County",5,65,1161,554,607
050,36,109,"New York","Tompkins County",5,66,1083,515,568
050,36,109,"New York","Tompkins County",5,67,1076,496,580
050,36,109,"New York","Tompkins County",5,68,1076,511,565
050,36,109,"New York","Tompkins County",5,69,1062,518,544
050,36,109,"New York","Tompkins County",5,70,1078,509,569
050,36,109,"New York","Tompkins County",5,71,1039,480,559
050,36,109,"New York","Tompkins County",5,72,944,448,496
050,36,109,"New York","Tompkins County",5,73,901,424,477
050,36,109,"New York","Tompkins County",5,74,822,391,431
050,36,109,"New York","Tompkins County",5,75,799,360,439
050,36,109,"New York","Tompkins County",5,76,870,414,456
050,36,109,"New York","Tompkins County",5,77,599,284,315
050,36,109,"New York","Tompkins County",5,78,556,266,290
050,36,109,"New York","Tompkins County",5,79,524,250,274
050,36,109,"New York","Tompkins County",5,80,513,232,281
050,36,109,"New York","Tompkins County",5,81,447,200,247
050,36,109,"New York","Tompkins County",5,82,400,171,229
050,36,109,"New York","Tompkins County",5,83,322,148,174
050,36,109,"New York","Tompkins County",5,84,302,138,164
050,36,109,"New York","Tompkins County",5,85,1874,683,1191
050,36,111,"New York","Ulster County",1,0,1562,810,752
050,36,111,"New York","Ulster County",1,1,1599,840,759
050,36,111,"New York","Ulster County",1,2,1559,821,738
050,36,111,"New York","Ulster County",1,3,1583,854,729
050,36,111,"New York","Ulster County",1,4,1661,882,779
050,36,111,"New York","Ulster County",1,5,1660,842,818
050,36,111,"New York","Ulster County",1,6,1678,854,824
050,36,111,"New York","Ulster County",1,7,1698,845,853
050,36,111,"New York","Ulster County",1,8,1752,870,882
050,36,111,"New York","Ulster County",1,9,1775,896,879
050,36,111,"New York","Ulster County",1,10,1773,908,865
050,36,111,"New York","Ulster County",1,11,1902,945,957
050,36,111,"New York","Ulster County",1,12,1987,1013,974
050,36,111,"New York","Ulster County",1,13,1999,1018,981
050,36,111,"New York","Ulster County",1,14,1984,1007,977
050,36,111,"New York","Ulster County",1,15,1986,1000,986
050,36,111,"New York","Ulster County",1,16,2103,1058,1045
050,36,111,"New York","Ulster County",1,17,2037,1064,973
050,36,111,"New York","Ulster County",1,18,2365,1125,1240
050,36,111,"New York","Ulster County",1,19,2388,1128,1260
050,36,111,"New York","Ulster County",1,20,2328,1132,1196
050,36,111,"New York","Ulster County",1,21,2186,1073,1113
050,36,111,"New York","Ulster County",1,22,2117,1078,1039
050,36,111,"New York","Ulster County",1,23,2108,1130,978
050,36,111,"New York","Ulster County",1,24,2158,1182,976
050,36,111,"New York","Ulster County",1,25,2185,1148,1037
050,36,111,"New York","Ulster County",1,26,2251,1196,1055
050,36,111,"New York","Ulster County",1,27,2284,1196,1088
050,36,111,"New York","Ulster County",1,28,2230,1192,1038
050,36,111,"New York","Ulster County",1,29,2330,1219,1111
050,36,111,"New York","Ulster County",1,30,2319,1186,1133
050,36,111,"New York","Ulster County",1,31,2368,1231,1137
050,36,111,"New York","Ulster County",1,32,2325,1189,1136
050,36,111,"New York","Ulster County",1,33,2224,1159,1065
050,36,111,"New York","Ulster County",1,34,2161,1148,1013
050,36,111,"New York","Ulster County",1,35,2281,1204,1077
050,36,111,"New York","Ulster County",1,36,2252,1225,1027
050,36,111,"New York","Ulster County",1,37,2162,1154,1008
050,36,111,"New York","Ulster County",1,38,2198,1152,1046
050,36,111,"New York","Ulster County",1,39,2245,1160,1085
050,36,111,"New York","Ulster County",1,40,2252,1161,1091
050,36,111,"New York","Ulster County",1,41,2097,1083,1014
050,36,111,"New York","Ulster County",1,42,2160,1109,1051
050,36,111,"New York","Ulster County",1,43,2126,1100,1026
050,36,111,"New York","Ulster County",1,44,2142,1119,1023
050,36,111,"New York","Ulster County",1,45,2143,1101,1042
050,36,111,"New York","Ulster County",1,46,2068,1065,1003
050,36,111,"New York","Ulster County",1,47,2159,1128,1031
050,36,111,"New York","Ulster County",1,48,2348,1200,1148
050,36,111,"New York","Ulster County",1,49,2562,1321,1241
050,36,111,"New York","Ulster County",1,50,2514,1299,1215
050,36,111,"New York","Ulster County",1,51,2438,1240,1198
050,36,111,"New York","Ulster County",1,52,2446,1245,1201
050,36,111,"New York","Ulster County",1,53,2579,1263,1316
050,36,111,"New York","Ulster County",1,54,2697,1329,1368
050,36,111,"New York","Ulster County",1,55,2805,1398,1407
050,36,111,"New York","Ulster County",1,56,2920,1468,1452
050,36,111,"New York","Ulster County",1,57,2924,1485,1439
050,36,111,"New York","Ulster County",1,58,2970,1483,1487
050,36,111,"New York","Ulster County",1,59,2969,1457,1512
050,36,111,"New York","Ulster County",1,60,2923,1440,1483
050,36,111,"New York","Ulster County",1,61,2855,1433,1422
050,36,111,"New York","Ulster County",1,62,2922,1449,1473
050,36,111,"New York","Ulster County",1,63,2741,1385,1356
050,36,111,"New York","Ulster County",1,64,2598,1258,1340
050,36,111,"New York","Ulster County",1,65,2483,1214,1269
050,36,111,"New York","Ulster County",1,66,2435,1188,1247
050,36,111,"New York","Ulster County",1,67,2407,1184,1223
050,36,111,"New York","Ulster County",1,68,2418,1162,1256
050,36,111,"New York","Ulster County",1,69,2289,1095,1194
050,36,111,"New York","Ulster County",1,70,2124,1054,1070
050,36,111,"New York","Ulster County",1,71,2077,977,1100
050,36,111,"New York","Ulster County",1,72,2139,1024,1115
050,36,111,"New York","Ulster County",1,73,2122,1028,1094
050,36,111,"New York","Ulster County",1,74,1474,671,803
050,36,111,"New York","Ulster County",1,75,1479,680,799
050,36,111,"New York","Ulster County",1,76,1468,669,799
050,36,111,"New York","Ulster County",1,77,1468,685,783
050,36,111,"New York","Ulster County",1,78,1217,576,641
050,36,111,"New York","Ulster County",1,79,1017,458,559
050,36,111,"New York","Ulster County",1,80,903,405,498
050,36,111,"New York","Ulster County",1,81,854,366,488
050,36,111,"New York","Ulster County",1,82,750,325,425
050,36,111,"New York","Ulster County",1,83,689,283,406
050,36,111,"New York","Ulster County",1,84,641,253,388
050,36,111,"New York","Ulster County",1,85,4266,1514,2752
050,36,111,"New York","Ulster County",2,0,1544,811,733
050,36,111,"New York","Ulster County",2,1,1593,830,763
050,36,111,"New York","Ulster County",2,2,1569,827,742
050,36,111,"New York","Ulster County",2,3,1573,844,729
050,36,111,"New York","Ulster County",2,4,1650,884,766
050,36,111,"New York","Ulster County",2,5,1665,856,809
050,36,111,"New York","Ulster County",2,6,1678,850,828
050,36,111,"New York","Ulster County",2,7,1693,846,847
050,36,111,"New York","Ulster County",2,8,1731,857,874
050,36,111,"New York","Ulster County",2,9,1767,888,879
050,36,111,"New York","Ulster County",2,10,1775,904,871
050,36,111,"New York","Ulster County",2,11,1862,931,931
050,36,111,"New York","Ulster County",2,12,1976,1002,974
050,36,111,"New York","Ulster County",2,13,1998,1018,980
050,36,111,"New York","Ulster County",2,14,1986,1008,978
050,36,111,"New York","Ulster County",2,15,1985,1001,984
050,36,111,"New York","Ulster County",2,16,2084,1047,1037
050,36,111,"New York","Ulster County",2,17,2050,1061,989
050,36,111,"New York","Ulster County",2,18,2353,1122,1231
050,36,111,"New York","Ulster County",2,19,2389,1129,1260
050,36,111,"New York","Ulster County",2,20,2342,1134,1208
050,36,111,"New York","Ulster County",2,21,2171,1062,1109
050,36,111,"New York","Ulster County",2,22,2104,1065,1039
050,36,111,"New York","Ulster County",2,23,2097,1119,978
050,36,111,"New York","Ulster County",2,24,2140,1158,982
050,36,111,"New York","Ulster County",2,25,2164,1142,1022
050,36,111,"New York","Ulster County",2,26,2218,1172,1046
050,36,111,"New York","Ulster County",2,27,2263,1185,1078
050,36,111,"New York","Ulster County",2,28,2229,1189,1040
050,36,111,"New York","Ulster County",2,29,2300,1200,1100
050,36,111,"New York","Ulster County",2,30,2328,1187,1141
050,36,111,"New York","Ulster County",2,31,2359,1225,1134
050,36,111,"New York","Ulster County",2,32,2306,1173,1133
050,36,111,"New York","Ulster County",2,33,2244,1150,1094
050,36,111,"New York","Ulster County",2,34,2161,1138,1023
050,36,111,"New York","Ulster County",2,35,2273,1202,1071
050,36,111,"New York","Ulster County",2,36,2238,1214,1024
050,36,111,"New York","Ulster County",2,37,2171,1146,1025
050,36,111,"New York","Ulster County",2,38,2202,1158,1044
050,36,111,"New York","Ulster County",2,39,2228,1159,1069
050,36,111,"New York","Ulster County",2,40,2254,1150,1104
050,36,111,"New York","Ulster County",2,41,2107,1074,1033
050,36,111,"New York","Ulster County",2,42,2134,1092,1042
050,36,111,"New York","Ulster County",2,43,2138,1097,1041
050,36,111,"New York","Ulster County",2,44,2114,1103,1011
050,36,111,"New York","Ulster County",2,45,2148,1103,1045
050,36,111,"New York","Ulster County",2,46,2083,1068,1015
050,36,111,"New York","Ulster County",2,47,2119,1096,1023
050,36,111,"New York","Ulster County",2,48,2284,1167,1117
050,36,111,"New York","Ulster County",2,49,2508,1288,1220
050,36,111,"New York","Ulster County",2,50,2517,1297,1220
050,36,111,"New York","Ulster County",2,51,2441,1241,1200
050,36,111,"New York","Ulster County",2,52,2425,1229,1196
050,36,111,"New York","Ulster County",2,53,2538,1250,1288
050,36,111,"New York","Ulster County",2,54,2664,1314,1350
050,36,111,"New York","Ulster County",2,55,2762,1369,1393
050,36,111,"New York","Ulster County",2,56,2899,1451,1448
050,36,111,"New York","Ulster County",2,57,2895,1467,1428
050,36,111,"New York","Ulster County",2,58,2963,1479,1484
050,36,111,"New York","Ulster County",2,59,2956,1462,1494
050,36,111,"New York","Ulster County",2,60,2916,1431,1485
050,36,111,"New York","Ulster County",2,61,2854,1425,1429
050,36,111,"New York","Ulster County",2,62,2894,1439,1455
050,36,111,"New York","Ulster County",2,63,2782,1397,1385
050,36,111,"New York","Ulster County",2,64,2606,1274,1332
050,36,111,"New York","Ulster County",2,65,2506,1225,1281
050,36,111,"New York","Ulster County",2,66,2432,1185,1247
050,36,111,"New York","Ulster County",2,67,2398,1175,1223
050,36,111,"New York","Ulster County",2,68,2387,1152,1235
050,36,111,"New York","Ulster County",2,69,2325,1109,1216
050,36,111,"New York","Ulster County",2,70,2154,1058,1096
050,36,111,"New York","Ulster County",2,71,2074,986,1088
050,36,111,"New York","Ulster County",2,72,2074,988,1086
050,36,111,"New York","Ulster County",2,73,2217,1070,1147
050,36,111,"New York","Ulster County",2,74,1519,704,815
050,36,111,"New York","Ulster County",2,75,1472,676,796
050,36,111,"New York","Ulster County",2,76,1447,658,789
050,36,111,"New York","Ulster County",2,77,1493,690,803
050,36,111,"New York","Ulster County",2,78,1240,589,651
050,36,111,"New York","Ulster County",2,79,1043,473,570
050,36,111,"New York","Ulster County",2,80,915,403,512
050,36,111,"New York","Ulster County",2,81,844,363,481
050,36,111,"New York","Ulster County",2,82,765,330,435
050,36,111,"New York","Ulster County",2,83,682,287,395
050,36,111,"New York","Ulster County",2,84,636,252,384
050,36,111,"New York","Ulster County",2,85,4188,1488,2700
050,36,111,"New York","Ulster County",3,0,1554,793,761
050,36,111,"New York","Ulster County",3,1,1577,817,760
050,36,111,"New York","Ulster County",3,2,1626,850,776
050,36,111,"New York","Ulster County",3,3,1603,839,764
050,36,111,"New York","Ulster County",3,4,1616,859,757
050,36,111,"New York","Ulster County",3,5,1671,890,781
050,36,111,"New York","Ulster County",3,6,1701,877,824
050,36,111,"New York","Ulster County",3,7,1669,838,831
050,36,111,"New York","Ulster County",3,8,1688,856,832
050,36,111,"New York","Ulster County",3,9,1723,851,872
050,36,111,"New York","Ulster County",3,10,1793,900,893
050,36,111,"New York","Ulster County",3,11,1772,890,882
050,36,111,"New York","Ulster County",3,12,1843,921,922
050,36,111,"New York","Ulster County",3,13,1996,1008,988
050,36,111,"New York","Ulster County",3,14,1999,1018,981
050,36,111,"New York","Ulster County",3,15,1985,1008,977
050,36,111,"New York","Ulster County",3,16,1975,993,982
050,36,111,"New York","Ulster County",3,17,2054,1033,1021
050,36,111,"New York","Ulster County",3,18,2621,1216,1405
050,36,111,"New York","Ulster County",3,19,2672,1244,1428
050,36,111,"New York","Ulster County",3,20,2520,1193,1327
050,36,111,"New York","Ulster County",3,21,2294,1094,1200
050,36,111,"New York","Ulster County",3,22,2147,1074,1073
050,36,111,"New York","Ulster County",3,23,2099,1110,989
050,36,111,"New York","Ulster County",3,24,2071,1097,974
050,36,111,"New York","Ulster County",3,25,2172,1152,1020
050,36,111,"New York","Ulster County",3,26,2145,1130,1015
050,36,111,"New York","Ulster County",3,27,2269,1173,1096
050,36,111,"New York","Ulster County",3,28,2252,1203,1049
050,36,111,"New York","Ulster County",3,29,2280,1194,1086
050,36,111,"New York","Ulster County",3,30,2366,1213,1153
050,36,111,"New York","Ulster County",3,31,2515,1290,1225
050,36,111,"New York","Ulster County",3,32,2432,1231,1201
050,36,111,"New York","Ulster County",3,33,2485,1219,1266
050,36,111,"New York","Ulster County",3,34,2281,1176,1105
050,36,111,"New York","Ulster County",3,35,2324,1222,1102
050,36,111,"New York","Ulster County",3,36,2321,1248,1073
050,36,111,"New York","Ulster County",3,37,2279,1192,1087
050,36,111,"New York","Ulster County",3,38,2328,1240,1088
050,36,111,"New York","Ulster County",3,39,2318,1238,1080
050,36,111,"New York","Ulster County",3,40,2313,1157,1156
050,36,111,"New York","Ulster County",3,41,2269,1128,1141
050,36,111,"New York","Ulster County",3,42,2166,1095,1071
050,36,111,"New York","Ulster County",3,43,2196,1101,1095
050,36,111,"New York","Ulster County",3,44,2205,1149,1056
050,36,111,"New York","Ulster County",3,45,2137,1117,1020
050,36,111,"New York","Ulster County",3,46,2184,1131,1053
050,36,111,"New York","Ulster County",3,47,2066,1060,1006
050,36,111,"New York","Ulster County",3,48,2121,1096,1025
050,36,111,"New York","Ulster County",3,49,2292,1182,1110
050,36,111,"New York","Ulster County",3,50,2541,1317,1224
050,36,111,"New York","Ulster County",3,51,2532,1282,1250
050,36,111,"New York","Ulster County",3,52,2416,1229,1187
050,36,111,"New York","Ulster County",3,53,2413,1216,1197
050,36,111,"New York","Ulster County",3,54,2565,1286,1279
050,36,111,"New York","Ulster County",3,55,2622,1277,1345
050,36,111,"New York","Ulster County",3,56,2770,1369,1401
050,36,111,"New York","Ulster County",3,57,2825,1425,1400
050,36,111,"New York","Ulster County",3,58,2940,1454,1486
050,36,111,"New York","Ulster County",3,59,2900,1459,1441
050,36,111,"New York","Ulster County",3,60,2921,1445,1476
050,36,111,"New York","Ulster County",3,61,2892,1394,1498
050,36,111,"New York","Ulster County",3,62,2863,1432,1431
050,36,111,"New York","Ulster County",3,63,2818,1394,1424
050,36,111,"New York","Ulster County",3,64,2735,1348,1387
050,36,111,"New York","Ulster County",3,65,2566,1256,1310
050,36,111,"New York","Ulster County",3,66,2452,1188,1264
050,36,111,"New York","Ulster County",3,67,2419,1175,1244
050,36,111,"New York","Ulster County",3,68,2354,1162,1192
050,36,111,"New York","Ulster County",3,69,2334,1115,1219
050,36,111,"New York","Ulster County",3,70,2282,1086,1196
050,36,111,"New York","Ulster County",3,71,2101,1024,1077
050,36,111,"New York","Ulster County",3,72,2026,966,1060
050,36,111,"New York","Ulster County",3,73,2023,958,1065
050,36,111,"New York","Ulster County",3,74,2154,1029,1125
050,36,111,"New York","Ulster County",3,75,1463,686,777
050,36,111,"New York","Ulster County",3,76,1422,651,771
050,36,111,"New York","Ulster County",3,77,1418,627,791
050,36,111,"New York","Ulster County",3,78,1417,652,765
050,36,111,"New York","Ulster County",3,79,1185,565,620
050,36,111,"New York","Ulster County",3,80,990,430,560
050,36,111,"New York","Ulster County",3,81,838,363,475
050,36,111,"New York","Ulster County",3,82,791,342,449
050,36,111,"New York","Ulster County",3,83,712,296,416
050,36,111,"New York","Ulster County",3,84,617,247,370
050,36,111,"New York","Ulster County",3,85,4187,1504,2683
050,36,111,"New York","Ulster County",4,0,1573,792,781
050,36,111,"New York","Ulster County",4,1,1551,799,752
050,36,111,"New York","Ulster County",4,2,1584,824,760
050,36,111,"New York","Ulster County",4,3,1612,837,775
050,36,111,"New York","Ulster County",4,4,1593,832,761
050,36,111,"New York","Ulster County",4,5,1601,843,758
050,36,111,"New York","Ulster County",4,6,1632,870,762
050,36,111,"New York","Ulster County",4,7,1680,870,810
050,36,111,"New York","Ulster County",4,8,1660,839,821
050,36,111,"New York","Ulster County",4,9,1670,851,819
050,36,111,"New York","Ulster County",4,10,1713,851,862
050,36,111,"New York","Ulster County",4,11,1785,911,874
050,36,111,"New York","Ulster County",4,12,1751,878,873
050,36,111,"New York","Ulster County",4,13,1830,924,906
050,36,111,"New York","Ulster County",4,14,1982,1023,959
050,36,111,"New York","Ulster County",4,15,2000,1023,977
050,36,111,"New York","Ulster County",4,16,1996,1015,981
050,36,111,"New York","Ulster County",4,17,1925,982,943
050,36,111,"New York","Ulster County",4,18,2624,1189,1435
050,36,111,"New York","Ulster County",4,19,2727,1244,1483
050,36,111,"New York","Ulster County",4,20,2492,1200,1292
050,36,111,"New York","Ulster County",4,21,2234,1059,1175
050,36,111,"New York","Ulster County",4,22,2146,1065,1081
050,36,111,"New York","Ulster County",4,23,2015,1053,962
050,36,111,"New York","Ulster County",4,24,2071,1097,974
050,36,111,"New York","Ulster County",4,25,2045,1098,947
050,36,111,"New York","Ulster County",4,26,2043,1114,929
050,36,111,"New York","Ulster County",4,27,2139,1123,1016
050,36,111,"New York","Ulster County",4,28,2216,1182,1034
050,36,111,"New York","Ulster County",4,29,2271,1200,1071
050,36,111,"New York","Ulster County",4,30,2205,1122,1083
050,36,111,"New York","Ulster County",4,31,2379,1240,1139
050,36,111,"New York","Ulster County",4,32,2535,1269,1266
050,36,111,"New York","Ulster County",4,33,2517,1261,1256
050,36,111,"New York","Ulster County",4,34,2459,1199,1260
050,36,111,"New York","Ulster County",4,35,2352,1217,1135
050,36,111,"New York","Ulster County",4,36,2351,1262,1089
050,36,111,"New York","Ulster County",4,37,2270,1168,1102
050,36,111,"New York","Ulster County",4,38,2344,1253,1091
050,36,111,"New York","Ulster County",4,39,2391,1286,1105
050,36,111,"New York","Ulster County",4,40,2342,1230,1112
050,36,111,"New York","Ulster County",4,41,2250,1113,1137
050,36,111,"New York","Ulster County",4,42,2271,1128,1143
050,36,111,"New York","Ulster County",4,43,2164,1089,1075
050,36,111,"New York","Ulster County",4,44,2187,1119,1068
050,36,111,"New York","Ulster County",4,45,2208,1164,1044
050,36,111,"New York","Ulster County",4,46,2144,1129,1015
050,36,111,"New York","Ulster County",4,47,2178,1123,1055
050,36,111,"New York","Ulster County",4,48,2036,1039,997
050,36,111,"New York","Ulster County",4,49,2100,1082,1018
050,36,111,"New York","Ulster County",4,50,2252,1160,1092
050,36,111,"New York","Ulster County",4,51,2563,1300,1263
050,36,111,"New York","Ulster County",4,52,2483,1253,1230
050,36,111,"New York","Ulster County",4,53,2406,1212,1194
050,36,111,"New York","Ulster County",4,54,2432,1250,1182
050,36,111,"New York","Ulster County",4,55,2500,1242,1258
050,36,111,"New York","Ulster County",4,56,2628,1283,1345
050,36,111,"New York","Ulster County",4,57,2683,1336,1347
050,36,111,"New York","Ulster County",4,58,2844,1408,1436
050,36,111,"New York","Ulster County",4,59,2839,1439,1400
050,36,111,"New York","Ulster County",4,60,2845,1432,1413
050,36,111,"New York","Ulster County",4,61,2865,1412,1453
050,36,111,"New York","Ulster County",4,62,2881,1394,1487
050,36,111,"New York","Ulster County",4,63,2768,1388,1380
050,36,111,"New York","Ulster County",4,64,2737,1337,1400
050,36,111,"New York","Ulster County",4,65,2696,1335,1361
050,36,111,"New York","Ulster County",4,66,2499,1211,1288
050,36,111,"New York","Ulster County",4,67,2407,1161,1246
050,36,111,"New York","Ulster County",4,68,2377,1149,1228
050,36,111,"New York","Ulster County",4,69,2300,1128,1172
050,36,111,"New York","Ulster County",4,70,2284,1103,1181
050,36,111,"New York","Ulster County",4,71,2226,1035,1191
050,36,111,"New York","Ulster County",4,72,2054,999,1055
050,36,111,"New York","Ulster County",4,73,1977,936,1041
050,36,111,"New York","Ulster County",4,74,1961,931,1030
050,36,111,"New York","Ulster County",4,75,2109,997,1112
050,36,111,"New York","Ulster County",4,76,1408,645,763
050,36,111,"New York","Ulster County",4,77,1403,646,757
050,36,111,"New York","Ulster County",4,78,1335,593,742
050,36,111,"New York","Ulster County",4,79,1335,615,720
050,36,111,"New York","Ulster County",4,80,1159,535,624
050,36,111,"New York","Ulster County",4,81,903,391,512
050,36,111,"New York","Ulster County",4,82,785,337,448
050,36,111,"New York","Ulster County",4,83,740,310,430
050,36,111,"New York","Ulster County",4,84,653,256,397
050,36,111,"New York","Ulster County",4,85,4139,1485,2654
050,36,111,"New York","Ulster County",5,0,1574,793,781
050,36,111,"New York","Ulster County",5,1,1604,819,785
050,36,111,"New York","Ulster County",5,2,1581,821,760
050,36,111,"New York","Ulster County",5,3,1572,812,760
050,36,111,"New York","Ulster County",5,4,1585,826,759
050,36,111,"New York","Ulster County",5,5,1579,824,755
050,36,111,"New York","Ulster County",5,6,1608,848,760
050,36,111,"New York","Ulster County",5,7,1643,874,769
050,36,111,"New York","Ulster County",5,8,1664,850,814
050,36,111,"New York","Ulster County",5,9,1649,829,820
050,36,111,"New York","Ulster County",5,10,1660,851,809
050,36,111,"New York","Ulster County",5,11,1695,829,866
050,36,111,"New York","Ulster County",5,12,1756,892,864
050,36,111,"New York","Ulster County",5,13,1734,869,865
050,36,111,"New York","Ulster County",5,14,1808,920,888
050,36,111,"New York","Ulster County",5,15,1996,1037,959
050,36,111,"New York","Ulster County",5,16,2025,1033,992
050,36,111,"New York","Ulster County",5,17,1964,997,967
050,36,111,"New York","Ulster County",5,18,2525,1161,1364
050,36,111,"New York","Ulster County",5,19,2735,1230,1505
050,36,111,"New York","Ulster County",5,20,2509,1184,1325
050,36,111,"New York","Ulster County",5,21,2224,1102,1122
050,36,111,"New York","Ulster County",5,22,2144,1066,1078
050,36,111,"New York","Ulster County",5,23,2083,1073,1010
050,36,111,"New York","Ulster County",5,24,2035,1073,962
050,36,111,"New York","Ulster County",5,25,2058,1100,958
050,36,111,"New York","Ulster County",5,26,1988,1069,919
050,36,111,"New York","Ulster County",5,27,2099,1145,954
050,36,111,"New York","Ulster County",5,28,2170,1176,994
050,36,111,"New York","Ulster County",5,29,2216,1179,1037
050,36,111,"New York","Ulster County",5,30,2235,1162,1073
050,36,111,"New York","Ulster County",5,31,2283,1165,1118
050,36,111,"New York","Ulster County",5,32,2392,1205,1187
050,36,111,"New York","Ulster County",5,33,2581,1288,1293
050,36,111,"New York","Ulster County",5,34,2495,1273,1222
050,36,111,"New York","Ulster County",5,35,2518,1253,1265
050,36,111,"New York","Ulster County",5,36,2381,1261,1120
050,36,111,"New York","Ulster County",5,37,2315,1202,1113
050,36,111,"New York","Ulster County",5,38,2359,1237,1122
050,36,111,"New York","Ulster County",5,39,2397,1318,1079
050,36,111,"New York","Ulster County",5,40,2428,1285,1143
050,36,111,"New York","Ulster County",5,41,2310,1196,1114
050,36,111,"New York","Ulster County",5,42,2285,1123,1162
050,36,111,"New York","Ulster County",5,43,2283,1127,1156
050,36,111,"New York","Ulster County",5,44,2211,1137,1074
050,36,111,"New York","Ulster County",5,45,2212,1138,1074
050,36,111,"New York","Ulster County",5,46,2222,1173,1049
050,36,111,"New York","Ulster County",5,47,2109,1102,1007
050,36,111,"New York","Ulster County",5,48,2170,1114,1056
050,36,111,"New York","Ulster County",5,49,2018,1032,986
050,36,111,"New York","Ulster County",5,50,2094,1068,1026
050,36,111,"New York","Ulster County",5,51,2278,1174,1104
050,36,111,"New York","Ulster County",5,52,2543,1295,1248
050,36,111,"New York","Ulster County",5,53,2472,1234,1238
050,36,111,"New York","Ulster County",5,54,2436,1263,1173
050,36,111,"New York","Ulster County",5,55,2383,1213,1170
050,36,111,"New York","Ulster County",5,56,2521,1247,1274
050,36,111,"New York","Ulster County",5,57,2546,1260,1286
050,36,111,"New York","Ulster County",5,58,2729,1335,1394
050,36,111,"New York","Ulster County",5,59,2743,1378,1365
050,36,111,"New York","Ulster County",5,60,2787,1408,1379
050,36,111,"New York","Ulster County",5,61,2799,1402,1397
050,36,111,"New York","Ulster County",5,62,2879,1422,1457
050,36,111,"New York","Ulster County",5,63,2816,1368,1448
050,36,111,"New York","Ulster County",5,64,2721,1352,1369
050,36,111,"New York","Ulster County",5,65,2701,1330,1371
050,36,111,"New York","Ulster County",5,66,2636,1303,1333
050,36,111,"New York","Ulster County",5,67,2478,1194,1284
050,36,111,"New York","Ulster County",5,68,2373,1144,1229
050,36,111,"New York","Ulster County",5,69,2327,1129,1198
050,36,111,"New York","Ulster County",5,70,2263,1115,1148
050,36,111,"New York","Ulster County",5,71,2214,1055,1159
050,36,111,"New York","Ulster County",5,72,2186,1030,1156
050,36,111,"New York","Ulster County",5,73,2012,971,1041
050,36,111,"New York","Ulster County",5,74,1930,916,1014
050,36,111,"New York","Ulster County",5,75,1912,898,1014
050,36,111,"New York","Ulster County",5,76,2056,965,1091
050,36,111,"New York","Ulster County",5,77,1376,624,752
050,36,111,"New York","Ulster County",5,78,1338,624,714
050,36,111,"New York","Ulster County",5,79,1279,569,710
050,36,111,"New York","Ulster County",5,80,1290,580,710
050,36,111,"New York","Ulster County",5,81,1085,497,588
050,36,111,"New York","Ulster County",5,82,860,373,487
050,36,111,"New York","Ulster County",5,83,738,307,431
050,36,111,"New York","Ulster County",5,84,672,269,403
050,36,111,"New York","Ulster County",5,85,4173,1507,2666
050,36,113,"New York","Warren County",1,0,548,277,271
050,36,113,"New York","Warren County",1,1,553,271,282
050,36,113,"New York","Warren County",1,2,578,298,280
050,36,113,"New York","Warren County",1,3,581,312,269
050,36,113,"New York","Warren County",1,4,603,319,284
050,36,113,"New York","Warren County",1,5,582,286,296
050,36,113,"New York","Warren County",1,6,641,323,318
050,36,113,"New York","Warren County",1,7,663,348,315
050,36,113,"New York","Warren County",1,8,665,336,329
050,36,113,"New York","Warren County",1,9,662,352,310
050,36,113,"New York","Warren County",1,10,688,380,308
050,36,113,"New York","Warren County",1,11,724,367,357
050,36,113,"New York","Warren County",1,12,703,366,337
050,36,113,"New York","Warren County",1,13,723,361,362
050,36,113,"New York","Warren County",1,14,707,357,350
050,36,113,"New York","Warren County",1,15,761,404,357
050,36,113,"New York","Warren County",1,16,746,395,351
050,36,113,"New York","Warren County",1,17,762,411,351
050,36,113,"New York","Warren County",1,18,711,385,326
050,36,113,"New York","Warren County",1,19,627,337,290
050,36,113,"New York","Warren County",1,20,659,332,327
050,36,113,"New York","Warren County",1,21,682,345,337
050,36,113,"New York","Warren County",1,22,706,350,356
050,36,113,"New York","Warren County",1,23,721,361,360
050,36,113,"New York","Warren County",1,24,734,371,363
050,36,113,"New York","Warren County",1,25,726,370,356
050,36,113,"New York","Warren County",1,26,753,376,377
050,36,113,"New York","Warren County",1,27,747,391,356
050,36,113,"New York","Warren County",1,28,766,383,383
050,36,113,"New York","Warren County",1,29,848,427,421
050,36,113,"New York","Warren County",1,30,814,422,392
050,36,113,"New York","Warren County",1,31,770,412,358
050,36,113,"New York","Warren County",1,32,755,399,356
050,36,113,"New York","Warren County",1,33,760,373,387
050,36,113,"New York","Warren County",1,34,769,382,387
050,36,113,"New York","Warren County",1,35,725,344,381
050,36,113,"New York","Warren County",1,36,761,376,385
050,36,113,"New York","Warren County",1,37,801,399,402
050,36,113,"New York","Warren County",1,38,715,365,350
050,36,113,"New York","Warren County",1,39,718,386,332
050,36,113,"New York","Warren County",1,40,697,354,343
050,36,113,"New York","Warren County",1,41,681,339,342
050,36,113,"New York","Warren County",1,42,709,358,351
050,36,113,"New York","Warren County",1,43,729,359,370
050,36,113,"New York","Warren County",1,44,662,348,314
050,36,113,"New York","Warren County",1,45,650,336,314
050,36,113,"New York","Warren County",1,46,672,337,335
050,36,113,"New York","Warren County",1,47,753,361,392
050,36,113,"New York","Warren County",1,48,799,377,422
050,36,113,"New York","Warren County",1,49,900,423,477
050,36,113,"New York","Warren County",1,50,889,426,463
050,36,113,"New York","Warren County",1,51,940,456,484
050,36,113,"New York","Warren County",1,52,908,473,435
050,36,113,"New York","Warren County",1,53,925,460,465
050,36,113,"New York","Warren County",1,54,1014,493,521
050,36,113,"New York","Warren County",1,55,1057,497,560
050,36,113,"New York","Warren County",1,56,1051,483,568
050,36,113,"New York","Warren County",1,57,1095,523,572
050,36,113,"New York","Warren County",1,58,1142,564,578
050,36,113,"New York","Warren County",1,59,1099,547,552
050,36,113,"New York","Warren County",1,60,1075,514,561
050,36,113,"New York","Warren County",1,61,1090,529,561
050,36,113,"New York","Warren County",1,62,1079,510,569
050,36,113,"New York","Warren County",1,63,1040,512,528
050,36,113,"New York","Warren County",1,64,1006,479,527
050,36,113,"New York","Warren County",1,65,991,497,494
050,36,113,"New York","Warren County",1,66,1017,512,505
050,36,113,"New York","Warren County",1,67,1001,495,506
050,36,113,"New York","Warren County",1,68,1003,502,501
050,36,113,"New York","Warren County",1,69,930,454,476
050,36,113,"New York","Warren County",1,70,867,419,448
050,36,113,"New York","Warren County",1,71,888,424,464
050,36,113,"New York","Warren County",1,72,878,435,443
050,36,113,"New York","Warren County",1,73,906,449,457
050,36,113,"New York","Warren County",1,74,595,292,303
050,36,113,"New York","Warren County",1,75,572,267,305
050,36,113,"New York","Warren County",1,76,560,252,308
050,36,113,"New York","Warren County",1,77,582,273,309
050,36,113,"New York","Warren County",1,78,501,237,264
050,36,113,"New York","Warren County",1,79,420,203,217
050,36,113,"New York","Warren County",1,80,391,179,212
050,36,113,"New York","Warren County",1,81,355,167,188
050,36,113,"New York","Warren County",1,82,336,152,184
050,36,113,"New York","Warren County",1,83,287,125,162
050,36,113,"New York","Warren County",1,84,259,107,152
050,36,113,"New York","Warren County",1,85,1578,574,1004
050,36,113,"New York","Warren County",2,0,521,258,263
050,36,113,"New York","Warren County",2,1,549,272,277
050,36,113,"New York","Warren County",2,2,568,292,276
050,36,113,"New York","Warren County",2,3,578,307,271
050,36,113,"New York","Warren County",2,4,600,318,282
050,36,113,"New York","Warren County",2,5,590,297,293
050,36,113,"New York","Warren County",2,6,630,319,311
050,36,113,"New York","Warren County",2,7,657,343,314
050,36,113,"New York","Warren County",2,8,664,338,326
050,36,113,"New York","Warren County",2,9,663,349,314
050,36,113,"New York","Warren County",2,10,683,372,311
050,36,113,"New York","Warren County",2,11,710,367,343
050,36,113,"New York","Warren County",2,12,714,368,346
050,36,113,"New York","Warren County",2,13,716,361,355
050,36,113,"New York","Warren County",2,14,712,359,353
050,36,113,"New York","Warren County",2,15,746,391,355
050,36,113,"New York","Warren County",2,16,752,398,354
050,36,113,"New York","Warren County",2,17,762,410,352
050,36,113,"New York","Warren County",2,18,702,379,323
050,36,113,"New York","Warren County",2,19,633,340,293
050,36,113,"New York","Warren County",2,20,660,334,326
050,36,113,"New York","Warren County",2,21,672,341,331
050,36,113,"New York","Warren County",2,22,706,353,353
050,36,113,"New York","Warren County",2,23,725,362,363
050,36,113,"New York","Warren County",2,24,727,364,363
050,36,113,"New York","Warren County",2,25,730,370,360
050,36,113,"New York","Warren County",2,26,753,378,375
050,36,113,"New York","Warren County",2,27,746,387,359
050,36,113,"New York","Warren County",2,28,757,380,377
050,36,113,"New York","Warren County",2,29,822,415,407
050,36,113,"New York","Warren County",2,30,822,424,398
050,36,113,"New York","Warren County",2,31,776,411,365
050,36,113,"New York","Warren County",2,32,757,398,359
050,36,113,"New York","Warren County",2,33,758,378,380
050,36,113,"New York","Warren County",2,34,768,382,386
050,36,113,"New York","Warren County",2,35,746,357,389
050,36,113,"New York","Warren County",2,36,754,370,384
050,36,113,"New York","Warren County",2,37,796,396,400
050,36,113,"New York","Warren County",2,38,735,372,363
050,36,113,"New York","Warren County",2,39,717,381,336
050,36,113,"New York","Warren County",2,40,698,357,341
050,36,113,"New York","Warren County",2,41,686,345,341
050,36,113,"New York","Warren County",2,42,691,347,344
050,36,113,"New York","Warren County",2,43,729,364,365
050,36,113,"New York","Warren County",2,44,669,345,324
050,36,113,"New York","Warren County",2,45,657,340,317
050,36,113,"New York","Warren County",2,46,663,334,329
050,36,113,"New York","Warren County",2,47,730,353,377
050,36,113,"New York","Warren County",2,48,787,370,417
050,36,113,"New York","Warren County",2,49,873,412,461
050,36,113,"New York","Warren County",2,50,897,425,472
050,36,113,"New York","Warren County",2,51,924,446,478
050,36,113,"New York","Warren County",2,52,915,471,444
050,36,113,"New York","Warren County",2,53,923,463,460
050,36,113,"New York","Warren County",2,54,992,484,508
050,36,113,"New York","Warren County",2,55,1045,495,550
050,36,113,"New York","Warren County",2,56,1055,486,569
050,36,113,"New York","Warren County",2,57,1087,516,571
050,36,113,"New York","Warren County",2,58,1128,551,577
050,36,113,"New York","Warren County",2,59,1111,552,559
050,36,113,"New York","Warren County",2,60,1082,521,561
050,36,113,"New York","Warren County",2,61,1081,521,560
050,36,113,"New York","Warren County",2,62,1075,513,562
050,36,113,"New York","Warren County",2,63,1059,516,543
050,36,113,"New York","Warren County",2,64,1009,484,525
050,36,113,"New York","Warren County",2,65,990,488,502
050,36,113,"New York","Warren County",2,66,1013,511,502
050,36,113,"New York","Warren County",2,67,998,495,503
050,36,113,"New York","Warren County",2,68,997,498,499
050,36,113,"New York","Warren County",2,69,954,471,483
050,36,113,"New York","Warren County",2,70,877,427,450
050,36,113,"New York","Warren County",2,71,885,426,459
050,36,113,"New York","Warren County",2,72,856,420,436
050,36,113,"New York","Warren County",2,73,942,468,474
050,36,113,"New York","Warren County",2,74,624,308,316
050,36,113,"New York","Warren County",2,75,580,274,306
050,36,113,"New York","Warren County",2,76,556,252,304
050,36,113,"New York","Warren County",2,77,587,273,314
050,36,113,"New York","Warren County",2,78,500,236,264
050,36,113,"New York","Warren County",2,79,429,205,224
050,36,113,"New York","Warren County",2,80,394,182,212
050,36,113,"New York","Warren County",2,81,354,166,188
050,36,113,"New York","Warren County",2,82,334,151,183
050,36,113,"New York","Warren County",2,83,285,127,158
050,36,113,"New York","Warren County",2,84,258,108,150
050,36,113,"New York","Warren County",2,85,1553,575,978
050,36,113,"New York","Warren County",3,0,501,242,259
050,36,113,"New York","Warren County",3,1,552,276,276
050,36,113,"New York","Warren County",3,2,549,270,279
050,36,113,"New York","Warren County",3,3,573,301,272
050,36,113,"New York","Warren County",3,4,596,310,286
050,36,113,"New York","Warren County",3,5,605,322,283
050,36,113,"New York","Warren County",3,6,589,295,294
050,36,113,"New York","Warren County",3,7,634,319,315
050,36,113,"New York","Warren County",3,8,644,337,307
050,36,113,"New York","Warren County",3,9,659,331,328
050,36,113,"New York","Warren County",3,10,670,349,321
050,36,113,"New York","Warren County",3,11,674,362,312
050,36,113,"New York","Warren County",3,12,697,360,337
050,36,113,"New York","Warren County",3,13,728,377,351
050,36,113,"New York","Warren County",3,14,730,369,361
050,36,113,"New York","Warren County",3,15,712,371,341
050,36,113,"New York","Warren County",3,16,733,378,355
050,36,113,"New York","Warren County",3,17,758,404,354
050,36,113,"New York","Warren County",3,18,698,379,319
050,36,113,"New York","Warren County",3,19,642,344,298
050,36,113,"New York","Warren County",3,20,657,346,311
050,36,113,"New York","Warren County",3,21,669,343,326
050,36,113,"New York","Warren County",3,22,712,363,349
050,36,113,"New York","Warren County",3,23,694,362,332
050,36,113,"New York","Warren County",3,24,704,351,353
050,36,113,"New York","Warren County",3,25,721,365,356
050,36,113,"New York","Warren County",3,26,737,378,359
050,36,113,"New York","Warren County",3,27,764,403,361
050,36,113,"New York","Warren County",3,28,751,375,376
050,36,113,"New York","Warren County",3,29,765,378,387
050,36,113,"New York","Warren County",3,30,848,427,421
050,36,113,"New York","Warren County",3,31,842,445,397
050,36,113,"New York","Warren County",3,32,794,413,381
050,36,113,"New York","Warren County",3,33,760,406,354
050,36,113,"New York","Warren County",3,34,765,384,381
050,36,113,"New York","Warren County",3,35,781,386,395
050,36,113,"New York","Warren County",3,36,790,382,408
050,36,113,"New York","Warren County",3,37,778,375,403
050,36,113,"New York","Warren County",3,38,833,418,415
050,36,113,"New York","Warren County",3,39,752,392,360
050,36,113,"New York","Warren County",3,40,688,362,326
050,36,113,"New York","Warren County",3,41,723,367,356
050,36,113,"New York","Warren County",3,42,680,348,332
050,36,113,"New York","Warren County",3,43,708,364,344
050,36,113,"New York","Warren County",3,44,711,354,357
050,36,113,"New York","Warren County",3,45,669,345,324
050,36,113,"New York","Warren County",3,46,653,342,311
050,36,113,"New York","Warren County",3,47,661,332,329
050,36,113,"New York","Warren County",3,48,735,354,381
050,36,113,"New York","Warren County",3,49,786,372,414
050,36,113,"New York","Warren County",3,50,886,421,465
050,36,113,"New York","Warren County",3,51,895,422,473
050,36,113,"New York","Warren County",3,52,942,458,484
050,36,113,"New York","Warren County",3,53,898,457,441
050,36,113,"New York","Warren County",3,54,915,451,464
050,36,113,"New York","Warren County",3,55,970,472,498
050,36,113,"New York","Warren County",3,56,1045,491,554
050,36,113,"New York","Warren County",3,57,1074,514,560
050,36,113,"New York","Warren County",3,58,1096,517,579
050,36,113,"New York","Warren County",3,59,1116,551,565
050,36,113,"New York","Warren County",3,60,1132,563,569
050,36,113,"New York","Warren County",3,61,1070,512,558
050,36,113,"New York","Warren County",3,62,1096,525,571
050,36,113,"New York","Warren County",3,63,1074,510,564
050,36,113,"New York","Warren County",3,64,1074,518,556
050,36,113,"New York","Warren County",3,65,1022,487,535
050,36,113,"New York","Warren County",3,66,987,487,500
050,36,113,"New York","Warren County",3,67,1006,509,497
050,36,113,"New York","Warren County",3,68,991,493,498
050,36,113,"New York","Warren County",3,69,989,503,486
050,36,113,"New York","Warren County",3,70,948,467,481
050,36,113,"New York","Warren County",3,71,862,429,433
050,36,113,"New York","Warren County",3,72,876,414,462
050,36,113,"New York","Warren County",3,73,819,402,417
050,36,113,"New York","Warren County",3,74,922,462,460
050,36,113,"New York","Warren County",3,75,596,293,303
050,36,113,"New York","Warren County",3,76,564,265,299
050,36,113,"New York","Warren County",3,77,536,232,304
050,36,113,"New York","Warren County",3,78,548,258,290
050,36,113,"New York","Warren County",3,79,485,227,258
050,36,113,"New York","Warren County",3,80,419,195,224
050,36,113,"New York","Warren County",3,81,366,174,192
050,36,113,"New York","Warren County",3,82,318,144,174
050,36,113,"New York","Warren County",3,83,317,141,176
050,36,113,"New York","Warren County",3,84,260,117,143
050,36,113,"New York","Warren County",3,85,1546,575,971
050,36,113,"New York","Warren County",4,0,520,265,255
050,36,113,"New York","Warren County",4,1,527,271,256
050,36,113,"New York","Warren County",4,2,551,271,280
050,36,113,"New York","Warren County",4,3,550,284,266
050,36,113,"New York","Warren County",4,4,588,305,283
050,36,113,"New York","Warren County",4,5,611,320,291
050,36,113,"New York","Warren County",4,6,621,323,298
050,36,113,"New York","Warren County",4,7,607,305,302
050,36,113,"New York","Warren County",4,8,636,327,309
050,36,113,"New York","Warren County",4,9,646,338,308
050,36,113,"New York","Warren County",4,10,653,329,324
050,36,113,"New York","Warren County",4,11,677,353,324
050,36,113,"New York","Warren County",4,12,663,356,307
050,36,113,"New York","Warren County",4,13,689,351,338
050,36,113,"New York","Warren County",4,14,719,380,339
050,36,113,"New York","Warren County",4,15,706,357,349
050,36,113,"New York","Warren County",4,16,699,366,333
050,36,113,"New York","Warren County",4,17,723,380,343
050,36,113,"New York","Warren County",4,18,696,379,317
050,36,113,"New York","Warren County",4,19,615,331,284
050,36,113,"New York","Warren County",4,20,661,343,318
050,36,113,"New York","Warren County",4,21,641,345,296
050,36,113,"New York","Warren County",4,22,676,346,330
050,36,113,"New York","Warren County",4,23,709,362,347
050,36,113,"New York","Warren County",4,24,681,343,338
050,36,113,"New York","Warren County",4,25,696,358,338
050,36,113,"New York","Warren County",4,26,737,370,367
050,36,113,"New York","Warren County",4,27,732,380,352
050,36,113,"New York","Warren County",4,28,738,371,367
050,36,113,"New York","Warren County",4,29,793,389,404
050,36,113,"New York","Warren County",4,30,771,390,381
050,36,113,"New York","Warren County",4,31,814,400,414
050,36,113,"New York","Warren County",4,32,827,434,393
050,36,113,"New York","Warren County",4,33,800,402,398
050,36,113,"New York","Warren County",4,34,799,433,366
050,36,113,"New York","Warren County",4,35,770,380,390
050,36,113,"New York","Warren County",4,36,774,380,394
050,36,113,"New York","Warren County",4,37,789,378,411
050,36,113,"New York","Warren County",4,38,771,376,395
050,36,113,"New York","Warren County",4,39,847,430,417
050,36,113,"New York","Warren County",4,40,741,380,361
050,36,113,"New York","Warren County",4,41,706,377,329
050,36,113,"New York","Warren County",4,42,727,369,358
050,36,113,"New York","Warren County",4,43,712,367,345
050,36,113,"New York","Warren County",4,44,683,342,341
050,36,113,"New York","Warren County",4,45,710,353,357
050,36,113,"New York","Warren County",4,46,662,341,321
050,36,113,"New York","Warren County",4,47,625,333,292
050,36,113,"New York","Warren County",4,48,676,332,344
050,36,113,"New York","Warren County",4,49,730,355,375
050,36,113,"New York","Warren County",4,50,790,369,421
050,36,113,"New York","Warren County",4,51,864,419,445
050,36,113,"New York","Warren County",4,52,899,432,467
050,36,113,"New York","Warren County",4,53,925,439,486
050,36,113,"New York","Warren County",4,54,892,452,440
050,36,113,"New York","Warren County",4,55,921,457,464
050,36,113,"New York","Warren County",4,56,958,461,497
050,36,113,"New York","Warren County",4,57,1037,496,541
050,36,113,"New York","Warren County",4,58,1057,501,556
050,36,113,"New York","Warren County",4,59,1077,512,565
050,36,113,"New York","Warren County",4,60,1103,543,560
050,36,113,"New York","Warren County",4,61,1131,551,580
050,36,113,"New York","Warren County",4,62,1080,517,563
050,36,113,"New York","Warren County",4,63,1096,515,581
050,36,113,"New York","Warren County",4,64,1102,529,573
050,36,113,"New York","Warren County",4,65,1055,510,545
050,36,113,"New York","Warren County",4,66,1022,488,534
050,36,113,"New York","Warren County",4,67,991,498,493
050,36,113,"New York","Warren County",4,68,1005,503,502
050,36,113,"New York","Warren County",4,69,977,484,493
050,36,113,"New York","Warren County",4,70,975,485,490
050,36,113,"New York","Warren County",4,71,934,465,469
050,36,113,"New York","Warren County",4,72,845,417,428
050,36,113,"New York","Warren County",4,73,858,403,455
050,36,113,"New York","Warren County",4,74,778,379,399
050,36,113,"New York","Warren County",4,75,906,458,448
050,36,113,"New York","Warren County",4,76,581,292,289
050,36,113,"New York","Warren County",4,77,548,249,299
050,36,113,"New York","Warren County",4,78,510,226,284
050,36,113,"New York","Warren County",4,79,547,252,295
050,36,113,"New York","Warren County",4,80,449,204,245
050,36,113,"New York","Warren County",4,81,381,185,196
050,36,113,"New York","Warren County",4,82,340,157,183
050,36,113,"New York","Warren County",4,83,295,132,163
050,36,113,"New York","Warren County",4,84,287,133,154
050,36,113,"New York","Warren County",4,85,1516,576,940
050,36,113,"New York","Warren County",5,0,518,263,255
050,36,113,"New York","Warren County",5,1,554,287,267
050,36,113,"New York","Warren County",5,2,519,276,243
050,36,113,"New York","Warren County",5,3,565,285,280
050,36,113,"New York","Warren County",5,4,569,292,277
050,36,113,"New York","Warren County",5,5,591,298,293
050,36,113,"New York","Warren County",5,6,619,322,297
050,36,113,"New York","Warren County",5,7,631,326,305
050,36,113,"New York","Warren County",5,8,610,313,297
050,36,113,"New York","Warren County",5,9,645,338,307
050,36,113,"New York","Warren County",5,10,645,333,312
050,36,113,"New York","Warren County",5,11,655,325,330
050,36,113,"New York","Warren County",5,12,674,350,324
050,36,113,"New York","Warren County",5,13,673,356,317
050,36,113,"New York","Warren County",5,14,688,358,330
050,36,113,"New York","Warren County",5,15,726,378,348
050,36,113,"New York","Warren County",5,16,703,360,343
050,36,113,"New York","Warren County",5,17,708,368,340
050,36,113,"New York","Warren County",5,18,668,353,315
050,36,113,"New York","Warren County",5,19,615,342,273
050,36,113,"New York","Warren County",5,20,635,336,299
050,36,113,"New York","Warren County",5,21,669,361,308
050,36,113,"New York","Warren County",5,22,684,366,318
050,36,113,"New York","Warren County",5,23,697,354,343
050,36,113,"New York","Warren County",5,24,703,363,340
050,36,113,"New York","Warren County",5,25,696,355,341
050,36,113,"New York","Warren County",5,26,714,371,343
050,36,113,"New York","Warren County",5,27,717,377,340
050,36,113,"New York","Warren County",5,28,706,366,340
050,36,113,"New York","Warren County",5,29,755,390,365
050,36,113,"New York","Warren County",5,30,807,402,405
050,36,113,"New York","Warren County",5,31,758,372,386
050,36,113,"New York","Warren County",5,32,797,395,402
050,36,113,"New York","Warren County",5,33,833,428,405
050,36,113,"New York","Warren County",5,34,815,403,412
050,36,113,"New York","Warren County",5,35,789,429,360
050,36,113,"New York","Warren County",5,36,771,385,386
050,36,113,"New York","Warren County",5,37,799,390,409
050,36,113,"New York","Warren County",5,38,782,377,405
050,36,113,"New York","Warren County",5,39,781,391,390
050,36,113,"New York","Warren County",5,40,827,410,417
050,36,113,"New York","Warren County",5,41,760,391,369
050,36,113,"New York","Warren County",5,42,711,374,337
050,36,113,"New York","Warren County",5,43,730,386,344
050,36,113,"New York","Warren County",5,44,693,354,339
050,36,113,"New York","Warren County",5,45,685,339,346
050,36,113,"New York","Warren County",5,46,710,357,353
050,36,113,"New York","Warren County",5,47,657,336,321
050,36,113,"New York","Warren County",5,48,626,319,307
050,36,113,"New York","Warren County",5,49,659,326,333
050,36,113,"New York","Warren County",5,50,736,353,383
050,36,113,"New York","Warren County",5,51,787,377,410
050,36,113,"New York","Warren County",5,52,867,427,440
050,36,113,"New York","Warren County",5,53,889,415,474
050,36,113,"New York","Warren County",5,54,925,434,491
050,36,113,"New York","Warren County",5,55,899,459,440
050,36,113,"New York","Warren County",5,56,933,464,469
050,36,113,"New York","Warren County",5,57,956,471,485
050,36,113,"New York","Warren County",5,58,1034,488,546
050,36,113,"New York","Warren County",5,59,1032,496,536
050,36,113,"New York","Warren County",5,60,1080,519,561
050,36,113,"New York","Warren County",5,61,1090,534,556
050,36,113,"New York","Warren County",5,62,1136,550,586
050,36,113,"New York","Warren County",5,63,1053,499,554
050,36,113,"New York","Warren County",5,64,1102,521,581
050,36,113,"New York","Warren County",5,65,1081,514,567
050,36,113,"New York","Warren County",5,66,1067,517,550
050,36,113,"New York","Warren County",5,67,1020,491,529
050,36,113,"New York","Warren County",5,68,982,489,493
050,36,113,"New York","Warren County",5,69,990,492,498
050,36,113,"New York","Warren County",5,70,967,471,496
050,36,113,"New York","Warren County",5,71,970,475,495
050,36,113,"New York","Warren County",5,72,943,467,476
050,36,113,"New York","Warren County",5,73,819,395,424
050,36,113,"New York","Warren County",5,74,832,388,444
050,36,113,"New York","Warren County",5,75,760,373,387
050,36,113,"New York","Warren County",5,76,888,445,443
050,36,113,"New York","Warren County",5,77,567,283,284
050,36,113,"New York","Warren County",5,78,526,242,284
050,36,113,"New York","Warren County",5,79,506,219,287
050,36,113,"New York","Warren County",5,80,526,241,285
050,36,113,"New York","Warren County",5,81,418,197,221
050,36,113,"New York","Warren County",5,82,346,171,175
050,36,113,"New York","Warren County",5,83,319,148,171
050,36,113,"New York","Warren County",5,84,268,129,139
050,36,113,"New York","Warren County",5,85,1524,589,935
050,36,115,"New York","Washington County",1,0,527,269,258
050,36,115,"New York","Washington County",1,1,537,273,264
050,36,115,"New York","Washington County",1,2,572,282,290
050,36,115,"New York","Washington County",1,3,562,263,299
050,36,115,"New York","Washington County",1,4,593,310,283
050,36,115,"New York","Washington County",1,5,630,329,301
050,36,115,"New York","Washington County",1,6,610,319,291
050,36,115,"New York","Washington County",1,7,628,318,310
050,36,115,"New York","Washington County",1,8,630,320,310
050,36,115,"New York","Washington County",1,9,649,356,293
050,36,115,"New York","Washington County",1,10,657,356,301
050,36,115,"New York","Washington County",1,11,674,353,321
050,36,115,"New York","Washington County",1,12,684,339,345
050,36,115,"New York","Washington County",1,13,697,352,345
050,36,115,"New York","Washington County",1,14,696,352,344
050,36,115,"New York","Washington County",1,15,710,365,345
050,36,115,"New York","Washington County",1,16,709,375,334
050,36,115,"New York","Washington County",1,17,715,394,321
050,36,115,"New York","Washington County",1,18,663,404,259
050,36,115,"New York","Washington County",1,19,576,353,223
050,36,115,"New York","Washington County",1,20,657,408,249
050,36,115,"New York","Washington County",1,21,659,407,252
050,36,115,"New York","Washington County",1,22,631,349,282
050,36,115,"New York","Washington County",1,23,680,379,301
050,36,115,"New York","Washington County",1,24,699,370,329
050,36,115,"New York","Washington County",1,25,717,397,320
050,36,115,"New York","Washington County",1,26,696,375,321
050,36,115,"New York","Washington County",1,27,742,409,333
050,36,115,"New York","Washington County",1,28,768,418,350
050,36,115,"New York","Washington County",1,29,763,420,343
050,36,115,"New York","Washington County",1,30,758,395,363
050,36,115,"New York","Washington County",1,31,737,380,357
050,36,115,"New York","Washington County",1,32,758,399,359
050,36,115,"New York","Washington County",1,33,788,434,354
050,36,115,"New York","Washington County",1,34,706,385,321
050,36,115,"New York","Washington County",1,35,745,403,342
050,36,115,"New York","Washington County",1,36,783,398,385
050,36,115,"New York","Washington County",1,37,760,402,358
050,36,115,"New York","Washington County",1,38,685,360,325
050,36,115,"New York","Washington County",1,39,709,399,310
050,36,115,"New York","Washington County",1,40,748,417,331
050,36,115,"New York","Washington County",1,41,726,402,324
050,36,115,"New York","Washington County",1,42,770,422,348
050,36,115,"New York","Washington County",1,43,746,419,327
050,36,115,"New York","Washington County",1,44,711,386,325
050,36,115,"New York","Washington County",1,45,717,384,333
050,36,115,"New York","Washington County",1,46,702,380,322
050,36,115,"New York","Washington County",1,47,737,411,326
050,36,115,"New York","Washington County",1,48,810,436,374
050,36,115,"New York","Washington County",1,49,861,465,396
050,36,115,"New York","Washington County",1,50,873,468,405
050,36,115,"New York","Washington County",1,51,901,485,416
050,36,115,"New York","Washington County",1,52,911,467,444
050,36,115,"New York","Washington County",1,53,936,464,472
050,36,115,"New York","Washington County",1,54,939,482,457
050,36,115,"New York","Washington County",1,55,998,492,506
050,36,115,"New York","Washington County",1,56,967,477,490
050,36,115,"New York","Washington County",1,57,961,485,476
050,36,115,"New York","Washington County",1,58,981,489,492
050,36,115,"New York","Washington County",1,59,974,493,481
050,36,115,"New York","Washington County",1,60,966,489,477
050,36,115,"New York","Washington County",1,61,955,473,482
050,36,115,"New York","Washington County",1,62,996,503,493
050,36,115,"New York","Washington County",1,63,924,462,462
050,36,115,"New York","Washington County",1,64,931,482,449
050,36,115,"New York","Washington County",1,65,871,440,431
050,36,115,"New York","Washington County",1,66,881,451,430
050,36,115,"New York","Washington County",1,67,808,401,407
050,36,115,"New York","Washington County",1,68,782,398,384
050,36,115,"New York","Washington County",1,69,734,381,353
050,36,115,"New York","Washington County",1,70,706,358,348
050,36,115,"New York","Washington County",1,71,694,330,364
050,36,115,"New York","Washington County",1,72,706,354,352
050,36,115,"New York","Washington County",1,73,686,342,344
050,36,115,"New York","Washington County",1,74,496,236,260
050,36,115,"New York","Washington County",1,75,483,236,247
050,36,115,"New York","Washington County",1,76,487,243,244
050,36,115,"New York","Washington County",1,77,498,226,272
050,36,115,"New York","Washington County",1,78,410,176,234
050,36,115,"New York","Washington County",1,79,379,185,194
050,36,115,"New York","Washington County",1,80,322,152,170
050,36,115,"New York","Washington County",1,81,296,136,160
050,36,115,"New York","Washington County",1,82,279,135,144
050,36,115,"New York","Washington County",1,83,241,110,131
050,36,115,"New York","Washington County",1,84,226,101,125
050,36,115,"New York","Washington County",1,85,1411,482,929
050,36,115,"New York","Washington County",2,0,538,278,260
050,36,115,"New York","Washington County",2,1,531,270,261
050,36,115,"New York","Washington County",2,2,566,280,286
050,36,115,"New York","Washington County",2,3,564,268,296
050,36,115,"New York","Washington County",2,4,589,298,291
050,36,115,"New York","Washington County",2,5,624,325,299
050,36,115,"New York","Washington County",2,6,616,322,294
050,36,115,"New York","Washington County",2,7,622,316,306
050,36,115,"New York","Washington County",2,8,630,319,311
050,36,115,"New York","Washington County",2,9,641,347,294
050,36,115,"New York","Washington County",2,10,651,355,296
050,36,115,"New York","Washington County",2,11,668,354,314
050,36,115,"New York","Washington County",2,12,682,342,340
050,36,115,"New York","Washington County",2,13,690,348,342
050,36,115,"New York","Washington County",2,14,690,350,340
050,36,115,"New York","Washington County",2,15,705,362,343
050,36,115,"New York","Washington County",2,16,706,370,336
050,36,115,"New York","Washington County",2,17,714,394,320
050,36,115,"New York","Washington County",2,18,648,392,256
050,36,115,"New York","Washington County",2,19,575,355,220
050,36,115,"New York","Washington County",2,20,655,406,249
050,36,115,"New York","Washington County",2,21,648,391,257
050,36,115,"New York","Washington County",2,22,629,350,279
050,36,115,"New York","Washington County",2,23,666,367,299
050,36,115,"New York","Washington County",2,24,686,367,319
050,36,115,"New York","Washington County",2,25,706,387,319
050,36,115,"New York","Washington County",2,26,703,378,325
050,36,115,"New York","Washington County",2,27,736,407,329
050,36,115,"New York","Washington County",2,28,764,418,346
050,36,115,"New York","Washington County",2,29,758,411,347
050,36,115,"New York","Washington County",2,30,757,395,362
050,36,115,"New York","Washington County",2,31,739,381,358
050,36,115,"New York","Washington County",2,32,753,394,359
050,36,115,"New York","Washington County",2,33,776,424,352
050,36,115,"New York","Washington County",2,34,720,391,329
050,36,115,"New York","Washington County",2,35,742,402,340
050,36,115,"New York","Washington County",2,36,761,389,372
050,36,115,"New York","Washington County",2,37,765,399,366
050,36,115,"New York","Washington County",2,38,698,368,330
050,36,115,"New York","Washington County",2,39,705,395,310
050,36,115,"New York","Washington County",2,40,742,414,328
050,36,115,"New York","Washington County",2,41,724,399,325
050,36,115,"New York","Washington County",2,42,753,416,337
050,36,115,"New York","Washington County",2,43,753,418,335
050,36,115,"New York","Washington County",2,44,710,389,321
050,36,115,"New York","Washington County",2,45,714,382,332
050,36,115,"New York","Washington County",2,46,702,380,322
050,36,115,"New York","Washington County",2,47,720,399,321
050,36,115,"New York","Washington County",2,48,789,425,364
050,36,115,"New York","Washington County",2,49,851,459,392
050,36,115,"New York","Washington County",2,50,865,461,404
050,36,115,"New York","Washington County",2,51,893,479,414
050,36,115,"New York","Washington County",2,52,895,462,433
050,36,115,"New York","Washington County",2,53,932,466,466
050,36,115,"New York","Washington County",2,54,936,475,461
050,36,115,"New York","Washington County",2,55,982,486,496
050,36,115,"New York","Washington County",2,56,970,476,494
050,36,115,"New York","Washington County",2,57,965,483,482
050,36,115,"New York","Washington County",2,58,975,486,489
050,36,115,"New York","Washington County",2,59,975,492,483
050,36,115,"New York","Washington County",2,60,963,489,474
050,36,115,"New York","Washington County",2,61,955,475,480
050,36,115,"New York","Washington County",2,62,983,497,486
050,36,115,"New York","Washington County",2,63,941,471,470
050,36,115,"New York","Washington County",2,64,927,475,452
050,36,115,"New York","Washington County",2,65,880,447,433
050,36,115,"New York","Washington County",2,66,877,447,430
050,36,115,"New York","Washington County",2,67,817,411,406
050,36,115,"New York","Washington County",2,68,779,394,385
050,36,115,"New York","Washington County",2,69,750,386,364
050,36,115,"New York","Washington County",2,70,708,361,347
050,36,115,"New York","Washington County",2,71,694,335,359
050,36,115,"New York","Washington County",2,72,690,340,350
050,36,115,"New York","Washington County",2,73,727,362,365
050,36,115,"New York","Washington County",2,74,501,242,259
050,36,115,"New York","Washington County",2,75,479,232,247
050,36,115,"New York","Washington County",2,76,478,237,241
050,36,115,"New York","Washington County",2,77,508,234,274
050,36,115,"New York","Washington County",2,78,413,179,234
050,36,115,"New York","Washington County",2,79,379,182,197
050,36,115,"New York","Washington County",2,80,332,157,175
050,36,115,"New York","Washington County",2,81,297,136,161
050,36,115,"New York","Washington County",2,82,281,133,148
050,36,115,"New York","Washington County",2,83,240,107,133
050,36,115,"New York","Washington County",2,84,228,106,122
050,36,115,"New York","Washington County",2,85,1401,483,918
050,36,115,"New York","Washington County",3,0,515,265,250
050,36,115,"New York","Washington County",3,1,527,286,241
050,36,115,"New York","Washington County",3,2,526,265,261
050,36,115,"New York","Washington County",3,3,580,288,292
050,36,115,"New York","Washington County",3,4,576,275,301
050,36,115,"New York","Washington County",3,5,590,292,298
050,36,115,"New York","Washington County",3,6,641,327,314
050,36,115,"New York","Washington County",3,7,605,324,281
050,36,115,"New York","Washington County",3,8,635,329,306
050,36,115,"New York","Washington County",3,9,627,327,300
050,36,115,"New York","Washington County",3,10,631,344,287
050,36,115,"New York","Washington County",3,11,654,356,298
050,36,115,"New York","Washington County",3,12,680,358,322
050,36,115,"New York","Washington County",3,13,679,341,338
050,36,115,"New York","Washington County",3,14,687,351,336
050,36,115,"New York","Washington County",3,15,691,359,332
050,36,115,"New York","Washington County",3,16,694,358,336
050,36,115,"New York","Washington County",3,17,716,393,323
050,36,115,"New York","Washington County",3,18,654,392,262
050,36,115,"New York","Washington County",3,19,561,363,198
050,36,115,"New York","Washington County",3,20,650,408,242
050,36,115,"New York","Washington County",3,21,636,363,273
050,36,115,"New York","Washington County",3,22,625,352,273
050,36,115,"New York","Washington County",3,23,653,370,283
050,36,115,"New York","Washington County",3,24,663,373,290
050,36,115,"New York","Washington County",3,25,693,368,325
050,36,115,"New York","Washington County",3,26,709,380,329
050,36,115,"New York","Washington County",3,27,704,395,309
050,36,115,"New York","Washington County",3,28,755,424,331
050,36,115,"New York","Washington County",3,29,782,430,352
050,36,115,"New York","Washington County",3,30,751,407,344
050,36,115,"New York","Washington County",3,31,754,386,368
050,36,115,"New York","Washington County",3,32,739,379,360
050,36,115,"New York","Washington County",3,33,758,388,370
050,36,115,"New York","Washington County",3,34,785,412,373
050,36,115,"New York","Washington County",3,35,754,422,332
050,36,115,"New York","Washington County",3,36,750,402,348
050,36,115,"New York","Washington County",3,37,773,401,372
050,36,115,"New York","Washington County",3,38,751,386,365
050,36,115,"New York","Washington County",3,39,720,384,336
050,36,115,"New York","Washington County",3,40,729,400,329
050,36,115,"New York","Washington County",3,41,720,396,324
050,36,115,"New York","Washington County",3,42,728,400,328
050,36,115,"New York","Washington County",3,43,766,422,344
050,36,115,"New York","Washington County",3,44,753,415,338
050,36,115,"New York","Washington County",3,45,704,379,325
050,36,115,"New York","Washington County",3,46,750,410,340
050,36,115,"New York","Washington County",3,47,700,381,319
050,36,115,"New York","Washington County",3,48,701,385,316
050,36,115,"New York","Washington County",3,49,779,421,358
050,36,115,"New York","Washington County",3,50,826,434,392
050,36,115,"New York","Washington County",3,51,862,459,403
050,36,115,"New York","Washington County",3,52,851,449,402
050,36,115,"New York","Washington County",3,53,877,449,428
050,36,115,"New York","Washington County",3,54,931,467,464
050,36,115,"New York","Washington County",3,55,948,477,471
050,36,115,"New York","Washington County",3,56,963,478,485
050,36,115,"New York","Washington County",3,57,964,482,482
050,36,115,"New York","Washington County",3,58,950,474,476
050,36,115,"New York","Washington County",3,59,963,475,488
050,36,115,"New York","Washington County",3,60,965,482,483
050,36,115,"New York","Washington County",3,61,947,476,471
050,36,115,"New York","Washington County",3,62,954,478,476
050,36,115,"New York","Washington County",3,63,952,472,480
050,36,115,"New York","Washington County",3,64,944,475,469
050,36,115,"New York","Washington County",3,65,902,459,443
050,36,115,"New York","Washington County",3,66,862,445,417
050,36,115,"New York","Washington County",3,67,861,436,425
050,36,115,"New York","Washington County",3,68,803,389,414
050,36,115,"New York","Washington County",3,69,774,396,378
050,36,115,"New York","Washington County",3,70,723,370,353
050,36,115,"New York","Washington County",3,71,686,350,336
050,36,115,"New York","Washington County",3,72,667,313,354
050,36,115,"New York","Washington County",3,73,667,330,337
050,36,115,"New York","Washington County",3,74,697,340,357
050,36,115,"New York","Washington County",3,75,483,232,251
050,36,115,"New York","Washington County",3,76,455,214,241
050,36,115,"New York","Washington County",3,77,470,234,236
050,36,115,"New York","Washington County",3,78,489,227,262
050,36,115,"New York","Washington County",3,79,388,176,212
050,36,115,"New York","Washington County",3,80,361,169,192
050,36,115,"New York","Washington County",3,81,303,137,166
050,36,115,"New York","Washington County",3,82,282,132,150
050,36,115,"New York","Washington County",3,83,258,118,140
050,36,115,"New York","Washington County",3,84,222,104,118
050,36,115,"New York","Washington County",3,85,1404,486,918
050,36,115,"New York","Washington County",4,0,555,294,261
050,36,115,"New York","Washington County",4,1,520,270,250
050,36,115,"New York","Washington County",4,2,536,278,258
050,36,115,"New York","Washington County",4,3,555,285,270
050,36,115,"New York","Washington County",4,4,583,289,294
050,36,115,"New York","Washington County",4,5,572,270,302
050,36,115,"New York","Washington County",4,6,598,300,298
050,36,115,"New York","Washington County",4,7,638,328,310
050,36,115,"New York","Washington County",4,8,608,320,288
050,36,115,"New York","Washington County",4,9,643,330,313
050,36,115,"New York","Washington County",4,10,631,323,308
050,36,115,"New York","Washington County",4,11,635,347,288
050,36,115,"New York","Washington County",4,12,663,353,310
050,36,115,"New York","Washington County",4,13,685,363,322
050,36,115,"New York","Washington County",4,14,661,330,331
050,36,115,"New York","Washington County",4,15,701,362,339
050,36,115,"New York","Washington County",4,16,685,360,325
050,36,115,"New York","Washington County",4,17,731,389,342
050,36,115,"New York","Washington County",4,18,634,378,256
050,36,115,"New York","Washington County",4,19,546,349,197
050,36,115,"New York","Washington County",4,20,625,414,211
050,36,115,"New York","Washington County",4,21,626,371,255
050,36,115,"New York","Washington County",4,22,636,333,303
050,36,115,"New York","Washington County",4,23,639,348,291
050,36,115,"New York","Washington County",4,24,636,355,281
050,36,115,"New York","Washington County",4,25,681,375,306
050,36,115,"New York","Washington County",4,26,694,368,326
050,36,115,"New York","Washington County",4,27,732,406,326
050,36,115,"New York","Washington County",4,28,696,406,290
050,36,115,"New York","Washington County",4,29,749,412,337
050,36,115,"New York","Washington County",4,30,765,407,358
050,36,115,"New York","Washington County",4,31,780,417,363
050,36,115,"New York","Washington County",4,32,747,384,363
050,36,115,"New York","Washington County",4,33,740,382,358
050,36,115,"New York","Washington County",4,34,752,371,381
050,36,115,"New York","Washington County",4,35,822,440,382
050,36,115,"New York","Washington County",4,36,779,437,342
050,36,115,"New York","Washington County",4,37,744,395,349
050,36,115,"New York","Washington County",4,38,756,390,366
050,36,115,"New York","Washington County",4,39,767,406,361
050,36,115,"New York","Washington County",4,40,736,393,343
050,36,115,"New York","Washington County",4,41,729,393,336
050,36,115,"New York","Washington County",4,42,716,399,317
050,36,115,"New York","Washington County",4,43,748,411,337
050,36,115,"New York","Washington County",4,44,751,412,339
050,36,115,"New York","Washington County",4,45,744,405,339
050,36,115,"New York","Washington County",4,46,717,389,328
050,36,115,"New York","Washington County",4,47,741,413,328
050,36,115,"New York","Washington County",4,48,695,369,326
050,36,115,"New York","Washington County",4,49,702,380,322
050,36,115,"New York","Washington County",4,50,762,402,360
050,36,115,"New York","Washington County",4,51,850,448,402
050,36,115,"New York","Washington County",4,52,849,446,403
050,36,115,"New York","Washington County",4,53,854,451,403
050,36,115,"New York","Washington County",4,54,872,448,424
050,36,115,"New York","Washington County",4,55,909,450,459
050,36,115,"New York","Washington County",4,56,934,463,471
050,36,115,"New York","Washington County",4,57,979,480,499
050,36,115,"New York","Washington County",4,58,976,485,491
050,36,115,"New York","Washington County",4,59,924,458,466
050,36,115,"New York","Washington County",4,60,963,468,495
050,36,115,"New York","Washington County",4,61,956,481,475
050,36,115,"New York","Washington County",4,62,951,480,471
050,36,115,"New York","Washington County",4,63,935,462,473
050,36,115,"New York","Washington County",4,64,964,478,486
050,36,115,"New York","Washington County",4,65,919,454,465
050,36,115,"New York","Washington County",4,66,900,462,438
050,36,115,"New York","Washington County",4,67,857,440,417
050,36,115,"New York","Washington County",4,68,848,417,431
050,36,115,"New York","Washington County",4,69,798,385,413
050,36,115,"New York","Washington County",4,70,755,387,368
050,36,115,"New York","Washington County",4,71,702,355,347
050,36,115,"New York","Washington County",4,72,672,342,330
050,36,115,"New York","Washington County",4,73,652,305,347
050,36,115,"New York","Washington County",4,74,648,317,331
050,36,115,"New York","Washington County",4,75,666,318,348
050,36,115,"New York","Washington County",4,76,461,214,247
050,36,115,"New York","Washington County",4,77,440,199,241
050,36,115,"New York","Washington County",4,78,450,220,230
050,36,115,"New York","Washington County",4,79,453,220,233
050,36,115,"New York","Washington County",4,80,377,170,207
050,36,115,"New York","Washington County",4,81,341,157,184
050,36,115,"New York","Washington County",4,82,292,136,156
050,36,115,"New York","Washington County",4,83,255,116,139
050,36,115,"New York","Washington County",4,84,248,117,131
050,36,115,"New York","Washington County",4,85,1373,491,882
050,36,115,"New York","Washington County",5,0,554,293,261
050,36,115,"New York","Washington County",5,1,548,293,255
050,36,115,"New York","Washington County",5,2,539,276,263
050,36,115,"New York","Washington County",5,3,534,279,255
050,36,115,"New York","Washington County",5,4,564,288,276
050,36,115,"New York","Washington County",5,5,576,286,290
050,36,115,"New York","Washington County",5,6,574,272,302
050,36,115,"New York","Washington County",5,7,599,305,294
050,36,115,"New York","Washington County",5,8,627,326,301
050,36,115,"New York","Washington County",5,9,583,310,273
050,36,115,"New York","Washington County",5,10,632,329,303
050,36,115,"New York","Washington County",5,11,630,319,311
050,36,115,"New York","Washington County",5,12,639,354,285
050,36,115,"New York","Washington County",5,13,669,364,305
050,36,115,"New York","Washington County",5,14,685,356,329
050,36,115,"New York","Washington County",5,15,661,321,340
050,36,115,"New York","Washington County",5,16,683,354,329
050,36,115,"New York","Washington County",5,17,675,366,309
050,36,115,"New York","Washington County",5,18,631,357,274
050,36,115,"New York","Washington County",5,19,516,320,196
050,36,115,"New York","Washington County",5,20,592,360,232
050,36,115,"New York","Washington County",5,21,593,351,242
050,36,115,"New York","Washington County",5,22,598,327,271
050,36,115,"New York","Washington County",5,23,638,333,305
050,36,115,"New York","Washington County",5,24,617,338,279
050,36,115,"New York","Washington County",5,25,650,351,299
050,36,115,"New York","Washington County",5,26,643,349,294
050,36,115,"New York","Washington County",5,27,697,360,337
050,36,115,"New York","Washington County",5,28,736,406,330
050,36,115,"New York","Washington County",5,29,665,380,285
050,36,115,"New York","Washington County",5,30,713,380,333
050,36,115,"New York","Washington County",5,31,760,393,367
050,36,115,"New York","Washington County",5,32,771,406,365
050,36,115,"New York","Washington County",5,33,729,369,360
050,36,115,"New York","Washington County",5,34,717,364,353
050,36,115,"New York","Washington County",5,35,742,375,367
050,36,115,"New York","Washington County",5,36,809,419,390
050,36,115,"New York","Washington County",5,37,777,434,343
050,36,115,"New York","Washington County",5,38,711,370,341
050,36,115,"New York","Washington County",5,39,764,397,367
050,36,115,"New York","Washington County",5,40,770,408,362
050,36,115,"New York","Washington County",5,41,704,368,336
050,36,115,"New York","Washington County",5,42,720,383,337
050,36,115,"New York","Washington County",5,43,695,373,322
050,36,115,"New York","Washington County",5,44,708,376,332
050,36,115,"New York","Washington County",5,45,733,391,342
050,36,115,"New York","Washington County",5,46,754,413,341
050,36,115,"New York","Washington County",5,47,706,377,329
050,36,115,"New York","Washington County",5,48,740,404,336
050,36,115,"New York","Washington County",5,49,687,360,327
050,36,115,"New York","Washington County",5,50,677,355,322
050,36,115,"New York","Washington County",5,51,757,394,363
050,36,115,"New York","Washington County",5,52,826,432,394
050,36,115,"New York","Washington County",5,53,851,449,402
050,36,115,"New York","Washington County",5,54,850,444,406
050,36,115,"New York","Washington County",5,55,872,445,427
050,36,115,"New York","Washington County",5,56,879,425,454
050,36,115,"New York","Washington County",5,57,933,461,472
050,36,115,"New York","Washington County",5,58,953,461,492
050,36,115,"New York","Washington County",5,59,950,464,486
050,36,115,"New York","Washington County",5,60,937,461,476
050,36,115,"New York","Washington County",5,61,953,455,498
050,36,115,"New York","Washington County",5,62,956,489,467
050,36,115,"New York","Washington County",5,63,947,467,480
050,36,115,"New York","Washington County",5,64,966,476,490
050,36,115,"New York","Washington County",5,65,930,464,466
050,36,115,"New York","Washington County",5,66,916,455,461
050,36,115,"New York","Washington County",5,67,886,450,436
050,36,115,"New York","Washington County",5,68,837,425,412
050,36,115,"New York","Washington County",5,69,841,414,427
050,36,115,"New York","Washington County",5,70,771,372,399
050,36,115,"New York","Washington County",5,71,742,381,361
050,36,115,"New York","Washington County",5,72,678,344,334
050,36,115,"New York","Washington County",5,73,671,344,327
050,36,115,"New York","Washington County",5,74,634,291,343
050,36,115,"New York","Washington County",5,75,616,297,319
050,36,115,"New York","Washington County",5,76,644,300,344
050,36,115,"New York","Washington County",5,77,450,206,244
050,36,115,"New York","Washington County",5,78,420,183,237
050,36,115,"New York","Washington County",5,79,417,218,199
050,36,115,"New York","Washington County",5,80,436,209,227
050,36,115,"New York","Washington County",5,81,358,156,202
050,36,115,"New York","Washington County",5,82,335,154,181
050,36,115,"New York","Washington County",5,83,267,119,148
050,36,115,"New York","Washington County",5,84,244,115,129
050,36,115,"New York","Washington County",5,85,1389,525,864
050,36,117,"New York","Wayne County",1,0,969,490,479
050,36,117,"New York","Wayne County",1,1,981,505,476
050,36,117,"New York","Wayne County",1,2,1014,526,488
050,36,117,"New York","Wayne County",1,3,1008,515,493
050,36,117,"New York","Wayne County",1,4,1033,521,512
050,36,117,"New York","Wayne County",1,5,1026,506,520
050,36,117,"New York","Wayne County",1,6,1003,523,480
050,36,117,"New York","Wayne County",1,7,1090,558,532
050,36,117,"New York","Wayne County",1,8,1081,552,529
050,36,117,"New York","Wayne County",1,9,1093,566,527
050,36,117,"New York","Wayne County",1,10,1115,575,540
050,36,117,"New York","Wayne County",1,11,1160,594,566
050,36,117,"New York","Wayne County",1,12,1194,600,594
050,36,117,"New York","Wayne County",1,13,1184,596,588
050,36,117,"New York","Wayne County",1,14,1170,615,555
050,36,117,"New York","Wayne County",1,15,1162,596,566
050,36,117,"New York","Wayne County",1,16,1172,590,582
050,36,117,"New York","Wayne County",1,17,1150,549,601
050,36,117,"New York","Wayne County",1,18,964,478,486
050,36,117,"New York","Wayne County",1,19,784,410,374
050,36,117,"New York","Wayne County",1,20,861,435,426
050,36,117,"New York","Wayne County",1,21,927,470,457
050,36,117,"New York","Wayne County",1,22,972,489,483
050,36,117,"New York","Wayne County",1,23,951,505,446
050,36,117,"New York","Wayne County",1,24,990,533,457
050,36,117,"New York","Wayne County",1,25,1031,524,507
050,36,117,"New York","Wayne County",1,26,1057,540,517
050,36,117,"New York","Wayne County",1,27,1045,548,497
050,36,117,"New York","Wayne County",1,28,1050,526,524
050,36,117,"New York","Wayne County",1,29,1090,540,550
050,36,117,"New York","Wayne County",1,30,1063,540,523
050,36,117,"New York","Wayne County",1,31,1044,523,521
050,36,117,"New York","Wayne County",1,32,1041,530,511
050,36,117,"New York","Wayne County",1,33,1027,519,508
050,36,117,"New York","Wayne County",1,34,1019,521,498
050,36,117,"New York","Wayne County",1,35,1112,559,553
050,36,117,"New York","Wayne County",1,36,1069,549,520
050,36,117,"New York","Wayne County",1,37,1055,528,527
050,36,117,"New York","Wayne County",1,38,1108,573,535
050,36,117,"New York","Wayne County",1,39,1090,554,536
050,36,117,"New York","Wayne County",1,40,1036,521,515
050,36,117,"New York","Wayne County",1,41,1020,500,520
050,36,117,"New York","Wayne County",1,42,959,479,480
050,36,117,"New York","Wayne County",1,43,925,491,434
050,36,117,"New York","Wayne County",1,44,912,497,415
050,36,117,"New York","Wayne County",1,45,979,478,501
050,36,117,"New York","Wayne County",1,46,967,484,483
050,36,117,"New York","Wayne County",1,47,1021,517,504
050,36,117,"New York","Wayne County",1,48,1172,596,576
050,36,117,"New York","Wayne County",1,49,1357,675,682
050,36,117,"New York","Wayne County",1,50,1298,646,652
050,36,117,"New York","Wayne County",1,51,1261,647,614
050,36,117,"New York","Wayne County",1,52,1284,668,616
050,36,117,"New York","Wayne County",1,53,1378,676,702
050,36,117,"New York","Wayne County",1,54,1397,695,702
050,36,117,"New York","Wayne County",1,55,1477,747,730
050,36,117,"New York","Wayne County",1,56,1486,734,752
050,36,117,"New York","Wayne County",1,57,1502,743,759
050,36,117,"New York","Wayne County",1,58,1571,800,771
050,36,117,"New York","Wayne County",1,59,1564,795,769
050,36,117,"New York","Wayne County",1,60,1460,729,731
050,36,117,"New York","Wayne County",1,61,1477,752,725
050,36,117,"New York","Wayne County",1,62,1473,757,716
050,36,117,"New York","Wayne County",1,63,1387,692,695
050,36,117,"New York","Wayne County",1,64,1329,663,666
050,36,117,"New York","Wayne County",1,65,1271,615,656
050,36,117,"New York","Wayne County",1,66,1265,633,632
050,36,117,"New York","Wayne County",1,67,1191,602,589
050,36,117,"New York","Wayne County",1,68,1158,596,562
050,36,117,"New York","Wayne County",1,69,1057,555,502
050,36,117,"New York","Wayne County",1,70,1020,519,501
050,36,117,"New York","Wayne County",1,71,1007,508,499
050,36,117,"New York","Wayne County",1,72,1013,486,527
050,36,117,"New York","Wayne County",1,73,1024,503,521
050,36,117,"New York","Wayne County",1,74,715,317,398
050,36,117,"New York","Wayne County",1,75,700,313,387
050,36,117,"New York","Wayne County",1,76,683,318,365
050,36,117,"New York","Wayne County",1,77,711,341,370
050,36,117,"New York","Wayne County",1,78,572,285,287
050,36,117,"New York","Wayne County",1,79,499,235,264
050,36,117,"New York","Wayne County",1,80,426,192,234
050,36,117,"New York","Wayne County",1,81,403,184,219
050,36,117,"New York","Wayne County",1,82,373,170,203
050,36,117,"New York","Wayne County",1,83,337,160,177
050,36,117,"New York","Wayne County",1,84,302,134,168
050,36,117,"New York","Wayne County",1,85,1912,691,1221
050,36,117,"New York","Wayne County",2,0,956,489,467
050,36,117,"New York","Wayne County",2,1,976,500,476
050,36,117,"New York","Wayne County",2,2,1005,518,487
050,36,117,"New York","Wayne County",2,3,999,513,486
050,36,117,"New York","Wayne County",2,4,1029,521,508
050,36,117,"New York","Wayne County",2,5,1032,511,521
050,36,117,"New York","Wayne County",2,6,1013,522,491
050,36,117,"New York","Wayne County",2,7,1065,548,517
050,36,117,"New York","Wayne County",2,8,1081,553,528
050,36,117,"New York","Wayne County",2,9,1085,559,526
050,36,117,"New York","Wayne County",2,10,1106,571,535
050,36,117,"New York","Wayne County",2,11,1141,586,555
050,36,117,"New York","Wayne County",2,12,1190,600,590
050,36,117,"New York","Wayne County",2,13,1180,595,585
050,36,117,"New York","Wayne County",2,14,1170,609,561
050,36,117,"New York","Wayne County",2,15,1163,603,560
050,36,117,"New York","Wayne County",2,16,1168,591,577
050,36,117,"New York","Wayne County",2,17,1152,557,595
050,36,117,"New York","Wayne County",2,18,962,478,484
050,36,117,"New York","Wayne County",2,19,784,402,382
050,36,117,"New York","Wayne County",2,20,866,439,427
050,36,117,"New York","Wayne County",2,21,911,459,452
050,36,117,"New York","Wayne County",2,22,965,487,478
050,36,117,"New York","Wayne County",2,23,959,507,452
050,36,117,"New York","Wayne County",2,24,980,524,456
050,36,117,"New York","Wayne County",2,25,1022,526,496
050,36,117,"New York","Wayne County",2,26,1053,536,517
050,36,117,"New York","Wayne County",2,27,1046,547,499
050,36,117,"New York","Wayne County",2,28,1055,534,521
050,36,117,"New York","Wayne County",2,29,1089,542,547
050,36,117,"New York","Wayne County",2,30,1078,544,534
050,36,117,"New York","Wayne County",2,31,1048,531,517
050,36,117,"New York","Wayne County",2,32,1040,524,516
050,36,117,"New York","Wayne County",2,33,1030,523,507
050,36,117,"New York","Wayne County",2,34,1022,523,499
050,36,117,"New York","Wayne County",2,35,1098,555,543
050,36,117,"New York","Wayne County",2,36,1072,546,526
050,36,117,"New York","Wayne County",2,37,1058,533,525
050,36,117,"New York","Wayne County",2,38,1094,560,534
050,36,117,"New York","Wayne County",2,39,1093,558,535
050,36,117,"New York","Wayne County",2,40,1055,534,521
050,36,117,"New York","Wayne County",2,41,1024,503,521
050,36,117,"New York","Wayne County",2,42,966,481,485
050,36,117,"New York","Wayne County",2,43,938,491,447
050,36,117,"New York","Wayne County",2,44,904,490,414
050,36,117,"New York","Wayne County",2,45,966,483,483
050,36,117,"New York","Wayne County",2,46,968,481,487
050,36,117,"New York","Wayne County",2,47,1008,509,499
050,36,117,"New York","Wayne County",2,48,1141,578,563
050,36,117,"New York","Wayne County",2,49,1315,657,658
050,36,117,"New York","Wayne County",2,50,1316,649,667
050,36,117,"New York","Wayne County",2,51,1268,645,623
050,36,117,"New York","Wayne County",2,52,1276,662,614
050,36,117,"New York","Wayne County",2,53,1356,673,683
050,36,117,"New York","Wayne County",2,54,1389,690,699
050,36,117,"New York","Wayne County",2,55,1454,734,720
050,36,117,"New York","Wayne County",2,56,1486,739,747
050,36,117,"New York","Wayne County",2,57,1494,740,754
050,36,117,"New York","Wayne County",2,58,1552,784,768
050,36,117,"New York","Wayne County",2,59,1566,798,768
050,36,117,"New York","Wayne County",2,60,1475,739,736
050,36,117,"New York","Wayne County",2,61,1463,743,720
050,36,117,"New York","Wayne County",2,62,1467,749,718
050,36,117,"New York","Wayne County",2,63,1417,712,705
050,36,117,"New York","Wayne County",2,64,1326,665,661
050,36,117,"New York","Wayne County",2,65,1285,625,660
050,36,117,"New York","Wayne County",2,66,1263,627,636
050,36,117,"New York","Wayne County",2,67,1200,605,595
050,36,117,"New York","Wayne County",2,68,1157,594,563
050,36,117,"New York","Wayne County",2,69,1084,565,519
050,36,117,"New York","Wayne County",2,70,1020,520,500
050,36,117,"New York","Wayne County",2,71,1007,506,501
050,36,117,"New York","Wayne County",2,72,991,480,511
050,36,117,"New York","Wayne County",2,73,1060,517,543
050,36,117,"New York","Wayne County",2,74,738,336,402
050,36,117,"New York","Wayne County",2,75,700,315,385
050,36,117,"New York","Wayne County",2,76,673,309,364
050,36,117,"New York","Wayne County",2,77,713,340,373
050,36,117,"New York","Wayne County",2,78,589,287,302
050,36,117,"New York","Wayne County",2,79,508,246,262
050,36,117,"New York","Wayne County",2,80,438,198,240
050,36,117,"New York","Wayne County",2,81,401,184,217
050,36,117,"New York","Wayne County",2,82,376,168,208
050,36,117,"New York","Wayne County",2,83,338,158,180
050,36,117,"New York","Wayne County",2,84,311,143,168
050,36,117,"New York","Wayne County",2,85,1924,696,1228
050,36,117,"New York","Wayne County",3,0,896,461,435
050,36,117,"New York","Wayne County",3,1,993,518,475
050,36,117,"New York","Wayne County",3,2,996,504,492
050,36,117,"New York","Wayne County",3,3,1033,541,492
050,36,117,"New York","Wayne County",3,4,1012,522,490
050,36,117,"New York","Wayne County",3,5,1044,526,518
050,36,117,"New York","Wayne County",3,6,1023,514,509
050,36,117,"New York","Wayne County",3,7,1004,511,493
050,36,117,"New York","Wayne County",3,8,1081,564,517
050,36,117,"New York","Wayne County",3,9,1084,549,535
050,36,117,"New York","Wayne County",3,10,1091,568,523
050,36,117,"New York","Wayne County",3,11,1109,576,533
050,36,117,"New York","Wayne County",3,12,1162,604,558
050,36,117,"New York","Wayne County",3,13,1182,603,579
050,36,117,"New York","Wayne County",3,14,1170,591,579
050,36,117,"New York","Wayne County",3,15,1163,599,564
050,36,117,"New York","Wayne County",3,16,1157,595,562
050,36,117,"New York","Wayne County",3,17,1163,595,568
050,36,117,"New York","Wayne County",3,18,973,493,480
050,36,117,"New York","Wayne County",3,19,760,381,379
050,36,117,"New York","Wayne County",3,20,838,421,417
050,36,117,"New York","Wayne County",3,21,897,455,442
050,36,117,"New York","Wayne County",3,22,950,474,476
050,36,117,"New York","Wayne County",3,23,997,502,495
050,36,117,"New York","Wayne County",3,24,963,499,464
050,36,117,"New York","Wayne County",3,25,953,514,439
050,36,117,"New York","Wayne County",3,26,1016,519,497
050,36,117,"New York","Wayne County",3,27,1061,543,518
050,36,117,"New York","Wayne County",3,28,1045,543,502
050,36,117,"New York","Wayne County",3,29,1110,572,538
050,36,117,"New York","Wayne County",3,30,1124,546,578
050,36,117,"New York","Wayne County",3,31,1103,561,542
050,36,117,"New York","Wayne County",3,32,1049,527,522
050,36,117,"New York","Wayne County",3,33,1061,541,520
050,36,117,"New York","Wayne County",3,34,1071,545,526
050,36,117,"New York","Wayne County",3,35,1064,555,509
050,36,117,"New York","Wayne County",3,36,1143,581,562
050,36,117,"New York","Wayne County",3,37,1083,548,535
050,36,117,"New York","Wayne County",3,38,1051,526,525
050,36,117,"New York","Wayne County",3,39,1116,558,558
050,36,117,"New York","Wayne County",3,40,1080,564,516
050,36,117,"New York","Wayne County",3,41,1059,527,532
050,36,117,"New York","Wayne County",3,42,1024,503,521
050,36,117,"New York","Wayne County",3,43,973,490,483
050,36,117,"New York","Wayne County",3,44,920,484,436
050,36,117,"New York","Wayne County",3,45,904,481,423
050,36,117,"New York","Wayne County",3,46,974,490,484
050,36,117,"New York","Wayne County",3,47,959,483,476
050,36,117,"New York","Wayne County",3,48,1031,517,514
050,36,117,"New York","Wayne County",3,49,1125,561,564
050,36,117,"New York","Wayne County",3,50,1297,643,654
050,36,117,"New York","Wayne County",3,51,1318,650,668
050,36,117,"New York","Wayne County",3,52,1252,637,615
050,36,117,"New York","Wayne County",3,53,1265,656,609
050,36,117,"New York","Wayne County",3,54,1336,660,676
050,36,117,"New York","Wayne County",3,55,1388,686,702
050,36,117,"New York","Wayne County",3,56,1425,712,713
050,36,117,"New York","Wayne County",3,57,1473,740,733
050,36,117,"New York","Wayne County",3,58,1481,730,751
050,36,117,"New York","Wayne County",3,59,1529,771,758
050,36,117,"New York","Wayne County",3,60,1539,780,759
050,36,117,"New York","Wayne County",3,61,1450,724,726
050,36,117,"New York","Wayne County",3,62,1446,732,714
050,36,117,"New York","Wayne County",3,63,1448,736,712
050,36,117,"New York","Wayne County",3,64,1404,704,700
050,36,117,"New York","Wayne County",3,65,1298,646,652
050,36,117,"New York","Wayne County",3,66,1266,618,648
050,36,117,"New York","Wayne County",3,67,1229,612,617
050,36,117,"New York","Wayne County",3,68,1180,592,588
050,36,117,"New York","Wayne County",3,69,1134,584,550
050,36,117,"New York","Wayne County",3,70,1062,545,517
050,36,117,"New York","Wayne County",3,71,995,504,491
050,36,117,"New York","Wayne County",3,72,981,488,493
050,36,117,"New York","Wayne County",3,73,964,463,501
050,36,117,"New York","Wayne County",3,74,1042,507,535
050,36,117,"New York","Wayne County",3,75,711,325,386
050,36,117,"New York","Wayne County",3,76,671,300,371
050,36,117,"New York","Wayne County",3,77,652,305,347
050,36,117,"New York","Wayne County",3,78,661,305,356
050,36,117,"New York","Wayne County",3,79,575,285,290
050,36,117,"New York","Wayne County",3,80,487,232,255
050,36,117,"New York","Wayne County",3,81,409,184,225
050,36,117,"New York","Wayne County",3,82,370,161,209
050,36,117,"New York","Wayne County",3,83,357,163,194
050,36,117,"New York","Wayne County",3,84,314,155,159
050,36,117,"New York","Wayne County",3,85,1900,696,1204
050,36,117,"New York","Wayne County",4,0,890,447,443
050,36,117,"New York","Wayne County",4,1,908,469,439
050,36,117,"New York","Wayne County",4,2,1033,538,495
050,36,117,"New York","Wayne County",4,3,1025,512,513
050,36,117,"New York","Wayne County",4,4,1025,527,498
050,36,117,"New York","Wayne County",4,5,1010,521,489
050,36,117,"New York","Wayne County",4,6,1060,527,533
050,36,117,"New York","Wayne County",4,7,1015,522,493
050,36,117,"New York","Wayne County",4,8,1015,523,492
050,36,117,"New York","Wayne County",4,9,1065,556,509
050,36,117,"New York","Wayne County",4,10,1086,545,541
050,36,117,"New York","Wayne County",4,11,1087,573,514
050,36,117,"New York","Wayne County",4,12,1104,571,533
050,36,117,"New York","Wayne County",4,13,1159,606,553
050,36,117,"New York","Wayne County",4,14,1187,598,589
050,36,117,"New York","Wayne County",4,15,1170,602,568
050,36,117,"New York","Wayne County",4,16,1158,597,561
050,36,117,"New York","Wayne County",4,17,1163,603,560
050,36,117,"New York","Wayne County",4,18,977,518,459
050,36,117,"New York","Wayne County",4,19,742,385,357
050,36,117,"New York","Wayne County",4,20,822,409,413
050,36,117,"New York","Wayne County",4,21,881,434,447
050,36,117,"New York","Wayne County",4,22,937,467,470
050,36,117,"New York","Wayne County",4,23,954,499,455
050,36,117,"New York","Wayne County",4,24,996,499,497
050,36,117,"New York","Wayne County",4,25,944,492,452
050,36,117,"New York","Wayne County",4,26,935,484,451
050,36,117,"New York","Wayne County",4,27,1038,532,506
050,36,117,"New York","Wayne County",4,28,1049,540,509
050,36,117,"New York","Wayne County",4,29,1068,558,510
050,36,117,"New York","Wayne County",4,30,1120,586,534
050,36,117,"New York","Wayne County",4,31,1164,565,599
050,36,117,"New York","Wayne County",4,32,1098,560,538
050,36,117,"New York","Wayne County",4,33,1070,533,537
050,36,117,"New York","Wayne County",4,34,1104,566,538
050,36,117,"New York","Wayne County",4,35,1094,561,533
050,36,117,"New York","Wayne County",4,36,1064,540,524
050,36,117,"New York","Wayne County",4,37,1118,561,557
050,36,117,"New York","Wayne County",4,38,1077,542,535
050,36,117,"New York","Wayne County",4,39,1063,525,538
050,36,117,"New York","Wayne County",4,40,1127,569,558
050,36,117,"New York","Wayne County",4,41,1086,571,515
050,36,117,"New York","Wayne County",4,42,1048,523,525
050,36,117,"New York","Wayne County",4,43,1026,506,520
050,36,117,"New York","Wayne County",4,44,960,479,481
050,36,117,"New York","Wayne County",4,45,920,484,436
050,36,117,"New York","Wayne County",4,46,884,467,417
050,36,117,"New York","Wayne County",4,47,975,483,492
050,36,117,"New York","Wayne County",4,48,976,491,485
050,36,117,"New York","Wayne County",4,49,1007,508,499
050,36,117,"New York","Wayne County",4,50,1114,552,562
050,36,117,"New York","Wayne County",4,51,1294,647,647
050,36,117,"New York","Wayne County",4,52,1317,656,661
050,36,117,"New York","Wayne County",4,53,1256,634,622
050,36,117,"New York","Wayne County",4,54,1261,656,605
050,36,117,"New York","Wayne County",4,55,1332,663,669
050,36,117,"New York","Wayne County",4,56,1360,670,690
050,36,117,"New York","Wayne County",4,57,1390,693,697
050,36,117,"New York","Wayne County",4,58,1440,719,721
050,36,117,"New York","Wayne County",4,59,1477,734,743
050,36,117,"New York","Wayne County",4,60,1513,765,748
050,36,117,"New York","Wayne County",4,61,1530,784,746
050,36,117,"New York","Wayne County",4,62,1458,738,720
050,36,117,"New York","Wayne County",4,63,1432,712,720
050,36,117,"New York","Wayne County",4,64,1415,711,704
050,36,117,"New York","Wayne County",4,65,1379,687,692
050,36,117,"New York","Wayne County",4,66,1280,637,643
050,36,117,"New York","Wayne County",4,67,1248,607,641
050,36,117,"New York","Wayne County",4,68,1202,599,603
050,36,117,"New York","Wayne County",4,69,1167,593,574
050,36,117,"New York","Wayne County",4,70,1092,554,538
050,36,117,"New York","Wayne County",4,71,1052,534,518
050,36,117,"New York","Wayne County",4,72,964,488,476
050,36,117,"New York","Wayne County",4,73,955,472,483
050,36,117,"New York","Wayne County",4,74,945,450,495
050,36,117,"New York","Wayne County",4,75,1009,492,517
050,36,117,"New York","Wayne County",4,76,693,312,381
050,36,117,"New York","Wayne County",4,77,651,292,359
050,36,117,"New York","Wayne County",4,78,606,274,332
050,36,117,"New York","Wayne County",4,79,650,304,346
050,36,117,"New York","Wayne County",4,80,556,272,284
050,36,117,"New York","Wayne County",4,81,470,219,251
050,36,117,"New York","Wayne County",4,82,374,165,209
050,36,117,"New York","Wayne County",4,83,355,156,199
050,36,117,"New York","Wayne County",4,84,330,156,174
050,36,117,"New York","Wayne County",4,85,1907,715,1192
050,36,117,"New York","Wayne County",5,0,887,444,443
050,36,117,"New York","Wayne County",5,1,908,451,457
050,36,117,"New York","Wayne County",5,2,907,468,439
050,36,117,"New York","Wayne County",5,3,1047,548,499
050,36,117,"New York","Wayne County",5,4,1012,507,505
050,36,117,"New York","Wayne County",5,5,1037,536,501
050,36,117,"New York","Wayne County",5,6,1026,534,492
050,36,117,"New York","Wayne County",5,7,1047,527,520
050,36,117,"New York","Wayne County",5,8,1028,532,496
050,36,117,"New York","Wayne County",5,9,1023,527,496
050,36,117,"New York","Wayne County",5,10,1066,571,495
050,36,117,"New York","Wayne County",5,11,1094,546,548
050,36,117,"New York","Wayne County",5,12,1069,555,514
050,36,117,"New York","Wayne County",5,13,1089,570,519
050,36,117,"New York","Wayne County",5,14,1173,614,559
050,36,117,"New York","Wayne County",5,15,1169,585,584
050,36,117,"New York","Wayne County",5,16,1166,592,574
050,36,117,"New York","Wayne County",5,17,1146,584,562
050,36,117,"New York","Wayne County",5,18,956,512,444
050,36,117,"New York","Wayne County",5,19,757,396,361
050,36,117,"New York","Wayne County",5,20,834,426,408
050,36,117,"New York","Wayne County",5,21,865,426,439
050,36,117,"New York","Wayne County",5,22,922,448,474
050,36,117,"New York","Wayne County",5,23,975,500,475
050,36,117,"New York","Wayne County",5,24,967,508,459
050,36,117,"New York","Wayne County",5,25,979,495,484
050,36,117,"New York","Wayne County",5,26,930,484,446
050,36,117,"New York","Wayne County",5,27,968,504,464
050,36,117,"New York","Wayne County",5,28,1014,520,494
050,36,117,"New York","Wayne County",5,29,1070,539,531
050,36,117,"New York","Wayne County",5,30,1064,551,513
050,36,117,"New York","Wayne County",5,31,1151,611,540
050,36,117,"New York","Wayne County",5,32,1198,570,628
050,36,117,"New York","Wayne County",5,33,1108,564,544
050,36,117,"New York","Wayne County",5,34,1090,534,556
050,36,117,"New York","Wayne County",5,35,1135,577,558
050,36,117,"New York","Wayne County",5,36,1104,568,536
050,36,117,"New York","Wayne County",5,37,1056,530,526
050,36,117,"New York","Wayne County",5,38,1113,560,553
050,36,117,"New York","Wayne County",5,39,1078,538,540
050,36,117,"New York","Wayne County",5,40,1068,544,524
050,36,117,"New York","Wayne County",5,41,1139,574,565
050,36,117,"New York","Wayne County",5,42,1080,570,510
050,36,117,"New York","Wayne County",5,43,1051,534,517
050,36,117,"New York","Wayne County",5,44,1004,487,517
050,36,117,"New York","Wayne County",5,45,959,476,483
050,36,117,"New York","Wayne County",5,46,932,492,440
050,36,117,"New York","Wayne County",5,47,891,476,415
050,36,117,"New York","Wayne County",5,48,988,494,494
050,36,117,"New York","Wayne County",5,49,948,482,466
050,36,117,"New York","Wayne County",5,50,991,486,505
050,36,117,"New York","Wayne County",5,51,1120,565,555
050,36,117,"New York","Wayne County",5,52,1275,651,624
050,36,117,"New York","Wayne County",5,53,1321,649,672
050,36,117,"New York","Wayne County",5,54,1250,635,615
050,36,117,"New York","Wayne County",5,55,1268,665,603
050,36,117,"New York","Wayne County",5,56,1306,646,660
050,36,117,"New York","Wayne County",5,57,1340,665,675
050,36,117,"New York","Wayne County",5,58,1390,687,703
050,36,117,"New York","Wayne County",5,59,1421,701,720
050,36,117,"New York","Wayne County",5,60,1461,725,736
050,36,117,"New York","Wayne County",5,61,1489,755,734
050,36,117,"New York","Wayne County",5,62,1525,777,748
050,36,117,"New York","Wayne County",5,63,1434,719,715
050,36,117,"New York","Wayne County",5,64,1410,700,710
050,36,117,"New York","Wayne County",5,65,1409,708,701
050,36,117,"New York","Wayne County",5,66,1368,681,687
050,36,117,"New York","Wayne County",5,67,1261,625,636
050,36,117,"New York","Wayne County",5,68,1234,607,627
050,36,117,"New York","Wayne County",5,69,1185,599,586
050,36,117,"New York","Wayne County",5,70,1137,565,572
050,36,117,"New York","Wayne County",5,71,1086,551,535
050,36,117,"New York","Wayne County",5,72,1029,516,513
050,36,117,"New York","Wayne County",5,73,937,475,462
050,36,117,"New York","Wayne County",5,74,943,463,480
050,36,117,"New York","Wayne County",5,75,908,435,473
050,36,117,"New York","Wayne County",5,76,976,464,512
050,36,117,"New York","Wayne County",5,77,672,306,366
050,36,117,"New York","Wayne County",5,78,610,261,349
050,36,117,"New York","Wayne County",5,79,595,275,320
050,36,117,"New York","Wayne County",5,80,614,282,332
050,36,117,"New York","Wayne County",5,81,523,260,263
050,36,117,"New York","Wayne County",5,82,434,197,237
050,36,117,"New York","Wayne County",5,83,358,161,197
050,36,117,"New York","Wayne County",5,84,326,149,177
050,36,117,"New York","Wayne County",5,85,1935,739,1196
050,36,119,"New York","Westchester County",1,0,10264,5238,5026
050,36,119,"New York","Westchester County",1,1,10577,5369,5208
050,36,119,"New York","Westchester County",1,2,10880,5620,5260
050,36,119,"New York","Westchester County",1,3,11209,5745,5464
050,36,119,"New York","Westchester County",1,4,11653,5966,5687
050,36,119,"New York","Westchester County",1,5,11951,6186,5765
050,36,119,"New York","Westchester County",1,6,11854,6117,5737
050,36,119,"New York","Westchester County",1,7,11787,6111,5676
050,36,119,"New York","Westchester County",1,8,12039,6223,5816
050,36,119,"New York","Westchester County",1,9,12352,6318,6034
050,36,119,"New York","Westchester County",1,10,12506,6475,6031
050,36,119,"New York","Westchester County",1,11,12514,6519,5995
050,36,119,"New York","Westchester County",1,12,13234,6818,6416
050,36,119,"New York","Westchester County",1,13,13210,6809,6401
050,36,119,"New York","Westchester County",1,14,13132,6768,6364
050,36,119,"New York","Westchester County",1,15,13472,6915,6557
050,36,119,"New York","Westchester County",1,16,13991,7154,6837
050,36,119,"New York","Westchester County",1,17,13609,7034,6575
050,36,119,"New York","Westchester County",1,18,13186,6720,6466
050,36,119,"New York","Westchester County",1,19,12271,6047,6224
050,36,119,"New York","Westchester County",1,20,12233,6113,6120
050,36,119,"New York","Westchester County",1,21,12244,6096,6148
050,36,119,"New York","Westchester County",1,22,12114,5969,6145
050,36,119,"New York","Westchester County",1,23,11622,5735,5887
050,36,119,"New York","Westchester County",1,24,11459,5639,5820
050,36,119,"New York","Westchester County",1,25,11386,5647,5739
050,36,119,"New York","Westchester County",1,26,11611,5830,5781
050,36,119,"New York","Westchester County",1,27,11447,5787,5660
050,36,119,"New York","Westchester County",1,28,11239,5698,5541
050,36,119,"New York","Westchester County",1,29,11176,5657,5519
050,36,119,"New York","Westchester County",1,30,11181,5677,5504
050,36,119,"New York","Westchester County",1,31,11327,5665,5662
050,36,119,"New York","Westchester County",1,32,11755,5836,5919
050,36,119,"New York","Westchester County",1,33,12006,6000,6006
050,36,119,"New York","Westchester County",1,34,12221,6123,6098
050,36,119,"New York","Westchester County",1,35,12399,6251,6148
050,36,119,"New York","Westchester County",1,36,12467,6267,6200
050,36,119,"New York","Westchester County",1,37,12973,6444,6529
050,36,119,"New York","Westchester County",1,38,13005,6431,6574
050,36,119,"New York","Westchester County",1,39,13211,6549,6662
050,36,119,"New York","Westchester County",1,40,13231,6574,6657
050,36,119,"New York","Westchester County",1,41,13288,6539,6749
050,36,119,"New York","Westchester County",1,42,13273,6581,6692
050,36,119,"New York","Westchester County",1,43,13333,6516,6817
050,36,119,"New York","Westchester County",1,44,13158,6443,6715
050,36,119,"New York","Westchester County",1,45,13256,6524,6732
050,36,119,"New York","Westchester County",1,46,12983,6434,6549
050,36,119,"New York","Westchester County",1,47,12999,6351,6648
050,36,119,"New York","Westchester County",1,48,13730,6751,6979
050,36,119,"New York","Westchester County",1,49,14908,7383,7525
050,36,119,"New York","Westchester County",1,50,14946,7380,7566
050,36,119,"New York","Westchester County",1,51,14601,7211,7390
050,36,119,"New York","Westchester County",1,52,14487,7083,7404
050,36,119,"New York","Westchester County",1,53,14364,6961,7403
050,36,119,"New York","Westchester County",1,54,14684,7133,7551
050,36,119,"New York","Westchester County",1,55,15006,7250,7756
050,36,119,"New York","Westchester County",1,56,14908,7253,7655
050,36,119,"New York","Westchester County",1,57,14619,7172,7447
050,36,119,"New York","Westchester County",1,58,14535,7088,7447
050,36,119,"New York","Westchester County",1,59,14465,7101,7364
050,36,119,"New York","Westchester County",1,60,14046,6885,7161
050,36,119,"New York","Westchester County",1,61,13648,6598,7050
050,36,119,"New York","Westchester County",1,62,13394,6497,6897
050,36,119,"New York","Westchester County",1,63,12809,6235,6574
050,36,119,"New York","Westchester County",1,64,12394,5935,6459
050,36,119,"New York","Westchester County",1,65,11780,5596,6184
050,36,119,"New York","Westchester County",1,66,11015,5174,5841
050,36,119,"New York","Westchester County",1,67,10461,4856,5605
050,36,119,"New York","Westchester County",1,68,10182,4780,5402
050,36,119,"New York","Westchester County",1,69,9521,4399,5122
050,36,119,"New York","Westchester County",1,70,9360,4315,5045
050,36,119,"New York","Westchester County",1,71,8984,4116,4868
050,36,119,"New York","Westchester County",1,72,8913,4072,4841
050,36,119,"New York","Westchester County",1,73,8884,4086,4798
050,36,119,"New York","Westchester County",1,74,6676,3016,3660
050,36,119,"New York","Westchester County",1,75,6468,2849,3619
050,36,119,"New York","Westchester County",1,76,6354,2737,3617
050,36,119,"New York","Westchester County",1,77,6501,2752,3749
050,36,119,"New York","Westchester County",1,78,5506,2369,3137
050,36,119,"New York","Westchester County",1,79,5034,2089,2945
050,36,119,"New York","Westchester County",1,80,4733,1886,2847
050,36,119,"New York","Westchester County",1,81,4512,1807,2705
050,36,119,"New York","Westchester County",1,82,4248,1664,2584
050,36,119,"New York","Westchester County",1,83,3920,1511,2409
050,36,119,"New York","Westchester County",1,84,3655,1438,2217
050,36,119,"New York","Westchester County",1,85,25930,8795,17135
050,36,119,"New York","Westchester County",2,0,10226,5232,4994
050,36,119,"New York","Westchester County",2,1,10525,5354,5171
050,36,119,"New York","Westchester County",2,2,10841,5577,5264
050,36,119,"New York","Westchester County",2,3,11113,5713,5400
050,36,119,"New York","Westchester County",2,4,11566,5923,5643
050,36,119,"New York","Westchester County",2,5,11909,6145,5764
050,36,119,"New York","Westchester County",2,6,11883,6143,5740
050,36,119,"New York","Westchester County",2,7,11769,6092,5677
050,36,119,"New York","Westchester County",2,8,11935,6175,5760
050,36,119,"New York","Westchester County",2,9,12260,6293,5967
050,36,119,"New York","Westchester County",2,10,12453,6434,6019
050,36,119,"New York","Westchester County",2,11,12448,6472,5976
050,36,119,"New York","Westchester County",2,12,13096,6754,6342
050,36,119,"New York","Westchester County",2,13,13186,6807,6379
050,36,119,"New York","Westchester County",2,14,13136,6775,6361
050,36,119,"New York","Westchester County",2,15,13399,6876,6523
050,36,119,"New York","Westchester County",2,16,13919,7129,6790
050,36,119,"New York","Westchester County",2,17,13668,7034,6634
050,36,119,"New York","Westchester County",2,18,13140,6693,6447
050,36,119,"New York","Westchester County",2,19,12297,6054,6243
050,36,119,"New York","Westchester County",2,20,12314,6153,6161
050,36,119,"New York","Westchester County",2,21,12212,6081,6131
050,36,119,"New York","Westchester County",2,22,12032,5945,6087
050,36,119,"New York","Westchester County",2,23,11641,5749,5892
050,36,119,"New York","Westchester County",2,24,11416,5617,5799
050,36,119,"New York","Westchester County",2,25,11375,5632,5743
050,36,119,"New York","Westchester County",2,26,11540,5780,5760
050,36,119,"New York","Westchester County",2,27,11450,5780,5670
050,36,119,"New York","Westchester County",2,28,11310,5719,5591
050,36,119,"New York","Westchester County",2,29,11192,5661,5531
050,36,119,"New York","Westchester County",2,30,11258,5711,5547
050,36,119,"New York","Westchester County",2,31,11301,5670,5631
050,36,119,"New York","Westchester County",2,32,11678,5810,5868
050,36,119,"New York","Westchester County",2,33,11959,5963,5996
050,36,119,"New York","Westchester County",2,34,12210,6123,6087
050,36,119,"New York","Westchester County",2,35,12456,6270,6186
050,36,119,"New York","Westchester County",2,36,12432,6259,6173
050,36,119,"New York","Westchester County",2,37,12909,6416,6493
050,36,119,"New York","Westchester County",2,38,13079,6467,6612
050,36,119,"New York","Westchester County",2,39,13144,6517,6627
050,36,119,"New York","Westchester County",2,40,13331,6629,6702
050,36,119,"New York","Westchester County",2,41,13255,6541,6714
050,36,119,"New York","Westchester County",2,42,13212,6542,6670
050,36,119,"New York","Westchester County",2,43,13383,6553,6830
050,36,119,"New York","Westchester County",2,44,13113,6425,6688
050,36,119,"New York","Westchester County",2,45,13255,6516,6739
050,36,119,"New York","Westchester County",2,46,12999,6431,6568
050,36,119,"New York","Westchester County",2,47,12954,6344,6610
050,36,119,"New York","Westchester County",2,48,13558,6659,6899
050,36,119,"New York","Westchester County",2,49,14667,7250,7417
050,36,119,"New York","Westchester County",2,50,14915,7367,7548
050,36,119,"New York","Westchester County",2,51,14601,7209,7392
050,36,119,"New York","Westchester County",2,52,14487,7103,7384
050,36,119,"New York","Westchester County",2,53,14323,6940,7383
050,36,119,"New York","Westchester County",2,54,14547,7069,7478
050,36,119,"New York","Westchester County",2,55,14848,7178,7670
050,36,119,"New York","Westchester County",2,56,14910,7239,7671
050,36,119,"New York","Westchester County",2,57,14625,7155,7470
050,36,119,"New York","Westchester County",2,58,14474,7067,7407
050,36,119,"New York","Westchester County",2,59,14436,7080,7356
050,36,119,"New York","Westchester County",2,60,14090,6910,7180
050,36,119,"New York","Westchester County",2,61,13630,6595,7035
050,36,119,"New York","Westchester County",2,62,13347,6459,6888
050,36,119,"New York","Westchester County",2,63,12949,6301,6648
050,36,119,"New York","Westchester County",2,64,12339,5927,6412
050,36,119,"New York","Westchester County",2,65,11817,5616,6201
050,36,119,"New York","Westchester County",2,66,11126,5230,5896
050,36,119,"New York","Westchester County",2,67,10457,4855,5602
050,36,119,"New York","Westchester County",2,68,10088,4717,5371
050,36,119,"New York","Westchester County",2,69,9633,4455,5178
050,36,119,"New York","Westchester County",2,70,9299,4280,5019
050,36,119,"New York","Westchester County",2,71,8955,4087,4868
050,36,119,"New York","Westchester County",2,72,8732,3983,4749
050,36,119,"New York","Westchester County",2,73,9142,4198,4944
050,36,119,"New York","Westchester County",2,74,6751,3053,3698
050,36,119,"New York","Westchester County",2,75,6472,2850,3622
050,36,119,"New York","Westchester County",2,76,6250,2698,3552
050,36,119,"New York","Westchester County",2,77,6473,2744,3729
050,36,119,"New York","Westchester County",2,78,5570,2371,3199
050,36,119,"New York","Westchester County",2,79,5014,2078,2936
050,36,119,"New York","Westchester County",2,80,4693,1881,2812
050,36,119,"New York","Westchester County",2,81,4433,1768,2665
050,36,119,"New York","Westchester County",2,82,4234,1650,2584
050,36,119,"New York","Westchester County",2,83,3866,1487,2379
050,36,119,"New York","Westchester County",2,84,3584,1397,2187
050,36,119,"New York","Westchester County",2,85,24939,8477,16462
050,36,119,"New York","Westchester County",3,0,9764,5028,4736
050,36,119,"New York","Westchester County",3,1,10404,5268,5136
050,36,119,"New York","Westchester County",3,2,10711,5475,5236
050,36,119,"New York","Westchester County",3,3,10949,5597,5352
050,36,119,"New York","Westchester County",3,4,11054,5694,5360
050,36,119,"New York","Westchester County",3,5,11570,5913,5657
050,36,119,"New York","Westchester County",3,6,11944,6178,5766
050,36,119,"New York","Westchester County",3,7,11825,6114,5711
050,36,119,"New York","Westchester County",3,8,11727,6064,5663
050,36,119,"New York","Westchester County",3,9,11872,6132,5740
050,36,119,"New York","Westchester County",3,10,12133,6219,5914
050,36,119,"New York","Westchester County",3,11,12230,6319,5911
050,36,119,"New York","Westchester County",3,12,12367,6427,5940
050,36,119,"New York","Westchester County",3,13,13006,6744,6262
050,36,119,"New York","Westchester County",3,14,13060,6784,6276
050,36,119,"New York","Westchester County",3,15,13050,6729,6321
050,36,119,"New York","Westchester County",3,16,13486,7000,6486
050,36,119,"New York","Westchester County",3,17,13748,6995,6753
050,36,119,"New York","Westchester County",3,18,13489,6778,6711
050,36,119,"New York","Westchester County",3,19,12418,6029,6389
050,36,119,"New York","Westchester County",3,20,12418,6157,6261
050,36,119,"New York","Westchester County",3,21,12468,6189,6279
050,36,119,"New York","Westchester County",3,22,11956,5963,5993
050,36,119,"New York","Westchester County",3,23,11511,5744,5767
050,36,119,"New York","Westchester County",3,24,11372,5668,5704
050,36,119,"New York","Westchester County",3,25,11353,5621,5732
050,36,119,"New York","Westchester County",3,26,11240,5553,5687
050,36,119,"New York","Westchester County",3,27,11467,5746,5721
050,36,119,"New York","Westchester County",3,28,11539,5776,5763
050,36,119,"New York","Westchester County",3,29,11436,5774,5662
050,36,119,"New York","Westchester County",3,30,11362,5712,5650
050,36,119,"New York","Westchester County",3,31,11511,5847,5664
050,36,119,"New York","Westchester County",3,32,11617,5868,5749
050,36,119,"New York","Westchester County",3,33,11972,5941,6031
050,36,119,"New York","Westchester County",3,34,12262,6067,6195
050,36,119,"New York","Westchester County",3,35,12583,6292,6291
050,36,119,"New York","Westchester County",3,36,12775,6419,6356
050,36,119,"New York","Westchester County",3,37,12684,6358,6326
050,36,119,"New York","Westchester County",3,38,13098,6509,6589
050,36,119,"New York","Westchester County",3,39,13234,6544,6690
050,36,119,"New York","Westchester County",3,40,13302,6630,6672
050,36,119,"New York","Westchester County",3,41,13466,6731,6735
050,36,119,"New York","Westchester County",3,42,13347,6594,6753
050,36,119,"New York","Westchester County",3,43,13262,6552,6710
050,36,119,"New York","Westchester County",3,44,13303,6555,6748
050,36,119,"New York","Westchester County",3,45,13091,6428,6663
050,36,119,"New York","Westchester County",3,46,13168,6468,6700
050,36,119,"New York","Westchester County",3,47,12888,6344,6544
050,36,119,"New York","Westchester County",3,48,12840,6291,6549
050,36,119,"New York","Westchester County",3,49,13444,6604,6840
050,36,119,"New York","Westchester County",3,50,14565,7187,7378
050,36,119,"New York","Westchester County",3,51,14714,7257,7457
050,36,119,"New York","Westchester County",3,52,14463,7125,7338
050,36,119,"New York","Westchester County",3,53,14327,7007,7320
050,36,119,"New York","Westchester County",3,54,14109,6855,7254
050,36,119,"New York","Westchester County",3,55,14248,6905,7343
050,36,119,"New York","Westchester County",3,56,14590,7074,7516
050,36,119,"New York","Westchester County",3,57,14625,7099,7526
050,36,119,"New York","Westchester County",3,58,14326,6996,7330
050,36,119,"New York","Westchester County",3,59,14143,6911,7232
050,36,119,"New York","Westchester County",3,60,14137,6927,7210
050,36,119,"New York","Westchester County",3,61,13705,6705,7000
050,36,119,"New York","Westchester County",3,62,13274,6399,6875
050,36,119,"New York","Westchester County",3,63,12990,6316,6674
050,36,119,"New York","Westchester County",3,64,12577,6114,6463
050,36,119,"New York","Westchester County",3,65,11912,5710,6202
050,36,119,"New York","Westchester County",3,66,11574,5494,6080
050,36,119,"New York","Westchester County",3,67,10869,5080,5789
050,36,119,"New York","Westchester County",3,68,10165,4719,5446
050,36,119,"New York","Westchester County",3,69,9855,4602,5253
050,36,119,"New York","Westchester County",3,70,9432,4341,5091
050,36,119,"New York","Westchester County",3,71,9115,4171,4944
050,36,119,"New York","Westchester County",3,72,8707,3951,4756
050,36,119,"New York","Westchester County",3,73,8597,3879,4718
050,36,119,"New York","Westchester County",3,74,8896,4049,4847
050,36,119,"New York","Westchester County",3,75,6538,2944,3594
050,36,119,"New York","Westchester County",3,76,6320,2760,3560
050,36,119,"New York","Westchester County",3,77,6100,2618,3482
050,36,119,"New York","Westchester County",3,78,6239,2599,3640
050,36,119,"New York","Westchester County",3,79,5382,2268,3114
050,36,119,"New York","Westchester County",3,80,4825,1964,2861
050,36,119,"New York","Westchester County",3,81,4543,1824,2719
050,36,119,"New York","Westchester County",3,82,4249,1659,2590
050,36,119,"New York","Westchester County",3,83,4051,1572,2479
050,36,119,"New York","Westchester County",3,84,3670,1384,2286
050,36,119,"New York","Westchester County",3,85,25248,8576,16672
050,36,119,"New York","Westchester County",4,0,10380,5382,4998
050,36,119,"New York","Westchester County",4,1,9725,5017,4708
050,36,119,"New York","Westchester County",4,2,10534,5322,5212
050,36,119,"New York","Westchester County",4,3,10636,5396,5240
050,36,119,"New York","Westchester County",4,4,10901,5581,5320
050,36,119,"New York","Westchester County",4,5,10998,5662,5336
050,36,119,"New York","Westchester County",4,6,11448,5867,5581
050,36,119,"New York","Westchester County",4,7,11835,6098,5737
050,36,119,"New York","Westchester County",4,8,11712,6054,5658
050,36,119,"New York","Westchester County",4,9,11605,5936,5669
050,36,119,"New York","Westchester County",4,10,11685,6035,5650
050,36,119,"New York","Westchester County",4,11,12009,6196,5813
050,36,119,"New York","Westchester County",4,12,12168,6311,5857
050,36,119,"New York","Westchester County",4,13,12259,6402,5857
050,36,119,"New York","Westchester County",4,14,12975,6739,6236
050,36,119,"New York","Westchester County",4,15,13043,6741,6302
050,36,119,"New York","Westchester County",4,16,13221,6884,6337
050,36,119,"New York","Westchester County",4,17,13392,6917,6475
050,36,119,"New York","Westchester County",4,18,13404,6667,6737
050,36,119,"New York","Westchester County",4,19,12268,5942,6326
050,36,119,"New York","Westchester County",4,20,12131,6030,6101
050,36,119,"New York","Westchester County",4,21,12309,6128,6181
050,36,119,"New York","Westchester County",4,22,12079,6043,6036
050,36,119,"New York","Westchester County",4,23,11154,5630,5524
050,36,119,"New York","Westchester County",4,24,11016,5513,5503
050,36,119,"New York","Westchester County",4,25,11049,5492,5557
050,36,119,"New York","Westchester County",4,26,10925,5418,5507
050,36,119,"New York","Westchester County",4,27,10811,5356,5455
050,36,119,"New York","Westchester County",4,28,11131,5597,5534
050,36,119,"New York","Westchester County",4,29,11222,5628,5594
050,36,119,"New York","Westchester County",4,30,11285,5684,5601
050,36,119,"New York","Westchester County",4,31,11365,5668,5697
050,36,119,"New York","Westchester County",4,32,11672,5913,5759
050,36,119,"New York","Westchester County",4,33,11683,5862,5821
050,36,119,"New York","Westchester County",4,34,12007,6017,5990
050,36,119,"New York","Westchester County",4,35,12286,6061,6225
050,36,119,"New York","Westchester County",4,36,12664,6343,6321
050,36,119,"New York","Westchester County",4,37,12789,6382,6407
050,36,119,"New York","Westchester County",4,38,12640,6262,6378
050,36,119,"New York","Westchester County",4,39,13110,6512,6598
050,36,119,"New York","Westchester County",4,40,13292,6574,6718
050,36,119,"New York","Westchester County",4,41,13351,6673,6678
050,36,119,"New York","Westchester County",4,42,13463,6766,6697
050,36,119,"New York","Westchester County",4,43,13354,6579,6775
050,36,119,"New York","Westchester County",4,44,13202,6482,6720
050,36,119,"New York","Westchester County",4,45,13184,6452,6732
050,36,119,"New York","Westchester County",4,46,13027,6430,6597
050,36,119,"New York","Westchester County",4,47,13058,6382,6676
050,36,119,"New York","Westchester County",4,48,12814,6344,6470
050,36,119,"New York","Westchester County",4,49,12797,6270,6527
050,36,119,"New York","Westchester County",4,50,13361,6567,6794
050,36,119,"New York","Westchester County",4,51,14392,7096,7296
050,36,119,"New York","Westchester County",4,52,14631,7192,7439
050,36,119,"New York","Westchester County",4,53,14172,6956,7216
050,36,119,"New York","Westchester County",4,54,14109,6940,7169
050,36,119,"New York","Westchester County",4,55,13848,6701,7147
050,36,119,"New York","Westchester County",4,56,14039,6832,7207
050,36,119,"New York","Westchester County",4,57,14341,6960,7381
050,36,119,"New York","Westchester County",4,58,14365,6964,7401
050,36,119,"New York","Westchester County",4,59,14029,6863,7166
050,36,119,"New York","Westchester County",4,60,13809,6739,7070
050,36,119,"New York","Westchester County",4,61,13813,6716,7097
050,36,119,"New York","Westchester County",4,62,13456,6582,6874
050,36,119,"New York","Westchester County",4,63,12962,6245,6717
050,36,119,"New York","Westchester County",4,64,12691,6174,6517
050,36,119,"New York","Westchester County",4,65,12232,5917,6315
050,36,119,"New York","Westchester County",4,66,11596,5522,6074
050,36,119,"New York","Westchester County",4,67,11246,5328,5918
050,36,119,"New York","Westchester County",4,68,10569,4926,5643
050,36,119,"New York","Westchester County",4,69,9860,4523,5337
050,36,119,"New York","Westchester County",4,70,9609,4450,5159
050,36,119,"New York","Westchester County",4,71,9211,4208,5003
050,36,119,"New York","Westchester County",4,72,8865,4026,4839
050,36,119,"New York","Westchester County",4,73,8516,3833,4683
050,36,119,"New York","Westchester County",4,74,8372,3773,4599
050,36,119,"New York","Westchester County",4,75,8655,3897,4758
050,36,119,"New York","Westchester County",4,76,6360,2850,3510
050,36,119,"New York","Westchester County",4,77,6155,2668,3487
050,36,119,"New York","Westchester County",4,78,5879,2505,3374
050,36,119,"New York","Westchester County",4,79,5998,2448,3550
050,36,119,"New York","Westchester County",4,80,5154,2140,3014
050,36,119,"New York","Westchester County",4,81,4686,1909,2777
050,36,119,"New York","Westchester County",4,82,4316,1698,2618
050,36,119,"New York","Westchester County",4,83,4044,1562,2482
050,36,119,"New York","Westchester County",4,84,3838,1463,2375
050,36,119,"New York","Westchester County",4,85,25489,8621,16868
050,36,119,"New York","Westchester County",5,0,10333,5346,4987
050,36,119,"New York","Westchester County",5,1,10398,5370,5028
050,36,119,"New York","Westchester County",5,2,9850,5072,4778
050,36,119,"New York","Westchester County",5,3,10518,5321,5197
050,36,119,"New York","Westchester County",5,4,10761,5461,5300
050,36,119,"New York","Westchester County",5,5,11007,5629,5378
050,36,119,"New York","Westchester County",5,6,11062,5708,5354
050,36,119,"New York","Westchester County",5,7,11414,5839,5575
050,36,119,"New York","Westchester County",5,8,11744,6036,5708
050,36,119,"New York","Westchester County",5,9,11651,6008,5643
050,36,119,"New York","Westchester County",5,10,11526,5907,5619
050,36,119,"New York","Westchester County",5,11,11684,6042,5642
050,36,119,"New York","Westchester County",5,12,11986,6210,5776
050,36,119,"New York","Westchester County",5,13,12192,6369,5823
050,36,119,"New York","Westchester County",5,14,12326,6442,5884
050,36,119,"New York","Westchester County",5,15,13047,6758,6289
050,36,119,"New York","Westchester County",5,16,13216,6861,6355
050,36,119,"New York","Westchester County",5,17,13166,6810,6356
050,36,119,"New York","Westchester County",5,18,13153,6660,6493
050,36,119,"New York","Westchester County",5,19,12480,5956,6524
050,36,119,"New York","Westchester County",5,20,12249,6022,6227
050,36,119,"New York","Westchester County",5,21,12220,6099,6121
050,36,119,"New York","Westchester County",5,22,11932,6003,5929
050,36,119,"New York","Westchester County",5,23,11415,5761,5654
050,36,119,"New York","Westchester County",5,24,10873,5444,5429
050,36,119,"New York","Westchester County",5,25,10768,5407,5361
050,36,119,"New York","Westchester County",5,26,10864,5399,5465
050,36,119,"New York","Westchester County",5,27,10711,5340,5371
050,36,119,"New York","Westchester County",5,28,10683,5310,5373
050,36,119,"New York","Westchester County",5,29,11003,5539,5464
050,36,119,"New York","Westchester County",5,30,11172,5533,5639
050,36,119,"New York","Westchester County",5,31,11330,5658,5672
050,36,119,"New York","Westchester County",5,32,11651,5815,5836
050,36,119,"New York","Westchester County",5,33,11855,6000,5855
050,36,119,"New York","Westchester County",5,34,11915,5941,5974
050,36,119,"New York","Westchester County",5,35,12240,6165,6075
050,36,119,"New York","Westchester County",5,36,12360,6163,6197
050,36,119,"New York","Westchester County",5,37,12812,6325,6487
050,36,119,"New York","Westchester County",5,38,12834,6421,6413
050,36,119,"New York","Westchester County",5,39,12868,6455,6413
050,36,119,"New York","Westchester County",5,40,13202,6623,6579
050,36,119,"New York","Westchester County",5,41,13400,6613,6787
050,36,119,"New York","Westchester County",5,42,13405,6655,6750
050,36,119,"New York","Westchester County",5,43,13537,6757,6780
050,36,119,"New York","Westchester County",5,44,13316,6563,6753
050,36,119,"New York","Westchester County",5,45,13224,6500,6724
050,36,119,"New York","Westchester County",5,46,13249,6496,6753
050,36,119,"New York","Westchester County",5,47,12932,6381,6551
050,36,119,"New York","Westchester County",5,48,13069,6373,6696
050,36,119,"New York","Westchester County",5,49,12757,6290,6467
050,36,119,"New York","Westchester County",5,50,12759,6253,6506
050,36,119,"New York","Westchester County",5,51,13374,6593,6781
050,36,119,"New York","Westchester County",5,52,14353,7087,7266
050,36,119,"New York","Westchester County",5,53,14416,7076,7340
050,36,119,"New York","Westchester County",5,54,14038,6921,7117
050,36,119,"New York","Westchester County",5,55,13937,6849,7088
050,36,119,"New York","Westchester County",5,56,13706,6610,7096
050,36,119,"New York","Westchester County",5,57,13875,6718,7157
050,36,119,"New York","Westchester County",5,58,14131,6854,7277
050,36,119,"New York","Westchester County",5,59,14114,6867,7247
050,36,119,"New York","Westchester County",5,60,13791,6730,7061
050,36,119,"New York","Westchester County",5,61,13585,6609,6976
050,36,119,"New York","Westchester County",5,62,13528,6566,6962
050,36,119,"New York","Westchester County",5,63,13224,6485,6739
050,36,119,"New York","Westchester County",5,64,12748,6142,6606
050,36,119,"New York","Westchester County",5,65,12348,5992,6356
050,36,119,"New York","Westchester County",5,66,12048,5809,6239
050,36,119,"New York","Westchester County",5,67,11358,5393,5965
050,36,119,"New York","Westchester County",5,68,11004,5206,5798
050,36,119,"New York","Westchester County",5,69,10318,4786,5532
050,36,119,"New York","Westchester County",5,70,9672,4422,5250
050,36,119,"New York","Westchester County",5,71,9453,4360,5093
050,36,119,"New York","Westchester County",5,72,9056,4118,4938
050,36,119,"New York","Westchester County",5,73,8693,3930,4763
050,36,119,"New York","Westchester County",5,74,8332,3740,4592
050,36,119,"New York","Westchester County",5,75,8175,3666,4509
050,36,119,"New York","Westchester County",5,76,8401,3763,4638
050,36,119,"New York","Westchester County",5,77,6198,2756,3442
050,36,119,"New York","Westchester County",5,78,5969,2552,3417
050,36,119,"New York","Westchester County",5,79,5657,2373,3284
050,36,119,"New York","Westchester County",5,80,5765,2318,3447
050,36,119,"New York","Westchester County",5,81,4977,2080,2897
050,36,119,"New York","Westchester County",5,82,4475,1785,2690
050,36,119,"New York","Westchester County",5,83,4123,1610,2513
050,36,119,"New York","Westchester County",5,84,3863,1478,2385
050,36,119,"New York","Westchester County",5,85,25993,8831,17162
050,36,121,"New York","Wyoming County",1,0,355,180,175
050,36,121,"New York","Wyoming County",1,1,354,173,181
050,36,121,"New York","Wyoming County",1,2,373,189,184
050,36,121,"New York","Wyoming County",1,3,377,182,195
050,36,121,"New York","Wyoming County",1,4,407,201,206
050,36,121,"New York","Wyoming County",1,5,412,202,210
050,36,121,"New York","Wyoming County",1,6,426,236,190
050,36,121,"New York","Wyoming County",1,7,409,212,197
050,36,121,"New York","Wyoming County",1,8,408,205,203
050,36,121,"New York","Wyoming County",1,9,434,221,213
050,36,121,"New York","Wyoming County",1,10,449,232,217
050,36,121,"New York","Wyoming County",1,11,457,228,229
050,36,121,"New York","Wyoming County",1,12,419,205,214
050,36,121,"New York","Wyoming County",1,13,453,230,223
050,36,121,"New York","Wyoming County",1,14,420,208,212
050,36,121,"New York","Wyoming County",1,15,458,229,229
050,36,121,"New York","Wyoming County",1,16,504,252,252
050,36,121,"New York","Wyoming County",1,17,489,240,249
050,36,121,"New York","Wyoming County",1,18,396,198,198
050,36,121,"New York","Wyoming County",1,19,323,178,145
050,36,121,"New York","Wyoming County",1,20,375,196,179
050,36,121,"New York","Wyoming County",1,21,403,231,172
050,36,121,"New York","Wyoming County",1,22,443,242,201
050,36,121,"New York","Wyoming County",1,23,452,255,197
050,36,121,"New York","Wyoming County",1,24,469,276,193
050,36,121,"New York","Wyoming County",1,25,494,297,197
050,36,121,"New York","Wyoming County",1,26,542,330,212
050,36,121,"New York","Wyoming County",1,27,571,347,224
050,36,121,"New York","Wyoming County",1,28,555,332,223
050,36,121,"New York","Wyoming County",1,29,547,325,222
050,36,121,"New York","Wyoming County",1,30,586,361,225
050,36,121,"New York","Wyoming County",1,31,545,344,201
050,36,121,"New York","Wyoming County",1,32,575,360,215
050,36,121,"New York","Wyoming County",1,33,569,328,241
050,36,121,"New York","Wyoming County",1,34,561,352,209
050,36,121,"New York","Wyoming County",1,35,558,333,225
050,36,121,"New York","Wyoming County",1,36,515,299,216
050,36,121,"New York","Wyoming County",1,37,524,310,214
050,36,121,"New York","Wyoming County",1,38,569,345,224
050,36,121,"New York","Wyoming County",1,39,555,346,209
050,36,121,"New York","Wyoming County",1,40,500,286,214
050,36,121,"New York","Wyoming County",1,41,500,293,207
050,36,121,"New York","Wyoming County",1,42,472,278,194
050,36,121,"New York","Wyoming County",1,43,461,277,184
050,36,121,"New York","Wyoming County",1,44,490,283,207
050,36,121,"New York","Wyoming County",1,45,499,292,207
050,36,121,"New York","Wyoming County",1,46,472,263,209
050,36,121,"New York","Wyoming County",1,47,513,295,218
050,36,121,"New York","Wyoming County",1,48,561,344,217
050,36,121,"New York","Wyoming County",1,49,584,332,252
050,36,121,"New York","Wyoming County",1,50,597,344,253
050,36,121,"New York","Wyoming County",1,51,564,327,237
050,36,121,"New York","Wyoming County",1,52,577,327,250
050,36,121,"New York","Wyoming County",1,53,585,303,282
050,36,121,"New York","Wyoming County",1,54,597,320,277
050,36,121,"New York","Wyoming County",1,55,639,337,302
050,36,121,"New York","Wyoming County",1,56,648,335,313
050,36,121,"New York","Wyoming County",1,57,617,313,304
050,36,121,"New York","Wyoming County",1,58,656,353,303
050,36,121,"New York","Wyoming County",1,59,636,351,285
050,36,121,"New York","Wyoming County",1,60,610,319,291
050,36,121,"New York","Wyoming County",1,61,590,311,279
050,36,121,"New York","Wyoming County",1,62,629,309,320
050,36,121,"New York","Wyoming County",1,63,621,306,315
050,36,121,"New York","Wyoming County",1,64,554,295,259
050,36,121,"New York","Wyoming County",1,65,549,300,249
050,36,121,"New York","Wyoming County",1,66,545,296,249
050,36,121,"New York","Wyoming County",1,67,537,286,251
050,36,121,"New York","Wyoming County",1,68,550,289,261
050,36,121,"New York","Wyoming County",1,69,483,252,231
050,36,121,"New York","Wyoming County",1,70,447,232,215
050,36,121,"New York","Wyoming County",1,71,422,214,208
050,36,121,"New York","Wyoming County",1,72,421,217,204
050,36,121,"New York","Wyoming County",1,73,430,218,212
050,36,121,"New York","Wyoming County",1,74,318,149,169
050,36,121,"New York","Wyoming County",1,75,301,141,160
050,36,121,"New York","Wyoming County",1,76,297,152,145
050,36,121,"New York","Wyoming County",1,77,289,150,139
050,36,121,"New York","Wyoming County",1,78,232,115,117
050,36,121,"New York","Wyoming County",1,79,205,93,112
050,36,121,"New York","Wyoming County",1,80,211,96,115
050,36,121,"New York","Wyoming County",1,81,178,80,98
050,36,121,"New York","Wyoming County",1,82,167,84,83
050,36,121,"New York","Wyoming County",1,83,148,62,86
050,36,121,"New York","Wyoming County",1,84,119,53,66
050,36,121,"New York","Wyoming County",1,85,792,273,519
050,36,121,"New York","Wyoming County",2,0,361,188,173
050,36,121,"New York","Wyoming County",2,1,351,177,174
050,36,121,"New York","Wyoming County",2,2,368,187,181
050,36,121,"New York","Wyoming County",2,3,375,185,190
050,36,121,"New York","Wyoming County",2,4,403,198,205
050,36,121,"New York","Wyoming County",2,5,409,203,206
050,36,121,"New York","Wyoming County",2,6,423,227,196
050,36,121,"New York","Wyoming County",2,7,409,216,193
050,36,121,"New York","Wyoming County",2,8,407,206,201
050,36,121,"New York","Wyoming County",2,9,424,215,209
050,36,121,"New York","Wyoming County",2,10,444,228,216
050,36,121,"New York","Wyoming County",2,11,452,225,227
050,36,121,"New York","Wyoming County",2,12,429,212,217
050,36,121,"New York","Wyoming County",2,13,442,222,220
050,36,121,"New York","Wyoming County",2,14,427,211,216
050,36,121,"New York","Wyoming County",2,15,449,224,225
050,36,121,"New York","Wyoming County",2,16,492,247,245
050,36,121,"New York","Wyoming County",2,17,486,240,246
050,36,121,"New York","Wyoming County",2,18,399,200,199
050,36,121,"New York","Wyoming County",2,19,321,173,148
050,36,121,"New York","Wyoming County",2,20,372,196,176
050,36,121,"New York","Wyoming County",2,21,392,222,170
050,36,121,"New York","Wyoming County",2,22,437,241,196
050,36,121,"New York","Wyoming County",2,23,455,255,200
050,36,121,"New York","Wyoming County",2,24,460,266,194
050,36,121,"New York","Wyoming County",2,25,488,290,198
050,36,121,"New York","Wyoming County",2,26,528,320,208
050,36,121,"New York","Wyoming County",2,27,559,338,221
050,36,121,"New York","Wyoming County",2,28,550,328,222
050,36,121,"New York","Wyoming County",2,29,545,320,225
050,36,121,"New York","Wyoming County",2,30,567,344,223
050,36,121,"New York","Wyoming County",2,31,542,335,207
050,36,121,"New York","Wyoming County",2,32,564,349,215
050,36,121,"New York","Wyoming County",2,33,558,325,233
050,36,121,"New York","Wyoming County",2,34,556,341,215
050,36,121,"New York","Wyoming County",2,35,555,329,226
050,36,121,"New York","Wyoming County",2,36,513,300,213
050,36,121,"New York","Wyoming County",2,37,521,305,216
050,36,121,"New York","Wyoming County",2,38,552,334,218
050,36,121,"New York","Wyoming County",2,39,549,339,210
050,36,121,"New York","Wyoming County",2,40,507,291,216
050,36,121,"New York","Wyoming County",2,41,493,286,207
050,36,121,"New York","Wyoming County",2,42,468,272,196
050,36,121,"New York","Wyoming County",2,43,464,276,188
050,36,121,"New York","Wyoming County",2,44,476,278,198
050,36,121,"New York","Wyoming County",2,45,487,280,207
050,36,121,"New York","Wyoming County",2,46,467,260,207
050,36,121,"New York","Wyoming County",2,47,499,284,215
050,36,121,"New York","Wyoming County",2,48,545,329,216
050,36,121,"New York","Wyoming County",2,49,576,330,246
050,36,121,"New York","Wyoming County",2,50,593,340,253
050,36,121,"New York","Wyoming County",2,51,565,325,240
050,36,121,"New York","Wyoming County",2,52,565,321,244
050,36,121,"New York","Wyoming County",2,53,582,307,275
050,36,121,"New York","Wyoming County",2,54,586,310,276
050,36,121,"New York","Wyoming County",2,55,623,329,294
050,36,121,"New York","Wyoming County",2,56,644,334,310
050,36,121,"New York","Wyoming County",2,57,619,313,306
050,36,121,"New York","Wyoming County",2,58,643,341,302
050,36,121,"New York","Wyoming County",2,59,636,346,290
050,36,121,"New York","Wyoming County",2,60,616,325,291
050,36,121,"New York","Wyoming County",2,61,586,310,276
050,36,121,"New York","Wyoming County",2,62,615,306,309
050,36,121,"New York","Wyoming County",2,63,628,309,319
050,36,121,"New York","Wyoming County",2,64,564,294,270
050,36,121,"New York","Wyoming County",2,65,543,292,251
050,36,121,"New York","Wyoming County",2,66,545,296,249
050,36,121,"New York","Wyoming County",2,67,536,286,250
050,36,121,"New York","Wyoming County",2,68,540,284,256
050,36,121,"New York","Wyoming County",2,69,499,261,238
050,36,121,"New York","Wyoming County",2,70,451,234,217
050,36,121,"New York","Wyoming County",2,71,426,219,207
050,36,121,"New York","Wyoming County",2,72,412,210,202
050,36,121,"New York","Wyoming County",2,73,445,226,219
050,36,121,"New York","Wyoming County",2,74,324,153,171
050,36,121,"New York","Wyoming County",2,75,300,140,160
050,36,121,"New York","Wyoming County",2,76,296,149,147
050,36,121,"New York","Wyoming County",2,77,294,151,143
050,36,121,"New York","Wyoming County",2,78,238,119,119
050,36,121,"New York","Wyoming County",2,79,209,97,112
050,36,121,"New York","Wyoming County",2,80,207,92,115
050,36,121,"New York","Wyoming County",2,81,183,82,101
050,36,121,"New York","Wyoming County",2,82,165,80,85
050,36,121,"New York","Wyoming County",2,83,146,65,81
050,36,121,"New York","Wyoming County",2,84,120,55,65
050,36,121,"New York","Wyoming County",2,85,799,279,520
050,36,121,"New York","Wyoming County",3,0,357,186,171
050,36,121,"New York","Wyoming County",3,1,373,199,174
050,36,121,"New York","Wyoming County",3,2,368,180,188
050,36,121,"New York","Wyoming County",3,3,385,194,191
050,36,121,"New York","Wyoming County",3,4,378,187,191
050,36,121,"New York","Wyoming County",3,5,395,185,210
050,36,121,"New York","Wyoming County",3,6,416,206,210
050,36,121,"New York","Wyoming County",3,7,408,220,188
050,36,121,"New York","Wyoming County",3,8,407,216,191
050,36,121,"New York","Wyoming County",3,9,408,205,203
050,36,121,"New York","Wyoming County",3,10,419,207,212
050,36,121,"New York","Wyoming County",3,11,441,232,209
050,36,121,"New York","Wyoming County",3,12,458,224,234
050,36,121,"New York","Wyoming County",3,13,433,215,218
050,36,121,"New York","Wyoming County",3,14,453,223,230
050,36,121,"New York","Wyoming County",3,15,417,207,210
050,36,121,"New York","Wyoming County",3,16,447,222,225
050,36,121,"New York","Wyoming County",3,17,482,243,239
050,36,121,"New York","Wyoming County",3,18,416,207,209
050,36,121,"New York","Wyoming County",3,19,324,164,160
050,36,121,"New York","Wyoming County",3,20,383,197,186
050,36,121,"New York","Wyoming County",3,21,376,204,172
050,36,121,"New York","Wyoming County",3,22,442,258,184
050,36,121,"New York","Wyoming County",3,23,480,272,208
050,36,121,"New York","Wyoming County",3,24,457,265,192
050,36,121,"New York","Wyoming County",3,25,481,276,205
050,36,121,"New York","Wyoming County",3,26,477,297,180
050,36,121,"New York","Wyoming County",3,27,536,318,218
050,36,121,"New York","Wyoming County",3,28,532,317,215
050,36,121,"New York","Wyoming County",3,29,536,315,221
050,36,121,"New York","Wyoming County",3,30,530,310,220
050,36,121,"New York","Wyoming County",3,31,565,335,230
050,36,121,"New York","Wyoming County",3,32,535,321,214
050,36,121,"New York","Wyoming County",3,33,537,317,220
050,36,121,"New York","Wyoming County",3,34,536,310,226
050,36,121,"New York","Wyoming County",3,35,533,307,226
050,36,121,"New York","Wyoming County",3,36,522,311,211
050,36,121,"New York","Wyoming County",3,37,519,301,218
050,36,121,"New York","Wyoming County",3,38,530,315,215
050,36,121,"New York","Wyoming County",3,39,552,326,226
050,36,121,"New York","Wyoming County",3,40,536,321,215
050,36,121,"New York","Wyoming County",3,41,520,299,221
050,36,121,"New York","Wyoming County",3,42,465,262,203
050,36,121,"New York","Wyoming County",3,43,468,276,192
050,36,121,"New York","Wyoming County",3,44,480,290,190
050,36,121,"New York","Wyoming County",3,45,450,258,192
050,36,121,"New York","Wyoming County",3,46,456,250,206
050,36,121,"New York","Wyoming County",3,47,474,268,206
050,36,121,"New York","Wyoming County",3,48,485,286,199
050,36,121,"New York","Wyoming County",3,49,529,303,226
050,36,121,"New York","Wyoming County",3,50,556,317,239
050,36,121,"New York","Wyoming County",3,51,589,332,257
050,36,121,"New York","Wyoming County",3,52,549,307,242
050,36,121,"New York","Wyoming County",3,53,563,314,249
050,36,121,"New York","Wyoming County",3,54,561,295,266
050,36,121,"New York","Wyoming County",3,55,587,315,272
050,36,121,"New York","Wyoming County",3,56,617,322,295
050,36,121,"New York","Wyoming County",3,57,626,319,307
050,36,121,"New York","Wyoming County",3,58,636,320,316
050,36,121,"New York","Wyoming County",3,59,624,324,300
050,36,121,"New York","Wyoming County",3,60,641,355,286
050,36,121,"New York","Wyoming County",3,61,611,323,288
050,36,121,"New York","Wyoming County",3,62,572,298,274
050,36,121,"New York","Wyoming County",3,63,612,309,303
050,36,121,"New York","Wyoming County",3,64,612,298,314
050,36,121,"New York","Wyoming County",3,65,556,289,267
050,36,121,"New York","Wyoming County",3,66,532,282,250
050,36,121,"New York","Wyoming County",3,67,539,287,252
050,36,121,"New York","Wyoming County",3,68,523,281,242
050,36,121,"New York","Wyoming County",3,69,519,266,253
050,36,121,"New York","Wyoming County",3,70,500,257,243
050,36,121,"New York","Wyoming County",3,71,438,232,206
050,36,121,"New York","Wyoming County",3,72,416,212,204
050,36,121,"New York","Wyoming County",3,73,399,203,196
050,36,121,"New York","Wyoming County",3,74,441,210,231
050,36,121,"New York","Wyoming County",3,75,294,135,159
050,36,121,"New York","Wyoming County",3,76,292,139,153
050,36,121,"New York","Wyoming County",3,77,274,138,136
050,36,121,"New York","Wyoming County",3,78,279,140,139
050,36,121,"New York","Wyoming County",3,79,232,120,112
050,36,121,"New York","Wyoming County",3,80,200,91,109
050,36,121,"New York","Wyoming County",3,81,200,87,113
050,36,121,"New York","Wyoming County",3,82,157,69,88
050,36,121,"New York","Wyoming County",3,83,157,70,87
050,36,121,"New York","Wyoming County",3,84,120,56,64
050,36,121,"New York","Wyoming County",3,85,796,284,512
050,36,121,"New York","Wyoming County",4,0,345,183,162
050,36,121,"New York","Wyoming County",4,1,373,193,180
050,36,121,"New York","Wyoming County",4,2,375,203,172
050,36,121,"New York","Wyoming County",4,3,379,185,194
050,36,121,"New York","Wyoming County",4,4,380,195,185
050,36,121,"New York","Wyoming County",4,5,389,192,197
050,36,121,"New York","Wyoming County",4,6,400,186,214
050,36,121,"New York","Wyoming County",4,7,421,209,212
050,36,121,"New York","Wyoming County",4,8,419,228,191
050,36,121,"New York","Wyoming County",4,9,408,211,197
050,36,121,"New York","Wyoming County",4,10,411,202,209
050,36,121,"New York","Wyoming County",4,11,409,211,198
050,36,121,"New York","Wyoming County",4,12,435,231,204
050,36,121,"New York","Wyoming County",4,13,448,227,221
050,36,121,"New York","Wyoming County",4,14,440,217,223
050,36,121,"New York","Wyoming County",4,15,444,219,225
050,36,121,"New York","Wyoming County",4,16,426,207,219
050,36,121,"New York","Wyoming County",4,17,448,226,222
050,36,121,"New York","Wyoming County",4,18,415,212,203
050,36,121,"New York","Wyoming County",4,19,331,171,160
050,36,121,"New York","Wyoming County",4,20,360,177,183
050,36,121,"New York","Wyoming County",4,21,377,193,184
050,36,121,"New York","Wyoming County",4,22,426,236,190
050,36,121,"New York","Wyoming County",4,23,468,284,184
050,36,121,"New York","Wyoming County",4,24,469,272,197
050,36,121,"New York","Wyoming County",4,25,451,276,175
050,36,121,"New York","Wyoming County",4,26,500,304,196
050,36,121,"New York","Wyoming County",4,27,470,290,180
050,36,121,"New York","Wyoming County",4,28,521,301,220
050,36,121,"New York","Wyoming County",4,29,532,319,213
050,36,121,"New York","Wyoming County",4,30,537,315,222
050,36,121,"New York","Wyoming County",4,31,538,309,229
050,36,121,"New York","Wyoming County",4,32,563,332,231
050,36,121,"New York","Wyoming County",4,33,519,301,218
050,36,121,"New York","Wyoming County",4,34,523,309,214
050,36,121,"New York","Wyoming County",4,35,534,294,240
050,36,121,"New York","Wyoming County",4,36,508,301,207
050,36,121,"New York","Wyoming County",4,37,515,311,204
050,36,121,"New York","Wyoming County",4,38,524,302,222
050,36,121,"New York","Wyoming County",4,39,521,308,213
050,36,121,"New York","Wyoming County",4,40,516,299,217
050,36,121,"New York","Wyoming County",4,41,555,334,221
050,36,121,"New York","Wyoming County",4,42,506,282,224
050,36,121,"New York","Wyoming County",4,43,474,274,200
050,36,121,"New York","Wyoming County",4,44,484,293,191
050,36,121,"New York","Wyoming County",4,45,478,279,199
050,36,121,"New York","Wyoming County",4,46,436,246,190
050,36,121,"New York","Wyoming County",4,47,447,248,199
050,36,121,"New York","Wyoming County",4,48,458,261,197
050,36,121,"New York","Wyoming County",4,49,466,262,204
050,36,121,"New York","Wyoming County",4,50,523,299,224
050,36,121,"New York","Wyoming County",4,51,553,317,236
050,36,121,"New York","Wyoming County",4,52,579,333,246
050,36,121,"New York","Wyoming County",4,53,547,297,250
050,36,121,"New York","Wyoming County",4,54,552,305,247
050,36,121,"New York","Wyoming County",4,55,554,292,262
050,36,121,"New York","Wyoming County",4,56,587,299,288
050,36,121,"New York","Wyoming County",4,57,607,308,299
050,36,121,"New York","Wyoming County",4,58,625,323,302
050,36,121,"New York","Wyoming County",4,59,612,303,309
050,36,121,"New York","Wyoming County",4,60,619,329,290
050,36,121,"New York","Wyoming County",4,61,642,356,286
050,36,121,"New York","Wyoming County",4,62,591,306,285
050,36,121,"New York","Wyoming County",4,63,569,300,269
050,36,121,"New York","Wyoming County",4,64,595,294,301
050,36,121,"New York","Wyoming County",4,65,597,288,309
050,36,121,"New York","Wyoming County",4,66,547,290,257
050,36,121,"New York","Wyoming County",4,67,532,279,253
050,36,121,"New York","Wyoming County",4,68,532,287,245
050,36,121,"New York","Wyoming County",4,69,487,259,228
050,36,121,"New York","Wyoming County",4,70,506,256,250
050,36,121,"New York","Wyoming County",4,71,492,255,237
050,36,121,"New York","Wyoming County",4,72,426,227,199
050,36,121,"New York","Wyoming County",4,73,406,205,201
050,36,121,"New York","Wyoming County",4,74,391,189,202
050,36,121,"New York","Wyoming County",4,75,414,200,214
050,36,121,"New York","Wyoming County",4,76,283,128,155
050,36,121,"New York","Wyoming County",4,77,270,130,140
050,36,121,"New York","Wyoming County",4,78,260,132,128
050,36,121,"New York","Wyoming County",4,79,269,133,136
050,36,121,"New York","Wyoming County",4,80,218,112,106
050,36,121,"New York","Wyoming County",4,81,191,81,110
050,36,121,"New York","Wyoming County",4,82,178,77,101
050,36,121,"New York","Wyoming County",4,83,146,57,89
050,36,121,"New York","Wyoming County",4,84,135,64,71
050,36,121,"New York","Wyoming County",4,85,794,292,502
050,36,121,"New York","Wyoming County",5,0,345,183,162
050,36,121,"New York","Wyoming County",5,1,344,182,162
050,36,121,"New York","Wyoming County",5,2,382,204,178
050,36,121,"New York","Wyoming County",5,3,376,200,176
050,36,121,"New York","Wyoming County",5,4,378,192,186
050,36,121,"New York","Wyoming County",5,5,394,203,191
050,36,121,"New York","Wyoming County",5,6,382,193,189
050,36,121,"New York","Wyoming County",5,7,409,193,216
050,36,121,"New York","Wyoming County",5,8,414,203,211
050,36,121,"New York","Wyoming County",5,9,416,219,197
050,36,121,"New York","Wyoming County",5,10,403,207,196
050,36,121,"New York","Wyoming County",5,11,409,200,209
050,36,121,"New York","Wyoming County",5,12,409,209,200
050,36,121,"New York","Wyoming County",5,13,432,223,209
050,36,121,"New York","Wyoming County",5,14,449,225,224
050,36,121,"New York","Wyoming County",5,15,431,216,215
050,36,121,"New York","Wyoming County",5,16,453,222,231
050,36,121,"New York","Wyoming County",5,17,425,206,219
050,36,121,"New York","Wyoming County",5,18,381,197,184
050,36,121,"New York","Wyoming County",5,19,331,171,160
050,36,121,"New York","Wyoming County",5,20,378,188,190
050,36,121,"New York","Wyoming County",5,21,368,193,175
050,36,121,"New York","Wyoming County",5,22,431,231,200
050,36,121,"New York","Wyoming County",5,23,456,269,187
050,36,121,"New York","Wyoming County",5,24,486,294,192
050,36,121,"New York","Wyoming County",5,25,483,290,193
050,36,121,"New York","Wyoming County",5,26,455,279,176
050,36,121,"New York","Wyoming County",5,27,501,308,193
050,36,121,"New York","Wyoming County",5,28,466,286,180
050,36,121,"New York","Wyoming County",5,29,531,309,222
050,36,121,"New York","Wyoming County",5,30,531,327,204
050,36,121,"New York","Wyoming County",5,31,532,310,222
050,36,121,"New York","Wyoming County",5,32,551,311,240
050,36,121,"New York","Wyoming County",5,33,566,343,223
050,36,121,"New York","Wyoming County",5,34,523,307,216
050,36,121,"New York","Wyoming County",5,35,520,295,225
050,36,121,"New York","Wyoming County",5,36,519,293,226
050,36,121,"New York","Wyoming County",5,37,516,306,210
050,36,121,"New York","Wyoming County",5,38,511,315,196
050,36,121,"New York","Wyoming County",5,39,532,311,221
050,36,121,"New York","Wyoming County",5,40,512,298,214
050,36,121,"New York","Wyoming County",5,41,538,318,220
050,36,121,"New York","Wyoming County",5,42,550,328,222
050,36,121,"New York","Wyoming County",5,43,506,288,218
050,36,121,"New York","Wyoming County",5,44,484,286,198
050,36,121,"New York","Wyoming County",5,45,476,286,190
050,36,121,"New York","Wyoming County",5,46,466,274,192
050,36,121,"New York","Wyoming County",5,47,449,250,199
050,36,121,"New York","Wyoming County",5,48,448,256,192
050,36,121,"New York","Wyoming County",5,49,446,245,201
050,36,121,"New York","Wyoming County",5,50,459,266,193
050,36,121,"New York","Wyoming County",5,51,522,300,222
050,36,121,"New York","Wyoming County",5,52,551,318,233
050,36,121,"New York","Wyoming County",5,53,583,325,258
050,36,121,"New York","Wyoming County",5,54,539,290,249
050,36,121,"New York","Wyoming County",5,55,550,312,238
050,36,121,"New York","Wyoming County",5,56,539,283,256
050,36,121,"New York","Wyoming County",5,57,564,273,291
050,36,121,"New York","Wyoming County",5,58,606,314,292
050,36,121,"New York","Wyoming County",5,59,602,312,290
050,36,121,"New York","Wyoming County",5,60,608,305,303
050,36,121,"New York","Wyoming County",5,61,613,329,284
050,36,121,"New York","Wyoming County",5,62,627,341,286
050,36,121,"New York","Wyoming County",5,63,592,306,286
050,36,121,"New York","Wyoming County",5,64,558,291,267
050,36,121,"New York","Wyoming County",5,65,584,290,294
050,36,121,"New York","Wyoming County",5,66,593,280,313
050,36,121,"New York","Wyoming County",5,67,539,280,259
050,36,121,"New York","Wyoming County",5,68,519,275,244
050,36,121,"New York","Wyoming County",5,69,514,271,243
050,36,121,"New York","Wyoming County",5,70,493,254,239
050,36,121,"New York","Wyoming County",5,71,490,251,239
050,36,121,"New York","Wyoming County",5,72,478,247,231
050,36,121,"New York","Wyoming County",5,73,424,225,199
050,36,121,"New York","Wyoming County",5,74,400,195,205
050,36,121,"New York","Wyoming County",5,75,364,174,190
050,36,121,"New York","Wyoming County",5,76,397,190,207
050,36,121,"New York","Wyoming County",5,77,272,122,150
050,36,121,"New York","Wyoming County",5,78,258,123,135
050,36,121,"New York","Wyoming County",5,79,249,123,126
050,36,121,"New York","Wyoming County",5,80,258,125,133
050,36,121,"New York","Wyoming County",5,81,202,99,103
050,36,121,"New York","Wyoming County",5,82,169,72,97
050,36,121,"New York","Wyoming County",5,83,167,68,99
050,36,121,"New York","Wyoming County",5,84,124,54,70
050,36,121,"New York","Wyoming County",5,85,831,324,507
050,36,123,"New York","Yates County",1,0,327,168,159
050,36,123,"New York","Yates County",1,1,329,173,156
050,36,123,"New York","Yates County",1,2,323,168,155
050,36,123,"New York","Yates County",1,3,315,170,145
050,36,123,"New York","Yates County",1,4,297,150,147
050,36,123,"New York","Yates County",1,5,281,142,139
050,36,123,"New York","Yates County",1,6,294,154,140
050,36,123,"New York","Yates County",1,7,315,154,161
050,36,123,"New York","Yates County",1,8,326,156,170
050,36,123,"New York","Yates County",1,9,305,161,144
050,36,123,"New York","Yates County",1,10,318,163,155
050,36,123,"New York","Yates County",1,11,326,183,143
050,36,123,"New York","Yates County",1,12,300,149,151
050,36,123,"New York","Yates County",1,13,300,134,166
050,36,123,"New York","Yates County",1,14,310,157,153
050,36,123,"New York","Yates County",1,15,289,134,155
050,36,123,"New York","Yates County",1,16,319,155,164
050,36,123,"New York","Yates County",1,17,331,145,186
050,36,123,"New York","Yates County",1,18,379,179,200
050,36,123,"New York","Yates County",1,19,407,179,228
050,36,123,"New York","Yates County",1,20,416,183,233
050,36,123,"New York","Yates County",1,21,418,182,236
050,36,123,"New York","Yates County",1,22,378,179,199
050,36,123,"New York","Yates County",1,23,307,156,151
050,36,123,"New York","Yates County",1,24,304,152,152
050,36,123,"New York","Yates County",1,25,278,136,142
050,36,123,"New York","Yates County",1,26,285,135,150
050,36,123,"New York","Yates County",1,27,281,132,149
050,36,123,"New York","Yates County",1,28,279,135,144
050,36,123,"New York","Yates County",1,29,278,135,143
050,36,123,"New York","Yates County",1,30,251,123,128
050,36,123,"New York","Yates County",1,31,245,147,98
050,36,123,"New York","Yates County",1,32,257,139,118
050,36,123,"New York","Yates County",1,33,232,114,118
050,36,123,"New York","Yates County",1,34,258,130,128
050,36,123,"New York","Yates County",1,35,266,134,132
050,36,123,"New York","Yates County",1,36,252,134,118
050,36,123,"New York","Yates County",1,37,242,118,124
050,36,123,"New York","Yates County",1,38,259,132,127
050,36,123,"New York","Yates County",1,39,244,126,118
050,36,123,"New York","Yates County",1,40,236,119,117
050,36,123,"New York","Yates County",1,41,236,115,121
050,36,123,"New York","Yates County",1,42,230,113,117
050,36,123,"New York","Yates County",1,43,238,118,120
050,36,123,"New York","Yates County",1,44,223,110,113
050,36,123,"New York","Yates County",1,45,222,114,108
050,36,123,"New York","Yates County",1,46,214,107,107
050,36,123,"New York","Yates County",1,47,244,114,130
050,36,123,"New York","Yates County",1,48,250,129,121
050,36,123,"New York","Yates County",1,49,280,146,134
050,36,123,"New York","Yates County",1,50,275,134,141
050,36,123,"New York","Yates County",1,51,269,140,129
050,36,123,"New York","Yates County",1,52,252,134,118
050,36,123,"New York","Yates County",1,53,276,141,135
050,36,123,"New York","Yates County",1,54,293,148,145
050,36,123,"New York","Yates County",1,55,332,170,162
050,36,123,"New York","Yates County",1,56,351,174,177
050,36,123,"New York","Yates County",1,57,359,162,197
050,36,123,"New York","Yates County",1,58,364,159,205
050,36,123,"New York","Yates County",1,59,378,177,201
050,36,123,"New York","Yates County",1,60,356,170,186
050,36,123,"New York","Yates County",1,61,394,196,198
050,36,123,"New York","Yates County",1,62,395,201,194
050,36,123,"New York","Yates County",1,63,382,186,196
050,36,123,"New York","Yates County",1,64,385,180,205
050,36,123,"New York","Yates County",1,65,389,193,196
050,36,123,"New York","Yates County",1,66,361,168,193
050,36,123,"New York","Yates County",1,67,352,172,180
050,36,123,"New York","Yates County",1,68,331,157,174
050,36,123,"New York","Yates County",1,69,320,158,162
050,36,123,"New York","Yates County",1,70,319,152,167
050,36,123,"New York","Yates County",1,71,304,154,150
050,36,123,"New York","Yates County",1,72,299,159,140
050,36,123,"New York","Yates County",1,73,318,176,142
050,36,123,"New York","Yates County",1,74,218,118,100
050,36,123,"New York","Yates County",1,75,208,106,102
050,36,123,"New York","Yates County",1,76,189,94,95
050,36,123,"New York","Yates County",1,77,200,96,104
050,36,123,"New York","Yates County",1,78,159,81,78
050,36,123,"New York","Yates County",1,79,140,65,75
050,36,123,"New York","Yates County",1,80,127,61,66
050,36,123,"New York","Yates County",1,81,122,57,65
050,36,123,"New York","Yates County",1,82,123,48,75
050,36,123,"New York","Yates County",1,83,95,44,51
050,36,123,"New York","Yates County",1,84,90,40,50
050,36,123,"New York","Yates County",1,85,550,199,351
050,36,123,"New York","Yates County",2,0,316,168,148
050,36,123,"New York","Yates County",2,1,326,170,156
050,36,123,"New York","Yates County",2,2,323,168,155
050,36,123,"New York","Yates County",2,3,314,168,146
050,36,123,"New York","Yates County",2,4,303,155,148
050,36,123,"New York","Yates County",2,5,284,143,141
050,36,123,"New York","Yates County",2,6,291,150,141
050,36,123,"New York","Yates County",2,7,309,154,155
050,36,123,"New York","Yates County",2,8,322,154,168
050,36,123,"New York","Yates County",2,9,308,160,148
050,36,123,"New York","Yates County",2,10,314,163,151
050,36,123,"New York","Yates County",2,11,320,177,143
050,36,123,"New York","Yates County",2,12,309,159,150
050,36,123,"New York","Yates County",2,13,303,138,165
050,36,123,"New York","Yates County",2,14,308,151,157
050,36,123,"New York","Yates County",2,15,296,140,156
050,36,123,"New York","Yates County",2,16,312,151,161
050,36,123,"New York","Yates County",2,17,328,147,181
050,36,123,"New York","Yates County",2,18,375,171,204
050,36,123,"New York","Yates County",2,19,404,176,228
050,36,123,"New York","Yates County",2,20,411,182,229
050,36,123,"New York","Yates County",2,21,418,183,235
050,36,123,"New York","Yates County",2,22,373,179,194
050,36,123,"New York","Yates County",2,23,313,157,156
050,36,123,"New York","Yates County",2,24,302,152,150
050,36,123,"New York","Yates County",2,25,284,140,144
050,36,123,"New York","Yates County",2,26,280,133,147
050,36,123,"New York","Yates County",2,27,280,131,149
050,36,123,"New York","Yates County",2,28,277,134,143
050,36,123,"New York","Yates County",2,29,279,134,145
050,36,123,"New York","Yates County",2,30,259,128,131
050,36,123,"New York","Yates County",2,31,246,141,105
050,36,123,"New York","Yates County",2,32,253,139,114
050,36,123,"New York","Yates County",2,33,235,119,116
050,36,123,"New York","Yates County",2,34,254,128,126
050,36,123,"New York","Yates County",2,35,263,132,131
050,36,123,"New York","Yates County",2,36,255,135,120
050,36,123,"New York","Yates County",2,37,246,123,123
050,36,123,"New York","Yates County",2,38,255,130,125
050,36,123,"New York","Yates County",2,39,247,127,120
050,36,123,"New York","Yates County",2,40,240,121,119
050,36,123,"New York","Yates County",2,41,235,116,119
050,36,123,"New York","Yates County",2,42,229,112,117
050,36,123,"New York","Yates County",2,43,238,117,121
050,36,123,"New York","Yates County",2,44,224,110,114
050,36,123,"New York","Yates County",2,45,222,113,109
050,36,123,"New York","Yates County",2,46,214,109,105
050,36,123,"New York","Yates County",2,47,237,112,125
050,36,123,"New York","Yates County",2,48,246,125,121
050,36,123,"New York","Yates County",2,49,273,142,131
050,36,123,"New York","Yates County",2,50,275,136,139
050,36,123,"New York","Yates County",2,51,271,140,131
050,36,123,"New York","Yates County",2,52,259,137,122
050,36,123,"New York","Yates County",2,53,269,139,130
050,36,123,"New York","Yates County",2,54,289,147,142
050,36,123,"New York","Yates County",2,55,326,167,159
050,36,123,"New York","Yates County",2,56,348,175,173
050,36,123,"New York","Yates County",2,57,356,165,191
050,36,123,"New York","Yates County",2,58,360,158,202
050,36,123,"New York","Yates County",2,59,376,174,202
050,36,123,"New York","Yates County",2,60,359,171,188
050,36,123,"New York","Yates County",2,61,386,190,196
050,36,123,"New York","Yates County",2,62,390,197,193
050,36,123,"New York","Yates County",2,63,386,189,197
050,36,123,"New York","Yates County",2,64,381,182,199
050,36,123,"New York","Yates County",2,65,387,189,198
050,36,123,"New York","Yates County",2,66,366,173,193
050,36,123,"New York","Yates County",2,67,350,168,182
050,36,123,"New York","Yates County",2,68,332,160,172
050,36,123,"New York","Yates County",2,69,324,157,167
050,36,123,"New York","Yates County",2,70,314,152,162
050,36,123,"New York","Yates County",2,71,308,154,154
050,36,123,"New York","Yates County",2,72,293,154,139
050,36,123,"New York","Yates County",2,73,331,181,150
050,36,123,"New York","Yates County",2,74,226,124,102
050,36,123,"New York","Yates County",2,75,211,108,103
050,36,123,"New York","Yates County",2,76,191,95,96
050,36,123,"New York","Yates County",2,77,203,99,104
050,36,123,"New York","Yates County",2,78,161,81,80
050,36,123,"New York","Yates County",2,79,141,66,75
050,36,123,"New York","Yates County",2,80,127,61,66
050,36,123,"New York","Yates County",2,81,120,56,64
050,36,123,"New York","Yates County",2,82,121,48,73
050,36,123,"New York","Yates County",2,83,99,45,54
050,36,123,"New York","Yates County",2,84,90,40,50
050,36,123,"New York","Yates County",2,85,543,201,342
050,36,123,"New York","Yates County",3,0,342,169,173
050,36,123,"New York","Yates County",3,1,318,176,142
050,36,123,"New York","Yates County",3,2,322,172,150
050,36,123,"New York","Yates County",3,3,306,162,144
050,36,123,"New York","Yates County",3,4,318,166,152
050,36,123,"New York","Yates County",3,5,296,152,144
050,36,123,"New York","Yates County",3,6,279,143,136
050,36,123,"New York","Yates County",3,7,283,139,144
050,36,123,"New York","Yates County",3,8,316,154,162
050,36,123,"New York","Yates County",3,9,322,150,172
050,36,123,"New York","Yates County",3,10,306,157,149
050,36,123,"New York","Yates County",3,11,308,159,149
050,36,123,"New York","Yates County",3,12,318,175,143
050,36,123,"New York","Yates County",3,13,312,159,153
050,36,123,"New York","Yates County",3,14,309,138,171
050,36,123,"New York","Yates County",3,15,306,144,162
050,36,123,"New York","Yates County",3,16,288,136,152
050,36,123,"New York","Yates County",3,17,320,147,173
050,36,123,"New York","Yates County",3,18,365,162,203
050,36,123,"New York","Yates County",3,19,385,161,224
050,36,123,"New York","Yates County",3,20,383,169,214
050,36,123,"New York","Yates County",3,21,406,187,219
050,36,123,"New York","Yates County",3,22,353,178,175
050,36,123,"New York","Yates County",3,23,313,159,154
050,36,123,"New York","Yates County",3,24,284,144,140
050,36,123,"New York","Yates County",3,25,290,151,139
050,36,123,"New York","Yates County",3,26,260,131,129
050,36,123,"New York","Yates County",3,27,272,126,146
050,36,123,"New York","Yates County",3,28,261,127,134
050,36,123,"New York","Yates County",3,29,276,133,143
050,36,123,"New York","Yates County",3,30,288,139,149
050,36,123,"New York","Yates County",3,31,260,130,130
050,36,123,"New York","Yates County",3,32,244,132,112
050,36,123,"New York","Yates County",3,33,241,133,108
050,36,123,"New York","Yates County",3,34,246,126,120
050,36,123,"New York","Yates County",3,35,250,124,126
050,36,123,"New York","Yates County",3,36,264,138,126
050,36,123,"New York","Yates County",3,37,256,131,125
050,36,123,"New York","Yates County",3,38,249,125,124
050,36,123,"New York","Yates County",3,39,265,137,128
050,36,123,"New York","Yates County",3,40,249,128,121
050,36,123,"New York","Yates County",3,41,237,119,118
050,36,123,"New York","Yates County",3,42,239,117,122
050,36,123,"New York","Yates County",3,43,227,113,114
050,36,123,"New York","Yates County",3,44,243,117,126
050,36,123,"New York","Yates County",3,45,226,109,117
050,36,123,"New York","Yates County",3,46,222,110,112
050,36,123,"New York","Yates County",3,47,227,112,115
050,36,123,"New York","Yates County",3,48,224,109,115
050,36,123,"New York","Yates County",3,49,251,124,127
050,36,123,"New York","Yates County",3,50,290,146,144
050,36,123,"New York","Yates County",3,51,267,135,132
050,36,123,"New York","Yates County",3,52,275,143,132
050,36,123,"New York","Yates County",3,53,257,133,124
050,36,123,"New York","Yates County",3,54,272,138,134
050,36,123,"New York","Yates County",3,55,292,149,143
050,36,123,"New York","Yates County",3,56,328,170,158
050,36,123,"New York","Yates County",3,57,353,177,176
050,36,123,"New York","Yates County",3,58,370,172,198
050,36,123,"New York","Yates County",3,59,376,168,208
050,36,123,"New York","Yates County",3,60,379,173,206
050,36,123,"New York","Yates County",3,61,376,180,196
050,36,123,"New York","Yates County",3,62,381,189,192
050,36,123,"New York","Yates County",3,63,386,192,194
050,36,123,"New York","Yates County",3,64,403,195,208
050,36,123,"New York","Yates County",3,65,379,180,199
050,36,123,"New York","Yates County",3,66,384,194,190
050,36,123,"New York","Yates County",3,67,359,171,188
050,36,123,"New York","Yates County",3,68,341,166,175
050,36,123,"New York","Yates County",3,69,330,154,176
050,36,123,"New York","Yates County",3,70,310,152,158
050,36,123,"New York","Yates County",3,71,309,152,157
050,36,123,"New York","Yates County",3,72,296,149,147
050,36,123,"New York","Yates County",3,73,290,156,134
050,36,123,"New York","Yates County",3,74,316,175,141
050,36,123,"New York","Yates County",3,75,212,113,99
050,36,123,"New York","Yates County",3,76,203,98,105
050,36,123,"New York","Yates County",3,77,182,89,93
050,36,123,"New York","Yates County",3,78,186,97,89
050,36,123,"New York","Yates County",3,79,147,73,74
050,36,123,"New York","Yates County",3,80,131,61,70
050,36,123,"New York","Yates County",3,81,117,54,63
050,36,123,"New York","Yates County",3,82,115,50,65
050,36,123,"New York","Yates County",3,83,100,41,59
050,36,123,"New York","Yates County",3,84,94,41,53
050,36,123,"New York","Yates County",3,85,507,199,308
050,36,123,"New York","Yates County",4,0,341,174,167
050,36,123,"New York","Yates County",4,1,354,187,167
050,36,123,"New York","Yates County",4,2,311,163,148
050,36,123,"New York","Yates County",4,3,330,169,161
050,36,123,"New York","Yates County",4,4,308,161,147
050,36,123,"New York","Yates County",4,5,325,171,154
050,36,123,"New York","Yates County",4,6,288,150,138
050,36,123,"New York","Yates County",4,7,284,143,141
050,36,123,"New York","Yates County",4,8,279,139,140
050,36,123,"New York","Yates County",4,9,307,149,158
050,36,123,"New York","Yates County",4,10,319,149,170
050,36,123,"New York","Yates County",4,11,295,153,142
050,36,123,"New York","Yates County",4,12,301,157,144
050,36,123,"New York","Yates County",4,13,308,168,140
050,36,123,"New York","Yates County",4,14,315,156,159
050,36,123,"New York","Yates County",4,15,303,133,170
050,36,123,"New York","Yates County",4,16,299,142,157
050,36,123,"New York","Yates County",4,17,300,131,169
050,36,123,"New York","Yates County",4,18,348,155,193
050,36,123,"New York","Yates County",4,19,353,142,211
050,36,123,"New York","Yates County",4,20,343,137,206
050,36,123,"New York","Yates County",4,21,368,171,197
050,36,123,"New York","Yates County",4,22,350,183,167
050,36,123,"New York","Yates County",4,23,298,156,142
050,36,123,"New York","Yates County",4,24,287,151,136
050,36,123,"New York","Yates County",4,25,283,144,139
050,36,123,"New York","Yates County",4,26,270,136,134
050,36,123,"New York","Yates County",4,27,267,135,132
050,36,123,"New York","Yates County",4,28,271,132,139
050,36,123,"New York","Yates County",4,29,272,133,139
050,36,123,"New York","Yates County",4,30,277,133,144
050,36,123,"New York","Yates County",4,31,274,132,142
050,36,123,"New York","Yates County",4,32,266,133,133
050,36,123,"New York","Yates County",4,33,236,129,107
050,36,123,"New York","Yates County",4,34,247,143,104
050,36,123,"New York","Yates County",4,35,238,124,114
050,36,123,"New York","Yates County",4,36,258,132,126
050,36,123,"New York","Yates County",4,37,268,135,133
050,36,123,"New York","Yates County",4,38,257,133,124
050,36,123,"New York","Yates County",4,39,251,130,121
050,36,123,"New York","Yates County",4,40,255,128,127
050,36,123,"New York","Yates County",4,41,254,132,122
050,36,123,"New York","Yates County",4,42,235,119,116
050,36,123,"New York","Yates County",4,43,246,119,127
050,36,123,"New York","Yates County",4,44,225,115,110
050,36,123,"New York","Yates County",4,45,230,109,121
050,36,123,"New York","Yates County",4,46,219,111,108
050,36,123,"New York","Yates County",4,47,236,117,119
050,36,123,"New York","Yates County",4,48,217,109,108
050,36,123,"New York","Yates County",4,49,220,107,113
050,36,123,"New York","Yates County",4,50,250,122,128
050,36,123,"New York","Yates County",4,51,294,147,147
050,36,123,"New York","Yates County",4,52,270,133,137
050,36,123,"New York","Yates County",4,53,270,136,134
050,36,123,"New York","Yates County",4,54,250,127,123
050,36,123,"New York","Yates County",4,55,269,136,133
050,36,123,"New York","Yates County",4,56,294,150,144
050,36,123,"New York","Yates County",4,57,322,171,151
050,36,123,"New York","Yates County",4,58,353,176,177
050,36,123,"New York","Yates County",4,59,367,170,197
050,36,123,"New York","Yates County",4,60,371,167,204
050,36,123,"New York","Yates County",4,61,389,178,211
050,36,123,"New York","Yates County",4,62,371,177,194
050,36,123,"New York","Yates County",4,63,384,186,198
050,36,123,"New York","Yates County",4,64,380,194,186
050,36,123,"New York","Yates County",4,65,393,187,206
050,36,123,"New York","Yates County",4,66,371,174,197
050,36,123,"New York","Yates County",4,67,381,196,185
050,36,123,"New York","Yates County",4,68,351,164,187
050,36,123,"New York","Yates County",4,69,344,165,179
050,36,123,"New York","Yates County",4,70,329,156,173
050,36,123,"New York","Yates County",4,71,302,152,150
050,36,123,"New York","Yates County",4,72,293,143,150
050,36,123,"New York","Yates County",4,73,302,152,150
050,36,123,"New York","Yates County",4,74,275,150,125
050,36,123,"New York","Yates County",4,75,301,168,133
050,36,123,"New York","Yates County",4,76,201,106,95
050,36,123,"New York","Yates County",4,77,195,95,100
050,36,123,"New York","Yates County",4,78,175,88,87
050,36,123,"New York","Yates County",4,79,173,89,84
050,36,123,"New York","Yates County",4,80,144,74,70
050,36,123,"New York","Yates County",4,81,123,55,68
050,36,123,"New York","Yates County",4,82,118,51,67
050,36,123,"New York","Yates County",4,83,98,43,55
050,36,123,"New York","Yates County",4,84,101,38,63
050,36,123,"New York","Yates County",4,85,512,203,309
050,36,123,"New York","Yates County",5,0,343,175,168
050,36,123,"New York","Yates County",5,1,347,177,170
050,36,123,"New York","Yates County",5,2,346,176,170
050,36,123,"New York","Yates County",5,3,302,158,144
050,36,123,"New York","Yates County",5,4,332,170,162
050,36,123,"New York","Yates County",5,5,304,159,145
050,36,123,"New York","Yates County",5,6,318,166,152
050,36,123,"New York","Yates County",5,7,290,147,143
050,36,123,"New York","Yates County",5,8,281,145,136
050,36,123,"New York","Yates County",5,9,269,137,132
050,36,123,"New York","Yates County",5,10,295,142,153
050,36,123,"New York","Yates County",5,11,314,147,167
050,36,123,"New York","Yates County",5,12,291,150,141
050,36,123,"New York","Yates County",5,13,303,159,144
050,36,123,"New York","Yates County",5,14,300,161,139
050,36,123,"New York","Yates County",5,15,317,160,157
050,36,123,"New York","Yates County",5,16,297,140,157
050,36,123,"New York","Yates County",5,17,309,141,168
050,36,123,"New York","Yates County",5,18,337,148,189
050,36,123,"New York","Yates County",5,19,355,142,213
050,36,123,"New York","Yates County",5,20,343,132,211
050,36,123,"New York","Yates County",5,21,361,153,208
050,36,123,"New York","Yates County",5,22,329,169,160
050,36,123,"New York","Yates County",5,23,303,161,142
050,36,123,"New York","Yates County",5,24,288,150,138
050,36,123,"New York","Yates County",5,25,267,148,119
050,36,123,"New York","Yates County",5,26,268,146,122
050,36,123,"New York","Yates County",5,27,258,125,133
050,36,123,"New York","Yates County",5,28,272,141,131
050,36,123,"New York","Yates County",5,29,273,134,139
050,36,123,"New York","Yates County",5,30,287,137,150
050,36,123,"New York","Yates County",5,31,268,135,133
050,36,123,"New York","Yates County",5,32,280,129,151
050,36,123,"New York","Yates County",5,33,256,125,131
050,36,123,"New York","Yates County",5,34,238,135,103
050,36,123,"New York","Yates County",5,35,231,125,106
050,36,123,"New York","Yates County",5,36,243,128,115
050,36,123,"New York","Yates County",5,37,254,132,122
050,36,123,"New York","Yates County",5,38,254,133,121
050,36,123,"New York","Yates County",5,39,250,124,126
050,36,123,"New York","Yates County",5,40,248,124,124
050,36,123,"New York","Yates County",5,41,252,129,123
050,36,123,"New York","Yates County",5,42,255,131,124
050,36,123,"New York","Yates County",5,43,242,124,118
050,36,123,"New York","Yates County",5,44,235,112,123
050,36,123,"New York","Yates County",5,45,226,114,112
050,36,123,"New York","Yates County",5,46,231,114,117
050,36,123,"New York","Yates County",5,47,224,110,114
050,36,123,"New York","Yates County",5,48,221,113,108
050,36,123,"New York","Yates County",5,49,225,114,111
050,36,123,"New York","Yates County",5,50,218,99,119
050,36,123,"New York","Yates County",5,51,246,120,126
050,36,123,"New York","Yates County",5,52,292,145,147
050,36,123,"New York","Yates County",5,53,270,130,140
050,36,123,"New York","Yates County",5,54,271,135,136
050,36,123,"New York","Yates County",5,55,257,131,126
050,36,123,"New York","Yates County",5,56,287,143,144
050,36,123,"New York","Yates County",5,57,290,145,145
050,36,123,"New York","Yates County",5,58,319,170,149
050,36,123,"New York","Yates County",5,59,360,179,181
050,36,123,"New York","Yates County",5,60,355,162,193
050,36,123,"New York","Yates County",5,61,375,165,210
050,36,123,"New York","Yates County",5,62,382,173,209
050,36,123,"New York","Yates County",5,63,381,184,197
050,36,123,"New York","Yates County",5,64,386,192,194
050,36,123,"New York","Yates County",5,65,375,195,180
050,36,123,"New York","Yates County",5,66,383,181,202
050,36,123,"New York","Yates County",5,67,370,174,196
050,36,123,"New York","Yates County",5,68,380,199,181
050,36,123,"New York","Yates County",5,69,352,160,192
050,36,123,"New York","Yates County",5,70,339,162,177
050,36,123,"New York","Yates County",5,71,314,151,163
050,36,123,"New York","Yates County",5,72,296,147,149
050,36,123,"New York","Yates County",5,73,293,144,149
050,36,123,"New York","Yates County",5,74,296,152,144
050,36,123,"New York","Yates County",5,75,263,140,123
050,36,123,"New York","Yates County",5,76,291,161,130
050,36,123,"New York","Yates County",5,77,196,103,93
050,36,123,"New York","Yates County",5,78,189,94,95
050,36,123,"New York","Yates County",5,79,170,85,85
050,36,123,"New York","Yates County",5,80,171,90,81
050,36,123,"New York","Yates County",5,81,134,66,68
050,36,123,"New York","Yates County",5,82,115,47,68
050,36,123,"New York","Yates County",5,83,104,48,56
050,36,123,"New York","Yates County",5,84,95,39,56
050,36,123,"New York","Yates County",5,85,525,202,323

