"SUMLEV","STATE","COUNTY","STNAME","CTYNAME","YEAR","AGE","TOT_POP","TOT_MALE","TOT_FEMALE"
050,01,001,"Alabama","Autauga County",1,0,617,313,304
050,01,001,"Alabama","Autauga County",1,1,642,343,299
050,01,001,"Alabama","Autauga County",1,2,705,401,304
050,01,001,"Alabama","Autauga County",1,3,736,367,369
050,01,001,"Alabama","Autauga County",1,4,791,394,397
050,01,001,"Alabama","Autauga County",1,5,722,374,348
050,01,001,"Alabama","Autauga County",1,6,748,381,367
050,01,001,"Alabama","Autauga County",1,7,687,347,340
050,01,001,"Alabama","Autauga County",1,8,742,387,355
050,01,001,"Alabama","Autauga County",1,9,764,386,378
050,01,001,"Alabama","Autauga County",1,10,790,406,384
050,01,001,"Alabama","Autauga County",1,11,873,450,423
050,01,001,"Alabama","Autauga County",1,12,872,460,412
050,01,001,"Alabama","Autauga County",1,13,826,421,405
050,01,001,"Alabama","Autauga County",1,14,829,416,413
050,01,001,"Alabama","Autauga County",1,15,862,426,436
050,01,001,"Alabama","Autauga County",1,16,836,418,418
050,01,001,"Alabama","Autauga County",1,17,841,428,413
050,01,001,"Alabama","Autauga County",1,18,738,379,359
050,01,001,"Alabama","Autauga County",1,19,604,311,293
050,01,001,"Alabama","Autauga County",1,20,602,314,288
050,01,001,"Alabama","Autauga County",1,21,619,316,303
050,01,001,"Alabama","Autauga County",1,22,648,333,315
050,01,001,"Alabama","Autauga County",1,23,676,353,323
050,01,001,"Alabama","Autauga County",1,24,695,340,355
050,01,001,"Alabama","Autauga County",1,25,730,364,366
050,01,001,"Alabama","Autauga County",1,26,772,389,383
050,01,001,"Alabama","Autauga County",1,27,774,403,371
050,01,001,"Alabama","Autauga County",1,28,794,373,421
050,01,001,"Alabama","Autauga County",1,29,816,383,433
050,01,001,"Alabama","Autauga County",1,30,805,394,411
050,01,001,"Alabama","Autauga County",1,31,741,367,374
050,01,001,"Alabama","Autauga County",1,32,737,337,400
050,01,001,"Alabama","Autauga County",1,33,743,348,395
050,01,001,"Alabama","Autauga County",1,34,762,380,382
050,01,001,"Alabama","Autauga County",1,35,810,421,389
050,01,001,"Alabama","Autauga County",1,36,776,366,410
050,01,001,"Alabama","Autauga County",1,37,778,391,387
050,01,001,"Alabama","Autauga County",1,38,787,379,408
050,01,001,"Alabama","Autauga County",1,39,819,389,430
050,01,001,"Alabama","Autauga County",1,40,750,367,383
050,01,001,"Alabama","Autauga County",1,41,750,352,398
050,01,001,"Alabama","Autauga County",1,42,806,370,436
050,01,001,"Alabama","Autauga County",1,43,804,383,421
050,01,001,"Alabama","Autauga County",1,44,699,339,360
050,01,001,"Alabama","Autauga County",1,45,761,371,390
050,01,001,"Alabama","Autauga County",1,46,762,369,393
050,01,001,"Alabama","Autauga County",1,47,804,390,414
050,01,001,"Alabama","Autauga County",1,48,843,420,423
050,01,001,"Alabama","Autauga County",1,49,860,419,441
050,01,001,"Alabama","Autauga County",1,50,781,386,395
050,01,001,"Alabama","Autauga County",1,51,774,385,389
050,01,001,"Alabama","Autauga County",1,52,730,372,358
050,01,001,"Alabama","Autauga County",1,53,798,401,397
050,01,001,"Alabama","Autauga County",1,54,804,397,407
050,01,001,"Alabama","Autauga County",1,55,844,412,432
050,01,001,"Alabama","Autauga County",1,56,807,395,412
050,01,001,"Alabama","Autauga County",1,57,828,400,428
050,01,001,"Alabama","Autauga County",1,58,827,415,412
050,01,001,"Alabama","Autauga County",1,59,832,427,405
050,01,001,"Alabama","Autauga County",1,60,792,387,405
050,01,001,"Alabama","Autauga County",1,61,772,381,391
050,01,001,"Alabama","Autauga County",1,62,733,334,399
050,01,001,"Alabama","Autauga County",1,63,638,276,362
050,01,001,"Alabama","Autauga County",1,64,672,314,358
050,01,001,"Alabama","Autauga County",1,65,626,300,326
050,01,001,"Alabama","Autauga County",1,66,611,300,311
050,01,001,"Alabama","Autauga County",1,67,580,295,285
050,01,001,"Alabama","Autauga County",1,68,589,291,298
050,01,001,"Alabama","Autauga County",1,69,513,244,269
050,01,001,"Alabama","Autauga County",1,70,512,215,297
050,01,001,"Alabama","Autauga County",1,71,487,217,270
050,01,001,"Alabama","Autauga County",1,72,534,245,289
050,01,001,"Alabama","Autauga County",1,73,536,241,295
050,01,001,"Alabama","Autauga County",1,74,393,156,237
050,01,001,"Alabama","Autauga County",1,75,381,163,218
050,01,001,"Alabama","Autauga County",1,76,408,175,233
050,01,001,"Alabama","Autauga County",1,77,400,154,246
050,01,001,"Alabama","Autauga County",1,78,334,137,197
050,01,001,"Alabama","Autauga County",1,79,288,129,159
050,01,001,"Alabama","Autauga County",1,80,252,105,147
050,01,001,"Alabama","Autauga County",1,81,266,114,152
050,01,001,"Alabama","Autauga County",1,82,249,110,139
050,01,001,"Alabama","Autauga County",1,83,202,86,116
050,01,001,"Alabama","Autauga County",1,84,175,79,96
050,01,001,"Alabama","Autauga County",1,85,893,332,561
050,01,001,"Alabama","Autauga County",2,0,634,330,304
050,01,001,"Alabama","Autauga County",2,1,649,344,305
050,01,001,"Alabama","Autauga County",2,2,695,387,308
050,01,001,"Alabama","Autauga County",2,3,740,380,360
050,01,001,"Alabama","Autauga County",2,4,786,391,395
050,01,001,"Alabama","Autauga County",2,5,747,381,366
050,01,001,"Alabama","Autauga County",2,6,743,378,365
050,01,001,"Alabama","Autauga County",2,7,707,357,350
050,01,001,"Alabama","Autauga County",2,8,731,377,354
050,01,001,"Alabama","Autauga County",2,9,760,388,372
050,01,001,"Alabama","Autauga County",2,10,791,404,387
050,01,001,"Alabama","Autauga County",2,11,854,438,416
050,01,001,"Alabama","Autauga County",2,12,880,461,419
050,01,001,"Alabama","Autauga County",2,13,838,430,408
050,01,001,"Alabama","Autauga County",2,14,827,416,411
050,01,001,"Alabama","Autauga County",2,15,852,423,429
050,01,001,"Alabama","Autauga County",2,16,843,421,422
050,01,001,"Alabama","Autauga County",2,17,837,424,413
050,01,001,"Alabama","Autauga County",2,18,724,374,350
050,01,001,"Alabama","Autauga County",2,19,606,313,293
050,01,001,"Alabama","Autauga County",2,20,621,322,299
050,01,001,"Alabama","Autauga County",2,21,616,314,302
050,01,001,"Alabama","Autauga County",2,22,652,334,318
050,01,001,"Alabama","Autauga County",2,23,677,351,326
050,01,001,"Alabama","Autauga County",2,24,692,345,347
050,01,001,"Alabama","Autauga County",2,25,728,361,367
050,01,001,"Alabama","Autauga County",2,26,773,392,381
050,01,001,"Alabama","Autauga County",2,27,779,405,374
050,01,001,"Alabama","Autauga County",2,28,794,383,411
050,01,001,"Alabama","Autauga County",2,29,817,382,435
050,01,001,"Alabama","Autauga County",2,30,813,392,421
050,01,001,"Alabama","Autauga County",2,31,761,374,387
050,01,001,"Alabama","Autauga County",2,32,746,350,396
050,01,001,"Alabama","Autauga County",2,33,742,347,395
050,01,001,"Alabama","Autauga County",2,34,763,379,384
050,01,001,"Alabama","Autauga County",2,35,803,414,389
050,01,001,"Alabama","Autauga County",2,36,778,377,401
050,01,001,"Alabama","Autauga County",2,37,778,384,394
050,01,001,"Alabama","Autauga County",2,38,794,383,411
050,01,001,"Alabama","Autauga County",2,39,807,384,423
050,01,001,"Alabama","Autauga County",2,40,770,374,396
050,01,001,"Alabama","Autauga County",2,41,750,356,394
050,01,001,"Alabama","Autauga County",2,42,791,367,424
050,01,001,"Alabama","Autauga County",2,43,806,381,425
050,01,001,"Alabama","Autauga County",2,44,719,348,371
050,01,001,"Alabama","Autauga County",2,45,749,367,382
050,01,001,"Alabama","Autauga County",2,46,759,367,392
050,01,001,"Alabama","Autauga County",2,47,791,382,409
050,01,001,"Alabama","Autauga County",2,48,829,410,419
050,01,001,"Alabama","Autauga County",2,49,855,421,434
050,01,001,"Alabama","Autauga County",2,50,798,392,406
050,01,001,"Alabama","Autauga County",2,51,763,382,381
050,01,001,"Alabama","Autauga County",2,52,735,374,361
050,01,001,"Alabama","Autauga County",2,53,778,393,385
050,01,001,"Alabama","Autauga County",2,54,799,396,403
050,01,001,"Alabama","Autauga County",2,55,837,408,429
050,01,001,"Alabama","Autauga County",2,56,816,400,416
050,01,001,"Alabama","Autauga County",2,57,822,400,422
050,01,001,"Alabama","Autauga County",2,58,826,411,415
050,01,001,"Alabama","Autauga County",2,59,836,428,408
050,01,001,"Alabama","Autauga County",2,60,799,396,403
050,01,001,"Alabama","Autauga County",2,61,771,377,394
050,01,001,"Alabama","Autauga County",2,62,733,344,389
050,01,001,"Alabama","Autauga County",2,63,664,290,374
050,01,001,"Alabama","Autauga County",2,64,655,299,356
050,01,001,"Alabama","Autauga County",2,65,635,300,335
050,01,001,"Alabama","Autauga County",2,66,618,300,318
050,01,001,"Alabama","Autauga County",2,67,587,295,292
050,01,001,"Alabama","Autauga County",2,68,579,287,292
050,01,001,"Alabama","Autauga County",2,69,528,252,276
050,01,001,"Alabama","Autauga County",2,70,516,225,291
050,01,001,"Alabama","Autauga County",2,71,497,219,278
050,01,001,"Alabama","Autauga County",2,72,510,230,280
050,01,001,"Alabama","Autauga County",2,73,560,253,307
050,01,001,"Alabama","Autauga County",2,74,401,167,234
050,01,001,"Alabama","Autauga County",2,75,382,159,223
050,01,001,"Alabama","Autauga County",2,76,392,166,226
050,01,001,"Alabama","Autauga County",2,77,405,159,246
050,01,001,"Alabama","Autauga County",2,78,339,137,202
050,01,001,"Alabama","Autauga County",2,79,293,127,166
050,01,001,"Alabama","Autauga County",2,80,258,106,152
050,01,001,"Alabama","Autauga County",2,81,257,111,146
050,01,001,"Alabama","Autauga County",2,82,249,107,142
050,01,001,"Alabama","Autauga County",2,83,206,90,116
050,01,001,"Alabama","Autauga County",2,84,178,80,98
050,01,001,"Alabama","Autauga County",2,85,896,337,559
050,01,001,"Alabama","Autauga County",3,0,675,345,330
050,01,001,"Alabama","Autauga County",3,1,654,342,312
050,01,001,"Alabama","Autauga County",3,2,675,350,325
050,01,001,"Alabama","Autauga County",3,3,695,387,308
050,01,001,"Alabama","Autauga County",3,4,742,378,364
050,01,001,"Alabama","Autauga County",3,5,793,399,394
050,01,001,"Alabama","Autauga County",3,6,762,389,373
050,01,001,"Alabama","Autauga County",3,7,770,393,377
050,01,001,"Alabama","Autauga County",3,8,706,361,345
050,01,001,"Alabama","Autauga County",3,9,708,353,355
050,01,001,"Alabama","Autauga County",3,10,784,396,388
050,01,001,"Alabama","Autauga County",3,11,798,408,390
050,01,001,"Alabama","Autauga County",3,12,875,444,431
050,01,001,"Alabama","Autauga County",3,13,875,459,416
050,01,001,"Alabama","Autauga County",3,14,851,439,412
050,01,001,"Alabama","Autauga County",3,15,837,409,428
050,01,001,"Alabama","Autauga County",3,16,875,425,450
050,01,001,"Alabama","Autauga County",3,17,853,431,422
050,01,001,"Alabama","Autauga County",3,18,714,366,348
050,01,001,"Alabama","Autauga County",3,19,574,303,271
050,01,001,"Alabama","Autauga County",3,20,643,321,322
050,01,001,"Alabama","Autauga County",3,21,610,310,300
050,01,001,"Alabama","Autauga County",3,22,659,331,328
050,01,001,"Alabama","Autauga County",3,23,655,336,319
050,01,001,"Alabama","Autauga County",3,24,679,352,327
050,01,001,"Alabama","Autauga County",3,25,694,326,368
050,01,001,"Alabama","Autauga County",3,26,749,386,363
050,01,001,"Alabama","Autauga County",3,27,754,375,379
050,01,001,"Alabama","Autauga County",3,28,765,398,367
050,01,001,"Alabama","Autauga County",3,29,818,391,427
050,01,001,"Alabama","Autauga County",3,30,839,379,460
050,01,001,"Alabama","Autauga County",3,31,802,383,419
050,01,001,"Alabama","Autauga County",3,32,820,408,412
050,01,001,"Alabama","Autauga County",3,33,768,343,425
050,01,001,"Alabama","Autauga County",3,34,765,341,424
050,01,001,"Alabama","Autauga County",3,35,819,411,408
050,01,001,"Alabama","Autauga County",3,36,824,424,400
050,01,001,"Alabama","Autauga County",3,37,791,391,400
050,01,001,"Alabama","Autauga County",3,38,794,391,403
050,01,001,"Alabama","Autauga County",3,39,799,387,412
050,01,001,"Alabama","Autauga County",3,40,781,369,412
050,01,001,"Alabama","Autauga County",3,41,805,400,405
050,01,001,"Alabama","Autauga County",3,42,736,337,399
050,01,001,"Alabama","Autauga County",3,43,800,381,419
050,01,001,"Alabama","Autauga County",3,44,784,369,415
050,01,001,"Alabama","Autauga County",3,45,713,351,362
050,01,001,"Alabama","Autauga County",3,46,729,351,378
050,01,001,"Alabama","Autauga County",3,47,757,366,391
050,01,001,"Alabama","Autauga County",3,48,782,372,410
050,01,001,"Alabama","Autauga County",3,49,838,413,425
050,01,001,"Alabama","Autauga County",3,50,843,405,438
050,01,001,"Alabama","Autauga County",3,51,795,394,401
050,01,001,"Alabama","Autauga County",3,52,761,372,389
050,01,001,"Alabama","Autauga County",3,53,730,368,362
050,01,001,"Alabama","Autauga County",3,54,773,386,387
050,01,001,"Alabama","Autauga County",3,55,792,395,397
050,01,001,"Alabama","Autauga County",3,56,822,406,416
050,01,001,"Alabama","Autauga County",3,57,817,397,420
050,01,001,"Alabama","Autauga County",3,58,815,387,428
050,01,001,"Alabama","Autauga County",3,59,826,419,407
050,01,001,"Alabama","Autauga County",3,60,827,415,412
050,01,001,"Alabama","Autauga County",3,61,777,380,397
050,01,001,"Alabama","Autauga County",3,62,763,371,392
050,01,001,"Alabama","Autauga County",3,63,722,331,391
050,01,001,"Alabama","Autauga County",3,64,673,298,375
050,01,001,"Alabama","Autauga County",3,65,668,307,361
050,01,001,"Alabama","Autauga County",3,66,634,309,325
050,01,001,"Alabama","Autauga County",3,67,609,295,314
050,01,001,"Alabama","Autauga County",3,68,578,291,287
050,01,001,"Alabama","Autauga County",3,69,563,279,284
050,01,001,"Alabama","Autauga County",3,70,513,245,268
050,01,001,"Alabama","Autauga County",3,71,497,215,282
050,01,001,"Alabama","Autauga County",3,72,488,212,276
050,01,001,"Alabama","Autauga County",3,73,498,222,276
050,01,001,"Alabama","Autauga County",3,74,543,245,298
050,01,001,"Alabama","Autauga County",3,75,400,162,238
050,01,001,"Alabama","Autauga County",3,76,371,152,219
050,01,001,"Alabama","Autauga County",3,77,344,144,200
050,01,001,"Alabama","Autauga County",3,78,372,144,228
050,01,001,"Alabama","Autauga County",3,79,320,134,186
050,01,001,"Alabama","Autauga County",3,80,288,116,172
050,01,001,"Alabama","Autauga County",3,81,241,99,142
050,01,001,"Alabama","Autauga County",3,82,238,95,143
050,01,001,"Alabama","Autauga County",3,83,220,92,128
050,01,001,"Alabama","Autauga County",3,84,183,76,107
050,01,001,"Alabama","Autauga County",3,85,911,354,557
050,01,001,"Alabama","Autauga County",4,0,695,353,342
050,01,001,"Alabama","Autauga County",4,1,680,349,331
050,01,001,"Alabama","Autauga County",4,2,685,348,337
050,01,001,"Alabama","Autauga County",4,3,730,363,367
050,01,001,"Alabama","Autauga County",4,4,673,371,302
050,01,001,"Alabama","Autauga County",4,5,788,414,374
050,01,001,"Alabama","Autauga County",4,6,833,425,408
050,01,001,"Alabama","Autauga County",4,7,782,400,382
050,01,001,"Alabama","Autauga County",4,8,754,399,355
050,01,001,"Alabama","Autauga County",4,9,735,389,346
050,01,001,"Alabama","Autauga County",4,10,726,360,366
050,01,001,"Alabama","Autauga County",4,11,776,394,382
050,01,001,"Alabama","Autauga County",4,12,824,427,397
050,01,001,"Alabama","Autauga County",4,13,891,449,442
050,01,001,"Alabama","Autauga County",4,14,900,472,428
050,01,001,"Alabama","Autauga County",4,15,860,434,426
050,01,001,"Alabama","Autauga County",4,16,831,423,408
050,01,001,"Alabama","Autauga County",4,17,866,428,438
050,01,001,"Alabama","Autauga County",4,18,727,377,350
050,01,001,"Alabama","Autauga County",4,19,542,280,262
050,01,001,"Alabama","Autauga County",4,20,590,297,293
050,01,001,"Alabama","Autauga County",4,21,647,314,333
050,01,001,"Alabama","Autauga County",4,22,643,328,315
050,01,001,"Alabama","Autauga County",4,23,693,347,346
050,01,001,"Alabama","Autauga County",4,24,687,354,333
050,01,001,"Alabama","Autauga County",4,25,703,350,353
050,01,001,"Alabama","Autauga County",4,26,699,321,378
050,01,001,"Alabama","Autauga County",4,27,759,384,375
050,01,001,"Alabama","Autauga County",4,28,748,372,376
050,01,001,"Alabama","Autauga County",4,29,768,395,373
050,01,001,"Alabama","Autauga County",4,30,805,378,427
050,01,001,"Alabama","Autauga County",4,31,887,400,487
050,01,001,"Alabama","Autauga County",4,32,820,401,419
050,01,001,"Alabama","Autauga County",4,33,845,407,438
050,01,001,"Alabama","Autauga County",4,34,806,367,439
050,01,001,"Alabama","Autauga County",4,35,818,374,444
050,01,001,"Alabama","Autauga County",4,36,816,425,391
050,01,001,"Alabama","Autauga County",4,37,830,421,409
050,01,001,"Alabama","Autauga County",4,38,798,375,423
050,01,001,"Alabama","Autauga County",4,39,803,395,408
050,01,001,"Alabama","Autauga County",4,40,801,391,410
050,01,001,"Alabama","Autauga County",4,41,772,357,415
050,01,001,"Alabama","Autauga County",4,42,797,404,393
050,01,001,"Alabama","Autauga County",4,43,732,340,392
050,01,001,"Alabama","Autauga County",4,44,757,348,409
050,01,001,"Alabama","Autauga County",4,45,773,365,408
050,01,001,"Alabama","Autauga County",4,46,725,357,368
050,01,001,"Alabama","Autauga County",4,47,715,347,368
050,01,001,"Alabama","Autauga County",4,48,753,362,391
050,01,001,"Alabama","Autauga County",4,49,779,383,396
050,01,001,"Alabama","Autauga County",4,50,828,399,429
050,01,001,"Alabama","Autauga County",4,51,869,418,451
050,01,001,"Alabama","Autauga County",4,52,779,382,397
050,01,001,"Alabama","Autauga County",4,53,760,376,384
050,01,001,"Alabama","Autauga County",4,54,753,378,375
050,01,001,"Alabama","Autauga County",4,55,768,385,383
050,01,001,"Alabama","Autauga County",4,56,785,390,395
050,01,001,"Alabama","Autauga County",4,57,822,402,420
050,01,001,"Alabama","Autauga County",4,58,805,386,419
050,01,001,"Alabama","Autauga County",4,59,817,397,420
050,01,001,"Alabama","Autauga County",4,60,822,420,402
050,01,001,"Alabama","Autauga County",4,61,828,418,410
050,01,001,"Alabama","Autauga County",4,62,792,382,410
050,01,001,"Alabama","Autauga County",4,63,753,362,391
050,01,001,"Alabama","Autauga County",4,64,716,316,400
050,01,001,"Alabama","Autauga County",4,65,679,298,381
050,01,001,"Alabama","Autauga County",4,66,662,309,353
050,01,001,"Alabama","Autauga County",4,67,633,307,326
050,01,001,"Alabama","Autauga County",4,68,599,287,312
050,01,001,"Alabama","Autauga County",4,69,567,286,281
050,01,001,"Alabama","Autauga County",4,70,556,279,277
050,01,001,"Alabama","Autauga County",4,71,504,243,261
050,01,001,"Alabama","Autauga County",4,72,488,213,275
050,01,001,"Alabama","Autauga County",4,73,470,198,272
050,01,001,"Alabama","Autauga County",4,74,491,222,269
050,01,001,"Alabama","Autauga County",4,75,539,236,303
050,01,001,"Alabama","Autauga County",4,76,369,147,222
050,01,001,"Alabama","Autauga County",4,77,346,142,204
050,01,001,"Alabama","Autauga County",4,78,324,131,193
050,01,001,"Alabama","Autauga County",4,79,362,142,220
050,01,001,"Alabama","Autauga County",4,80,300,122,178
050,01,001,"Alabama","Autauga County",4,81,274,106,168
050,01,001,"Alabama","Autauga County",4,82,229,92,137
050,01,001,"Alabama","Autauga County",4,83,212,82,130
050,01,001,"Alabama","Autauga County",4,84,196,75,121
050,01,001,"Alabama","Autauga County",4,85,962,388,574
050,01,001,"Alabama","Autauga County",5,0,705,358,347
050,01,001,"Alabama","Autauga County",5,1,736,391,345
050,01,001,"Alabama","Autauga County",5,2,704,369,335
050,01,001,"Alabama","Autauga County",5,3,715,365,350
050,01,001,"Alabama","Autauga County",5,4,757,408,349
050,01,001,"Alabama","Autauga County",5,5,697,368,329
050,01,001,"Alabama","Autauga County",5,6,783,408,375
050,01,001,"Alabama","Autauga County",5,7,822,423,399
050,01,001,"Alabama","Autauga County",5,8,785,391,394
050,01,001,"Alabama","Autauga County",5,9,763,393,370
050,01,001,"Alabama","Autauga County",5,10,740,387,353
050,01,001,"Alabama","Autauga County",5,11,736,365,371
050,01,001,"Alabama","Autauga County",5,12,796,383,413
050,01,001,"Alabama","Autauga County",5,13,829,425,404
050,01,001,"Alabama","Autauga County",5,14,889,456,433
050,01,001,"Alabama","Autauga County",5,15,913,473,440
050,01,001,"Alabama","Autauga County",5,16,886,454,432
050,01,001,"Alabama","Autauga County",5,17,833,432,401
050,01,001,"Alabama","Autauga County",5,18,719,359,360
050,01,001,"Alabama","Autauga County",5,19,584,307,277
050,01,001,"Alabama","Autauga County",5,20,587,301,286
050,01,001,"Alabama","Autauga County",5,21,624,300,324
050,01,001,"Alabama","Autauga County",5,22,679,327,352
050,01,001,"Alabama","Autauga County",5,23,674,338,336
050,01,001,"Alabama","Autauga County",5,24,685,346,339
050,01,001,"Alabama","Autauga County",5,25,710,356,354
050,01,001,"Alabama","Autauga County",5,26,697,348,349
050,01,001,"Alabama","Autauga County",5,27,697,319,378
050,01,001,"Alabama","Autauga County",5,28,746,379,367
050,01,001,"Alabama","Autauga County",5,29,743,365,378
050,01,001,"Alabama","Autauga County",5,30,780,394,386
050,01,001,"Alabama","Autauga County",5,31,804,376,428
050,01,001,"Alabama","Autauga County",5,32,901,408,493
050,01,001,"Alabama","Autauga County",5,33,826,394,432
050,01,001,"Alabama","Autauga County",5,34,858,433,425
050,01,001,"Alabama","Autauga County",5,35,871,398,473
050,01,001,"Alabama","Autauga County",5,36,828,386,442
050,01,001,"Alabama","Autauga County",5,37,811,422,389
050,01,001,"Alabama","Autauga County",5,38,840,416,424
050,01,001,"Alabama","Autauga County",5,39,826,382,444
050,01,001,"Alabama","Autauga County",5,40,791,396,395
050,01,001,"Alabama","Autauga County",5,41,796,378,418
050,01,001,"Alabama","Autauga County",5,42,809,368,441
050,01,001,"Alabama","Autauga County",5,43,804,403,401
050,01,001,"Alabama","Autauga County",5,44,724,340,384
050,01,001,"Alabama","Autauga County",5,45,752,349,403
050,01,001,"Alabama","Autauga County",5,46,784,366,418
050,01,001,"Alabama","Autauga County",5,47,727,354,373
050,01,001,"Alabama","Autauga County",5,48,726,345,381
050,01,001,"Alabama","Autauga County",5,49,741,357,384
050,01,001,"Alabama","Autauga County",5,50,768,377,391
050,01,001,"Alabama","Autauga County",5,51,840,410,430
050,01,001,"Alabama","Autauga County",5,52,889,426,463
050,01,001,"Alabama","Autauga County",5,53,777,369,408
050,01,001,"Alabama","Autauga County",5,54,759,383,376
050,01,001,"Alabama","Autauga County",5,55,755,380,375
050,01,001,"Alabama","Autauga County",5,56,786,396,390
050,01,001,"Alabama","Autauga County",5,57,778,392,386
050,01,001,"Alabama","Autauga County",5,58,814,398,416
050,01,001,"Alabama","Autauga County",5,59,816,388,428
050,01,001,"Alabama","Autauga County",5,60,821,399,422
050,01,001,"Alabama","Autauga County",5,61,827,415,412
050,01,001,"Alabama","Autauga County",5,62,821,421,400
050,01,001,"Alabama","Autauga County",5,63,780,361,419
050,01,001,"Alabama","Autauga County",5,64,751,359,392
050,01,001,"Alabama","Autauga County",5,65,696,300,396
050,01,001,"Alabama","Autauga County",5,66,674,299,375
050,01,001,"Alabama","Autauga County",5,67,659,310,349
050,01,001,"Alabama","Autauga County",5,68,630,307,323
050,01,001,"Alabama","Autauga County",5,69,580,280,300
050,01,001,"Alabama","Autauga County",5,70,562,286,276
050,01,001,"Alabama","Autauga County",5,71,554,279,275
050,01,001,"Alabama","Autauga County",5,72,491,231,260
050,01,001,"Alabama","Autauga County",5,73,473,204,269
050,01,001,"Alabama","Autauga County",5,74,464,196,268
050,01,001,"Alabama","Autauga County",5,75,486,216,270
050,01,001,"Alabama","Autauga County",5,76,524,230,294
050,01,001,"Alabama","Autauga County",5,77,342,133,209
050,01,001,"Alabama","Autauga County",5,78,330,134,196
050,01,001,"Alabama","Autauga County",5,79,322,128,194
050,01,001,"Alabama","Autauga County",5,80,356,129,227
050,01,001,"Alabama","Autauga County",5,81,285,107,178
050,01,001,"Alabama","Autauga County",5,82,265,98,167
050,01,001,"Alabama","Autauga County",5,83,209,82,127
050,01,001,"Alabama","Autauga County",5,84,189,68,121
050,01,001,"Alabama","Autauga County",5,85,1036,427,609
050,01,003,"Alabama","Baldwin County",1,0,2340,1209,1131
050,01,003,"Alabama","Baldwin County",1,1,2375,1229,1146
050,01,003,"Alabama","Baldwin County",1,2,2472,1306,1166
050,01,003,"Alabama","Baldwin County",1,3,2524,1319,1205
050,01,003,"Alabama","Baldwin County",1,4,2543,1348,1195
050,01,003,"Alabama","Baldwin County",1,5,2619,1365,1254
050,01,003,"Alabama","Baldwin County",1,6,2694,1368,1326
050,01,003,"Alabama","Baldwin County",1,7,2647,1330,1317
050,01,003,"Alabama","Baldwin County",1,8,2789,1448,1341
050,01,003,"Alabama","Baldwin County",1,9,2834,1490,1344
050,01,003,"Alabama","Baldwin County",1,10,2843,1455,1388
050,01,003,"Alabama","Baldwin County",1,11,2954,1505,1449
050,01,003,"Alabama","Baldwin County",1,12,3104,1546,1558
050,01,003,"Alabama","Baldwin County",1,13,3102,1589,1513
050,01,003,"Alabama","Baldwin County",1,14,3116,1573,1543
050,01,003,"Alabama","Baldwin County",1,15,3094,1567,1527
050,01,003,"Alabama","Baldwin County",1,16,3018,1532,1486
050,01,003,"Alabama","Baldwin County",1,17,2926,1436,1490
050,01,003,"Alabama","Baldwin County",1,18,2586,1313,1273
050,01,003,"Alabama","Baldwin County",1,19,2241,1124,1117
050,01,003,"Alabama","Baldwin County",1,20,2228,1146,1082
050,01,003,"Alabama","Baldwin County",1,21,2207,1093,1114
050,01,003,"Alabama","Baldwin County",1,22,2264,1137,1127
050,01,003,"Alabama","Baldwin County",1,23,2327,1171,1156
050,01,003,"Alabama","Baldwin County",1,24,2316,1171,1145
050,01,003,"Alabama","Baldwin County",1,25,2362,1196,1166
050,01,003,"Alabama","Baldwin County",1,26,2348,1182,1166
050,01,003,"Alabama","Baldwin County",1,27,2436,1212,1224
050,01,003,"Alabama","Baldwin County",1,28,2582,1283,1299
050,01,003,"Alabama","Baldwin County",1,29,2710,1334,1376
050,01,003,"Alabama","Baldwin County",1,30,2673,1288,1385
050,01,003,"Alabama","Baldwin County",1,31,2606,1284,1322
050,01,003,"Alabama","Baldwin County",1,32,2594,1245,1349
050,01,003,"Alabama","Baldwin County",1,33,2588,1280,1308
050,01,003,"Alabama","Baldwin County",1,34,2649,1316,1333
050,01,003,"Alabama","Baldwin County",1,35,2726,1339,1387
050,01,003,"Alabama","Baldwin County",1,36,2671,1372,1299
050,01,003,"Alabama","Baldwin County",1,37,2790,1362,1428
050,01,003,"Alabama","Baldwin County",1,38,2872,1418,1454
050,01,003,"Alabama","Baldwin County",1,39,2917,1408,1509
050,01,003,"Alabama","Baldwin County",1,40,2982,1458,1524
050,01,003,"Alabama","Baldwin County",1,41,2867,1373,1494
050,01,003,"Alabama","Baldwin County",1,42,2843,1397,1446
050,01,003,"Alabama","Baldwin County",1,43,2817,1367,1450
050,01,003,"Alabama","Baldwin County",1,44,2657,1299,1358
050,01,003,"Alabama","Baldwin County",1,45,2697,1344,1353
050,01,003,"Alabama","Baldwin County",1,46,2820,1370,1450
050,01,003,"Alabama","Baldwin County",1,47,2899,1418,1481
050,01,003,"Alabama","Baldwin County",1,48,3047,1526,1521
050,01,003,"Alabama","Baldwin County",1,49,3282,1599,1683
050,01,003,"Alabama","Baldwin County",1,50,3117,1499,1618
050,01,003,"Alabama","Baldwin County",1,51,3036,1499,1537
050,01,003,"Alabama","Baldwin County",1,52,2882,1408,1474
050,01,003,"Alabama","Baldwin County",1,53,2910,1419,1491
050,01,003,"Alabama","Baldwin County",1,54,2966,1429,1537
050,01,003,"Alabama","Baldwin County",1,55,3265,1534,1731
050,01,003,"Alabama","Baldwin County",1,56,3369,1621,1748
050,01,003,"Alabama","Baldwin County",1,57,3350,1609,1741
050,01,003,"Alabama","Baldwin County",1,58,3374,1626,1748
050,01,003,"Alabama","Baldwin County",1,59,3470,1673,1797
050,01,003,"Alabama","Baldwin County",1,60,3493,1634,1859
050,01,003,"Alabama","Baldwin County",1,61,3359,1542,1817
050,01,003,"Alabama","Baldwin County",1,62,3355,1549,1806
050,01,003,"Alabama","Baldwin County",1,63,3383,1586,1797
050,01,003,"Alabama","Baldwin County",1,64,3448,1638,1810
050,01,003,"Alabama","Baldwin County",1,65,3380,1569,1811
050,01,003,"Alabama","Baldwin County",1,66,3255,1507,1748
050,01,003,"Alabama","Baldwin County",1,67,3073,1428,1645
050,01,003,"Alabama","Baldwin County",1,68,3045,1420,1625
050,01,003,"Alabama","Baldwin County",1,69,2905,1381,1524
050,01,003,"Alabama","Baldwin County",1,70,2867,1327,1540
050,01,003,"Alabama","Baldwin County",1,71,2843,1318,1525
050,01,003,"Alabama","Baldwin County",1,72,2979,1461,1518
050,01,003,"Alabama","Baldwin County",1,73,3029,1513,1516
050,01,003,"Alabama","Baldwin County",1,74,2049,958,1091
050,01,003,"Alabama","Baldwin County",1,75,2074,1007,1067
050,01,003,"Alabama","Baldwin County",1,76,2068,981,1087
050,01,003,"Alabama","Baldwin County",1,77,1990,952,1038
050,01,003,"Alabama","Baldwin County",1,78,1642,801,841
050,01,003,"Alabama","Baldwin County",1,79,1469,695,774
050,01,003,"Alabama","Baldwin County",1,80,1284,565,719
050,01,003,"Alabama","Baldwin County",1,81,1250,584,666
050,01,003,"Alabama","Baldwin County",1,82,1092,508,584
050,01,003,"Alabama","Baldwin County",1,83,934,430,504
050,01,003,"Alabama","Baldwin County",1,84,875,401,474
050,01,003,"Alabama","Baldwin County",1,85,4290,1741,2549
050,01,003,"Alabama","Baldwin County",2,0,2326,1200,1126
050,01,003,"Alabama","Baldwin County",2,1,2372,1232,1140
050,01,003,"Alabama","Baldwin County",2,2,2468,1297,1171
050,01,003,"Alabama","Baldwin County",2,3,2516,1318,1198
050,01,003,"Alabama","Baldwin County",2,4,2559,1353,1206
050,01,003,"Alabama","Baldwin County",2,5,2622,1368,1254
050,01,003,"Alabama","Baldwin County",2,6,2702,1382,1320
050,01,003,"Alabama","Baldwin County",2,7,2680,1350,1330
050,01,003,"Alabama","Baldwin County",2,8,2774,1429,1345
050,01,003,"Alabama","Baldwin County",2,9,2847,1495,1352
050,01,003,"Alabama","Baldwin County",2,10,2864,1478,1386
050,01,003,"Alabama","Baldwin County",2,11,2942,1496,1446
050,01,003,"Alabama","Baldwin County",2,12,3098,1553,1545
050,01,003,"Alabama","Baldwin County",2,13,3123,1587,1536
050,01,003,"Alabama","Baldwin County",2,14,3140,1592,1548
050,01,003,"Alabama","Baldwin County",2,15,3121,1578,1543
050,01,003,"Alabama","Baldwin County",2,16,3051,1540,1511
050,01,003,"Alabama","Baldwin County",2,17,2964,1468,1496
050,01,003,"Alabama","Baldwin County",2,18,2574,1307,1267
050,01,003,"Alabama","Baldwin County",2,19,2247,1124,1123
050,01,003,"Alabama","Baldwin County",2,20,2283,1171,1112
050,01,003,"Alabama","Baldwin County",2,21,2218,1102,1116
050,01,003,"Alabama","Baldwin County",2,22,2278,1136,1142
050,01,003,"Alabama","Baldwin County",2,23,2336,1174,1162
050,01,003,"Alabama","Baldwin County",2,24,2327,1178,1149
050,01,003,"Alabama","Baldwin County",2,25,2360,1197,1163
050,01,003,"Alabama","Baldwin County",2,26,2356,1185,1171
050,01,003,"Alabama","Baldwin County",2,27,2415,1203,1212
050,01,003,"Alabama","Baldwin County",2,28,2572,1283,1289
050,01,003,"Alabama","Baldwin County",2,29,2694,1324,1370
050,01,003,"Alabama","Baldwin County",2,30,2713,1311,1402
050,01,003,"Alabama","Baldwin County",2,31,2636,1290,1346
050,01,003,"Alabama","Baldwin County",2,32,2606,1258,1348
050,01,003,"Alabama","Baldwin County",2,33,2605,1276,1329
050,01,003,"Alabama","Baldwin County",2,34,2654,1313,1341
050,01,003,"Alabama","Baldwin County",2,35,2738,1348,1390
050,01,003,"Alabama","Baldwin County",2,36,2695,1366,1329
050,01,003,"Alabama","Baldwin County",2,37,2779,1368,1411
050,01,003,"Alabama","Baldwin County",2,38,2876,1415,1461
050,01,003,"Alabama","Baldwin County",2,39,2920,1414,1506
050,01,003,"Alabama","Baldwin County",2,40,2998,1456,1542
050,01,003,"Alabama","Baldwin County",2,41,2918,1405,1513
050,01,003,"Alabama","Baldwin County",2,42,2847,1383,1464
050,01,003,"Alabama","Baldwin County",2,43,2848,1393,1455
050,01,003,"Alabama","Baldwin County",2,44,2687,1312,1375
050,01,003,"Alabama","Baldwin County",2,45,2720,1348,1372
050,01,003,"Alabama","Baldwin County",2,46,2802,1366,1436
050,01,003,"Alabama","Baldwin County",2,47,2894,1410,1484
050,01,003,"Alabama","Baldwin County",2,48,3019,1501,1518
050,01,003,"Alabama","Baldwin County",2,49,3253,1597,1656
050,01,003,"Alabama","Baldwin County",2,50,3174,1525,1649
050,01,003,"Alabama","Baldwin County",2,51,3068,1503,1565
050,01,003,"Alabama","Baldwin County",2,52,2927,1435,1492
050,01,003,"Alabama","Baldwin County",2,53,2927,1426,1501
050,01,003,"Alabama","Baldwin County",2,54,2961,1426,1535
050,01,003,"Alabama","Baldwin County",2,55,3212,1515,1697
050,01,003,"Alabama","Baldwin County",2,56,3378,1615,1763
050,01,003,"Alabama","Baldwin County",2,57,3388,1625,1763
050,01,003,"Alabama","Baldwin County",2,58,3391,1630,1761
050,01,003,"Alabama","Baldwin County",2,59,3503,1688,1815
050,01,003,"Alabama","Baldwin County",2,60,3508,1652,1856
050,01,003,"Alabama","Baldwin County",2,61,3428,1584,1844
050,01,003,"Alabama","Baldwin County",2,62,3379,1561,1818
050,01,003,"Alabama","Baldwin County",2,63,3444,1615,1829
050,01,003,"Alabama","Baldwin County",2,64,3449,1626,1823
050,01,003,"Alabama","Baldwin County",2,65,3423,1596,1827
050,01,003,"Alabama","Baldwin County",2,66,3319,1538,1781
050,01,003,"Alabama","Baldwin County",2,67,3124,1447,1677
050,01,003,"Alabama","Baldwin County",2,68,3048,1421,1627
050,01,003,"Alabama","Baldwin County",2,69,2971,1402,1569
050,01,003,"Alabama","Baldwin County",2,70,2869,1335,1534
050,01,003,"Alabama","Baldwin County",2,71,2860,1325,1535
050,01,003,"Alabama","Baldwin County",2,72,2919,1419,1500
050,01,003,"Alabama","Baldwin County",2,73,3167,1569,1598
050,01,003,"Alabama","Baldwin County",2,74,2141,1023,1118
050,01,003,"Alabama","Baldwin County",2,75,2081,1002,1079
050,01,003,"Alabama","Baldwin County",2,76,2045,974,1071
050,01,003,"Alabama","Baldwin County",2,77,2056,982,1074
050,01,003,"Alabama","Baldwin County",2,78,1703,831,872
050,01,003,"Alabama","Baldwin County",2,79,1497,713,784
050,01,003,"Alabama","Baldwin County",2,80,1311,583,728
050,01,003,"Alabama","Baldwin County",2,81,1239,576,663
050,01,003,"Alabama","Baldwin County",2,82,1108,512,596
050,01,003,"Alabama","Baldwin County",2,83,954,439,515
050,01,003,"Alabama","Baldwin County",2,84,873,396,477
050,01,003,"Alabama","Baldwin County",2,85,4345,1772,2573
050,01,003,"Alabama","Baldwin County",3,0,2352,1190,1162
050,01,003,"Alabama","Baldwin County",3,1,2420,1245,1175
050,01,003,"Alabama","Baldwin County",3,2,2422,1263,1159
050,01,003,"Alabama","Baldwin County",3,3,2570,1331,1239
050,01,003,"Alabama","Baldwin County",3,4,2627,1379,1248
050,01,003,"Alabama","Baldwin County",3,5,2698,1414,1284
050,01,003,"Alabama","Baldwin County",3,6,2700,1405,1295
050,01,003,"Alabama","Baldwin County",3,7,2823,1437,1386
050,01,003,"Alabama","Baldwin County",3,8,2780,1387,1393
050,01,003,"Alabama","Baldwin County",3,9,2865,1476,1389
050,01,003,"Alabama","Baldwin County",3,10,2888,1490,1398
050,01,003,"Alabama","Baldwin County",3,11,2966,1515,1451
050,01,003,"Alabama","Baldwin County",3,12,3033,1549,1484
050,01,003,"Alabama","Baldwin County",3,13,3194,1615,1579
050,01,003,"Alabama","Baldwin County",3,14,3237,1653,1584
050,01,003,"Alabama","Baldwin County",3,15,3235,1647,1588
050,01,003,"Alabama","Baldwin County",3,16,3140,1590,1550
050,01,003,"Alabama","Baldwin County",3,17,3126,1572,1554
050,01,003,"Alabama","Baldwin County",3,18,2634,1340,1294
050,01,003,"Alabama","Baldwin County",3,19,2240,1110,1130
050,01,003,"Alabama","Baldwin County",3,20,2417,1218,1199
050,01,003,"Alabama","Baldwin County",3,21,2344,1199,1145
050,01,003,"Alabama","Baldwin County",3,22,2376,1153,1223
050,01,003,"Alabama","Baldwin County",3,23,2458,1218,1240
050,01,003,"Alabama","Baldwin County",3,24,2376,1168,1208
050,01,003,"Alabama","Baldwin County",3,25,2405,1196,1209
050,01,003,"Alabama","Baldwin County",3,26,2457,1242,1215
050,01,003,"Alabama","Baldwin County",3,27,2442,1231,1211
050,01,003,"Alabama","Baldwin County",3,28,2561,1315,1246
050,01,003,"Alabama","Baldwin County",3,29,2656,1308,1348
050,01,003,"Alabama","Baldwin County",3,30,2772,1355,1417
050,01,003,"Alabama","Baldwin County",3,31,2820,1357,1463
050,01,003,"Alabama","Baldwin County",3,32,2765,1344,1421
050,01,003,"Alabama","Baldwin County",3,33,2720,1312,1408
050,01,003,"Alabama","Baldwin County",3,34,2710,1324,1386
050,01,003,"Alabama","Baldwin County",3,35,2764,1352,1412
050,01,003,"Alabama","Baldwin County",3,36,2830,1394,1436
050,01,003,"Alabama","Baldwin County",3,37,2768,1397,1371
050,01,003,"Alabama","Baldwin County",3,38,2841,1396,1445
050,01,003,"Alabama","Baldwin County",3,39,2968,1448,1520
050,01,003,"Alabama","Baldwin County",3,40,2997,1445,1552
050,01,003,"Alabama","Baldwin County",3,41,3069,1508,1561
050,01,003,"Alabama","Baldwin County",3,42,2983,1418,1565
050,01,003,"Alabama","Baldwin County",3,43,2911,1422,1489
050,01,003,"Alabama","Baldwin County",3,44,2929,1435,1494
050,01,003,"Alabama","Baldwin County",3,45,2774,1334,1440
050,01,003,"Alabama","Baldwin County",3,46,2813,1378,1435
050,01,003,"Alabama","Baldwin County",3,47,2904,1410,1494
050,01,003,"Alabama","Baldwin County",3,48,2957,1445,1512
050,01,003,"Alabama","Baldwin County",3,49,3067,1521,1546
050,01,003,"Alabama","Baldwin County",3,50,3347,1641,1706
050,01,003,"Alabama","Baldwin County",3,51,3280,1589,1691
050,01,003,"Alabama","Baldwin County",3,52,3167,1512,1655
050,01,003,"Alabama","Baldwin County",3,53,2995,1490,1505
050,01,003,"Alabama","Baldwin County",3,54,2987,1441,1546
050,01,003,"Alabama","Baldwin County",3,55,3062,1464,1598
050,01,003,"Alabama","Baldwin County",3,56,3344,1576,1768
050,01,003,"Alabama","Baldwin County",3,57,3471,1636,1835
050,01,003,"Alabama","Baldwin County",3,58,3514,1687,1827
050,01,003,"Alabama","Baldwin County",3,59,3476,1651,1825
050,01,003,"Alabama","Baldwin County",3,60,3601,1751,1850
050,01,003,"Alabama","Baldwin County",3,61,3637,1722,1915
050,01,003,"Alabama","Baldwin County",3,62,3539,1640,1899
050,01,003,"Alabama","Baldwin County",3,63,3500,1628,1872
050,01,003,"Alabama","Baldwin County",3,64,3547,1660,1887
050,01,003,"Alabama","Baldwin County",3,65,3593,1689,1904
050,01,003,"Alabama","Baldwin County",3,66,3485,1626,1859
050,01,003,"Alabama","Baldwin County",3,67,3337,1557,1780
050,01,003,"Alabama","Baldwin County",3,68,3178,1479,1699
050,01,003,"Alabama","Baldwin County",3,69,3076,1415,1661
050,01,003,"Alabama","Baldwin County",3,70,2984,1400,1584
050,01,003,"Alabama","Baldwin County",3,71,2870,1313,1557
050,01,003,"Alabama","Baldwin County",3,72,2882,1356,1526
050,01,003,"Alabama","Baldwin County",3,73,2852,1362,1490
050,01,003,"Alabama","Baldwin County",3,74,3114,1529,1585
050,01,003,"Alabama","Baldwin County",3,75,2115,1001,1114
050,01,003,"Alabama","Baldwin County",3,76,1989,949,1040
050,01,003,"Alabama","Baldwin County",3,77,1960,938,1022
050,01,003,"Alabama","Baldwin County",3,78,2009,964,1045
050,01,003,"Alabama","Baldwin County",3,79,1592,771,821
050,01,003,"Alabama","Baldwin County",3,80,1378,655,723
050,01,003,"Alabama","Baldwin County",3,81,1285,578,707
050,01,003,"Alabama","Baldwin County",3,82,1114,506,608
050,01,003,"Alabama","Baldwin County",3,83,1048,485,563
050,01,003,"Alabama","Baldwin County",3,84,903,396,507
050,01,003,"Alabama","Baldwin County",3,85,4404,1817,2587
050,01,003,"Alabama","Baldwin County",4,0,2525,1287,1238
050,01,003,"Alabama","Baldwin County",4,1,2396,1211,1185
050,01,003,"Alabama","Baldwin County",4,2,2512,1281,1231
050,01,003,"Alabama","Baldwin County",4,3,2544,1324,1220
050,01,003,"Alabama","Baldwin County",4,4,2664,1389,1275
050,01,003,"Alabama","Baldwin County",4,5,2718,1407,1311
050,01,003,"Alabama","Baldwin County",4,6,2843,1456,1387
050,01,003,"Alabama","Baldwin County",4,7,2792,1451,1341
050,01,003,"Alabama","Baldwin County",4,8,2913,1479,1434
050,01,003,"Alabama","Baldwin County",4,9,2936,1463,1473
050,01,003,"Alabama","Baldwin County",4,10,3021,1554,1467
050,01,003,"Alabama","Baldwin County",4,11,2971,1533,1438
050,01,003,"Alabama","Baldwin County",4,12,3081,1577,1504
050,01,003,"Alabama","Baldwin County",4,13,3156,1606,1550
050,01,003,"Alabama","Baldwin County",4,14,3257,1627,1630
050,01,003,"Alabama","Baldwin County",4,15,3348,1695,1653
050,01,003,"Alabama","Baldwin County",4,16,3257,1655,1602
050,01,003,"Alabama","Baldwin County",4,17,3205,1611,1594
050,01,003,"Alabama","Baldwin County",4,18,2724,1412,1312
050,01,003,"Alabama","Baldwin County",4,19,2246,1128,1118
050,01,003,"Alabama","Baldwin County",4,20,2372,1200,1172
050,01,003,"Alabama","Baldwin County",4,21,2456,1235,1221
050,01,003,"Alabama","Baldwin County",4,22,2500,1256,1244
050,01,003,"Alabama","Baldwin County",4,23,2521,1248,1273
050,01,003,"Alabama","Baldwin County",4,24,2533,1231,1302
050,01,003,"Alabama","Baldwin County",4,25,2501,1243,1258
050,01,003,"Alabama","Baldwin County",4,26,2471,1218,1253
050,01,003,"Alabama","Baldwin County",4,27,2570,1285,1285
050,01,003,"Alabama","Baldwin County",4,28,2572,1297,1275
050,01,003,"Alabama","Baldwin County",4,29,2656,1345,1311
050,01,003,"Alabama","Baldwin County",4,30,2750,1358,1392
050,01,003,"Alabama","Baldwin County",4,31,2895,1412,1483
050,01,003,"Alabama","Baldwin County",4,32,2967,1415,1552
050,01,003,"Alabama","Baldwin County",4,33,2902,1410,1492
050,01,003,"Alabama","Baldwin County",4,34,2813,1384,1429
050,01,003,"Alabama","Baldwin County",4,35,2797,1370,1427
050,01,003,"Alabama","Baldwin County",4,36,2886,1429,1457
050,01,003,"Alabama","Baldwin County",4,37,2955,1442,1513
050,01,003,"Alabama","Baldwin County",4,38,2845,1424,1421
050,01,003,"Alabama","Baldwin County",4,39,2936,1448,1488
050,01,003,"Alabama","Baldwin County",4,40,3082,1522,1560
050,01,003,"Alabama","Baldwin County",4,41,3086,1502,1584
050,01,003,"Alabama","Baldwin County",4,42,3123,1491,1632
050,01,003,"Alabama","Baldwin County",4,43,3134,1501,1633
050,01,003,"Alabama","Baldwin County",4,44,2995,1480,1515
050,01,003,"Alabama","Baldwin County",4,45,3030,1475,1555
050,01,003,"Alabama","Baldwin County",4,46,2858,1387,1471
050,01,003,"Alabama","Baldwin County",4,47,2929,1412,1517
050,01,003,"Alabama","Baldwin County",4,48,2989,1452,1537
050,01,003,"Alabama","Baldwin County",4,49,3060,1496,1564
050,01,003,"Alabama","Baldwin County",4,50,3196,1583,1613
050,01,003,"Alabama","Baldwin County",4,51,3511,1737,1774
050,01,003,"Alabama","Baldwin County",4,52,3392,1634,1758
050,01,003,"Alabama","Baldwin County",4,53,3268,1540,1728
050,01,003,"Alabama","Baldwin County",4,54,3088,1513,1575
050,01,003,"Alabama","Baldwin County",4,55,3096,1506,1590
050,01,003,"Alabama","Baldwin County",4,56,3185,1517,1668
050,01,003,"Alabama","Baldwin County",4,57,3483,1629,1854
050,01,003,"Alabama","Baldwin County",4,58,3558,1675,1883
050,01,003,"Alabama","Baldwin County",4,59,3657,1762,1895
050,01,003,"Alabama","Baldwin County",4,60,3627,1725,1902
050,01,003,"Alabama","Baldwin County",4,61,3757,1813,1944
050,01,003,"Alabama","Baldwin County",4,62,3754,1776,1978
050,01,003,"Alabama","Baldwin County",4,63,3629,1706,1923
050,01,003,"Alabama","Baldwin County",4,64,3618,1678,1940
050,01,003,"Alabama","Baldwin County",4,65,3600,1693,1907
050,01,003,"Alabama","Baldwin County",4,66,3663,1737,1926
050,01,003,"Alabama","Baldwin County",4,67,3534,1646,1888
050,01,003,"Alabama","Baldwin County",4,68,3380,1564,1816
050,01,003,"Alabama","Baldwin County",4,69,3195,1484,1711
050,01,003,"Alabama","Baldwin County",4,70,3052,1392,1660
050,01,003,"Alabama","Baldwin County",4,71,2959,1366,1593
050,01,003,"Alabama","Baldwin County",4,72,2903,1335,1568
050,01,003,"Alabama","Baldwin County",4,73,2853,1320,1533
050,01,003,"Alabama","Baldwin County",4,74,2821,1346,1475
050,01,003,"Alabama","Baldwin County",4,75,3042,1474,1568
050,01,003,"Alabama","Baldwin County",4,76,2021,967,1054
050,01,003,"Alabama","Baldwin County",4,77,1924,908,1016
050,01,003,"Alabama","Baldwin County",4,78,1937,942,995
050,01,003,"Alabama","Baldwin County",4,79,1918,904,1014
050,01,003,"Alabama","Baldwin County",4,80,1479,705,774
050,01,003,"Alabama","Baldwin County",4,81,1353,648,705
050,01,003,"Alabama","Baldwin County",4,82,1173,520,653
050,01,003,"Alabama","Baldwin County",4,83,1057,474,583
050,01,003,"Alabama","Baldwin County",4,84,988,437,551
050,01,003,"Alabama","Baldwin County",4,85,4567,1909,2658
050,01,003,"Alabama","Baldwin County",5,0,2559,1308,1251
050,01,003,"Alabama","Baldwin County",5,1,2570,1349,1221
050,01,003,"Alabama","Baldwin County",5,2,2492,1254,1238
050,01,003,"Alabama","Baldwin County",5,3,2594,1348,1246
050,01,003,"Alabama","Baldwin County",5,4,2645,1357,1288
050,01,003,"Alabama","Baldwin County",5,5,2817,1467,1350
050,01,003,"Alabama","Baldwin County",5,6,2835,1463,1372
050,01,003,"Alabama","Baldwin County",5,7,2923,1492,1431
050,01,003,"Alabama","Baldwin County",5,8,2886,1486,1400
050,01,003,"Alabama","Baldwin County",5,9,3014,1516,1498
050,01,003,"Alabama","Baldwin County",5,10,3044,1509,1535
050,01,003,"Alabama","Baldwin County",5,11,3099,1627,1472
050,01,003,"Alabama","Baldwin County",5,12,3123,1605,1518
050,01,003,"Alabama","Baldwin County",5,13,3183,1627,1556
050,01,003,"Alabama","Baldwin County",5,14,3260,1670,1590
050,01,003,"Alabama","Baldwin County",5,15,3359,1683,1676
050,01,003,"Alabama","Baldwin County",5,16,3377,1700,1677
050,01,003,"Alabama","Baldwin County",5,17,3330,1691,1639
050,01,003,"Alabama","Baldwin County",5,18,2772,1437,1335
050,01,003,"Alabama","Baldwin County",5,19,2328,1196,1132
050,01,003,"Alabama","Baldwin County",5,20,2440,1248,1192
050,01,003,"Alabama","Baldwin County",5,21,2481,1215,1266
050,01,003,"Alabama","Baldwin County",5,22,2637,1307,1330
050,01,003,"Alabama","Baldwin County",5,23,2626,1328,1298
050,01,003,"Alabama","Baldwin County",5,24,2553,1266,1287
050,01,003,"Alabama","Baldwin County",5,25,2604,1254,1350
050,01,003,"Alabama","Baldwin County",5,26,2607,1291,1316
050,01,003,"Alabama","Baldwin County",5,27,2574,1277,1297
050,01,003,"Alabama","Baldwin County",5,28,2656,1347,1309
050,01,003,"Alabama","Baldwin County",5,29,2665,1329,1336
050,01,003,"Alabama","Baldwin County",5,30,2781,1422,1359
050,01,003,"Alabama","Baldwin County",5,31,2874,1419,1455
050,01,003,"Alabama","Baldwin County",5,32,2998,1432,1566
050,01,003,"Alabama","Baldwin County",5,33,3067,1473,1594
050,01,003,"Alabama","Baldwin County",5,34,3050,1502,1548
050,01,003,"Alabama","Baldwin County",5,35,2918,1447,1471
050,01,003,"Alabama","Baldwin County",5,36,2892,1402,1490
050,01,003,"Alabama","Baldwin County",5,37,2965,1453,1512
050,01,003,"Alabama","Baldwin County",5,38,3051,1469,1582
050,01,003,"Alabama","Baldwin County",5,39,2967,1473,1494
050,01,003,"Alabama","Baldwin County",5,40,3055,1512,1543
050,01,003,"Alabama","Baldwin County",5,41,3214,1595,1619
050,01,003,"Alabama","Baldwin County",5,42,3133,1506,1627
050,01,003,"Alabama","Baldwin County",5,43,3218,1536,1682
050,01,003,"Alabama","Baldwin County",5,44,3178,1532,1646
050,01,003,"Alabama","Baldwin County",5,45,3091,1509,1582
050,01,003,"Alabama","Baldwin County",5,46,3076,1511,1565
050,01,003,"Alabama","Baldwin County",5,47,2983,1461,1522
050,01,003,"Alabama","Baldwin County",5,48,3030,1457,1573
050,01,003,"Alabama","Baldwin County",5,49,3033,1479,1554
050,01,003,"Alabama","Baldwin County",5,50,3133,1515,1618
050,01,003,"Alabama","Baldwin County",5,51,3342,1655,1687
050,01,003,"Alabama","Baldwin County",5,52,3592,1740,1852
050,01,003,"Alabama","Baldwin County",5,53,3509,1677,1832
050,01,003,"Alabama","Baldwin County",5,54,3377,1587,1790
050,01,003,"Alabama","Baldwin County",5,55,3191,1562,1629
050,01,003,"Alabama","Baldwin County",5,56,3188,1540,1648
050,01,003,"Alabama","Baldwin County",5,57,3332,1570,1762
050,01,003,"Alabama","Baldwin County",5,58,3605,1685,1920
050,01,003,"Alabama","Baldwin County",5,59,3706,1734,1972
050,01,003,"Alabama","Baldwin County",5,60,3756,1833,1923
050,01,003,"Alabama","Baldwin County",5,61,3742,1793,1949
050,01,003,"Alabama","Baldwin County",5,62,3883,1875,2008
050,01,003,"Alabama","Baldwin County",5,63,3853,1825,2028
050,01,003,"Alabama","Baldwin County",5,64,3748,1746,2002
050,01,003,"Alabama","Baldwin County",5,65,3720,1749,1971
050,01,003,"Alabama","Baldwin County",5,66,3660,1739,1921
050,01,003,"Alabama","Baldwin County",5,67,3657,1722,1935
050,01,003,"Alabama","Baldwin County",5,68,3549,1659,1890
050,01,003,"Alabama","Baldwin County",5,69,3420,1576,1844
050,01,003,"Alabama","Baldwin County",5,70,3207,1490,1717
050,01,003,"Alabama","Baldwin County",5,71,3035,1397,1638
050,01,003,"Alabama","Baldwin County",5,72,2982,1379,1603
050,01,003,"Alabama","Baldwin County",5,73,2858,1291,1567
050,01,003,"Alabama","Baldwin County",5,74,2817,1303,1514
050,01,003,"Alabama","Baldwin County",5,75,2788,1326,1462
050,01,003,"Alabama","Baldwin County",5,76,2972,1437,1535
050,01,003,"Alabama","Baldwin County",5,77,1988,945,1043
050,01,003,"Alabama","Baldwin County",5,78,1905,906,999
050,01,003,"Alabama","Baldwin County",5,79,1861,894,967
050,01,003,"Alabama","Baldwin County",5,80,1803,837,966
050,01,003,"Alabama","Baldwin County",5,81,1464,696,768
050,01,003,"Alabama","Baldwin County",5,82,1261,604,657
050,01,003,"Alabama","Baldwin County",5,83,1131,506,625
050,01,003,"Alabama","Baldwin County",5,84,998,428,570
050,01,003,"Alabama","Baldwin County",5,85,4847,2039,2808
050,01,005,"Alabama","Barbour County",1,0,247,122,125
050,01,005,"Alabama","Barbour County",1,1,277,136,141
050,01,005,"Alabama","Barbour County",1,2,291,160,131
050,01,005,"Alabama","Barbour County",1,3,272,146,126
050,01,005,"Alabama","Barbour County",1,4,277,136,141
050,01,005,"Alabama","Barbour County",1,5,263,131,132
050,01,005,"Alabama","Barbour County",1,6,251,121,130
050,01,005,"Alabama","Barbour County",1,7,259,127,132
050,01,005,"Alabama","Barbour County",1,8,314,152,162
050,01,005,"Alabama","Barbour County",1,9,328,157,171
050,01,005,"Alabama","Barbour County",1,10,324,167,157
050,01,005,"Alabama","Barbour County",1,11,316,156,160
050,01,005,"Alabama","Barbour County",1,12,334,161,173
050,01,005,"Alabama","Barbour County",1,13,354,185,169
050,01,005,"Alabama","Barbour County",1,14,321,158,163
050,01,005,"Alabama","Barbour County",1,15,301,156,145
050,01,005,"Alabama","Barbour County",1,16,302,157,145
050,01,005,"Alabama","Barbour County",1,17,322,164,158
050,01,005,"Alabama","Barbour County",1,18,290,152,138
050,01,005,"Alabama","Barbour County",1,19,257,140,117
050,01,005,"Alabama","Barbour County",1,20,267,149,118
050,01,005,"Alabama","Barbour County",1,21,275,160,115
050,01,005,"Alabama","Barbour County",1,22,307,186,121
050,01,005,"Alabama","Barbour County",1,23,304,188,116
050,01,005,"Alabama","Barbour County",1,24,314,194,120
050,01,005,"Alabama","Barbour County",1,25,353,211,142
050,01,005,"Alabama","Barbour County",1,26,333,212,121
050,01,005,"Alabama","Barbour County",1,27,347,210,137
050,01,005,"Alabama","Barbour County",1,28,352,222,130
050,01,005,"Alabama","Barbour County",1,29,348,223,125
050,01,005,"Alabama","Barbour County",1,30,361,235,126
050,01,005,"Alabama","Barbour County",1,31,346,212,134
050,01,005,"Alabama","Barbour County",1,32,319,197,122
050,01,005,"Alabama","Barbour County",1,33,325,188,137
050,01,005,"Alabama","Barbour County",1,34,310,168,142
050,01,005,"Alabama","Barbour County",1,35,354,195,159
050,01,005,"Alabama","Barbour County",1,36,327,182,145
050,01,005,"Alabama","Barbour County",1,37,302,170,132
050,01,005,"Alabama","Barbour County",1,38,305,188,117
050,01,005,"Alabama","Barbour County",1,39,323,191,132
050,01,005,"Alabama","Barbour County",1,40,352,218,134
050,01,005,"Alabama","Barbour County",1,41,313,192,121
050,01,005,"Alabama","Barbour County",1,42,299,183,116
050,01,005,"Alabama","Barbour County",1,43,289,179,110
050,01,005,"Alabama","Barbour County",1,44,274,164,110
050,01,005,"Alabama","Barbour County",1,45,295,177,118
050,01,005,"Alabama","Barbour County",1,46,311,177,134
050,01,005,"Alabama","Barbour County",1,47,333,191,142
050,01,005,"Alabama","Barbour County",1,48,356,196,160
050,01,005,"Alabama","Barbour County",1,49,316,168,148
050,01,005,"Alabama","Barbour County",1,50,298,176,122
050,01,005,"Alabama","Barbour County",1,51,303,169,134
050,01,005,"Alabama","Barbour County",1,52,296,159,137
050,01,005,"Alabama","Barbour County",1,53,304,160,144
050,01,005,"Alabama","Barbour County",1,54,325,171,154
050,01,005,"Alabama","Barbour County",1,55,338,175,163
050,01,005,"Alabama","Barbour County",1,56,365,188,177
050,01,005,"Alabama","Barbour County",1,57,352,162,190
050,01,005,"Alabama","Barbour County",1,58,345,176,169
050,01,005,"Alabama","Barbour County",1,59,317,165,152
050,01,005,"Alabama","Barbour County",1,60,328,166,162
050,01,005,"Alabama","Barbour County",1,61,303,158,145
050,01,005,"Alabama","Barbour County",1,62,302,157,145
050,01,005,"Alabama","Barbour County",1,63,293,137,156
050,01,005,"Alabama","Barbour County",1,64,320,149,171
050,01,005,"Alabama","Barbour County",1,65,320,155,165
050,01,005,"Alabama","Barbour County",1,66,304,140,164
050,01,005,"Alabama","Barbour County",1,67,312,144,168
050,01,005,"Alabama","Barbour County",1,68,295,139,156
050,01,005,"Alabama","Barbour County",1,69,298,133,165
050,01,005,"Alabama","Barbour County",1,70,309,139,170
050,01,005,"Alabama","Barbour County",1,71,281,123,158
050,01,005,"Alabama","Barbour County",1,72,284,128,156
050,01,005,"Alabama","Barbour County",1,73,298,124,174
050,01,005,"Alabama","Barbour County",1,74,240,112,128
050,01,005,"Alabama","Barbour County",1,75,213,101,112
050,01,005,"Alabama","Barbour County",1,76,200,87,113
050,01,005,"Alabama","Barbour County",1,77,224,97,127
050,01,005,"Alabama","Barbour County",1,78,172,83,89
050,01,005,"Alabama","Barbour County",1,79,142,65,77
050,01,005,"Alabama","Barbour County",1,80,130,58,72
050,01,005,"Alabama","Barbour County",1,81,128,57,71
050,01,005,"Alabama","Barbour County",1,82,112,48,64
050,01,005,"Alabama","Barbour County",1,83,94,35,59
050,01,005,"Alabama","Barbour County",1,84,102,40,62
050,01,005,"Alabama","Barbour County",1,85,472,156,316
050,01,005,"Alabama","Barbour County",2,0,252,124,128
050,01,005,"Alabama","Barbour County",2,1,269,132,137
050,01,005,"Alabama","Barbour County",2,2,287,154,133
050,01,005,"Alabama","Barbour County",2,3,275,148,127
050,01,005,"Alabama","Barbour County",2,4,276,139,137
050,01,005,"Alabama","Barbour County",2,5,265,132,133
050,01,005,"Alabama","Barbour County",2,6,251,123,128
050,01,005,"Alabama","Barbour County",2,7,256,125,131
050,01,005,"Alabama","Barbour County",2,8,297,144,153
050,01,005,"Alabama","Barbour County",2,9,326,156,170
050,01,005,"Alabama","Barbour County",2,10,328,166,162
050,01,005,"Alabama","Barbour County",2,11,318,158,160
050,01,005,"Alabama","Barbour County",2,12,335,161,174
050,01,005,"Alabama","Barbour County",2,13,350,181,169
050,01,005,"Alabama","Barbour County",2,14,330,166,164
050,01,005,"Alabama","Barbour County",2,15,308,156,152
050,01,005,"Alabama","Barbour County",2,16,300,156,144
050,01,005,"Alabama","Barbour County",2,17,317,162,155
050,01,005,"Alabama","Barbour County",2,18,284,150,134
050,01,005,"Alabama","Barbour County",2,19,256,138,118
050,01,005,"Alabama","Barbour County",2,20,269,149,120
050,01,005,"Alabama","Barbour County",2,21,276,160,116
050,01,005,"Alabama","Barbour County",2,22,302,182,120
050,01,005,"Alabama","Barbour County",2,23,303,184,119
050,01,005,"Alabama","Barbour County",2,24,300,180,120
050,01,005,"Alabama","Barbour County",2,25,339,203,136
050,01,005,"Alabama","Barbour County",2,26,329,202,127
050,01,005,"Alabama","Barbour County",2,27,333,200,133
050,01,005,"Alabama","Barbour County",2,28,340,209,131
050,01,005,"Alabama","Barbour County",2,29,339,214,125
050,01,005,"Alabama","Barbour County",2,30,352,225,127
050,01,005,"Alabama","Barbour County",2,31,334,203,131
050,01,005,"Alabama","Barbour County",2,32,318,194,124
050,01,005,"Alabama","Barbour County",2,33,311,177,134
050,01,005,"Alabama","Barbour County",2,34,304,162,142
050,01,005,"Alabama","Barbour County",2,35,337,180,157
050,01,005,"Alabama","Barbour County",2,36,324,176,148
050,01,005,"Alabama","Barbour County",2,37,302,168,134
050,01,005,"Alabama","Barbour County",2,38,303,181,122
050,01,005,"Alabama","Barbour County",2,39,311,182,129
050,01,005,"Alabama","Barbour County",2,40,344,206,138
050,01,005,"Alabama","Barbour County",2,41,318,193,125
050,01,005,"Alabama","Barbour County",2,42,293,178,115
050,01,005,"Alabama","Barbour County",2,43,290,178,112
050,01,005,"Alabama","Barbour County",2,44,266,158,108
050,01,005,"Alabama","Barbour County",2,45,287,170,117
050,01,005,"Alabama","Barbour County",2,46,300,169,131
050,01,005,"Alabama","Barbour County",2,47,320,181,139
050,01,005,"Alabama","Barbour County",2,48,349,191,158
050,01,005,"Alabama","Barbour County",2,49,320,169,151
050,01,005,"Alabama","Barbour County",2,50,295,168,127
050,01,005,"Alabama","Barbour County",2,51,295,166,129
050,01,005,"Alabama","Barbour County",2,52,293,157,136
050,01,005,"Alabama","Barbour County",2,53,300,156,144
050,01,005,"Alabama","Barbour County",2,54,317,167,150
050,01,005,"Alabama","Barbour County",2,55,330,170,160
050,01,005,"Alabama","Barbour County",2,56,355,183,172
050,01,005,"Alabama","Barbour County",2,57,347,162,185
050,01,005,"Alabama","Barbour County",2,58,349,176,173
050,01,005,"Alabama","Barbour County",2,59,320,163,157
050,01,005,"Alabama","Barbour County",2,60,324,164,160
050,01,005,"Alabama","Barbour County",2,61,306,157,149
050,01,005,"Alabama","Barbour County",2,62,298,154,144
050,01,005,"Alabama","Barbour County",2,63,293,139,154
050,01,005,"Alabama","Barbour County",2,64,313,145,168
050,01,005,"Alabama","Barbour County",2,65,317,151,166
050,01,005,"Alabama","Barbour County",2,66,307,142,165
050,01,005,"Alabama","Barbour County",2,67,308,142,166
050,01,005,"Alabama","Barbour County",2,68,296,138,158
050,01,005,"Alabama","Barbour County",2,69,299,133,166
050,01,005,"Alabama","Barbour County",2,70,305,138,167
050,01,005,"Alabama","Barbour County",2,71,288,126,162
050,01,005,"Alabama","Barbour County",2,72,279,125,154
050,01,005,"Alabama","Barbour County",2,73,306,129,177
050,01,005,"Alabama","Barbour County",2,74,235,108,127
050,01,005,"Alabama","Barbour County",2,75,220,102,118
050,01,005,"Alabama","Barbour County",2,76,200,89,111
050,01,005,"Alabama","Barbour County",2,77,222,95,127
050,01,005,"Alabama","Barbour County",2,78,180,84,96
050,01,005,"Alabama","Barbour County",2,79,146,69,77
050,01,005,"Alabama","Barbour County",2,80,130,60,70
050,01,005,"Alabama","Barbour County",2,81,127,56,71
050,01,005,"Alabama","Barbour County",2,82,112,48,64
050,01,005,"Alabama","Barbour County",2,83,96,36,60
050,01,005,"Alabama","Barbour County",2,84,97,38,59
050,01,005,"Alabama","Barbour County",2,85,471,155,316
050,01,005,"Alabama","Barbour County",3,0,266,138,128
050,01,005,"Alabama","Barbour County",3,1,256,124,132
050,01,005,"Alabama","Barbour County",3,2,253,131,122
050,01,005,"Alabama","Barbour County",3,3,281,155,126
050,01,005,"Alabama","Barbour County",3,4,261,138,123
050,01,005,"Alabama","Barbour County",3,5,269,135,134
050,01,005,"Alabama","Barbour County",3,6,256,125,131
050,01,005,"Alabama","Barbour County",3,7,260,127,133
050,01,005,"Alabama","Barbour County",3,8,254,122,132
050,01,005,"Alabama","Barbour County",3,9,284,139,145
050,01,005,"Alabama","Barbour County",3,10,312,136,176
050,01,005,"Alabama","Barbour County",3,11,332,165,167
050,01,005,"Alabama","Barbour County",3,12,310,155,155
050,01,005,"Alabama","Barbour County",3,13,344,169,175
050,01,005,"Alabama","Barbour County",3,14,345,174,171
050,01,005,"Alabama","Barbour County",3,15,324,164,160
050,01,005,"Alabama","Barbour County",3,16,308,153,155
050,01,005,"Alabama","Barbour County",3,17,298,156,142
050,01,005,"Alabama","Barbour County",3,18,265,138,127
050,01,005,"Alabama","Barbour County",3,19,247,133,114
050,01,005,"Alabama","Barbour County",3,20,270,148,122
050,01,005,"Alabama","Barbour County",3,21,281,168,113
050,01,005,"Alabama","Barbour County",3,22,302,178,124
050,01,005,"Alabama","Barbour County",3,23,303,179,124
050,01,005,"Alabama","Barbour County",3,24,270,168,102
050,01,005,"Alabama","Barbour County",3,25,295,181,114
050,01,005,"Alabama","Barbour County",3,26,336,198,138
050,01,005,"Alabama","Barbour County",3,27,304,182,122
050,01,005,"Alabama","Barbour County",3,28,325,190,135
050,01,005,"Alabama","Barbour County",3,29,348,220,128
050,01,005,"Alabama","Barbour County",3,30,355,231,124
050,01,005,"Alabama","Barbour County",3,31,307,191,116
050,01,005,"Alabama","Barbour County",3,32,317,198,119
050,01,005,"Alabama","Barbour County",3,33,298,177,121
050,01,005,"Alabama","Barbour County",3,34,294,158,136
050,01,005,"Alabama","Barbour County",3,35,284,156,128
050,01,005,"Alabama","Barbour County",3,36,331,181,150
050,01,005,"Alabama","Barbour County",3,37,309,163,146
050,01,005,"Alabama","Barbour County",3,38,312,181,131
050,01,005,"Alabama","Barbour County",3,39,293,173,120
050,01,005,"Alabama","Barbour County",3,40,305,177,128
050,01,005,"Alabama","Barbour County",3,41,336,200,136
050,01,005,"Alabama","Barbour County",3,42,323,189,134
050,01,005,"Alabama","Barbour County",3,43,295,185,110
050,01,005,"Alabama","Barbour County",3,44,272,167,105
050,01,005,"Alabama","Barbour County",3,45,271,156,115
050,01,005,"Alabama","Barbour County",3,46,276,154,122
050,01,005,"Alabama","Barbour County",3,47,287,161,126
050,01,005,"Alabama","Barbour County",3,48,311,178,133
050,01,005,"Alabama","Barbour County",3,49,333,177,156
050,01,005,"Alabama","Barbour County",3,50,320,169,151
050,01,005,"Alabama","Barbour County",3,51,287,162,125
050,01,005,"Alabama","Barbour County",3,52,290,154,136
050,01,005,"Alabama","Barbour County",3,53,304,161,143
050,01,005,"Alabama","Barbour County",3,54,295,152,143
050,01,005,"Alabama","Barbour County",3,55,313,158,155
050,01,005,"Alabama","Barbour County",3,56,311,164,147
050,01,005,"Alabama","Barbour County",3,57,352,179,173
050,01,005,"Alabama","Barbour County",3,58,355,171,184
050,01,005,"Alabama","Barbour County",3,59,349,175,174
050,01,005,"Alabama","Barbour County",3,60,314,159,155
050,01,005,"Alabama","Barbour County",3,61,322,161,161
050,01,005,"Alabama","Barbour County",3,62,306,157,149
050,01,005,"Alabama","Barbour County",3,63,285,147,138
050,01,005,"Alabama","Barbour County",3,64,294,137,157
050,01,005,"Alabama","Barbour County",3,65,297,139,158
050,01,005,"Alabama","Barbour County",3,66,314,150,164
050,01,005,"Alabama","Barbour County",3,67,296,136,160
050,01,005,"Alabama","Barbour County",3,68,300,135,165
050,01,005,"Alabama","Barbour County",3,69,291,133,158
050,01,005,"Alabama","Barbour County",3,70,288,133,155
050,01,005,"Alabama","Barbour County",3,71,292,132,160
050,01,005,"Alabama","Barbour County",3,72,283,119,164
050,01,005,"Alabama","Barbour County",3,73,270,119,151
050,01,005,"Alabama","Barbour County",3,74,289,124,165
050,01,005,"Alabama","Barbour County",3,75,225,98,127
050,01,005,"Alabama","Barbour County",3,76,208,100,108
050,01,005,"Alabama","Barbour County",3,77,186,81,105
050,01,005,"Alabama","Barbour County",3,78,216,91,125
050,01,005,"Alabama","Barbour County",3,79,168,76,92
050,01,005,"Alabama","Barbour County",3,80,134,59,75
050,01,005,"Alabama","Barbour County",3,81,122,51,71
050,01,005,"Alabama","Barbour County",3,82,112,48,64
050,01,005,"Alabama","Barbour County",3,83,100,42,58
050,01,005,"Alabama","Barbour County",3,84,85,30,55
050,01,005,"Alabama","Barbour County",3,85,492,167,325
050,01,005,"Alabama","Barbour County",4,0,276,146,130
050,01,005,"Alabama","Barbour County",4,1,253,132,121
050,01,005,"Alabama","Barbour County",4,2,261,124,137
050,01,005,"Alabama","Barbour County",4,3,239,122,117
050,01,005,"Alabama","Barbour County",4,4,284,162,122
050,01,005,"Alabama","Barbour County",4,5,257,139,118
050,01,005,"Alabama","Barbour County",4,6,271,141,130
050,01,005,"Alabama","Barbour County",4,7,257,133,124
050,01,005,"Alabama","Barbour County",4,8,256,128,128
050,01,005,"Alabama","Barbour County",4,9,258,121,137
050,01,005,"Alabama","Barbour County",4,10,284,137,147
050,01,005,"Alabama","Barbour County",4,11,301,129,172
050,01,005,"Alabama","Barbour County",4,12,326,160,166
050,01,005,"Alabama","Barbour County",4,13,300,146,154
050,01,005,"Alabama","Barbour County",4,14,333,162,171
050,01,005,"Alabama","Barbour County",4,15,350,179,171
050,01,005,"Alabama","Barbour County",4,16,316,160,156
050,01,005,"Alabama","Barbour County",4,17,309,160,149
050,01,005,"Alabama","Barbour County",4,18,265,144,121
050,01,005,"Alabama","Barbour County",4,19,225,125,100
050,01,005,"Alabama","Barbour County",4,20,264,146,118
050,01,005,"Alabama","Barbour County",4,21,287,163,124
050,01,005,"Alabama","Barbour County",4,22,315,191,124
050,01,005,"Alabama","Barbour County",4,23,329,193,136
050,01,005,"Alabama","Barbour County",4,24,289,177,112
050,01,005,"Alabama","Barbour County",4,25,305,195,110
050,01,005,"Alabama","Barbour County",4,26,326,201,125
050,01,005,"Alabama","Barbour County",4,27,331,202,129
050,01,005,"Alabama","Barbour County",4,28,309,198,111
050,01,005,"Alabama","Barbour County",4,29,325,200,125
050,01,005,"Alabama","Barbour County",4,30,361,239,122
050,01,005,"Alabama","Barbour County",4,31,361,240,121
050,01,005,"Alabama","Barbour County",4,32,326,214,112
050,01,005,"Alabama","Barbour County",4,33,313,198,115
050,01,005,"Alabama","Barbour County",4,34,314,182,132
050,01,005,"Alabama","Barbour County",4,35,313,174,139
050,01,005,"Alabama","Barbour County",4,36,301,169,132
050,01,005,"Alabama","Barbour County",4,37,333,186,147
050,01,005,"Alabama","Barbour County",4,38,331,189,142
050,01,005,"Alabama","Barbour County",4,39,296,171,125
050,01,005,"Alabama","Barbour County",4,40,293,178,115
050,01,005,"Alabama","Barbour County",4,41,310,190,120
050,01,005,"Alabama","Barbour County",4,42,315,175,140
050,01,005,"Alabama","Barbour County",4,43,342,206,136
050,01,005,"Alabama","Barbour County",4,44,291,187,104
050,01,005,"Alabama","Barbour County",4,45,285,183,102
050,01,005,"Alabama","Barbour County",4,46,273,155,118
050,01,005,"Alabama","Barbour County",4,47,280,160,120
050,01,005,"Alabama","Barbour County",4,48,290,166,124
050,01,005,"Alabama","Barbour County",4,49,311,174,137
050,01,005,"Alabama","Barbour County",4,50,338,187,151
050,01,005,"Alabama","Barbour County",4,51,319,171,148
050,01,005,"Alabama","Barbour County",4,52,286,155,131
050,01,005,"Alabama","Barbour County",4,53,301,165,136
050,01,005,"Alabama","Barbour County",4,54,300,165,135
050,01,005,"Alabama","Barbour County",4,55,304,155,149
050,01,005,"Alabama","Barbour County",4,56,306,158,148
050,01,005,"Alabama","Barbour County",4,57,295,148,147
050,01,005,"Alabama","Barbour County",4,58,366,193,173
050,01,005,"Alabama","Barbour County",4,59,346,167,179
050,01,005,"Alabama","Barbour County",4,60,347,174,173
050,01,005,"Alabama","Barbour County",4,61,318,162,156
050,01,005,"Alabama","Barbour County",4,62,332,170,162
050,01,005,"Alabama","Barbour County",4,63,296,148,148
050,01,005,"Alabama","Barbour County",4,64,292,147,145
050,01,005,"Alabama","Barbour County",4,65,287,131,156
050,01,005,"Alabama","Barbour County",4,66,295,138,157
050,01,005,"Alabama","Barbour County",4,67,315,148,167
050,01,005,"Alabama","Barbour County",4,68,292,130,162
050,01,005,"Alabama","Barbour County",4,69,294,129,165
050,01,005,"Alabama","Barbour County",4,70,278,127,151
050,01,005,"Alabama","Barbour County",4,71,276,123,153
050,01,005,"Alabama","Barbour County",4,72,286,130,156
050,01,005,"Alabama","Barbour County",4,73,273,116,157
050,01,005,"Alabama","Barbour County",4,74,265,123,142
050,01,005,"Alabama","Barbour County",4,75,275,114,161
050,01,005,"Alabama","Barbour County",4,76,217,93,124
050,01,005,"Alabama","Barbour County",4,77,199,95,104
050,01,005,"Alabama","Barbour County",4,78,181,77,104
050,01,005,"Alabama","Barbour County",4,79,197,84,113
050,01,005,"Alabama","Barbour County",4,80,155,71,84
050,01,005,"Alabama","Barbour County",4,81,131,54,77
050,01,005,"Alabama","Barbour County",4,82,108,44,64
050,01,005,"Alabama","Barbour County",4,83,95,40,55
050,01,005,"Alabama","Barbour County",4,84,92,41,51
050,01,005,"Alabama","Barbour County",4,85,503,168,335
050,01,005,"Alabama","Barbour County",5,0,265,138,127
050,01,005,"Alabama","Barbour County",5,1,270,147,123
050,01,005,"Alabama","Barbour County",5,2,256,137,119
050,01,005,"Alabama","Barbour County",5,3,268,131,137
050,01,005,"Alabama","Barbour County",5,4,248,123,125
050,01,005,"Alabama","Barbour County",5,5,290,167,123
050,01,005,"Alabama","Barbour County",5,6,261,136,125
050,01,005,"Alabama","Barbour County",5,7,268,140,128
050,01,005,"Alabama","Barbour County",5,8,257,128,129
050,01,005,"Alabama","Barbour County",5,9,243,124,119
050,01,005,"Alabama","Barbour County",5,10,249,117,132
050,01,005,"Alabama","Barbour County",5,11,283,137,146
050,01,005,"Alabama","Barbour County",5,12,295,132,163
050,01,005,"Alabama","Barbour County",5,13,333,165,168
050,01,005,"Alabama","Barbour County",5,14,289,136,153
050,01,005,"Alabama","Barbour County",5,15,333,164,169
050,01,005,"Alabama","Barbour County",5,16,345,176,169
050,01,005,"Alabama","Barbour County",5,17,315,162,153
050,01,005,"Alabama","Barbour County",5,18,257,136,121
050,01,005,"Alabama","Barbour County",5,19,227,126,101
050,01,005,"Alabama","Barbour County",5,20,247,139,108
050,01,005,"Alabama","Barbour County",5,21,291,169,122
050,01,005,"Alabama","Barbour County",5,22,313,182,131
050,01,005,"Alabama","Barbour County",5,23,332,202,130
050,01,005,"Alabama","Barbour County",5,24,316,191,125
050,01,005,"Alabama","Barbour County",5,25,293,190,103
050,01,005,"Alabama","Barbour County",5,26,314,200,114
050,01,005,"Alabama","Barbour County",5,27,321,198,123
050,01,005,"Alabama","Barbour County",5,28,343,206,137
050,01,005,"Alabama","Barbour County",5,29,314,206,108
050,01,005,"Alabama","Barbour County",5,30,343,219,124
050,01,005,"Alabama","Barbour County",5,31,350,227,123
050,01,005,"Alabama","Barbour County",5,32,347,227,120
050,01,005,"Alabama","Barbour County",5,33,304,196,108
050,01,005,"Alabama","Barbour County",5,34,306,188,118
050,01,005,"Alabama","Barbour County",5,35,315,181,134
050,01,005,"Alabama","Barbour County",5,36,298,167,131
050,01,005,"Alabama","Barbour County",5,37,292,163,129
050,01,005,"Alabama","Barbour County",5,38,359,209,150
050,01,005,"Alabama","Barbour County",5,39,311,170,141
050,01,005,"Alabama","Barbour County",5,40,288,167,121
050,01,005,"Alabama","Barbour County",5,41,293,175,118
050,01,005,"Alabama","Barbour County",5,42,300,181,119
050,01,005,"Alabama","Barbour County",5,43,327,195,132
050,01,005,"Alabama","Barbour County",5,44,326,195,131
050,01,005,"Alabama","Barbour County",5,45,301,194,107
050,01,005,"Alabama","Barbour County",5,46,285,176,109
050,01,005,"Alabama","Barbour County",5,47,270,156,114
050,01,005,"Alabama","Barbour County",5,48,276,156,120
050,01,005,"Alabama","Barbour County",5,49,271,157,114
050,01,005,"Alabama","Barbour County",5,50,310,173,137
050,01,005,"Alabama","Barbour County",5,51,329,183,146
050,01,005,"Alabama","Barbour County",5,52,308,158,150
050,01,005,"Alabama","Barbour County",5,53,289,159,130
050,01,005,"Alabama","Barbour County",5,54,301,168,133
050,01,005,"Alabama","Barbour County",5,55,301,158,143
050,01,005,"Alabama","Barbour County",5,56,290,145,145
050,01,005,"Alabama","Barbour County",5,57,296,143,153
050,01,005,"Alabama","Barbour County",5,58,306,161,145
050,01,005,"Alabama","Barbour County",5,59,364,189,175
050,01,005,"Alabama","Barbour County",5,60,349,174,175
050,01,005,"Alabama","Barbour County",5,61,341,169,172
050,01,005,"Alabama","Barbour County",5,62,315,158,157
050,01,005,"Alabama","Barbour County",5,63,327,165,162
050,01,005,"Alabama","Barbour County",5,64,301,150,151
050,01,005,"Alabama","Barbour County",5,65,279,137,142
050,01,005,"Alabama","Barbour County",5,66,288,133,155
050,01,005,"Alabama","Barbour County",5,67,293,139,154
050,01,005,"Alabama","Barbour County",5,68,308,143,165
050,01,005,"Alabama","Barbour County",5,69,281,120,161
050,01,005,"Alabama","Barbour County",5,70,285,131,154
050,01,005,"Alabama","Barbour County",5,71,276,126,150
050,01,005,"Alabama","Barbour County",5,72,269,119,150
050,01,005,"Alabama","Barbour County",5,73,274,124,150
050,01,005,"Alabama","Barbour County",5,74,260,113,147
050,01,005,"Alabama","Barbour County",5,75,257,115,142
050,01,005,"Alabama","Barbour County",5,76,265,111,154
050,01,005,"Alabama","Barbour County",5,77,210,90,120
050,01,005,"Alabama","Barbour County",5,78,194,91,103
050,01,005,"Alabama","Barbour County",5,79,165,69,96
050,01,005,"Alabama","Barbour County",5,80,191,82,109
050,01,005,"Alabama","Barbour County",5,81,145,63,82
050,01,005,"Alabama","Barbour County",5,82,114,46,68
050,01,005,"Alabama","Barbour County",5,83,95,36,59
050,01,005,"Alabama","Barbour County",5,84,84,34,50
050,01,005,"Alabama","Barbour County",5,85,527,187,340
050,01,007,"Alabama","Bibb County",1,0,241,121,120
050,01,007,"Alabama","Bibb County",1,1,236,111,125
050,01,007,"Alabama","Bibb County",1,2,239,111,128
050,01,007,"Alabama","Bibb County",1,3,252,128,124
050,01,007,"Alabama","Bibb County",1,4,266,131,135
050,01,007,"Alabama","Bibb County",1,5,241,124,117
050,01,007,"Alabama","Bibb County",1,6,246,135,111
050,01,007,"Alabama","Bibb County",1,7,250,130,120
050,01,007,"Alabama","Bibb County",1,8,228,113,115
050,01,007,"Alabama","Bibb County",1,9,237,127,110
050,01,007,"Alabama","Bibb County",1,10,232,124,108
050,01,007,"Alabama","Bibb County",1,11,241,121,120
050,01,007,"Alabama","Bibb County",1,12,263,138,125
050,01,007,"Alabama","Bibb County",1,13,284,148,136
050,01,007,"Alabama","Bibb County",1,14,260,133,127
050,01,007,"Alabama","Bibb County",1,15,251,139,112
050,01,007,"Alabama","Bibb County",1,16,284,149,135
050,01,007,"Alabama","Bibb County",1,17,267,139,128
050,01,007,"Alabama","Bibb County",1,18,232,126,106
050,01,007,"Alabama","Bibb County",1,19,188,112,76
050,01,007,"Alabama","Bibb County",1,20,207,121,86
050,01,007,"Alabama","Bibb County",1,21,249,140,109
050,01,007,"Alabama","Bibb County",1,22,258,145,113
050,01,007,"Alabama","Bibb County",1,23,286,178,108
050,01,007,"Alabama","Bibb County",1,24,297,175,122
050,01,007,"Alabama","Bibb County",1,25,321,187,134
050,01,007,"Alabama","Bibb County",1,26,318,187,131
050,01,007,"Alabama","Bibb County",1,27,348,204,144
050,01,007,"Alabama","Bibb County",1,28,322,180,142
050,01,007,"Alabama","Bibb County",1,29,353,208,145
050,01,007,"Alabama","Bibb County",1,30,331,195,136
050,01,007,"Alabama","Bibb County",1,31,335,194,141
050,01,007,"Alabama","Bibb County",1,32,322,194,128
050,01,007,"Alabama","Bibb County",1,33,301,178,123
050,01,007,"Alabama","Bibb County",1,34,315,194,121
050,01,007,"Alabama","Bibb County",1,35,302,179,123
050,01,007,"Alabama","Bibb County",1,36,327,202,125
050,01,007,"Alabama","Bibb County",1,37,310,187,123
050,01,007,"Alabama","Bibb County",1,38,290,175,115
050,01,007,"Alabama","Bibb County",1,39,300,164,136
050,01,007,"Alabama","Bibb County",1,40,287,166,121
050,01,007,"Alabama","Bibb County",1,41,280,165,115
050,01,007,"Alabama","Bibb County",1,42,270,146,124
050,01,007,"Alabama","Bibb County",1,43,279,153,126
050,01,007,"Alabama","Bibb County",1,44,300,176,124
050,01,007,"Alabama","Bibb County",1,45,320,178,142
050,01,007,"Alabama","Bibb County",1,46,311,173,138
050,01,007,"Alabama","Bibb County",1,47,310,176,134
050,01,007,"Alabama","Bibb County",1,48,350,197,153
050,01,007,"Alabama","Bibb County",1,49,335,180,155
050,01,007,"Alabama","Bibb County",1,50,307,174,133
050,01,007,"Alabama","Bibb County",1,51,291,157,134
050,01,007,"Alabama","Bibb County",1,52,316,167,149
050,01,007,"Alabama","Bibb County",1,53,293,157,136
050,01,007,"Alabama","Bibb County",1,54,302,159,143
050,01,007,"Alabama","Bibb County",1,55,311,164,147
050,01,007,"Alabama","Bibb County",1,56,334,184,150
050,01,007,"Alabama","Bibb County",1,57,333,180,153
050,01,007,"Alabama","Bibb County",1,58,296,147,149
050,01,007,"Alabama","Bibb County",1,59,289,148,141
050,01,007,"Alabama","Bibb County",1,60,266,136,130
050,01,007,"Alabama","Bibb County",1,61,303,159,144
050,01,007,"Alabama","Bibb County",1,62,298,151,147
050,01,007,"Alabama","Bibb County",1,63,247,124,123
050,01,007,"Alabama","Bibb County",1,64,267,128,139
050,01,007,"Alabama","Bibb County",1,65,253,116,137
050,01,007,"Alabama","Bibb County",1,66,221,115,106
050,01,007,"Alabama","Bibb County",1,67,235,111,124
050,01,007,"Alabama","Bibb County",1,68,246,115,131
050,01,007,"Alabama","Bibb County",1,69,217,105,112
050,01,007,"Alabama","Bibb County",1,70,217,107,110
050,01,007,"Alabama","Bibb County",1,71,215,107,108
050,01,007,"Alabama","Bibb County",1,72,218,103,115
050,01,007,"Alabama","Bibb County",1,73,235,110,125
050,01,007,"Alabama","Bibb County",1,74,166,72,94
050,01,007,"Alabama","Bibb County",1,75,164,70,94
050,01,007,"Alabama","Bibb County",1,76,133,59,74
050,01,007,"Alabama","Bibb County",1,77,138,61,77
050,01,007,"Alabama","Bibb County",1,78,140,60,80
050,01,007,"Alabama","Bibb County",1,79,122,53,69
050,01,007,"Alabama","Bibb County",1,80,127,59,68
050,01,007,"Alabama","Bibb County",1,81,114,48,66
050,01,007,"Alabama","Bibb County",1,82,91,37,54
050,01,007,"Alabama","Bibb County",1,83,63,19,44
050,01,007,"Alabama","Bibb County",1,84,66,24,42
050,01,007,"Alabama","Bibb County",1,85,395,124,271
050,01,007,"Alabama","Bibb County",2,0,237,116,121
050,01,007,"Alabama","Bibb County",2,1,234,111,123
050,01,007,"Alabama","Bibb County",2,2,237,111,126
050,01,007,"Alabama","Bibb County",2,3,247,124,123
050,01,007,"Alabama","Bibb County",2,4,261,129,132
050,01,007,"Alabama","Bibb County",2,5,246,125,121
050,01,007,"Alabama","Bibb County",2,6,244,132,112
050,01,007,"Alabama","Bibb County",2,7,247,131,116
050,01,007,"Alabama","Bibb County",2,8,233,117,116
050,01,007,"Alabama","Bibb County",2,9,237,126,111
050,01,007,"Alabama","Bibb County",2,10,235,126,109
050,01,007,"Alabama","Bibb County",2,11,236,121,115
050,01,007,"Alabama","Bibb County",2,12,259,135,124
050,01,007,"Alabama","Bibb County",2,13,275,142,133
050,01,007,"Alabama","Bibb County",2,14,264,135,129
050,01,007,"Alabama","Bibb County",2,15,253,137,116
050,01,007,"Alabama","Bibb County",2,16,275,148,127
050,01,007,"Alabama","Bibb County",2,17,268,140,128
050,01,007,"Alabama","Bibb County",2,18,226,123,103
050,01,007,"Alabama","Bibb County",2,19,188,110,78
050,01,007,"Alabama","Bibb County",2,20,212,125,87
050,01,007,"Alabama","Bibb County",2,21,247,141,106
050,01,007,"Alabama","Bibb County",2,22,262,146,116
050,01,007,"Alabama","Bibb County",2,23,282,172,110
050,01,007,"Alabama","Bibb County",2,24,292,175,117
050,01,007,"Alabama","Bibb County",2,25,313,182,131
050,01,007,"Alabama","Bibb County",2,26,315,182,133
050,01,007,"Alabama","Bibb County",2,27,340,200,140
050,01,007,"Alabama","Bibb County",2,28,322,181,141
050,01,007,"Alabama","Bibb County",2,29,347,203,144
050,01,007,"Alabama","Bibb County",2,30,327,191,136
050,01,007,"Alabama","Bibb County",2,31,331,194,137
050,01,007,"Alabama","Bibb County",2,32,318,189,129
050,01,007,"Alabama","Bibb County",2,33,300,179,121
050,01,007,"Alabama","Bibb County",2,34,307,187,120
050,01,007,"Alabama","Bibb County",2,35,301,177,124
050,01,007,"Alabama","Bibb County",2,36,315,191,124
050,01,007,"Alabama","Bibb County",2,37,308,184,124
050,01,007,"Alabama","Bibb County",2,38,299,181,118
050,01,007,"Alabama","Bibb County",2,39,291,160,131
050,01,007,"Alabama","Bibb County",2,40,288,161,127
050,01,007,"Alabama","Bibb County",2,41,276,162,114
050,01,007,"Alabama","Bibb County",2,42,268,146,122
050,01,007,"Alabama","Bibb County",2,43,280,152,128
050,01,007,"Alabama","Bibb County",2,44,294,171,123
050,01,007,"Alabama","Bibb County",2,45,315,176,139
050,01,007,"Alabama","Bibb County",2,46,305,167,138
050,01,007,"Alabama","Bibb County",2,47,310,177,133
050,01,007,"Alabama","Bibb County",2,48,338,191,147
050,01,007,"Alabama","Bibb County",2,49,334,179,155
050,01,007,"Alabama","Bibb County",2,50,311,175,136
050,01,007,"Alabama","Bibb County",2,51,290,156,134
050,01,007,"Alabama","Bibb County",2,52,308,162,146
050,01,007,"Alabama","Bibb County",2,53,294,157,137
050,01,007,"Alabama","Bibb County",2,54,296,156,140
050,01,007,"Alabama","Bibb County",2,55,310,163,147
050,01,007,"Alabama","Bibb County",2,56,329,179,150
050,01,007,"Alabama","Bibb County",2,57,330,178,152
050,01,007,"Alabama","Bibb County",2,58,304,153,151
050,01,007,"Alabama","Bibb County",2,59,293,150,143
050,01,007,"Alabama","Bibb County",2,60,272,139,133
050,01,007,"Alabama","Bibb County",2,61,292,152,140
050,01,007,"Alabama","Bibb County",2,62,297,150,147
050,01,007,"Alabama","Bibb County",2,63,259,131,128
050,01,007,"Alabama","Bibb County",2,64,261,127,134
050,01,007,"Alabama","Bibb County",2,65,253,117,136
050,01,007,"Alabama","Bibb County",2,66,230,116,114
050,01,007,"Alabama","Bibb County",2,67,233,112,121
050,01,007,"Alabama","Bibb County",2,68,236,109,127
050,01,007,"Alabama","Bibb County",2,69,222,106,116
050,01,007,"Alabama","Bibb County",2,70,215,106,109
050,01,007,"Alabama","Bibb County",2,71,217,108,109
050,01,007,"Alabama","Bibb County",2,72,214,102,112
050,01,007,"Alabama","Bibb County",2,73,241,112,129
050,01,007,"Alabama","Bibb County",2,74,172,77,95
050,01,007,"Alabama","Bibb County",2,75,164,69,95
050,01,007,"Alabama","Bibb County",2,76,139,61,78
050,01,007,"Alabama","Bibb County",2,77,141,61,80
050,01,007,"Alabama","Bibb County",2,78,135,56,79
050,01,007,"Alabama","Bibb County",2,79,124,55,69
050,01,007,"Alabama","Bibb County",2,80,125,58,67
050,01,007,"Alabama","Bibb County",2,81,116,51,65
050,01,007,"Alabama","Bibb County",2,82,94,38,56
050,01,007,"Alabama","Bibb County",2,83,70,23,47
050,01,007,"Alabama","Bibb County",2,84,64,24,40
050,01,007,"Alabama","Bibb County",2,85,398,122,276
050,01,007,"Alabama","Bibb County",3,0,236,125,111
050,01,007,"Alabama","Bibb County",3,1,245,121,124
050,01,007,"Alabama","Bibb County",3,2,236,109,127
050,01,007,"Alabama","Bibb County",3,3,231,104,127
050,01,007,"Alabama","Bibb County",3,4,248,124,124
050,01,007,"Alabama","Bibb County",3,5,266,137,129
050,01,007,"Alabama","Bibb County",3,6,244,120,124
050,01,007,"Alabama","Bibb County",3,7,253,134,119
050,01,007,"Alabama","Bibb County",3,8,256,136,120
050,01,007,"Alabama","Bibb County",3,9,229,121,108
050,01,007,"Alabama","Bibb County",3,10,235,122,113
050,01,007,"Alabama","Bibb County",3,11,233,125,108
050,01,007,"Alabama","Bibb County",3,12,237,124,113
050,01,007,"Alabama","Bibb County",3,13,272,143,129
050,01,007,"Alabama","Bibb County",3,14,282,143,139
050,01,007,"Alabama","Bibb County",3,15,270,145,125
050,01,007,"Alabama","Bibb County",3,16,258,139,119
050,01,007,"Alabama","Bibb County",3,17,281,161,120
050,01,007,"Alabama","Bibb County",3,18,225,117,108
050,01,007,"Alabama","Bibb County",3,19,188,104,84
050,01,007,"Alabama","Bibb County",3,20,210,118,92
050,01,007,"Alabama","Bibb County",3,21,243,149,94
050,01,007,"Alabama","Bibb County",3,22,263,146,117
050,01,007,"Alabama","Bibb County",3,23,293,172,121
050,01,007,"Alabama","Bibb County",3,24,292,181,111
050,01,007,"Alabama","Bibb County",3,25,301,174,127
050,01,007,"Alabama","Bibb County",3,26,311,190,121
050,01,007,"Alabama","Bibb County",3,27,335,205,130
050,01,007,"Alabama","Bibb County",3,28,319,184,135
050,01,007,"Alabama","Bibb County",3,29,354,204,150
050,01,007,"Alabama","Bibb County",3,30,330,186,144
050,01,007,"Alabama","Bibb County",3,31,346,220,126
050,01,007,"Alabama","Bibb County",3,32,337,199,138
050,01,007,"Alabama","Bibb County",3,33,330,203,127
050,01,007,"Alabama","Bibb County",3,34,314,185,129
050,01,007,"Alabama","Bibb County",3,35,298,175,123
050,01,007,"Alabama","Bibb County",3,36,303,174,129
050,01,007,"Alabama","Bibb County",3,37,312,188,124
050,01,007,"Alabama","Bibb County",3,38,322,198,124
050,01,007,"Alabama","Bibb County",3,39,303,180,123
050,01,007,"Alabama","Bibb County",3,40,283,157,126
050,01,007,"Alabama","Bibb County",3,41,281,161,120
050,01,007,"Alabama","Bibb County",3,42,282,169,113
050,01,007,"Alabama","Bibb County",3,43,276,155,121
050,01,007,"Alabama","Bibb County",3,44,299,175,124
050,01,007,"Alabama","Bibb County",3,45,304,176,128
050,01,007,"Alabama","Bibb County",3,46,298,164,134
050,01,007,"Alabama","Bibb County",3,47,325,190,135
050,01,007,"Alabama","Bibb County",3,48,309,177,132
050,01,007,"Alabama","Bibb County",3,49,314,172,142
050,01,007,"Alabama","Bibb County",3,50,349,191,158
050,01,007,"Alabama","Bibb County",3,51,304,175,129
050,01,007,"Alabama","Bibb County",3,52,282,152,130
050,01,007,"Alabama","Bibb County",3,53,306,152,154
050,01,007,"Alabama","Bibb County",3,54,286,153,133
050,01,007,"Alabama","Bibb County",3,55,304,159,145
050,01,007,"Alabama","Bibb County",3,56,316,166,150
050,01,007,"Alabama","Bibb County",3,57,340,179,161
050,01,007,"Alabama","Bibb County",3,58,313,171,142
050,01,007,"Alabama","Bibb County",3,59,314,163,151
050,01,007,"Alabama","Bibb County",3,60,287,145,142
050,01,007,"Alabama","Bibb County",3,61,266,137,129
050,01,007,"Alabama","Bibb County",3,62,290,147,143
050,01,007,"Alabama","Bibb County",3,63,284,148,136
050,01,007,"Alabama","Bibb County",3,64,261,130,131
050,01,007,"Alabama","Bibb County",3,65,246,118,128
050,01,007,"Alabama","Bibb County",3,66,250,113,137
050,01,007,"Alabama","Bibb County",3,67,231,118,113
050,01,007,"Alabama","Bibb County",3,68,222,102,120
050,01,007,"Alabama","Bibb County",3,69,239,113,126
050,01,007,"Alabama","Bibb County",3,70,214,101,113
050,01,007,"Alabama","Bibb County",3,71,210,100,110
050,01,007,"Alabama","Bibb County",3,72,208,101,107
050,01,007,"Alabama","Bibb County",3,73,199,92,107
050,01,007,"Alabama","Bibb County",3,74,239,114,125
050,01,007,"Alabama","Bibb County",3,75,158,66,92
050,01,007,"Alabama","Bibb County",3,76,157,67,90
050,01,007,"Alabama","Bibb County",3,77,134,58,76
050,01,007,"Alabama","Bibb County",3,78,142,52,90
050,01,007,"Alabama","Bibb County",3,79,120,53,67
050,01,007,"Alabama","Bibb County",3,80,115,54,61
050,01,007,"Alabama","Bibb County",3,81,110,51,59
050,01,007,"Alabama","Bibb County",3,82,111,44,67
050,01,007,"Alabama","Bibb County",3,83,85,34,51
050,01,007,"Alabama","Bibb County",3,84,62,24,38
050,01,007,"Alabama","Bibb County",3,85,393,120,273
050,01,007,"Alabama","Bibb County",4,0,233,101,132
050,01,007,"Alabama","Bibb County",4,1,231,122,109
050,01,007,"Alabama","Bibb County",4,2,243,126,117
050,01,007,"Alabama","Bibb County",4,3,219,103,116
050,01,007,"Alabama","Bibb County",4,4,229,105,124
050,01,007,"Alabama","Bibb County",4,5,245,122,123
050,01,007,"Alabama","Bibb County",4,6,251,129,122
050,01,007,"Alabama","Bibb County",4,7,242,115,127
050,01,007,"Alabama","Bibb County",4,8,246,129,117
050,01,007,"Alabama","Bibb County",4,9,253,133,120
050,01,007,"Alabama","Bibb County",4,10,230,124,106
050,01,007,"Alabama","Bibb County",4,11,234,121,113
050,01,007,"Alabama","Bibb County",4,12,233,126,107
050,01,007,"Alabama","Bibb County",4,13,234,120,114
050,01,007,"Alabama","Bibb County",4,14,267,140,127
050,01,007,"Alabama","Bibb County",4,15,276,138,138
050,01,007,"Alabama","Bibb County",4,16,269,148,121
050,01,007,"Alabama","Bibb County",4,17,257,141,116
050,01,007,"Alabama","Bibb County",4,18,228,133,95
050,01,007,"Alabama","Bibb County",4,19,180,102,78
050,01,007,"Alabama","Bibb County",4,20,197,110,87
050,01,007,"Alabama","Bibb County",4,21,233,148,85
050,01,007,"Alabama","Bibb County",4,22,267,161,106
050,01,007,"Alabama","Bibb County",4,23,274,154,120
050,01,007,"Alabama","Bibb County",4,24,295,174,121
050,01,007,"Alabama","Bibb County",4,25,288,178,110
050,01,007,"Alabama","Bibb County",4,26,275,160,115
050,01,007,"Alabama","Bibb County",4,27,311,189,122
050,01,007,"Alabama","Bibb County",4,28,324,204,120
050,01,007,"Alabama","Bibb County",4,29,334,199,135
050,01,007,"Alabama","Bibb County",4,30,317,184,133
050,01,007,"Alabama","Bibb County",4,31,322,185,137
050,01,007,"Alabama","Bibb County",4,32,337,219,118
050,01,007,"Alabama","Bibb County",4,33,314,185,129
050,01,007,"Alabama","Bibb County",4,34,335,204,131
050,01,007,"Alabama","Bibb County",4,35,297,170,127
050,01,007,"Alabama","Bibb County",4,36,301,181,120
050,01,007,"Alabama","Bibb County",4,37,275,149,126
050,01,007,"Alabama","Bibb County",4,38,319,196,123
050,01,007,"Alabama","Bibb County",4,39,301,182,119
050,01,007,"Alabama","Bibb County",4,40,278,161,117
050,01,007,"Alabama","Bibb County",4,41,273,153,120
050,01,007,"Alabama","Bibb County",4,42,272,153,119
050,01,007,"Alabama","Bibb County",4,43,294,172,122
050,01,007,"Alabama","Bibb County",4,44,285,169,116
050,01,007,"Alabama","Bibb County",4,45,285,156,129
050,01,007,"Alabama","Bibb County",4,46,283,160,123
050,01,007,"Alabama","Bibb County",4,47,313,177,136
050,01,007,"Alabama","Bibb County",4,48,315,184,131
050,01,007,"Alabama","Bibb County",4,49,290,157,133
050,01,007,"Alabama","Bibb County",4,50,321,180,141
050,01,007,"Alabama","Bibb County",4,51,328,178,150
050,01,007,"Alabama","Bibb County",4,52,306,175,131
050,01,007,"Alabama","Bibb County",4,53,274,147,127
050,01,007,"Alabama","Bibb County",4,54,295,144,151
050,01,007,"Alabama","Bibb County",4,55,278,146,132
050,01,007,"Alabama","Bibb County",4,56,296,158,138
050,01,007,"Alabama","Bibb County",4,57,315,164,151
050,01,007,"Alabama","Bibb County",4,58,321,168,153
050,01,007,"Alabama","Bibb County",4,59,316,178,138
050,01,007,"Alabama","Bibb County",4,60,309,156,153
050,01,007,"Alabama","Bibb County",4,61,279,139,140
050,01,007,"Alabama","Bibb County",4,62,262,129,133
050,01,007,"Alabama","Bibb County",4,63,286,149,137
050,01,007,"Alabama","Bibb County",4,64,281,142,139
050,01,007,"Alabama","Bibb County",4,65,247,129,118
050,01,007,"Alabama","Bibb County",4,66,238,109,129
050,01,007,"Alabama","Bibb County",4,67,254,115,139
050,01,007,"Alabama","Bibb County",4,68,222,108,114
050,01,007,"Alabama","Bibb County",4,69,208,100,108
050,01,007,"Alabama","Bibb County",4,70,236,112,124
050,01,007,"Alabama","Bibb County",4,71,210,97,113
050,01,007,"Alabama","Bibb County",4,72,198,95,103
050,01,007,"Alabama","Bibb County",4,73,201,96,105
050,01,007,"Alabama","Bibb County",4,74,201,95,106
050,01,007,"Alabama","Bibb County",4,75,230,102,128
050,01,007,"Alabama","Bibb County",4,76,149,65,84
050,01,007,"Alabama","Bibb County",4,77,153,60,93
050,01,007,"Alabama","Bibb County",4,78,142,54,88
050,01,007,"Alabama","Bibb County",4,79,124,48,76
050,01,007,"Alabama","Bibb County",4,80,104,48,56
050,01,007,"Alabama","Bibb County",4,81,107,52,55
050,01,007,"Alabama","Bibb County",4,82,110,48,62
050,01,007,"Alabama","Bibb County",4,83,98,41,57
050,01,007,"Alabama","Bibb County",4,84,81,34,47
050,01,007,"Alabama","Bibb County",4,85,402,116,286
050,01,007,"Alabama","Bibb County",5,0,236,102,134
050,01,007,"Alabama","Bibb County",5,1,235,98,137
050,01,007,"Alabama","Bibb County",5,2,229,121,108
050,01,007,"Alabama","Bibb County",5,3,242,123,119
050,01,007,"Alabama","Bibb County",5,4,225,103,122
050,01,007,"Alabama","Bibb County",5,5,240,114,126
050,01,007,"Alabama","Bibb County",5,6,239,116,123
050,01,007,"Alabama","Bibb County",5,7,242,123,119
050,01,007,"Alabama","Bibb County",5,8,245,121,124
050,01,007,"Alabama","Bibb County",5,9,229,126,103
050,01,007,"Alabama","Bibb County",5,10,255,129,126
050,01,007,"Alabama","Bibb County",5,11,229,127,102
050,01,007,"Alabama","Bibb County",5,12,229,119,110
050,01,007,"Alabama","Bibb County",5,13,226,124,102
050,01,007,"Alabama","Bibb County",5,14,239,116,123
050,01,007,"Alabama","Bibb County",5,15,254,130,124
050,01,007,"Alabama","Bibb County",5,16,280,142,138
050,01,007,"Alabama","Bibb County",5,17,272,152,120
050,01,007,"Alabama","Bibb County",5,18,220,122,98
050,01,007,"Alabama","Bibb County",5,19,177,103,74
050,01,007,"Alabama","Bibb County",5,20,201,110,91
050,01,007,"Alabama","Bibb County",5,21,231,136,95
050,01,007,"Alabama","Bibb County",5,22,256,147,109
050,01,007,"Alabama","Bibb County",5,23,286,174,112
050,01,007,"Alabama","Bibb County",5,24,298,159,139
050,01,007,"Alabama","Bibb County",5,25,297,178,119
050,01,007,"Alabama","Bibb County",5,26,285,170,115
050,01,007,"Alabama","Bibb County",5,27,288,172,116
050,01,007,"Alabama","Bibb County",5,28,299,178,121
050,01,007,"Alabama","Bibb County",5,29,343,208,135
050,01,007,"Alabama","Bibb County",5,30,305,171,134
050,01,007,"Alabama","Bibb County",5,31,327,189,138
050,01,007,"Alabama","Bibb County",5,32,317,178,139
050,01,007,"Alabama","Bibb County",5,33,330,215,115
050,01,007,"Alabama","Bibb County",5,34,314,185,129
050,01,007,"Alabama","Bibb County",5,35,317,183,134
050,01,007,"Alabama","Bibb County",5,36,297,162,135
050,01,007,"Alabama","Bibb County",5,37,285,168,117
050,01,007,"Alabama","Bibb County",5,38,285,159,126
050,01,007,"Alabama","Bibb County",5,39,288,177,111
050,01,007,"Alabama","Bibb County",5,40,283,167,116
050,01,007,"Alabama","Bibb County",5,41,280,159,121
050,01,007,"Alabama","Bibb County",5,42,265,146,119
050,01,007,"Alabama","Bibb County",5,43,273,148,125
050,01,007,"Alabama","Bibb County",5,44,298,181,117
050,01,007,"Alabama","Bibb County",5,45,290,168,122
050,01,007,"Alabama","Bibb County",5,46,266,140,126
050,01,007,"Alabama","Bibb County",5,47,294,170,124
050,01,007,"Alabama","Bibb County",5,48,304,168,136
050,01,007,"Alabama","Bibb County",5,49,292,160,132
050,01,007,"Alabama","Bibb County",5,50,300,167,133
050,01,007,"Alabama","Bibb County",5,51,323,176,147
050,01,007,"Alabama","Bibb County",5,52,327,175,152
050,01,007,"Alabama","Bibb County",5,53,300,169,131
050,01,007,"Alabama","Bibb County",5,54,271,146,125
050,01,007,"Alabama","Bibb County",5,55,290,142,148
050,01,007,"Alabama","Bibb County",5,56,273,141,132
050,01,007,"Alabama","Bibb County",5,57,297,156,141
050,01,007,"Alabama","Bibb County",5,58,298,154,144
050,01,007,"Alabama","Bibb County",5,59,323,178,145
050,01,007,"Alabama","Bibb County",5,60,309,172,137
050,01,007,"Alabama","Bibb County",5,61,303,151,152
050,01,007,"Alabama","Bibb County",5,62,277,130,147
050,01,007,"Alabama","Bibb County",5,63,254,127,127
050,01,007,"Alabama","Bibb County",5,64,287,145,142
050,01,007,"Alabama","Bibb County",5,65,266,128,138
050,01,007,"Alabama","Bibb County",5,66,250,130,120
050,01,007,"Alabama","Bibb County",5,67,252,116,136
050,01,007,"Alabama","Bibb County",5,68,243,104,139
050,01,007,"Alabama","Bibb County",5,69,216,108,108
050,01,007,"Alabama","Bibb County",5,70,198,98,100
050,01,007,"Alabama","Bibb County",5,71,224,105,119
050,01,007,"Alabama","Bibb County",5,72,203,95,108
050,01,007,"Alabama","Bibb County",5,73,185,89,96
050,01,007,"Alabama","Bibb County",5,74,202,96,106
050,01,007,"Alabama","Bibb County",5,75,181,80,101
050,01,007,"Alabama","Bibb County",5,76,225,102,123
050,01,007,"Alabama","Bibb County",5,77,146,59,87
050,01,007,"Alabama","Bibb County",5,78,156,54,102
050,01,007,"Alabama","Bibb County",5,79,126,51,75
050,01,007,"Alabama","Bibb County",5,80,110,45,65
050,01,007,"Alabama","Bibb County",5,81,95,46,49
050,01,007,"Alabama","Bibb County",5,82,104,50,54
050,01,007,"Alabama","Bibb County",5,83,102,45,57
050,01,007,"Alabama","Bibb County",5,84,93,42,51
050,01,007,"Alabama","Bibb County",5,85,422,121,301
050,01,009,"Alabama","Blount County",1,0,670,342,328
050,01,009,"Alabama","Blount County",1,1,678,358,320
050,01,009,"Alabama","Blount County",1,2,701,383,318
050,01,009,"Alabama","Blount County",1,3,706,382,324
050,01,009,"Alabama","Blount County",1,4,740,353,387
050,01,009,"Alabama","Blount County",1,5,720,356,364
050,01,009,"Alabama","Blount County",1,6,690,356,334
050,01,009,"Alabama","Blount County",1,7,726,363,363
050,01,009,"Alabama","Blount County",1,8,773,401,372
050,01,009,"Alabama","Blount County",1,9,768,386,382
050,01,009,"Alabama","Blount County",1,10,773,383,390
050,01,009,"Alabama","Blount County",1,11,788,405,383
050,01,009,"Alabama","Blount County",1,12,852,435,417
050,01,009,"Alabama","Blount County",1,13,843,417,426
050,01,009,"Alabama","Blount County",1,14,807,392,415
050,01,009,"Alabama","Blount County",1,15,823,388,435
050,01,009,"Alabama","Blount County",1,16,833,410,423
050,01,009,"Alabama","Blount County",1,17,817,415,402
050,01,009,"Alabama","Blount County",1,18,700,380,320
050,01,009,"Alabama","Blount County",1,19,587,320,267
050,01,009,"Alabama","Blount County",1,20,608,324,284
050,01,009,"Alabama","Blount County",1,21,625,322,303
050,01,009,"Alabama","Blount County",1,22,638,340,298
050,01,009,"Alabama","Blount County",1,23,666,346,320
050,01,009,"Alabama","Blount County",1,24,674,349,325
050,01,009,"Alabama","Blount County",1,25,693,357,336
050,01,009,"Alabama","Blount County",1,26,695,346,349
050,01,009,"Alabama","Blount County",1,27,708,355,353
050,01,009,"Alabama","Blount County",1,28,725,369,356
050,01,009,"Alabama","Blount County",1,29,730,373,357
050,01,009,"Alabama","Blount County",1,30,718,339,379
050,01,009,"Alabama","Blount County",1,31,709,340,369
050,01,009,"Alabama","Blount County",1,32,704,346,358
050,01,009,"Alabama","Blount County",1,33,674,360,314
050,01,009,"Alabama","Blount County",1,34,663,337,326
050,01,009,"Alabama","Blount County",1,35,695,351,344
050,01,009,"Alabama","Blount County",1,36,714,345,369
050,01,009,"Alabama","Blount County",1,37,734,356,378
050,01,009,"Alabama","Blount County",1,38,701,356,345
050,01,009,"Alabama","Blount County",1,39,723,374,349
050,01,009,"Alabama","Blount County",1,40,746,382,364
050,01,009,"Alabama","Blount County",1,41,716,376,340
050,01,009,"Alabama","Blount County",1,42,724,355,369
050,01,009,"Alabama","Blount County",1,43,728,356,372
050,01,009,"Alabama","Blount County",1,44,699,344,355
050,01,009,"Alabama","Blount County",1,45,706,365,341
050,01,009,"Alabama","Blount County",1,46,754,384,370
050,01,009,"Alabama","Blount County",1,47,783,381,402
050,01,009,"Alabama","Blount County",1,48,814,411,403
050,01,009,"Alabama","Blount County",1,49,846,431,415
050,01,009,"Alabama","Blount County",1,50,821,416,405
050,01,009,"Alabama","Blount County",1,51,804,413,391
050,01,009,"Alabama","Blount County",1,52,771,381,390
050,01,009,"Alabama","Blount County",1,53,798,397,401
050,01,009,"Alabama","Blount County",1,54,787,396,391
050,01,009,"Alabama","Blount County",1,55,827,404,423
050,01,009,"Alabama","Blount County",1,56,833,406,427
050,01,009,"Alabama","Blount County",1,57,813,420,393
050,01,009,"Alabama","Blount County",1,58,852,452,400
050,01,009,"Alabama","Blount County",1,59,820,418,402
050,01,009,"Alabama","Blount County",1,60,796,412,384
050,01,009,"Alabama","Blount County",1,61,765,413,352
050,01,009,"Alabama","Blount County",1,62,720,365,355
050,01,009,"Alabama","Blount County",1,63,745,358,387
050,01,009,"Alabama","Blount County",1,64,750,345,405
050,01,009,"Alabama","Blount County",1,65,734,375,359
050,01,009,"Alabama","Blount County",1,66,730,376,354
050,01,009,"Alabama","Blount County",1,67,693,323,370
050,01,009,"Alabama","Blount County",1,68,664,308,356
050,01,009,"Alabama","Blount County",1,69,577,279,298
050,01,009,"Alabama","Blount County",1,70,638,311,327
050,01,009,"Alabama","Blount County",1,71,639,298,341
050,01,009,"Alabama","Blount County",1,72,677,297,380
050,01,009,"Alabama","Blount County",1,73,678,315,363
050,01,009,"Alabama","Blount County",1,74,456,210,246
050,01,009,"Alabama","Blount County",1,75,471,212,259
050,01,009,"Alabama","Blount County",1,76,457,202,255
050,01,009,"Alabama","Blount County",1,77,469,214,255
050,01,009,"Alabama","Blount County",1,78,390,183,207
050,01,009,"Alabama","Blount County",1,79,324,139,185
050,01,009,"Alabama","Blount County",1,80,289,126,163
050,01,009,"Alabama","Blount County",1,81,273,131,142
050,01,009,"Alabama","Blount County",1,82,258,112,146
050,01,009,"Alabama","Blount County",1,83,257,129,128
050,01,009,"Alabama","Blount County",1,84,206,81,125
050,01,009,"Alabama","Blount County",1,85,1040,377,663
050,01,009,"Alabama","Blount County",2,0,640,321,319
050,01,009,"Alabama","Blount County",2,1,673,353,320
050,01,009,"Alabama","Blount County",2,2,696,377,319
050,01,009,"Alabama","Blount County",2,3,706,380,326
050,01,009,"Alabama","Blount County",2,4,734,360,374
050,01,009,"Alabama","Blount County",2,5,720,351,369
050,01,009,"Alabama","Blount County",2,6,696,353,343
050,01,009,"Alabama","Blount County",2,7,719,362,357
050,01,009,"Alabama","Blount County",2,8,757,390,367
050,01,009,"Alabama","Blount County",2,9,771,389,382
050,01,009,"Alabama","Blount County",2,10,774,386,388
050,01,009,"Alabama","Blount County",2,11,784,399,385
050,01,009,"Alabama","Blount County",2,12,840,427,413
050,01,009,"Alabama","Blount County",2,13,843,421,422
050,01,009,"Alabama","Blount County",2,14,814,398,416
050,01,009,"Alabama","Blount County",2,15,821,391,430
050,01,009,"Alabama","Blount County",2,16,835,404,431
050,01,009,"Alabama","Blount County",2,17,823,414,409
050,01,009,"Alabama","Blount County",2,18,696,375,321
050,01,009,"Alabama","Blount County",2,19,587,318,269
050,01,009,"Alabama","Blount County",2,20,620,332,288
050,01,009,"Alabama","Blount County",2,21,630,328,302
050,01,009,"Alabama","Blount County",2,22,644,338,306
050,01,009,"Alabama","Blount County",2,23,666,349,317
050,01,009,"Alabama","Blount County",2,24,671,350,321
050,01,009,"Alabama","Blount County",2,25,686,352,334
050,01,009,"Alabama","Blount County",2,26,694,351,343
050,01,009,"Alabama","Blount County",2,27,700,348,352
050,01,009,"Alabama","Blount County",2,28,723,368,355
050,01,009,"Alabama","Blount County",2,29,730,372,358
050,01,009,"Alabama","Blount County",2,30,730,352,378
050,01,009,"Alabama","Blount County",2,31,714,341,373
050,01,009,"Alabama","Blount County",2,32,704,346,358
050,01,009,"Alabama","Blount County",2,33,684,359,325
050,01,009,"Alabama","Blount County",2,34,664,341,323
050,01,009,"Alabama","Blount County",2,35,689,348,341
050,01,009,"Alabama","Blount County",2,36,704,345,359
050,01,009,"Alabama","Blount County",2,37,729,354,375
050,01,009,"Alabama","Blount County",2,38,707,356,351
050,01,009,"Alabama","Blount County",2,39,716,370,346
050,01,009,"Alabama","Blount County",2,40,746,383,363
050,01,009,"Alabama","Blount County",2,41,719,376,343
050,01,009,"Alabama","Blount County",2,42,721,361,360
050,01,009,"Alabama","Blount County",2,43,733,359,374
050,01,009,"Alabama","Blount County",2,44,699,345,354
050,01,009,"Alabama","Blount County",2,45,708,361,347
050,01,009,"Alabama","Blount County",2,46,743,379,364
050,01,009,"Alabama","Blount County",2,47,777,381,396
050,01,009,"Alabama","Blount County",2,48,805,403,402
050,01,009,"Alabama","Blount County",2,49,846,429,417
050,01,009,"Alabama","Blount County",2,50,829,422,407
050,01,009,"Alabama","Blount County",2,51,809,416,393
050,01,009,"Alabama","Blount County",2,52,776,384,392
050,01,009,"Alabama","Blount County",2,53,792,394,398
050,01,009,"Alabama","Blount County",2,54,789,396,393
050,01,009,"Alabama","Blount County",2,55,821,405,416
050,01,009,"Alabama","Blount County",2,56,841,410,431
050,01,009,"Alabama","Blount County",2,57,823,421,402
050,01,009,"Alabama","Blount County",2,58,840,440,400
050,01,009,"Alabama","Blount County",2,59,829,424,405
050,01,009,"Alabama","Blount County",2,60,802,413,389
050,01,009,"Alabama","Blount County",2,61,769,413,356
050,01,009,"Alabama","Blount County",2,62,727,377,350
050,01,009,"Alabama","Blount County",2,63,742,362,380
050,01,009,"Alabama","Blount County",2,64,740,345,395
050,01,009,"Alabama","Blount County",2,65,729,363,366
050,01,009,"Alabama","Blount County",2,66,722,369,353
050,01,009,"Alabama","Blount County",2,67,699,335,364
050,01,009,"Alabama","Blount County",2,68,660,309,351
050,01,009,"Alabama","Blount County",2,69,600,287,313
050,01,009,"Alabama","Blount County",2,70,618,302,316
050,01,009,"Alabama","Blount County",2,71,635,297,338
050,01,009,"Alabama","Blount County",2,72,655,291,364
050,01,009,"Alabama","Blount County",2,73,702,323,379
050,01,009,"Alabama","Blount County",2,74,475,221,254
050,01,009,"Alabama","Blount County",2,75,469,213,256
050,01,009,"Alabama","Blount County",2,76,447,198,249
050,01,009,"Alabama","Blount County",2,77,476,215,261
050,01,009,"Alabama","Blount County",2,78,387,179,208
050,01,009,"Alabama","Blount County",2,79,336,146,190
050,01,009,"Alabama","Blount County",2,80,296,128,168
050,01,009,"Alabama","Blount County",2,81,272,127,145
050,01,009,"Alabama","Blount County",2,82,255,114,141
050,01,009,"Alabama","Blount County",2,83,249,121,128
050,01,009,"Alabama","Blount County",2,84,215,90,125
050,01,009,"Alabama","Blount County",2,85,1050,382,668
050,01,009,"Alabama","Blount County",3,0,647,315,332
050,01,009,"Alabama","Blount County",3,1,678,349,329
050,01,009,"Alabama","Blount County",3,2,679,349,330
050,01,009,"Alabama","Blount County",3,3,694,379,315
050,01,009,"Alabama","Blount County",3,4,728,375,353
050,01,009,"Alabama","Blount County",3,5,726,362,364
050,01,009,"Alabama","Blount County",3,6,751,377,374
050,01,009,"Alabama","Blount County",3,7,701,364,337
050,01,009,"Alabama","Blount County",3,8,720,364,356
050,01,009,"Alabama","Blount County",3,9,758,398,360
050,01,009,"Alabama","Blount County",3,10,807,408,399
050,01,009,"Alabama","Blount County",3,11,768,386,382
050,01,009,"Alabama","Blount County",3,12,801,401,400
050,01,009,"Alabama","Blount County",3,13,844,433,411
050,01,009,"Alabama","Blount County",3,14,837,415,422
050,01,009,"Alabama","Blount County",3,15,815,400,415
050,01,009,"Alabama","Blount County",3,16,827,382,445
050,01,009,"Alabama","Blount County",3,17,822,398,424
050,01,009,"Alabama","Blount County",3,18,716,384,332
050,01,009,"Alabama","Blount County",3,19,563,302,261
050,01,009,"Alabama","Blount County",3,20,626,344,282
050,01,009,"Alabama","Blount County",3,21,664,348,316
050,01,009,"Alabama","Blount County",3,22,671,342,329
050,01,009,"Alabama","Blount County",3,23,661,348,313
050,01,009,"Alabama","Blount County",3,24,672,342,330
050,01,009,"Alabama","Blount County",3,25,687,356,331
050,01,009,"Alabama","Blount County",3,26,711,368,343
050,01,009,"Alabama","Blount County",3,27,702,355,347
050,01,009,"Alabama","Blount County",3,28,705,347,358
050,01,009,"Alabama","Blount County",3,29,721,368,353
050,01,009,"Alabama","Blount County",3,30,709,360,349
050,01,009,"Alabama","Blount County",3,31,739,357,382
050,01,009,"Alabama","Blount County",3,32,684,327,357
050,01,009,"Alabama","Blount County",3,33,721,363,358
050,01,009,"Alabama","Blount County",3,34,694,351,343
050,01,009,"Alabama","Blount County",3,35,661,335,326
050,01,009,"Alabama","Blount County",3,36,706,366,340
050,01,009,"Alabama","Blount County",3,37,712,350,362
050,01,009,"Alabama","Blount County",3,38,691,337,354
050,01,009,"Alabama","Blount County",3,39,689,340,349
050,01,009,"Alabama","Blount County",3,40,736,379,357
050,01,009,"Alabama","Blount County",3,41,739,389,350
050,01,009,"Alabama","Blount County",3,42,702,369,333
050,01,009,"Alabama","Blount County",3,43,732,364,368
050,01,009,"Alabama","Blount County",3,44,731,365,366
050,01,009,"Alabama","Blount County",3,45,697,336,361
050,01,009,"Alabama","Blount County",3,46,709,370,339
050,01,009,"Alabama","Blount County",3,47,744,384,360
050,01,009,"Alabama","Blount County",3,48,780,381,399
050,01,009,"Alabama","Blount County",3,49,813,403,410
050,01,009,"Alabama","Blount County",3,50,825,424,401
050,01,009,"Alabama","Blount County",3,51,822,425,397
050,01,009,"Alabama","Blount County",3,52,809,408,401
050,01,009,"Alabama","Blount County",3,53,779,384,395
050,01,009,"Alabama","Blount County",3,54,762,370,392
050,01,009,"Alabama","Blount County",3,55,779,388,391
050,01,009,"Alabama","Blount County",3,56,819,402,417
050,01,009,"Alabama","Blount County",3,57,848,416,432
050,01,009,"Alabama","Blount County",3,58,816,417,399
050,01,009,"Alabama","Blount County",3,59,841,439,402
050,01,009,"Alabama","Blount County",3,60,826,415,411
050,01,009,"Alabama","Blount County",3,61,796,410,386
050,01,009,"Alabama","Blount County",3,62,754,407,347
050,01,009,"Alabama","Blount County",3,63,703,364,339
050,01,009,"Alabama","Blount County",3,64,735,350,385
050,01,009,"Alabama","Blount County",3,65,724,340,384
050,01,009,"Alabama","Blount County",3,66,709,345,364
050,01,009,"Alabama","Blount County",3,67,715,369,346
050,01,009,"Alabama","Blount County",3,68,689,332,357
050,01,009,"Alabama","Blount County",3,69,645,298,347
050,01,009,"Alabama","Blount County",3,70,596,282,314
050,01,009,"Alabama","Blount County",3,71,597,291,306
050,01,009,"Alabama","Blount County",3,72,616,291,325
050,01,009,"Alabama","Blount County",3,73,614,269,345
050,01,009,"Alabama","Blount County",3,74,674,311,363
050,01,009,"Alabama","Blount County",3,75,460,216,244
050,01,009,"Alabama","Blount County",3,76,442,200,242
050,01,009,"Alabama","Blount County",3,77,437,184,253
050,01,009,"Alabama","Blount County",3,78,437,195,242
050,01,009,"Alabama","Blount County",3,79,366,169,197
050,01,009,"Alabama","Blount County",3,80,324,139,185
050,01,009,"Alabama","Blount County",3,81,257,112,145
050,01,009,"Alabama","Blount County",3,82,232,110,122
050,01,009,"Alabama","Blount County",3,83,235,107,128
050,01,009,"Alabama","Blount County",3,84,211,96,115
050,01,009,"Alabama","Blount County",3,85,1094,415,679
050,01,009,"Alabama","Blount County",4,0,682,327,355
050,01,009,"Alabama","Blount County",4,1,649,311,338
050,01,009,"Alabama","Blount County",4,2,683,360,323
050,01,009,"Alabama","Blount County",4,3,700,369,331
050,01,009,"Alabama","Blount County",4,4,730,389,341
050,01,009,"Alabama","Blount County",4,5,749,396,353
050,01,009,"Alabama","Blount County",4,6,733,360,373
050,01,009,"Alabama","Blount County",4,7,753,380,373
050,01,009,"Alabama","Blount County",4,8,722,369,353
050,01,009,"Alabama","Blount County",4,9,737,380,357
050,01,009,"Alabama","Blount County",4,10,750,397,353
050,01,009,"Alabama","Blount County",4,11,816,407,409
050,01,009,"Alabama","Blount County",4,12,782,397,385
050,01,009,"Alabama","Blount County",4,13,811,416,395
050,01,009,"Alabama","Blount County",4,14,852,435,417
050,01,009,"Alabama","Blount County",4,15,838,408,430
050,01,009,"Alabama","Blount County",4,16,844,409,435
050,01,009,"Alabama","Blount County",4,17,839,394,445
050,01,009,"Alabama","Blount County",4,18,688,342,346
050,01,009,"Alabama","Blount County",4,19,563,307,256
050,01,009,"Alabama","Blount County",4,20,596,317,279
050,01,009,"Alabama","Blount County",4,21,672,364,308
050,01,009,"Alabama","Blount County",4,22,691,361,330
050,01,009,"Alabama","Blount County",4,23,684,341,343
050,01,009,"Alabama","Blount County",4,24,705,371,334
050,01,009,"Alabama","Blount County",4,25,693,354,339
050,01,009,"Alabama","Blount County",4,26,711,367,344
050,01,009,"Alabama","Blount County",4,27,708,350,358
050,01,009,"Alabama","Blount County",4,28,719,366,353
050,01,009,"Alabama","Blount County",4,29,698,334,364
050,01,009,"Alabama","Blount County",4,30,722,359,363
050,01,009,"Alabama","Blount County",4,31,725,384,341
050,01,009,"Alabama","Blount County",4,32,739,360,379
050,01,009,"Alabama","Blount County",4,33,719,341,378
050,01,009,"Alabama","Blount County",4,34,717,362,355
050,01,009,"Alabama","Blount County",4,35,672,329,343
050,01,009,"Alabama","Blount County",4,36,671,338,333
050,01,009,"Alabama","Blount County",4,37,730,376,354
050,01,009,"Alabama","Blount County",4,38,702,348,354
050,01,009,"Alabama","Blount County",4,39,697,338,359
050,01,009,"Alabama","Blount County",4,40,707,343,364
050,01,009,"Alabama","Blount County",4,41,737,385,352
050,01,009,"Alabama","Blount County",4,42,733,383,350
050,01,009,"Alabama","Blount County",4,43,710,369,341
050,01,009,"Alabama","Blount County",4,44,721,358,363
050,01,009,"Alabama","Blount County",4,45,734,366,368
050,01,009,"Alabama","Blount County",4,46,699,336,363
050,01,009,"Alabama","Blount County",4,47,726,379,347
050,01,009,"Alabama","Blount County",4,48,760,389,371
050,01,009,"Alabama","Blount County",4,49,798,392,406
050,01,009,"Alabama","Blount County",4,50,825,415,410
050,01,009,"Alabama","Blount County",4,51,843,437,406
050,01,009,"Alabama","Blount County",4,52,807,412,395
050,01,009,"Alabama","Blount County",4,53,817,411,406
050,01,009,"Alabama","Blount County",4,54,765,379,386
050,01,009,"Alabama","Blount County",4,55,776,373,403
050,01,009,"Alabama","Blount County",4,56,789,392,397
050,01,009,"Alabama","Blount County",4,57,833,408,425
050,01,009,"Alabama","Blount County",4,58,841,413,428
050,01,009,"Alabama","Blount County",4,59,828,421,407
050,01,009,"Alabama","Blount County",4,60,828,433,395
050,01,009,"Alabama","Blount County",4,61,828,414,414
050,01,009,"Alabama","Blount County",4,62,787,406,381
050,01,009,"Alabama","Blount County",4,63,742,403,339
050,01,009,"Alabama","Blount County",4,64,701,365,336
050,01,009,"Alabama","Blount County",4,65,731,347,384
050,01,009,"Alabama","Blount County",4,66,730,342,388
050,01,009,"Alabama","Blount County",4,67,705,341,364
050,01,009,"Alabama","Blount County",4,68,709,365,344
050,01,009,"Alabama","Blount County",4,69,682,328,354
050,01,009,"Alabama","Blount County",4,70,630,286,344
050,01,009,"Alabama","Blount County",4,71,587,280,307
050,01,009,"Alabama","Blount County",4,72,585,281,304
050,01,009,"Alabama","Blount County",4,73,586,275,311
050,01,009,"Alabama","Blount County",4,74,589,256,333
050,01,009,"Alabama","Blount County",4,75,648,296,352
050,01,009,"Alabama","Blount County",4,76,432,203,229
050,01,009,"Alabama","Blount County",4,77,448,191,257
050,01,009,"Alabama","Blount County",4,78,396,166,230
050,01,009,"Alabama","Blount County",4,79,405,181,224
050,01,009,"Alabama","Blount County",4,80,359,159,200
050,01,009,"Alabama","Blount County",4,81,292,123,169
050,01,009,"Alabama","Blount County",4,82,226,101,125
050,01,009,"Alabama","Blount County",4,83,217,104,113
050,01,009,"Alabama","Blount County",4,84,199,83,116
050,01,009,"Alabama","Blount County",4,85,1133,445,688
050,01,009,"Alabama","Blount County",5,0,689,328,361
050,01,009,"Alabama","Blount County",5,1,704,347,357
050,01,009,"Alabama","Blount County",5,2,684,337,347
050,01,009,"Alabama","Blount County",5,3,699,373,326
050,01,009,"Alabama","Blount County",5,4,717,369,348
050,01,009,"Alabama","Blount County",5,5,743,408,335
050,01,009,"Alabama","Blount County",5,6,763,407,356
050,01,009,"Alabama","Blount County",5,7,754,379,375
050,01,009,"Alabama","Blount County",5,8,737,375,362
050,01,009,"Alabama","Blount County",5,9,732,378,354
050,01,009,"Alabama","Blount County",5,10,744,374,370
050,01,009,"Alabama","Blount County",5,11,759,406,353
050,01,009,"Alabama","Blount County",5,12,820,416,404
050,01,009,"Alabama","Blount County",5,13,785,407,378
050,01,009,"Alabama","Blount County",5,14,833,422,411
050,01,009,"Alabama","Blount County",5,15,865,441,424
050,01,009,"Alabama","Blount County",5,16,849,413,436
050,01,009,"Alabama","Blount County",5,17,840,412,428
050,01,009,"Alabama","Blount County",5,18,707,343,364
050,01,009,"Alabama","Blount County",5,19,551,276,275
050,01,009,"Alabama","Blount County",5,20,601,322,279
050,01,009,"Alabama","Blount County",5,21,630,334,296
050,01,009,"Alabama","Blount County",5,22,702,370,332
050,01,009,"Alabama","Blount County",5,23,748,397,351
050,01,009,"Alabama","Blount County",5,24,704,341,363
050,01,009,"Alabama","Blount County",5,25,692,361,331
050,01,009,"Alabama","Blount County",5,26,710,363,347
050,01,009,"Alabama","Blount County",5,27,714,367,347
050,01,009,"Alabama","Blount County",5,28,711,352,359
050,01,009,"Alabama","Blount County",5,29,723,372,351
050,01,009,"Alabama","Blount County",5,30,696,346,350
050,01,009,"Alabama","Blount County",5,31,744,381,363
050,01,009,"Alabama","Blount County",5,32,718,377,341
050,01,009,"Alabama","Blount County",5,33,722,358,364
050,01,009,"Alabama","Blount County",5,34,727,345,382
050,01,009,"Alabama","Blount County",5,35,741,372,369
050,01,009,"Alabama","Blount County",5,36,693,340,353
050,01,009,"Alabama","Blount County",5,37,695,353,342
050,01,009,"Alabama","Blount County",5,38,721,368,353
050,01,009,"Alabama","Blount County",5,39,713,346,367
050,01,009,"Alabama","Blount County",5,40,719,352,367
050,01,009,"Alabama","Blount County",5,41,694,330,364
050,01,009,"Alabama","Blount County",5,42,723,377,346
050,01,009,"Alabama","Blount County",5,43,727,385,342
050,01,009,"Alabama","Blount County",5,44,710,367,343
050,01,009,"Alabama","Blount County",5,45,730,362,368
050,01,009,"Alabama","Blount County",5,46,719,351,368
050,01,009,"Alabama","Blount County",5,47,713,336,377
050,01,009,"Alabama","Blount County",5,48,727,380,347
050,01,009,"Alabama","Blount County",5,49,753,384,369
050,01,009,"Alabama","Blount County",5,50,790,395,395
050,01,009,"Alabama","Blount County",5,51,818,411,407
050,01,009,"Alabama","Blount County",5,52,842,432,410
050,01,009,"Alabama","Blount County",5,53,800,409,391
050,01,009,"Alabama","Blount County",5,54,811,400,411
050,01,009,"Alabama","Blount County",5,55,774,384,390
050,01,009,"Alabama","Blount County",5,56,781,375,406
050,01,009,"Alabama","Blount County",5,57,783,386,397
050,01,009,"Alabama","Blount County",5,58,824,406,418
050,01,009,"Alabama","Blount County",5,59,849,420,429
050,01,009,"Alabama","Blount County",5,60,834,420,414
050,01,009,"Alabama","Blount County",5,61,821,432,389
050,01,009,"Alabama","Blount County",5,62,803,398,405
050,01,009,"Alabama","Blount County",5,63,775,401,374
050,01,009,"Alabama","Blount County",5,64,735,395,340
050,01,009,"Alabama","Blount County",5,65,699,364,335
050,01,009,"Alabama","Blount County",5,66,720,343,377
050,01,009,"Alabama","Blount County",5,67,719,336,383
050,01,009,"Alabama","Blount County",5,68,703,332,371
050,01,009,"Alabama","Blount County",5,69,702,358,344
050,01,009,"Alabama","Blount County",5,70,680,330,350
050,01,009,"Alabama","Blount County",5,71,605,278,327
050,01,009,"Alabama","Blount County",5,72,567,269,298
050,01,009,"Alabama","Blount County",5,73,567,277,290
050,01,009,"Alabama","Blount County",5,74,566,262,304
050,01,009,"Alabama","Blount County",5,75,571,247,324
050,01,009,"Alabama","Blount County",5,76,606,282,324
050,01,009,"Alabama","Blount County",5,77,421,191,230
050,01,009,"Alabama","Blount County",5,78,411,177,234
050,01,009,"Alabama","Blount County",5,79,380,158,222
050,01,009,"Alabama","Blount County",5,80,397,172,225
050,01,009,"Alabama","Blount County",5,81,323,144,179
050,01,009,"Alabama","Blount County",5,82,261,113,148
050,01,009,"Alabama","Blount County",5,83,212,99,113
050,01,009,"Alabama","Blount County",5,84,186,83,103
050,01,009,"Alabama","Blount County",5,85,1185,477,708
050,01,011,"Alabama","Bullock County",1,0,107,54,53
050,01,011,"Alabama","Bullock County",1,1,99,51,48
050,01,011,"Alabama","Bullock County",1,2,107,58,49
050,01,011,"Alabama","Bullock County",1,3,124,54,70
050,01,011,"Alabama","Bullock County",1,4,119,52,67
050,01,011,"Alabama","Bullock County",1,5,96,46,50
050,01,011,"Alabama","Bullock County",1,6,119,62,57
050,01,011,"Alabama","Bullock County",1,7,121,59,62
050,01,011,"Alabama","Bullock County",1,8,122,58,64
050,01,011,"Alabama","Bullock County",1,9,137,69,68
050,01,011,"Alabama","Bullock County",1,10,120,60,60
050,01,011,"Alabama","Bullock County",1,11,125,69,56
050,01,011,"Alabama","Bullock County",1,12,140,77,63
050,01,011,"Alabama","Bullock County",1,13,131,80,51
050,01,011,"Alabama","Bullock County",1,14,132,74,58
050,01,011,"Alabama","Bullock County",1,15,116,61,55
050,01,011,"Alabama","Bullock County",1,16,107,60,47
050,01,011,"Alabama","Bullock County",1,17,113,56,57
050,01,011,"Alabama","Bullock County",1,18,102,54,48
050,01,011,"Alabama","Bullock County",1,19,98,51,47
050,01,011,"Alabama","Bullock County",1,20,107,56,51
050,01,011,"Alabama","Bullock County",1,21,110,63,47
050,01,011,"Alabama","Bullock County",1,22,112,74,38
050,01,011,"Alabama","Bullock County",1,23,121,68,53
050,01,011,"Alabama","Bullock County",1,24,138,85,53
050,01,011,"Alabama","Bullock County",1,25,149,92,57
050,01,011,"Alabama","Bullock County",1,26,146,96,50
050,01,011,"Alabama","Bullock County",1,27,139,95,44
050,01,011,"Alabama","Bullock County",1,28,150,97,53
050,01,011,"Alabama","Bullock County",1,29,159,102,57
050,01,011,"Alabama","Bullock County",1,30,168,102,66
050,01,011,"Alabama","Bullock County",1,31,153,95,58
050,01,011,"Alabama","Bullock County",1,32,135,84,51
050,01,011,"Alabama","Bullock County",1,33,144,92,52
050,01,011,"Alabama","Bullock County",1,34,133,82,51
050,01,011,"Alabama","Bullock County",1,35,137,80,57
050,01,011,"Alabama","Bullock County",1,36,155,103,52
050,01,011,"Alabama","Bullock County",1,37,137,86,51
050,01,011,"Alabama","Bullock County",1,38,155,99,56
050,01,011,"Alabama","Bullock County",1,39,145,84,61
050,01,011,"Alabama","Bullock County",1,40,137,73,64
050,01,011,"Alabama","Bullock County",1,41,132,80,52
050,01,011,"Alabama","Bullock County",1,42,137,83,54
050,01,011,"Alabama","Bullock County",1,43,127,77,50
050,01,011,"Alabama","Bullock County",1,44,146,89,57
050,01,011,"Alabama","Bullock County",1,45,132,85,47
050,01,011,"Alabama","Bullock County",1,46,116,73,43
050,01,011,"Alabama","Bullock County",1,47,139,89,50
050,01,011,"Alabama","Bullock County",1,48,144,90,54
050,01,011,"Alabama","Bullock County",1,49,134,89,45
050,01,011,"Alabama","Bullock County",1,50,116,69,47
050,01,011,"Alabama","Bullock County",1,51,129,79,50
050,01,011,"Alabama","Bullock County",1,52,121,66,55
050,01,011,"Alabama","Bullock County",1,53,117,63,54
050,01,011,"Alabama","Bullock County",1,54,107,62,45
050,01,011,"Alabama","Bullock County",1,55,132,71,61
050,01,011,"Alabama","Bullock County",1,56,139,72,67
050,01,011,"Alabama","Bullock County",1,57,154,78,76
050,01,011,"Alabama","Bullock County",1,58,146,78,68
050,01,011,"Alabama","Bullock County",1,59,148,73,75
050,01,011,"Alabama","Bullock County",1,60,167,85,82
050,01,011,"Alabama","Bullock County",1,61,163,87,76
050,01,011,"Alabama","Bullock County",1,62,156,83,73
050,01,011,"Alabama","Bullock County",1,63,142,78,64
050,01,011,"Alabama","Bullock County",1,64,137,64,73
050,01,011,"Alabama","Bullock County",1,65,135,66,69
050,01,011,"Alabama","Bullock County",1,66,140,78,62
050,01,011,"Alabama","Bullock County",1,67,120,65,55
050,01,011,"Alabama","Bullock County",1,68,121,59,62
050,01,011,"Alabama","Bullock County",1,69,118,56,62
050,01,011,"Alabama","Bullock County",1,70,105,50,55
050,01,011,"Alabama","Bullock County",1,71,98,40,58
050,01,011,"Alabama","Bullock County",1,72,92,37,55
050,01,011,"Alabama","Bullock County",1,73,97,44,53
050,01,011,"Alabama","Bullock County",1,74,65,28,37
050,01,011,"Alabama","Bullock County",1,75,72,28,44
050,01,011,"Alabama","Bullock County",1,76,65,26,39
050,01,011,"Alabama","Bullock County",1,77,67,29,38
050,01,011,"Alabama","Bullock County",1,78,55,20,35
050,01,011,"Alabama","Bullock County",1,79,51,21,30
050,01,011,"Alabama","Bullock County",1,80,48,23,25
050,01,011,"Alabama","Bullock County",1,81,49,20,29
050,01,011,"Alabama","Bullock County",1,82,42,17,25
050,01,011,"Alabama","Bullock County",1,83,42,15,27
050,01,011,"Alabama","Bullock County",1,84,39,17,22
050,01,011,"Alabama","Bullock County",1,85,193,59,134
050,01,011,"Alabama","Bullock County",2,0,103,48,55
050,01,011,"Alabama","Bullock County",2,1,100,52,48
050,01,011,"Alabama","Bullock County",2,2,103,55,48
050,01,011,"Alabama","Bullock County",2,3,120,56,64
050,01,011,"Alabama","Bullock County",2,4,120,52,68
050,01,011,"Alabama","Bullock County",2,5,103,48,55
050,01,011,"Alabama","Bullock County",2,6,114,59,55
050,01,011,"Alabama","Bullock County",2,7,120,59,61
050,01,011,"Alabama","Bullock County",2,8,122,58,64
050,01,011,"Alabama","Bullock County",2,9,133,66,67
050,01,011,"Alabama","Bullock County",2,10,125,64,61
050,01,011,"Alabama","Bullock County",2,11,123,66,57
050,01,011,"Alabama","Bullock County",2,12,134,74,60
050,01,011,"Alabama","Bullock County",2,13,133,78,55
050,01,011,"Alabama","Bullock County",2,14,130,75,55
050,01,011,"Alabama","Bullock County",2,15,120,64,56
050,01,011,"Alabama","Bullock County",2,16,109,60,49
050,01,011,"Alabama","Bullock County",2,17,109,55,54
050,01,011,"Alabama","Bullock County",2,18,103,55,48
050,01,011,"Alabama","Bullock County",2,19,97,51,46
050,01,011,"Alabama","Bullock County",2,20,107,55,52
050,01,011,"Alabama","Bullock County",2,21,107,61,46
050,01,011,"Alabama","Bullock County",2,22,112,72,40
050,01,011,"Alabama","Bullock County",2,23,113,64,49
050,01,011,"Alabama","Bullock County",2,24,135,84,51
050,01,011,"Alabama","Bullock County",2,25,142,87,55
050,01,011,"Alabama","Bullock County",2,26,142,92,50
050,01,011,"Alabama","Bullock County",2,27,136,91,45
050,01,011,"Alabama","Bullock County",2,28,145,95,50
050,01,011,"Alabama","Bullock County",2,29,157,101,56
050,01,011,"Alabama","Bullock County",2,30,163,99,64
050,01,011,"Alabama","Bullock County",2,31,154,95,59
050,01,011,"Alabama","Bullock County",2,32,136,84,52
050,01,011,"Alabama","Bullock County",2,33,137,86,51
050,01,011,"Alabama","Bullock County",2,34,131,81,50
050,01,011,"Alabama","Bullock County",2,35,131,76,55
050,01,011,"Alabama","Bullock County",2,36,150,97,53
050,01,011,"Alabama","Bullock County",2,37,135,84,51
050,01,011,"Alabama","Bullock County",2,38,153,98,55
050,01,011,"Alabama","Bullock County",2,39,140,82,58
050,01,011,"Alabama","Bullock County",2,40,137,72,65
050,01,011,"Alabama","Bullock County",2,41,131,76,55
050,01,011,"Alabama","Bullock County",2,42,134,80,54
050,01,011,"Alabama","Bullock County",2,43,125,74,51
050,01,011,"Alabama","Bullock County",2,44,140,86,54
050,01,011,"Alabama","Bullock County",2,45,131,83,48
050,01,011,"Alabama","Bullock County",2,46,118,74,44
050,01,011,"Alabama","Bullock County",2,47,131,83,48
050,01,011,"Alabama","Bullock County",2,48,139,87,52
050,01,011,"Alabama","Bullock County",2,49,136,87,49
050,01,011,"Alabama","Bullock County",2,50,117,70,47
050,01,011,"Alabama","Bullock County",2,51,124,75,49
050,01,011,"Alabama","Bullock County",2,52,117,64,53
050,01,011,"Alabama","Bullock County",2,53,116,62,54
050,01,011,"Alabama","Bullock County",2,54,107,60,47
050,01,011,"Alabama","Bullock County",2,55,124,68,56
050,01,011,"Alabama","Bullock County",2,56,138,71,67
050,01,011,"Alabama","Bullock County",2,57,146,73,73
050,01,011,"Alabama","Bullock County",2,58,144,76,68
050,01,011,"Alabama","Bullock County",2,59,149,74,75
050,01,011,"Alabama","Bullock County",2,60,161,81,80
050,01,011,"Alabama","Bullock County",2,61,163,85,78
050,01,011,"Alabama","Bullock County",2,62,156,84,72
050,01,011,"Alabama","Bullock County",2,63,144,78,66
050,01,011,"Alabama","Bullock County",2,64,134,65,69
050,01,011,"Alabama","Bullock County",2,65,136,66,70
050,01,011,"Alabama","Bullock County",2,66,139,75,64
050,01,011,"Alabama","Bullock County",2,67,125,68,57
050,01,011,"Alabama","Bullock County",2,68,120,60,60
050,01,011,"Alabama","Bullock County",2,69,118,55,63
050,01,011,"Alabama","Bullock County",2,70,108,51,57
050,01,011,"Alabama","Bullock County",2,71,99,42,57
050,01,011,"Alabama","Bullock County",2,72,92,37,55
050,01,011,"Alabama","Bullock County",2,73,98,44,54
050,01,011,"Alabama","Bullock County",2,74,68,29,39
050,01,011,"Alabama","Bullock County",2,75,71,28,43
050,01,011,"Alabama","Bullock County",2,76,65,26,39
050,01,011,"Alabama","Bullock County",2,77,67,29,38
050,01,011,"Alabama","Bullock County",2,78,56,21,35
050,01,011,"Alabama","Bullock County",2,79,49,19,30
050,01,011,"Alabama","Bullock County",2,80,49,22,27
050,01,011,"Alabama","Bullock County",2,81,47,20,27
050,01,011,"Alabama","Bullock County",2,82,43,18,25
050,01,011,"Alabama","Bullock County",2,83,41,16,25
050,01,011,"Alabama","Bullock County",2,84,37,14,23
050,01,011,"Alabama","Bullock County",2,85,192,58,134
050,01,011,"Alabama","Bullock County",3,0,110,62,48
050,01,011,"Alabama","Bullock County",3,1,102,49,53
050,01,011,"Alabama","Bullock County",3,2,101,54,47
050,01,011,"Alabama","Bullock County",3,3,104,51,53
050,01,011,"Alabama","Bullock County",3,4,112,55,57
050,01,011,"Alabama","Bullock County",3,5,119,49,70
050,01,011,"Alabama","Bullock County",3,6,108,55,53
050,01,011,"Alabama","Bullock County",3,7,111,59,52
050,01,011,"Alabama","Bullock County",3,8,115,58,57
050,01,011,"Alabama","Bullock County",3,9,119,58,61
050,01,011,"Alabama","Bullock County",3,10,125,65,60
050,01,011,"Alabama","Bullock County",3,11,126,63,63
050,01,011,"Alabama","Bullock County",3,12,122,65,57
050,01,011,"Alabama","Bullock County",3,13,140,79,61
050,01,011,"Alabama","Bullock County",3,14,140,82,58
050,01,011,"Alabama","Bullock County",3,15,123,69,54
050,01,011,"Alabama","Bullock County",3,16,129,68,61
050,01,011,"Alabama","Bullock County",3,17,110,63,47
050,01,011,"Alabama","Bullock County",3,18,105,57,48
050,01,011,"Alabama","Bullock County",3,19,93,50,43
050,01,011,"Alabama","Bullock County",3,20,91,48,43
050,01,011,"Alabama","Bullock County",3,21,110,62,48
050,01,011,"Alabama","Bullock County",3,22,116,67,49
050,01,011,"Alabama","Bullock County",3,23,107,63,44
050,01,011,"Alabama","Bullock County",3,24,129,85,44
050,01,011,"Alabama","Bullock County",3,25,143,86,57
050,01,011,"Alabama","Bullock County",3,26,138,86,52
050,01,011,"Alabama","Bullock County",3,27,124,80,44
050,01,011,"Alabama","Bullock County",3,28,129,86,43
050,01,011,"Alabama","Bullock County",3,29,152,102,50
050,01,011,"Alabama","Bullock County",3,30,156,103,53
050,01,011,"Alabama","Bullock County",3,31,173,108,65
050,01,011,"Alabama","Bullock County",3,32,146,86,60
050,01,011,"Alabama","Bullock County",3,33,133,80,53
050,01,011,"Alabama","Bullock County",3,34,141,87,54
050,01,011,"Alabama","Bullock County",3,35,128,76,52
050,01,011,"Alabama","Bullock County",3,36,139,83,56
050,01,011,"Alabama","Bullock County",3,37,139,90,49
050,01,011,"Alabama","Bullock County",3,38,151,103,48
050,01,011,"Alabama","Bullock County",3,39,143,90,53
050,01,011,"Alabama","Bullock County",3,40,133,78,55
050,01,011,"Alabama","Bullock County",3,41,133,73,60
050,01,011,"Alabama","Bullock County",3,42,127,74,53
050,01,011,"Alabama","Bullock County",3,43,130,76,54
050,01,011,"Alabama","Bullock County",3,44,139,84,55
050,01,011,"Alabama","Bullock County",3,45,132,83,49
050,01,011,"Alabama","Bullock County",3,46,133,83,50
050,01,011,"Alabama","Bullock County",3,47,125,79,46
050,01,011,"Alabama","Bullock County",3,48,128,81,47
050,01,011,"Alabama","Bullock County",3,49,134,85,49
050,01,011,"Alabama","Bullock County",3,50,126,79,47
050,01,011,"Alabama","Bullock County",3,51,123,75,48
050,01,011,"Alabama","Bullock County",3,52,111,61,50
050,01,011,"Alabama","Bullock County",3,53,120,68,52
050,01,011,"Alabama","Bullock County",3,54,118,61,57
050,01,011,"Alabama","Bullock County",3,55,110,62,48
050,01,011,"Alabama","Bullock County",3,56,127,67,60
050,01,011,"Alabama","Bullock County",3,57,136,64,72
050,01,011,"Alabama","Bullock County",3,58,136,68,68
050,01,011,"Alabama","Bullock County",3,59,148,75,73
050,01,011,"Alabama","Bullock County",3,60,143,72,71
050,01,011,"Alabama","Bullock County",3,61,157,79,78
050,01,011,"Alabama","Bullock County",3,62,160,80,80
050,01,011,"Alabama","Bullock County",3,63,141,69,72
050,01,011,"Alabama","Bullock County",3,64,126,64,62
050,01,011,"Alabama","Bullock County",3,65,136,68,68
050,01,011,"Alabama","Bullock County",3,66,133,64,69
050,01,011,"Alabama","Bullock County",3,67,128,67,61
050,01,011,"Alabama","Bullock County",3,68,122,67,55
050,01,011,"Alabama","Bullock County",3,69,119,59,60
050,01,011,"Alabama","Bullock County",3,70,112,53,59
050,01,011,"Alabama","Bullock County",3,71,105,48,57
050,01,011,"Alabama","Bullock County",3,72,96,40,56
050,01,011,"Alabama","Bullock County",3,73,83,33,50
050,01,011,"Alabama","Bullock County",3,74,93,41,52
050,01,011,"Alabama","Bullock County",3,75,66,29,37
050,01,011,"Alabama","Bullock County",3,76,67,25,42
050,01,011,"Alabama","Bullock County",3,77,67,29,38
050,01,011,"Alabama","Bullock County",3,78,68,31,37
050,01,011,"Alabama","Bullock County",3,79,50,15,35
050,01,011,"Alabama","Bullock County",3,80,49,17,32
050,01,011,"Alabama","Bullock County",3,81,40,19,21
050,01,011,"Alabama","Bullock County",3,82,46,19,27
050,01,011,"Alabama","Bullock County",3,83,38,16,22
050,01,011,"Alabama","Bullock County",3,84,33,13,20
050,01,011,"Alabama","Bullock County",3,85,194,58,136
050,01,011,"Alabama","Bullock County",4,0,100,55,45
050,01,011,"Alabama","Bullock County",4,1,113,68,45
050,01,011,"Alabama","Bullock County",4,2,104,49,55
050,01,011,"Alabama","Bullock County",4,3,104,56,48
050,01,011,"Alabama","Bullock County",4,4,105,51,54
050,01,011,"Alabama","Bullock County",4,5,110,51,59
050,01,011,"Alabama","Bullock County",4,6,114,44,70
050,01,011,"Alabama","Bullock County",4,7,105,49,56
050,01,011,"Alabama","Bullock County",4,8,113,61,52
050,01,011,"Alabama","Bullock County",4,9,112,59,53
050,01,011,"Alabama","Bullock County",4,10,123,60,63
050,01,011,"Alabama","Bullock County",4,11,125,63,62
050,01,011,"Alabama","Bullock County",4,12,129,63,66
050,01,011,"Alabama","Bullock County",4,13,122,64,58
050,01,011,"Alabama","Bullock County",4,14,144,82,62
050,01,011,"Alabama","Bullock County",4,15,138,80,58
050,01,011,"Alabama","Bullock County",4,16,118,68,50
050,01,011,"Alabama","Bullock County",4,17,123,64,59
050,01,011,"Alabama","Bullock County",4,18,99,59,40
050,01,011,"Alabama","Bullock County",4,19,86,46,40
050,01,011,"Alabama","Bullock County",4,20,94,51,43
050,01,011,"Alabama","Bullock County",4,21,101,60,41
050,01,011,"Alabama","Bullock County",4,22,124,73,51
050,01,011,"Alabama","Bullock County",4,23,105,58,47
050,01,011,"Alabama","Bullock County",4,24,132,88,44
050,01,011,"Alabama","Bullock County",4,25,133,90,43
050,01,011,"Alabama","Bullock County",4,26,139,91,48
050,01,011,"Alabama","Bullock County",4,27,133,78,55
050,01,011,"Alabama","Bullock County",4,28,132,84,48
050,01,011,"Alabama","Bullock County",4,29,140,95,45
050,01,011,"Alabama","Bullock County",4,30,160,106,54
050,01,011,"Alabama","Bullock County",4,31,156,108,48
050,01,011,"Alabama","Bullock County",4,32,169,106,63
050,01,011,"Alabama","Bullock County",4,33,141,83,58
050,01,011,"Alabama","Bullock County",4,34,137,84,53
050,01,011,"Alabama","Bullock County",4,35,134,83,51
050,01,011,"Alabama","Bullock County",4,36,136,84,52
050,01,011,"Alabama","Bullock County",4,37,127,74,53
050,01,011,"Alabama","Bullock County",4,38,165,117,48
050,01,011,"Alabama","Bullock County",4,39,139,95,44
050,01,011,"Alabama","Bullock County",4,40,137,84,53
050,01,011,"Alabama","Bullock County",4,41,141,84,57
050,01,011,"Alabama","Bullock County",4,42,127,70,57
050,01,011,"Alabama","Bullock County",4,43,119,66,53
050,01,011,"Alabama","Bullock County",4,44,146,89,57
050,01,011,"Alabama","Bullock County",4,45,141,86,55
050,01,011,"Alabama","Bullock County",4,46,130,86,44
050,01,011,"Alabama","Bullock County",4,47,134,86,48
050,01,011,"Alabama","Bullock County",4,48,120,76,44
050,01,011,"Alabama","Bullock County",4,49,123,78,45
050,01,011,"Alabama","Bullock County",4,50,131,82,49
050,01,011,"Alabama","Bullock County",4,51,132,86,46
050,01,011,"Alabama","Bullock County",4,52,107,59,48
050,01,011,"Alabama","Bullock County",4,53,114,66,48
050,01,011,"Alabama","Bullock County",4,54,119,66,53
050,01,011,"Alabama","Bullock County",4,55,129,72,57
050,01,011,"Alabama","Bullock County",4,56,110,62,48
050,01,011,"Alabama","Bullock County",4,57,129,66,63
050,01,011,"Alabama","Bullock County",4,58,132,64,68
050,01,011,"Alabama","Bullock County",4,59,132,62,70
050,01,011,"Alabama","Bullock County",4,60,143,76,67
050,01,011,"Alabama","Bullock County",4,61,139,71,68
050,01,011,"Alabama","Bullock County",4,62,161,85,76
050,01,011,"Alabama","Bullock County",4,63,154,79,75
050,01,011,"Alabama","Bullock County",4,64,132,62,70
050,01,011,"Alabama","Bullock County",4,65,127,65,62
050,01,011,"Alabama","Bullock County",4,66,135,67,68
050,01,011,"Alabama","Bullock County",4,67,128,59,69
050,01,011,"Alabama","Bullock County",4,68,126,64,62
050,01,011,"Alabama","Bullock County",4,69,123,67,56
050,01,011,"Alabama","Bullock County",4,70,112,58,54
050,01,011,"Alabama","Bullock County",4,71,107,48,59
050,01,011,"Alabama","Bullock County",4,72,101,46,55
050,01,011,"Alabama","Bullock County",4,73,88,38,50
050,01,011,"Alabama","Bullock County",4,74,74,29,45
050,01,011,"Alabama","Bullock County",4,75,90,40,50
050,01,011,"Alabama","Bullock County",4,76,62,28,34
050,01,011,"Alabama","Bullock County",4,77,68,27,41
050,01,011,"Alabama","Bullock County",4,78,66,30,36
050,01,011,"Alabama","Bullock County",4,79,62,25,37
050,01,011,"Alabama","Bullock County",4,80,54,15,39
050,01,011,"Alabama","Bullock County",4,81,40,14,26
050,01,011,"Alabama","Bullock County",4,82,39,19,20
050,01,011,"Alabama","Bullock County",4,83,46,20,26
050,01,011,"Alabama","Bullock County",4,84,30,13,17
050,01,011,"Alabama","Bullock County",4,85,199,61,138
050,01,011,"Alabama","Bullock County",5,0,102,56,46
050,01,011,"Alabama","Bullock County",5,1,96,55,41
050,01,011,"Alabama","Bullock County",5,2,104,62,42
050,01,011,"Alabama","Bullock County",5,3,100,49,51
050,01,011,"Alabama","Bullock County",5,4,94,55,39
050,01,011,"Alabama","Bullock County",5,5,105,47,58
050,01,011,"Alabama","Bullock County",5,6,110,53,57
050,01,011,"Alabama","Bullock County",5,7,109,40,69
050,01,011,"Alabama","Bullock County",5,8,101,50,51
050,01,011,"Alabama","Bullock County",5,9,107,59,48
050,01,011,"Alabama","Bullock County",5,10,109,58,51
050,01,011,"Alabama","Bullock County",5,11,121,61,60
050,01,011,"Alabama","Bullock County",5,12,126,62,64
050,01,011,"Alabama","Bullock County",5,13,122,60,62
050,01,011,"Alabama","Bullock County",5,14,119,61,58
050,01,011,"Alabama","Bullock County",5,15,143,83,60
050,01,011,"Alabama","Bullock County",5,16,137,83,54
050,01,011,"Alabama","Bullock County",5,17,114,67,47
050,01,011,"Alabama","Bullock County",5,18,109,64,45
050,01,011,"Alabama","Bullock County",5,19,87,48,39
050,01,011,"Alabama","Bullock County",5,20,87,47,40
050,01,011,"Alabama","Bullock County",5,21,104,55,49
050,01,011,"Alabama","Bullock County",5,22,112,69,43
050,01,011,"Alabama","Bullock County",5,23,115,67,48
050,01,011,"Alabama","Bullock County",5,24,123,73,50
050,01,011,"Alabama","Bullock County",5,25,124,85,39
050,01,011,"Alabama","Bullock County",5,26,130,81,49
050,01,011,"Alabama","Bullock County",5,27,124,79,45
050,01,011,"Alabama","Bullock County",5,28,136,83,53
050,01,011,"Alabama","Bullock County",5,29,133,90,43
050,01,011,"Alabama","Bullock County",5,30,136,94,42
050,01,011,"Alabama","Bullock County",5,31,154,107,47
050,01,011,"Alabama","Bullock County",5,32,153,106,47
050,01,011,"Alabama","Bullock County",5,33,164,98,66
050,01,011,"Alabama","Bullock County",5,34,141,83,58
050,01,011,"Alabama","Bullock County",5,35,122,70,52
050,01,011,"Alabama","Bullock County",5,36,141,95,46
050,01,011,"Alabama","Bullock County",5,37,130,73,57
050,01,011,"Alabama","Bullock County",5,38,142,89,53
050,01,011,"Alabama","Bullock County",5,39,150,104,46
050,01,011,"Alabama","Bullock County",5,40,116,74,42
050,01,011,"Alabama","Bullock County",5,41,144,92,52
050,01,011,"Alabama","Bullock County",5,42,134,81,53
050,01,011,"Alabama","Bullock County",5,43,121,63,58
050,01,011,"Alabama","Bullock County",5,44,124,74,50
050,01,011,"Alabama","Bullock County",5,45,139,82,57
050,01,011,"Alabama","Bullock County",5,46,143,91,52
050,01,011,"Alabama","Bullock County",5,47,131,86,45
050,01,011,"Alabama","Bullock County",5,48,128,80,48
050,01,011,"Alabama","Bullock County",5,49,111,71,40
050,01,011,"Alabama","Bullock County",5,50,115,70,45
050,01,011,"Alabama","Bullock County",5,51,134,88,46
050,01,011,"Alabama","Bullock County",5,52,109,71,38
050,01,011,"Alabama","Bullock County",5,53,111,61,50
050,01,011,"Alabama","Bullock County",5,54,108,62,46
050,01,011,"Alabama","Bullock County",5,55,118,66,52
050,01,011,"Alabama","Bullock County",5,56,123,66,57
050,01,011,"Alabama","Bullock County",5,57,104,57,47
050,01,011,"Alabama","Bullock County",5,58,117,58,59
050,01,011,"Alabama","Bullock County",5,59,128,60,68
050,01,011,"Alabama","Bullock County",5,60,128,59,69
050,01,011,"Alabama","Bullock County",5,61,135,68,67
050,01,011,"Alabama","Bullock County",5,62,139,71,68
050,01,011,"Alabama","Bullock County",5,63,156,81,75
050,01,011,"Alabama","Bullock County",5,64,138,64,74
050,01,011,"Alabama","Bullock County",5,65,129,61,68
050,01,011,"Alabama","Bullock County",5,66,124,61,63
050,01,011,"Alabama","Bullock County",5,67,131,64,67
050,01,011,"Alabama","Bullock County",5,68,121,55,66
050,01,011,"Alabama","Bullock County",5,69,125,63,62
050,01,011,"Alabama","Bullock County",5,70,121,67,54
050,01,011,"Alabama","Bullock County",5,71,113,57,56
050,01,011,"Alabama","Bullock County",5,72,101,46,55
050,01,011,"Alabama","Bullock County",5,73,96,43,53
050,01,011,"Alabama","Bullock County",5,74,77,32,45
050,01,011,"Alabama","Bullock County",5,75,70,28,42
050,01,011,"Alabama","Bullock County",5,76,84,38,46
050,01,011,"Alabama","Bullock County",5,77,64,31,33
050,01,011,"Alabama","Bullock County",5,78,66,29,37
050,01,011,"Alabama","Bullock County",5,79,59,23,36
050,01,011,"Alabama","Bullock County",5,80,66,26,40
050,01,011,"Alabama","Bullock County",5,81,46,11,35
050,01,011,"Alabama","Bullock County",5,82,39,13,26
050,01,011,"Alabama","Bullock County",5,83,37,18,19
050,01,011,"Alabama","Bullock County",5,84,38,16,22
050,01,011,"Alabama","Bullock County",5,85,200,61,139
050,01,013,"Alabama","Butler County",1,0,192,98,94
050,01,013,"Alabama","Butler County",1,1,211,109,102
050,01,013,"Alabama","Butler County",1,2,220,108,112
050,01,013,"Alabama","Butler County",1,3,224,110,114
050,01,013,"Alabama","Butler County",1,4,218,107,111
050,01,013,"Alabama","Butler County",1,5,227,122,105
050,01,013,"Alabama","Butler County",1,6,231,119,112
050,01,013,"Alabama","Butler County",1,7,234,125,109
050,01,013,"Alabama","Butler County",1,8,225,117,108
050,01,013,"Alabama","Butler County",1,9,252,136,116
050,01,013,"Alabama","Butler County",1,10,231,119,112
050,01,013,"Alabama","Butler County",1,11,256,138,118
050,01,013,"Alabama","Butler County",1,12,279,152,127
050,01,013,"Alabama","Butler County",1,13,282,144,138
050,01,013,"Alabama","Butler County",1,14,257,136,121
050,01,013,"Alabama","Butler County",1,15,245,135,110
050,01,013,"Alabama","Butler County",1,16,245,142,103
050,01,013,"Alabama","Butler County",1,17,242,134,108
050,01,013,"Alabama","Butler County",1,18,221,121,100
050,01,013,"Alabama","Butler County",1,19,181,98,83
050,01,013,"Alabama","Butler County",1,20,212,105,107
050,01,013,"Alabama","Butler County",1,21,212,109,103
050,01,013,"Alabama","Butler County",1,22,218,118,100
050,01,013,"Alabama","Butler County",1,23,211,105,106
050,01,013,"Alabama","Butler County",1,24,221,100,121
050,01,013,"Alabama","Butler County",1,25,223,115,108
050,01,013,"Alabama","Butler County",1,26,198,100,98
050,01,013,"Alabama","Butler County",1,27,205,104,101
050,01,013,"Alabama","Butler County",1,28,237,119,118
050,01,013,"Alabama","Butler County",1,29,216,103,113
050,01,013,"Alabama","Butler County",1,30,217,109,108
050,01,013,"Alabama","Butler County",1,31,227,100,127
050,01,013,"Alabama","Butler County",1,32,205,89,116
050,01,013,"Alabama","Butler County",1,33,204,92,112
050,01,013,"Alabama","Butler County",1,34,213,93,120
050,01,013,"Alabama","Butler County",1,35,222,96,126
050,01,013,"Alabama","Butler County",1,36,236,115,121
050,01,013,"Alabama","Butler County",1,37,238,117,121
050,01,013,"Alabama","Butler County",1,38,226,109,117
050,01,013,"Alabama","Butler County",1,39,257,116,141
050,01,013,"Alabama","Butler County",1,40,255,101,154
050,01,013,"Alabama","Butler County",1,41,230,100,130
050,01,013,"Alabama","Butler County",1,42,239,101,138
050,01,013,"Alabama","Butler County",1,43,231,108,123
050,01,013,"Alabama","Butler County",1,44,218,103,115
050,01,013,"Alabama","Butler County",1,45,216,84,132
050,01,013,"Alabama","Butler County",1,46,215,98,117
050,01,013,"Alabama","Butler County",1,47,212,105,107
050,01,013,"Alabama","Butler County",1,48,226,99,127
050,01,013,"Alabama","Butler County",1,49,249,116,133
050,01,013,"Alabama","Butler County",1,50,249,118,131
050,01,013,"Alabama","Butler County",1,51,223,98,125
050,01,013,"Alabama","Butler County",1,52,216,96,120
050,01,013,"Alabama","Butler County",1,53,218,104,114
050,01,013,"Alabama","Butler County",1,54,207,89,118
050,01,013,"Alabama","Butler County",1,55,234,101,133
050,01,013,"Alabama","Butler County",1,56,266,122,144
050,01,013,"Alabama","Butler County",1,57,259,116,143
050,01,013,"Alabama","Butler County",1,58,264,106,158
050,01,013,"Alabama","Butler County",1,59,263,112,151
050,01,013,"Alabama","Butler County",1,60,268,125,143
050,01,013,"Alabama","Butler County",1,61,272,135,137
050,01,013,"Alabama","Butler County",1,62,276,140,136
050,01,013,"Alabama","Butler County",1,63,286,143,143
050,01,013,"Alabama","Butler County",1,64,281,130,151
050,01,013,"Alabama","Butler County",1,65,277,135,142
050,01,013,"Alabama","Butler County",1,66,264,106,158
050,01,013,"Alabama","Butler County",1,67,260,106,154
050,01,013,"Alabama","Butler County",1,68,245,120,125
050,01,013,"Alabama","Butler County",1,69,224,99,125
050,01,013,"Alabama","Butler County",1,70,223,105,118
050,01,013,"Alabama","Butler County",1,71,195,92,103
050,01,013,"Alabama","Butler County",1,72,185,85,100
050,01,013,"Alabama","Butler County",1,73,185,87,98
050,01,013,"Alabama","Butler County",1,74,168,76,92
050,01,013,"Alabama","Butler County",1,75,174,90,84
050,01,013,"Alabama","Butler County",1,76,150,70,80
050,01,013,"Alabama","Butler County",1,77,134,60,74
050,01,013,"Alabama","Butler County",1,78,131,56,75
050,01,013,"Alabama","Butler County",1,79,100,39,61
050,01,013,"Alabama","Butler County",1,80,116,45,71
050,01,013,"Alabama","Butler County",1,81,110,33,77
050,01,013,"Alabama","Butler County",1,82,105,40,65
050,01,013,"Alabama","Butler County",1,83,77,29,48
050,01,013,"Alabama","Butler County",1,84,89,30,59
050,01,013,"Alabama","Butler County",1,85,490,117,373
050,01,013,"Alabama","Butler County",2,0,197,105,92
050,01,013,"Alabama","Butler County",2,1,207,106,101
050,01,013,"Alabama","Butler County",2,2,222,110,112
050,01,013,"Alabama","Butler County",2,3,223,109,114
050,01,013,"Alabama","Butler County",2,4,220,110,110
050,01,013,"Alabama","Butler County",2,5,228,120,108
050,01,013,"Alabama","Butler County",2,6,230,119,111
050,01,013,"Alabama","Butler County",2,7,232,123,109
050,01,013,"Alabama","Butler County",2,8,225,117,108
050,01,013,"Alabama","Butler County",2,9,242,129,113
050,01,013,"Alabama","Butler County",2,10,235,123,112
050,01,013,"Alabama","Butler County",2,11,251,135,116
050,01,013,"Alabama","Butler County",2,12,279,152,127
050,01,013,"Alabama","Butler County",2,13,283,146,137
050,01,013,"Alabama","Butler County",2,14,263,139,124
050,01,013,"Alabama","Butler County",2,15,250,137,113
050,01,013,"Alabama","Butler County",2,16,245,141,104
050,01,013,"Alabama","Butler County",2,17,243,136,107
050,01,013,"Alabama","Butler County",2,18,215,119,96
050,01,013,"Alabama","Butler County",2,19,187,101,86
050,01,013,"Alabama","Butler County",2,20,211,106,105
050,01,013,"Alabama","Butler County",2,21,215,110,105
050,01,013,"Alabama","Butler County",2,22,220,118,102
050,01,013,"Alabama","Butler County",2,23,212,106,106
050,01,013,"Alabama","Butler County",2,24,219,102,117
050,01,013,"Alabama","Butler County",2,25,219,107,112
050,01,013,"Alabama","Butler County",2,26,201,100,101
050,01,013,"Alabama","Butler County",2,27,204,103,101
050,01,013,"Alabama","Butler County",2,28,228,114,114
050,01,013,"Alabama","Butler County",2,29,221,107,114
050,01,013,"Alabama","Butler County",2,30,219,109,110
050,01,013,"Alabama","Butler County",2,31,222,100,122
050,01,013,"Alabama","Butler County",2,32,209,92,117
050,01,013,"Alabama","Butler County",2,33,203,91,112
050,01,013,"Alabama","Butler County",2,34,209,92,117
050,01,013,"Alabama","Butler County",2,35,223,96,127
050,01,013,"Alabama","Butler County",2,36,229,108,121
050,01,013,"Alabama","Butler County",2,37,237,114,123
050,01,013,"Alabama","Butler County",2,38,231,112,119
050,01,013,"Alabama","Butler County",2,39,248,113,135
050,01,013,"Alabama","Butler County",2,40,258,107,151
050,01,013,"Alabama","Butler County",2,41,238,102,136
050,01,013,"Alabama","Butler County",2,42,236,102,134
050,01,013,"Alabama","Butler County",2,43,237,110,127
050,01,013,"Alabama","Butler County",2,44,218,102,116
050,01,013,"Alabama","Butler County",2,45,217,88,129
050,01,013,"Alabama","Butler County",2,46,216,95,121
050,01,013,"Alabama","Butler County",2,47,211,103,108
050,01,013,"Alabama","Butler County",2,48,223,100,123
050,01,013,"Alabama","Butler County",2,49,243,112,131
050,01,013,"Alabama","Butler County",2,50,249,118,131
050,01,013,"Alabama","Butler County",2,51,230,103,127
050,01,013,"Alabama","Butler County",2,52,220,98,122
050,01,013,"Alabama","Butler County",2,53,219,103,116
050,01,013,"Alabama","Butler County",2,54,209,91,118
050,01,013,"Alabama","Butler County",2,55,227,97,130
050,01,013,"Alabama","Butler County",2,56,255,114,141
050,01,013,"Alabama","Butler County",2,57,258,117,141
050,01,013,"Alabama","Butler County",2,58,262,108,154
050,01,013,"Alabama","Butler County",2,59,261,110,151
050,01,013,"Alabama","Butler County",2,60,264,119,145
050,01,013,"Alabama","Butler County",2,61,271,134,137
050,01,013,"Alabama","Butler County",2,62,272,138,134
050,01,013,"Alabama","Butler County",2,63,288,144,144
050,01,013,"Alabama","Butler County",2,64,280,132,148
050,01,013,"Alabama","Butler County",2,65,278,135,143
050,01,013,"Alabama","Butler County",2,66,269,113,156
050,01,013,"Alabama","Butler County",2,67,257,104,153
050,01,013,"Alabama","Butler County",2,68,244,115,129
050,01,013,"Alabama","Butler County",2,69,228,102,126
050,01,013,"Alabama","Butler County",2,70,224,105,119
050,01,013,"Alabama","Butler County",2,71,200,94,106
050,01,013,"Alabama","Butler County",2,72,183,86,97
050,01,013,"Alabama","Butler County",2,73,191,89,102
050,01,013,"Alabama","Butler County",2,74,162,73,89
050,01,013,"Alabama","Butler County",2,75,172,86,86
050,01,013,"Alabama","Butler County",2,76,152,71,81
050,01,013,"Alabama","Butler County",2,77,137,62,75
050,01,013,"Alabama","Butler County",2,78,125,55,70
050,01,013,"Alabama","Butler County",2,79,103,40,63
050,01,013,"Alabama","Butler County",2,80,112,44,68
050,01,013,"Alabama","Butler County",2,81,110,35,75
050,01,013,"Alabama","Butler County",2,82,108,39,69
050,01,013,"Alabama","Butler County",2,83,78,28,50
050,01,013,"Alabama","Butler County",2,84,84,29,55
050,01,013,"Alabama","Butler County",2,85,489,118,371
050,01,013,"Alabama","Butler County",3,0,225,118,107
050,01,013,"Alabama","Butler County",3,1,203,104,99
050,01,013,"Alabama","Butler County",3,2,211,109,102
050,01,013,"Alabama","Butler County",3,3,229,116,113
050,01,013,"Alabama","Butler County",3,4,223,105,118
050,01,013,"Alabama","Butler County",3,5,217,108,109
050,01,013,"Alabama","Butler County",3,6,240,122,118
050,01,013,"Alabama","Butler County",3,7,230,116,114
050,01,013,"Alabama","Butler County",3,8,234,118,116
050,01,013,"Alabama","Butler County",3,9,233,120,113
050,01,013,"Alabama","Butler County",3,10,253,138,115
050,01,013,"Alabama","Butler County",3,11,240,128,112
050,01,013,"Alabama","Butler County",3,12,255,138,117
050,01,013,"Alabama","Butler County",3,13,268,149,119
050,01,013,"Alabama","Butler County",3,14,284,147,137
050,01,013,"Alabama","Butler County",3,15,249,129,120
050,01,013,"Alabama","Butler County",3,16,239,132,107
050,01,013,"Alabama","Butler County",3,17,249,140,109
050,01,013,"Alabama","Butler County",3,18,211,120,91
050,01,013,"Alabama","Butler County",3,19,185,101,84
050,01,013,"Alabama","Butler County",3,20,195,103,92
050,01,013,"Alabama","Butler County",3,21,217,108,109
050,01,013,"Alabama","Butler County",3,22,218,111,107
050,01,013,"Alabama","Butler County",3,23,216,110,106
050,01,013,"Alabama","Butler County",3,24,207,106,101
050,01,013,"Alabama","Butler County",3,25,204,94,110
050,01,013,"Alabama","Butler County",3,26,210,101,109
050,01,013,"Alabama","Butler County",3,27,198,96,102
050,01,013,"Alabama","Butler County",3,28,200,98,102
050,01,013,"Alabama","Butler County",3,29,218,107,111
050,01,013,"Alabama","Butler County",3,30,227,110,117
050,01,013,"Alabama","Butler County",3,31,213,96,117
050,01,013,"Alabama","Butler County",3,32,228,104,124
050,01,013,"Alabama","Butler County",3,33,214,88,126
050,01,013,"Alabama","Butler County",3,34,206,95,111
050,01,013,"Alabama","Butler County",3,35,206,90,116
050,01,013,"Alabama","Butler County",3,36,219,94,125
050,01,013,"Alabama","Butler County",3,37,225,100,125
050,01,013,"Alabama","Butler County",3,38,238,116,122
050,01,013,"Alabama","Butler County",3,39,223,107,116
050,01,013,"Alabama","Butler County",3,40,249,113,136
050,01,013,"Alabama","Butler County",3,41,256,102,154
050,01,013,"Alabama","Butler County",3,42,226,98,128
050,01,013,"Alabama","Butler County",3,43,231,100,131
050,01,013,"Alabama","Butler County",3,44,249,109,140
050,01,013,"Alabama","Butler County",3,45,211,102,109
050,01,013,"Alabama","Butler County",3,46,219,88,131
050,01,013,"Alabama","Butler County",3,47,209,96,113
050,01,013,"Alabama","Butler County",3,48,206,103,103
050,01,013,"Alabama","Butler County",3,49,224,100,124
050,01,013,"Alabama","Butler County",3,50,245,118,127
050,01,013,"Alabama","Butler County",3,51,248,120,128
050,01,013,"Alabama","Butler County",3,52,229,104,125
050,01,013,"Alabama","Butler County",3,53,219,95,124
050,01,013,"Alabama","Butler County",3,54,213,104,109
050,01,013,"Alabama","Butler County",3,55,201,84,117
050,01,013,"Alabama","Butler County",3,56,231,102,129
050,01,013,"Alabama","Butler County",3,57,246,111,135
050,01,013,"Alabama","Butler County",3,58,251,110,141
050,01,013,"Alabama","Butler County",3,59,261,111,150
050,01,013,"Alabama","Butler County",3,60,255,106,149
050,01,013,"Alabama","Butler County",3,61,272,120,152
050,01,013,"Alabama","Butler County",3,62,269,131,138
050,01,013,"Alabama","Butler County",3,63,269,140,129
050,01,013,"Alabama","Butler County",3,64,277,139,138
050,01,013,"Alabama","Butler County",3,65,273,126,147
050,01,013,"Alabama","Butler County",3,66,280,134,146
050,01,013,"Alabama","Butler County",3,67,263,111,152
050,01,013,"Alabama","Butler County",3,68,246,98,148
050,01,013,"Alabama","Butler County",3,69,228,105,123
050,01,013,"Alabama","Butler County",3,70,219,99,120
050,01,013,"Alabama","Butler County",3,71,214,99,115
050,01,013,"Alabama","Butler County",3,72,191,89,102
050,01,013,"Alabama","Butler County",3,73,178,79,99
050,01,013,"Alabama","Butler County",3,74,186,86,100
050,01,013,"Alabama","Butler County",3,75,152,70,82
050,01,013,"Alabama","Butler County",3,76,164,77,87
050,01,013,"Alabama","Butler County",3,77,147,71,76
050,01,013,"Alabama","Butler County",3,78,130,59,71
050,01,013,"Alabama","Butler County",3,79,112,47,65
050,01,013,"Alabama","Butler County",3,80,100,39,61
050,01,013,"Alabama","Butler County",3,81,105,39,66
050,01,013,"Alabama","Butler County",3,82,111,33,78
050,01,013,"Alabama","Butler County",3,83,96,37,59
050,01,013,"Alabama","Butler County",3,84,75,27,48
050,01,013,"Alabama","Butler County",3,85,494,125,369
050,01,013,"Alabama","Butler County",4,0,204,107,97
050,01,013,"Alabama","Butler County",4,1,222,120,102
050,01,013,"Alabama","Butler County",4,2,207,114,93
050,01,013,"Alabama","Butler County",4,3,221,115,106
050,01,013,"Alabama","Butler County",4,4,230,111,119
050,01,013,"Alabama","Butler County",4,5,214,106,108
050,01,013,"Alabama","Butler County",4,6,219,111,108
050,01,013,"Alabama","Butler County",4,7,222,115,107
050,01,013,"Alabama","Butler County",4,8,230,115,115
050,01,013,"Alabama","Butler County",4,9,236,117,119
050,01,013,"Alabama","Butler County",4,10,229,120,109
050,01,013,"Alabama","Butler County",4,11,247,139,108
050,01,013,"Alabama","Butler County",4,12,230,127,103
050,01,013,"Alabama","Butler County",4,13,254,136,118
050,01,013,"Alabama","Butler County",4,14,272,148,124
050,01,013,"Alabama","Butler County",4,15,278,145,133
050,01,013,"Alabama","Butler County",4,16,249,130,119
050,01,013,"Alabama","Butler County",4,17,241,131,110
050,01,013,"Alabama","Butler County",4,18,211,124,87
050,01,013,"Alabama","Butler County",4,19,177,103,74
050,01,013,"Alabama","Butler County",4,20,188,101,87
050,01,013,"Alabama","Butler County",4,21,206,110,96
050,01,013,"Alabama","Butler County",4,22,230,113,117
050,01,013,"Alabama","Butler County",4,23,219,111,108
050,01,013,"Alabama","Butler County",4,24,226,112,114
050,01,013,"Alabama","Butler County",4,25,196,93,103
050,01,013,"Alabama","Butler County",4,26,215,100,115
050,01,013,"Alabama","Butler County",4,27,211,100,111
050,01,013,"Alabama","Butler County",4,28,193,92,101
050,01,013,"Alabama","Butler County",4,29,188,97,91
050,01,013,"Alabama","Butler County",4,30,213,105,108
050,01,013,"Alabama","Butler County",4,31,208,96,112
050,01,013,"Alabama","Butler County",4,32,216,101,115
050,01,013,"Alabama","Butler County",4,33,220,94,126
050,01,013,"Alabama","Butler County",4,34,204,82,122
050,01,013,"Alabama","Butler County",4,35,211,95,116
050,01,013,"Alabama","Butler County",4,36,208,91,117
050,01,013,"Alabama","Butler County",4,37,213,89,124
050,01,013,"Alabama","Butler County",4,38,214,98,116
050,01,013,"Alabama","Butler County",4,39,231,110,121
050,01,013,"Alabama","Butler County",4,40,219,103,116
050,01,013,"Alabama","Butler County",4,41,240,107,133
050,01,013,"Alabama","Butler County",4,42,243,96,147
050,01,013,"Alabama","Butler County",4,43,225,103,122
050,01,013,"Alabama","Butler County",4,44,235,105,130
050,01,013,"Alabama","Butler County",4,45,240,102,138
050,01,013,"Alabama","Butler County",4,46,213,99,114
050,01,013,"Alabama","Butler County",4,47,207,82,125
050,01,013,"Alabama","Butler County",4,48,217,99,118
050,01,013,"Alabama","Butler County",4,49,207,107,100
050,01,013,"Alabama","Butler County",4,50,229,106,123
050,01,013,"Alabama","Butler County",4,51,246,121,125
050,01,013,"Alabama","Butler County",4,52,241,115,126
050,01,013,"Alabama","Butler County",4,53,231,101,130
050,01,013,"Alabama","Butler County",4,54,222,99,123
050,01,013,"Alabama","Butler County",4,55,216,106,110
050,01,013,"Alabama","Butler County",4,56,203,86,117
050,01,013,"Alabama","Butler County",4,57,221,96,125
050,01,013,"Alabama","Butler County",4,58,233,105,128
050,01,013,"Alabama","Butler County",4,59,247,112,135
050,01,013,"Alabama","Butler County",4,60,257,111,146
050,01,013,"Alabama","Butler County",4,61,264,109,155
050,01,013,"Alabama","Butler County",4,62,264,113,151
050,01,013,"Alabama","Butler County",4,63,264,132,132
050,01,013,"Alabama","Butler County",4,64,262,132,130
050,01,013,"Alabama","Butler County",4,65,275,137,138
050,01,013,"Alabama","Butler County",4,66,270,124,146
050,01,013,"Alabama","Butler County",4,67,263,132,131
050,01,013,"Alabama","Butler County",4,68,259,110,149
050,01,013,"Alabama","Butler County",4,69,230,91,139
050,01,013,"Alabama","Butler County",4,70,225,102,123
050,01,013,"Alabama","Butler County",4,71,208,91,117
050,01,013,"Alabama","Butler County",4,72,203,95,108
050,01,013,"Alabama","Butler County",4,73,188,87,101
050,01,013,"Alabama","Butler County",4,74,174,75,99
050,01,013,"Alabama","Butler County",4,75,172,81,91
050,01,013,"Alabama","Butler County",4,76,146,65,81
050,01,013,"Alabama","Butler County",4,77,161,79,82
050,01,013,"Alabama","Butler County",4,78,145,72,73
050,01,013,"Alabama","Butler County",4,79,118,49,69
050,01,013,"Alabama","Butler County",4,80,103,44,59
050,01,013,"Alabama","Butler County",4,81,93,35,58
050,01,013,"Alabama","Butler County",4,82,98,36,62
050,01,013,"Alabama","Butler County",4,83,95,27,68
050,01,013,"Alabama","Butler County",4,84,89,35,54
050,01,013,"Alabama","Butler County",4,85,504,134,370
050,01,013,"Alabama","Butler County",5,0,209,110,99
050,01,013,"Alabama","Butler County",5,1,209,106,103
050,01,013,"Alabama","Butler County",5,2,215,110,105
050,01,013,"Alabama","Butler County",5,3,203,107,96
050,01,013,"Alabama","Butler County",5,4,224,118,106
050,01,013,"Alabama","Butler County",5,5,222,112,110
050,01,013,"Alabama","Butler County",5,6,195,100,95
050,01,013,"Alabama","Butler County",5,7,214,104,110
050,01,013,"Alabama","Butler County",5,8,216,112,104
050,01,013,"Alabama","Butler County",5,9,226,113,113
050,01,013,"Alabama","Butler County",5,10,242,125,117
050,01,013,"Alabama","Butler County",5,11,231,122,109
050,01,013,"Alabama","Butler County",5,12,239,132,107
050,01,013,"Alabama","Butler County",5,13,230,127,103
050,01,013,"Alabama","Butler County",5,14,247,132,115
050,01,013,"Alabama","Butler County",5,15,268,144,124
050,01,013,"Alabama","Butler County",5,16,271,134,137
050,01,013,"Alabama","Butler County",5,17,245,130,115
050,01,013,"Alabama","Butler County",5,18,204,114,90
050,01,013,"Alabama","Butler County",5,19,170,99,71
050,01,013,"Alabama","Butler County",5,20,173,99,74
050,01,013,"Alabama","Butler County",5,21,195,105,90
050,01,013,"Alabama","Butler County",5,22,212,114,98
050,01,013,"Alabama","Butler County",5,23,215,104,111
050,01,013,"Alabama","Butler County",5,24,223,109,114
050,01,013,"Alabama","Butler County",5,25,219,107,112
050,01,013,"Alabama","Butler County",5,26,189,91,98
050,01,013,"Alabama","Butler County",5,27,218,95,123
050,01,013,"Alabama","Butler County",5,28,205,95,110
050,01,013,"Alabama","Butler County",5,29,194,89,105
050,01,013,"Alabama","Butler County",5,30,196,103,93
050,01,013,"Alabama","Butler County",5,31,208,102,106
050,01,013,"Alabama","Butler County",5,32,201,94,107
050,01,013,"Alabama","Butler County",5,33,220,98,122
050,01,013,"Alabama","Butler County",5,34,222,92,130
050,01,013,"Alabama","Butler County",5,35,197,83,114
050,01,013,"Alabama","Butler County",5,36,210,97,113
050,01,013,"Alabama","Butler County",5,37,211,88,123
050,01,013,"Alabama","Butler County",5,38,202,85,117
050,01,013,"Alabama","Butler County",5,39,203,89,114
050,01,013,"Alabama","Butler County",5,40,236,111,125
050,01,013,"Alabama","Butler County",5,41,207,91,116
050,01,013,"Alabama","Butler County",5,42,245,107,138
050,01,013,"Alabama","Butler County",5,43,244,97,147
050,01,013,"Alabama","Butler County",5,44,226,100,126
050,01,013,"Alabama","Butler County",5,45,230,100,130
050,01,013,"Alabama","Butler County",5,46,231,98,133
050,01,013,"Alabama","Butler County",5,47,208,99,109
050,01,013,"Alabama","Butler County",5,48,210,90,120
050,01,013,"Alabama","Butler County",5,49,225,107,118
050,01,013,"Alabama","Butler County",5,50,202,105,97
050,01,013,"Alabama","Butler County",5,51,229,106,123
050,01,013,"Alabama","Butler County",5,52,248,126,122
050,01,013,"Alabama","Butler County",5,53,239,114,125
050,01,013,"Alabama","Butler County",5,54,231,100,131
050,01,013,"Alabama","Butler County",5,55,220,100,120
050,01,013,"Alabama","Butler County",5,56,204,104,100
050,01,013,"Alabama","Butler County",5,57,190,77,113
050,01,013,"Alabama","Butler County",5,58,210,90,120
050,01,013,"Alabama","Butler County",5,59,226,106,120
050,01,013,"Alabama","Butler County",5,60,240,105,135
050,01,013,"Alabama","Butler County",5,61,264,116,148
050,01,013,"Alabama","Butler County",5,62,252,102,150
050,01,013,"Alabama","Butler County",5,63,257,109,148
050,01,013,"Alabama","Butler County",5,64,249,124,125
050,01,013,"Alabama","Butler County",5,65,254,126,128
050,01,013,"Alabama","Butler County",5,66,274,134,140
050,01,013,"Alabama","Butler County",5,67,260,119,141
050,01,013,"Alabama","Butler County",5,68,260,129,131
050,01,013,"Alabama","Butler County",5,69,248,105,143
050,01,013,"Alabama","Butler County",5,70,227,87,140
050,01,013,"Alabama","Butler County",5,71,213,95,118
050,01,013,"Alabama","Butler County",5,72,201,88,113
050,01,013,"Alabama","Butler County",5,73,198,91,107
050,01,013,"Alabama","Butler County",5,74,187,86,101
050,01,013,"Alabama","Butler County",5,75,165,73,92
050,01,013,"Alabama","Butler County",5,76,166,75,91
050,01,013,"Alabama","Butler County",5,77,141,65,76
050,01,013,"Alabama","Butler County",5,78,155,75,80
050,01,013,"Alabama","Butler County",5,79,132,61,71
050,01,013,"Alabama","Butler County",5,80,106,44,62
050,01,013,"Alabama","Butler County",5,81,96,39,57
050,01,013,"Alabama","Butler County",5,82,90,32,58
050,01,013,"Alabama","Butler County",5,83,84,32,52
050,01,013,"Alabama","Butler County",5,84,93,27,66
050,01,013,"Alabama","Butler County",5,85,516,142,374
050,01,015,"Alabama","Calhoun County",1,0,1220,626,594
050,01,015,"Alabama","Calhoun County",1,1,1276,669,607
050,01,015,"Alabama","Calhoun County",1,2,1319,697,622
050,01,015,"Alabama","Calhoun County",1,3,1347,680,667
050,01,015,"Alabama","Calhoun County",1,4,1328,669,659
050,01,015,"Alabama","Calhoun County",1,5,1322,679,643
050,01,015,"Alabama","Calhoun County",1,6,1299,652,647
050,01,015,"Alabama","Calhoun County",1,7,1335,663,672
050,01,015,"Alabama","Calhoun County",1,8,1313,659,654
050,01,015,"Alabama","Calhoun County",1,9,1290,652,638
050,01,015,"Alabama","Calhoun County",1,10,1387,720,667
050,01,015,"Alabama","Calhoun County",1,11,1495,796,699
050,01,015,"Alabama","Calhoun County",1,12,1549,805,744
050,01,015,"Alabama","Calhoun County",1,13,1526,783,743
050,01,015,"Alabama","Calhoun County",1,14,1454,757,697
050,01,015,"Alabama","Calhoun County",1,15,1452,783,669
050,01,015,"Alabama","Calhoun County",1,16,1484,784,700
050,01,015,"Alabama","Calhoun County",1,17,1489,755,734
050,01,015,"Alabama","Calhoun County",1,18,1930,860,1070
050,01,015,"Alabama","Calhoun County",1,19,2258,1158,1100
050,01,015,"Alabama","Calhoun County",1,20,1850,945,905
050,01,015,"Alabama","Calhoun County",1,21,1716,856,860
050,01,015,"Alabama","Calhoun County",1,22,1631,804,827
050,01,015,"Alabama","Calhoun County",1,23,1564,790,774
050,01,015,"Alabama","Calhoun County",1,24,1428,712,716
050,01,015,"Alabama","Calhoun County",1,25,1408,706,702
050,01,015,"Alabama","Calhoun County",1,26,1456,725,731
050,01,015,"Alabama","Calhoun County",1,27,1505,747,758
050,01,015,"Alabama","Calhoun County",1,28,1558,774,784
050,01,015,"Alabama","Calhoun County",1,29,1639,778,861
050,01,015,"Alabama","Calhoun County",1,30,1578,806,772
050,01,015,"Alabama","Calhoun County",1,31,1519,764,755
050,01,015,"Alabama","Calhoun County",1,32,1390,680,710
050,01,015,"Alabama","Calhoun County",1,33,1394,676,718
050,01,015,"Alabama","Calhoun County",1,34,1387,665,722
050,01,015,"Alabama","Calhoun County",1,35,1350,653,697
050,01,015,"Alabama","Calhoun County",1,36,1333,686,647
050,01,015,"Alabama","Calhoun County",1,37,1417,702,715
050,01,015,"Alabama","Calhoun County",1,38,1430,697,733
050,01,015,"Alabama","Calhoun County",1,39,1447,706,741
050,01,015,"Alabama","Calhoun County",1,40,1425,687,738
050,01,015,"Alabama","Calhoun County",1,41,1402,688,714
050,01,015,"Alabama","Calhoun County",1,42,1405,685,720
050,01,015,"Alabama","Calhoun County",1,43,1368,679,689
050,01,015,"Alabama","Calhoun County",1,44,1371,675,696
050,01,015,"Alabama","Calhoun County",1,45,1317,634,683
050,01,015,"Alabama","Calhoun County",1,46,1258,621,637
050,01,015,"Alabama","Calhoun County",1,47,1347,676,671
050,01,015,"Alabama","Calhoun County",1,48,1421,693,728
050,01,015,"Alabama","Calhoun County",1,49,1516,741,775
050,01,015,"Alabama","Calhoun County",1,50,1402,691,711
050,01,015,"Alabama","Calhoun County",1,51,1444,682,762
050,01,015,"Alabama","Calhoun County",1,52,1390,678,712
050,01,015,"Alabama","Calhoun County",1,53,1428,718,710
050,01,015,"Alabama","Calhoun County",1,54,1419,700,719
050,01,015,"Alabama","Calhoun County",1,55,1536,769,767
050,01,015,"Alabama","Calhoun County",1,56,1525,769,756
050,01,015,"Alabama","Calhoun County",1,57,1562,786,776
050,01,015,"Alabama","Calhoun County",1,58,1621,778,843
050,01,015,"Alabama","Calhoun County",1,59,1617,764,853
050,01,015,"Alabama","Calhoun County",1,60,1606,742,864
050,01,015,"Alabama","Calhoun County",1,61,1579,744,835
050,01,015,"Alabama","Calhoun County",1,62,1580,755,825
050,01,015,"Alabama","Calhoun County",1,63,1562,736,826
050,01,015,"Alabama","Calhoun County",1,64,1581,762,819
050,01,015,"Alabama","Calhoun County",1,65,1511,706,805
050,01,015,"Alabama","Calhoun County",1,66,1412,669,743
050,01,015,"Alabama","Calhoun County",1,67,1404,652,752
050,01,015,"Alabama","Calhoun County",1,68,1376,648,728
050,01,015,"Alabama","Calhoun County",1,69,1260,548,712
050,01,015,"Alabama","Calhoun County",1,70,1195,524,671
050,01,015,"Alabama","Calhoun County",1,71,1227,560,667
050,01,015,"Alabama","Calhoun County",1,72,1239,572,667
050,01,015,"Alabama","Calhoun County",1,73,1167,523,644
050,01,015,"Alabama","Calhoun County",1,74,831,375,456
050,01,015,"Alabama","Calhoun County",1,75,811,356,455
050,01,015,"Alabama","Calhoun County",1,76,797,345,452
050,01,015,"Alabama","Calhoun County",1,77,801,322,479
050,01,015,"Alabama","Calhoun County",1,78,717,317,400
050,01,015,"Alabama","Calhoun County",1,79,601,268,333
050,01,015,"Alabama","Calhoun County",1,80,550,229,321
050,01,015,"Alabama","Calhoun County",1,81,508,204,304
050,01,015,"Alabama","Calhoun County",1,82,467,183,284
050,01,015,"Alabama","Calhoun County",1,83,401,156,245
050,01,015,"Alabama","Calhoun County",1,84,351,150,201
050,01,015,"Alabama","Calhoun County",1,85,2060,597,1463
050,01,015,"Alabama","Calhoun County",2,0,1224,635,589
050,01,015,"Alabama","Calhoun County",2,1,1259,659,600
050,01,015,"Alabama","Calhoun County",2,2,1310,690,620
050,01,015,"Alabama","Calhoun County",2,3,1339,686,653
050,01,015,"Alabama","Calhoun County",2,4,1332,674,658
050,01,015,"Alabama","Calhoun County",2,5,1333,681,652
050,01,015,"Alabama","Calhoun County",2,6,1317,665,652
050,01,015,"Alabama","Calhoun County",2,7,1326,660,666
050,01,015,"Alabama","Calhoun County",2,8,1317,660,657
050,01,015,"Alabama","Calhoun County",2,9,1299,657,642
050,01,015,"Alabama","Calhoun County",2,10,1367,707,660
050,01,015,"Alabama","Calhoun County",2,11,1468,777,691
050,01,015,"Alabama","Calhoun County",2,12,1549,808,741
050,01,015,"Alabama","Calhoun County",2,13,1524,783,741
050,01,015,"Alabama","Calhoun County",2,14,1467,762,705
050,01,015,"Alabama","Calhoun County",2,15,1454,777,677
050,01,015,"Alabama","Calhoun County",2,16,1479,786,693
050,01,015,"Alabama","Calhoun County",2,17,1484,759,725
050,01,015,"Alabama","Calhoun County",2,18,1902,853,1049
050,01,015,"Alabama","Calhoun County",2,19,2228,1134,1094
050,01,015,"Alabama","Calhoun County",2,20,1856,950,906
050,01,015,"Alabama","Calhoun County",2,21,1707,851,856
050,01,015,"Alabama","Calhoun County",2,22,1629,808,821
050,01,015,"Alabama","Calhoun County",2,23,1561,790,771
050,01,015,"Alabama","Calhoun County",2,24,1437,714,723
050,01,015,"Alabama","Calhoun County",2,25,1412,709,703
050,01,015,"Alabama","Calhoun County",2,26,1435,715,720
050,01,015,"Alabama","Calhoun County",2,27,1484,739,745
050,01,015,"Alabama","Calhoun County",2,28,1531,760,771
050,01,015,"Alabama","Calhoun County",2,29,1607,770,837
050,01,015,"Alabama","Calhoun County",2,30,1597,801,796
050,01,015,"Alabama","Calhoun County",2,31,1528,772,756
050,01,015,"Alabama","Calhoun County",2,32,1411,696,715
050,01,015,"Alabama","Calhoun County",2,33,1394,677,717
050,01,015,"Alabama","Calhoun County",2,34,1384,662,722
050,01,015,"Alabama","Calhoun County",2,35,1366,663,703
050,01,015,"Alabama","Calhoun County",2,36,1327,673,654
050,01,015,"Alabama","Calhoun County",2,37,1398,704,694
050,01,015,"Alabama","Calhoun County",2,38,1431,699,732
050,01,015,"Alabama","Calhoun County",2,39,1445,706,739
050,01,015,"Alabama","Calhoun County",2,40,1440,697,743
050,01,015,"Alabama","Calhoun County",2,41,1408,686,722
050,01,015,"Alabama","Calhoun County",2,42,1394,683,711
050,01,015,"Alabama","Calhoun County",2,43,1386,684,702
050,01,015,"Alabama","Calhoun County",2,44,1355,668,687
050,01,015,"Alabama","Calhoun County",2,45,1332,641,691
050,01,015,"Alabama","Calhoun County",2,46,1261,620,641
050,01,015,"Alabama","Calhoun County",2,47,1328,662,666
050,01,015,"Alabama","Calhoun County",2,48,1398,686,712
050,01,015,"Alabama","Calhoun County",2,49,1502,736,766
050,01,015,"Alabama","Calhoun County",2,50,1433,704,729
050,01,015,"Alabama","Calhoun County",2,51,1422,676,746
050,01,015,"Alabama","Calhoun County",2,52,1396,674,722
050,01,015,"Alabama","Calhoun County",2,53,1415,709,706
050,01,015,"Alabama","Calhoun County",2,54,1414,701,713
050,01,015,"Alabama","Calhoun County",2,55,1505,752,753
050,01,015,"Alabama","Calhoun County",2,56,1520,764,756
050,01,015,"Alabama","Calhoun County",2,57,1553,780,773
050,01,015,"Alabama","Calhoun County",2,58,1600,776,824
050,01,015,"Alabama","Calhoun County",2,59,1616,764,852
050,01,015,"Alabama","Calhoun County",2,60,1596,742,854
050,01,015,"Alabama","Calhoun County",2,61,1579,742,837
050,01,015,"Alabama","Calhoun County",2,62,1569,743,826
050,01,015,"Alabama","Calhoun County",2,63,1570,741,829
050,01,015,"Alabama","Calhoun County",2,64,1564,748,816
050,01,015,"Alabama","Calhoun County",2,65,1518,714,804
050,01,015,"Alabama","Calhoun County",2,66,1429,676,753
050,01,015,"Alabama","Calhoun County",2,67,1397,654,743
050,01,015,"Alabama","Calhoun County",2,68,1363,636,727
050,01,015,"Alabama","Calhoun County",2,69,1298,576,722
050,01,015,"Alabama","Calhoun County",2,70,1200,525,675
050,01,015,"Alabama","Calhoun County",2,71,1212,548,664
050,01,015,"Alabama","Calhoun County",2,72,1213,556,657
050,01,015,"Alabama","Calhoun County",2,73,1222,553,669
050,01,015,"Alabama","Calhoun County",2,74,852,385,467
050,01,015,"Alabama","Calhoun County",2,75,807,350,457
050,01,015,"Alabama","Calhoun County",2,76,788,339,449
050,01,015,"Alabama","Calhoun County",2,77,802,326,476
050,01,015,"Alabama","Calhoun County",2,78,709,302,407
050,01,015,"Alabama","Calhoun County",2,79,616,274,342
050,01,015,"Alabama","Calhoun County",2,80,549,227,322
050,01,015,"Alabama","Calhoun County",2,81,507,207,300
050,01,015,"Alabama","Calhoun County",2,82,471,187,284
050,01,015,"Alabama","Calhoun County",2,83,411,161,250
050,01,015,"Alabama","Calhoun County",2,84,350,148,202
050,01,015,"Alabama","Calhoun County",2,85,2055,602,1453
050,01,015,"Alabama","Calhoun County",3,0,1235,632,603
050,01,015,"Alabama","Calhoun County",3,1,1236,635,601
050,01,015,"Alabama","Calhoun County",3,2,1268,661,607
050,01,015,"Alabama","Calhoun County",3,3,1299,691,608
050,01,015,"Alabama","Calhoun County",3,4,1361,696,665
050,01,015,"Alabama","Calhoun County",3,5,1354,686,668
050,01,015,"Alabama","Calhoun County",3,6,1342,683,659
050,01,015,"Alabama","Calhoun County",3,7,1328,673,655
050,01,015,"Alabama","Calhoun County",3,8,1295,650,645
050,01,015,"Alabama","Calhoun County",3,9,1328,664,664
050,01,015,"Alabama","Calhoun County",3,10,1299,652,647
050,01,015,"Alabama","Calhoun County",3,11,1357,701,656
050,01,015,"Alabama","Calhoun County",3,12,1454,769,685
050,01,015,"Alabama","Calhoun County",3,13,1529,809,720
050,01,015,"Alabama","Calhoun County",3,14,1544,785,759
050,01,015,"Alabama","Calhoun County",3,15,1493,786,707
050,01,015,"Alabama","Calhoun County",3,16,1443,771,672
050,01,015,"Alabama","Calhoun County",3,17,1488,785,703
050,01,015,"Alabama","Calhoun County",3,18,1850,838,1012
050,01,015,"Alabama","Calhoun County",3,19,2163,1097,1066
050,01,015,"Alabama","Calhoun County",3,20,1832,922,910
050,01,015,"Alabama","Calhoun County",3,21,1755,872,883
050,01,015,"Alabama","Calhoun County",3,22,1649,820,829
050,01,015,"Alabama","Calhoun County",3,23,1578,826,752
050,01,015,"Alabama","Calhoun County",3,24,1444,707,737
050,01,015,"Alabama","Calhoun County",3,25,1435,732,703
050,01,015,"Alabama","Calhoun County",3,26,1384,684,700
050,01,015,"Alabama","Calhoun County",3,27,1426,714,712
050,01,015,"Alabama","Calhoun County",3,28,1465,724,741
050,01,015,"Alabama","Calhoun County",3,29,1526,745,781
050,01,015,"Alabama","Calhoun County",3,30,1597,766,831
050,01,015,"Alabama","Calhoun County",3,31,1612,801,811
050,01,015,"Alabama","Calhoun County",3,32,1482,758,724
050,01,015,"Alabama","Calhoun County",3,33,1449,723,726
050,01,015,"Alabama","Calhoun County",3,34,1390,652,738
050,01,015,"Alabama","Calhoun County",3,35,1383,669,714
050,01,015,"Alabama","Calhoun County",3,36,1380,677,703
050,01,015,"Alabama","Calhoun County",3,37,1298,667,631
050,01,015,"Alabama","Calhoun County",3,38,1376,680,696
050,01,015,"Alabama","Calhoun County",3,39,1438,712,726
050,01,015,"Alabama","Calhoun County",3,40,1420,686,734
050,01,015,"Alabama","Calhoun County",3,41,1434,685,749
050,01,015,"Alabama","Calhoun County",3,42,1404,673,731
050,01,015,"Alabama","Calhoun County",3,43,1390,679,711
050,01,015,"Alabama","Calhoun County",3,44,1360,690,670
050,01,015,"Alabama","Calhoun County",3,45,1332,642,690
050,01,015,"Alabama","Calhoun County",3,46,1333,639,694
050,01,015,"Alabama","Calhoun County",3,47,1261,624,637
050,01,015,"Alabama","Calhoun County",3,48,1323,658,665
050,01,015,"Alabama","Calhoun County",3,49,1380,692,688
050,01,015,"Alabama","Calhoun County",3,50,1492,732,760
050,01,015,"Alabama","Calhoun County",3,51,1424,687,737
050,01,015,"Alabama","Calhoun County",3,52,1433,677,756
050,01,015,"Alabama","Calhoun County",3,53,1413,676,737
050,01,015,"Alabama","Calhoun County",3,54,1407,707,700
050,01,015,"Alabama","Calhoun County",3,55,1416,693,723
050,01,015,"Alabama","Calhoun County",3,56,1469,732,737
050,01,015,"Alabama","Calhoun County",3,57,1515,759,756
050,01,015,"Alabama","Calhoun County",3,58,1535,761,774
050,01,015,"Alabama","Calhoun County",3,59,1594,772,822
050,01,015,"Alabama","Calhoun County",3,60,1576,762,814
050,01,015,"Alabama","Calhoun County",3,61,1542,709,833
050,01,015,"Alabama","Calhoun County",3,62,1547,728,819
050,01,015,"Alabama","Calhoun County",3,63,1519,710,809
050,01,015,"Alabama","Calhoun County",3,64,1558,736,822
050,01,015,"Alabama","Calhoun County",3,65,1519,727,792
050,01,015,"Alabama","Calhoun County",3,66,1480,703,777
050,01,015,"Alabama","Calhoun County",3,67,1413,666,747
050,01,015,"Alabama","Calhoun County",3,68,1324,604,720
050,01,015,"Alabama","Calhoun County",3,69,1354,624,730
050,01,015,"Alabama","Calhoun County",3,70,1230,550,680
050,01,015,"Alabama","Calhoun County",3,71,1174,507,667
050,01,015,"Alabama","Calhoun County",3,72,1172,522,650
050,01,015,"Alabama","Calhoun County",3,73,1142,517,625
050,01,015,"Alabama","Calhoun County",3,74,1180,531,649
050,01,015,"Alabama","Calhoun County",3,75,819,364,455
050,01,015,"Alabama","Calhoun County",3,76,779,324,455
050,01,015,"Alabama","Calhoun County",3,77,749,316,433
050,01,015,"Alabama","Calhoun County",3,78,733,297,436
050,01,015,"Alabama","Calhoun County",3,79,665,287,378
050,01,015,"Alabama","Calhoun County",3,80,549,238,311
050,01,015,"Alabama","Calhoun County",3,81,523,209,314
050,01,015,"Alabama","Calhoun County",3,82,464,195,269
050,01,015,"Alabama","Calhoun County",3,83,419,173,246
050,01,015,"Alabama","Calhoun County",3,84,354,134,220
050,01,015,"Alabama","Calhoun County",3,85,1994,584,1410
050,01,015,"Alabama","Calhoun County",4,0,1311,681,630
050,01,015,"Alabama","Calhoun County",4,1,1253,633,620
050,01,015,"Alabama","Calhoun County",4,2,1296,678,618
050,01,015,"Alabama","Calhoun County",4,3,1286,672,614
050,01,015,"Alabama","Calhoun County",4,4,1318,695,623
050,01,015,"Alabama","Calhoun County",4,5,1375,698,677
050,01,015,"Alabama","Calhoun County",4,6,1361,680,681
050,01,015,"Alabama","Calhoun County",4,7,1364,709,655
050,01,015,"Alabama","Calhoun County",4,8,1330,671,659
050,01,015,"Alabama","Calhoun County",4,9,1316,669,647
050,01,015,"Alabama","Calhoun County",4,10,1335,669,666
050,01,015,"Alabama","Calhoun County",4,11,1271,627,644
050,01,015,"Alabama","Calhoun County",4,12,1387,724,663
050,01,015,"Alabama","Calhoun County",4,13,1457,774,683
050,01,015,"Alabama","Calhoun County",4,14,1539,810,729
050,01,015,"Alabama","Calhoun County",4,15,1585,817,768
050,01,015,"Alabama","Calhoun County",4,16,1492,779,713
050,01,015,"Alabama","Calhoun County",4,17,1444,767,677
050,01,015,"Alabama","Calhoun County",4,18,1904,889,1015
050,01,015,"Alabama","Calhoun County",4,19,2218,1117,1101
050,01,015,"Alabama","Calhoun County",4,20,1823,924,899
050,01,015,"Alabama","Calhoun County",4,21,1746,856,890
050,01,015,"Alabama","Calhoun County",4,22,1733,876,857
050,01,015,"Alabama","Calhoun County",4,23,1616,832,784
050,01,015,"Alabama","Calhoun County",4,24,1498,763,735
050,01,015,"Alabama","Calhoun County",4,25,1452,707,745
050,01,015,"Alabama","Calhoun County",4,26,1433,724,709
050,01,015,"Alabama","Calhoun County",4,27,1383,705,678
050,01,015,"Alabama","Calhoun County",4,28,1396,698,698
050,01,015,"Alabama","Calhoun County",4,29,1430,688,742
050,01,015,"Alabama","Calhoun County",4,30,1556,755,801
050,01,015,"Alabama","Calhoun County",4,31,1597,774,823
050,01,015,"Alabama","Calhoun County",4,32,1570,787,783
050,01,015,"Alabama","Calhoun County",4,33,1504,778,726
050,01,015,"Alabama","Calhoun County",4,34,1406,707,699
050,01,015,"Alabama","Calhoun County",4,35,1390,661,729
050,01,015,"Alabama","Calhoun County",4,36,1389,672,717
050,01,015,"Alabama","Calhoun County",4,37,1365,660,705
050,01,015,"Alabama","Calhoun County",4,38,1287,637,650
050,01,015,"Alabama","Calhoun County",4,39,1401,699,702
050,01,015,"Alabama","Calhoun County",4,40,1440,713,727
050,01,015,"Alabama","Calhoun County",4,41,1413,667,746
050,01,015,"Alabama","Calhoun County",4,42,1438,683,755
050,01,015,"Alabama","Calhoun County",4,43,1378,664,714
050,01,015,"Alabama","Calhoun County",4,44,1392,687,705
050,01,015,"Alabama","Calhoun County",4,45,1341,674,667
050,01,015,"Alabama","Calhoun County",4,46,1334,650,684
050,01,015,"Alabama","Calhoun County",4,47,1368,669,699
050,01,015,"Alabama","Calhoun County",4,48,1255,618,637
050,01,015,"Alabama","Calhoun County",4,49,1293,656,637
050,01,015,"Alabama","Calhoun County",4,50,1358,690,668
050,01,015,"Alabama","Calhoun County",4,51,1459,715,744
050,01,015,"Alabama","Calhoun County",4,52,1415,674,741
050,01,015,"Alabama","Calhoun County",4,53,1446,685,761
050,01,015,"Alabama","Calhoun County",4,54,1398,670,728
050,01,015,"Alabama","Calhoun County",4,55,1373,681,692
050,01,015,"Alabama","Calhoun County",4,56,1388,679,709
050,01,015,"Alabama","Calhoun County",4,57,1457,723,734
050,01,015,"Alabama","Calhoun County",4,58,1476,731,745
050,01,015,"Alabama","Calhoun County",4,59,1520,745,775
050,01,015,"Alabama","Calhoun County",4,60,1584,775,809
050,01,015,"Alabama","Calhoun County",4,61,1545,744,801
050,01,015,"Alabama","Calhoun County",4,62,1519,696,823
050,01,015,"Alabama","Calhoun County",4,63,1493,705,788
050,01,015,"Alabama","Calhoun County",4,64,1509,707,802
050,01,015,"Alabama","Calhoun County",4,65,1533,721,812
050,01,015,"Alabama","Calhoun County",4,66,1472,713,759
050,01,015,"Alabama","Calhoun County",4,67,1468,690,778
050,01,015,"Alabama","Calhoun County",4,68,1345,617,728
050,01,015,"Alabama","Calhoun County",4,69,1301,575,726
050,01,015,"Alabama","Calhoun County",4,70,1299,603,696
050,01,015,"Alabama","Calhoun County",4,71,1222,544,678
050,01,015,"Alabama","Calhoun County",4,72,1135,484,651
050,01,015,"Alabama","Calhoun County",4,73,1105,483,622
050,01,015,"Alabama","Calhoun County",4,74,1103,503,600
050,01,015,"Alabama","Calhoun County",4,75,1138,499,639
050,01,015,"Alabama","Calhoun County",4,76,790,354,436
050,01,015,"Alabama","Calhoun County",4,77,734,295,439
050,01,015,"Alabama","Calhoun County",4,78,695,293,402
050,01,015,"Alabama","Calhoun County",4,79,674,284,390
050,01,015,"Alabama","Calhoun County",4,80,603,250,353
050,01,015,"Alabama","Calhoun County",4,81,511,213,298
050,01,015,"Alabama","Calhoun County",4,82,477,190,287
050,01,015,"Alabama","Calhoun County",4,83,415,177,238
050,01,015,"Alabama","Calhoun County",4,84,361,145,216
050,01,015,"Alabama","Calhoun County",4,85,1990,580,1410
050,01,015,"Alabama","Calhoun County",5,0,1326,687,639
050,01,015,"Alabama","Calhoun County",5,1,1285,670,615
050,01,015,"Alabama","Calhoun County",5,2,1275,628,647
050,01,015,"Alabama","Calhoun County",5,3,1325,705,620
050,01,015,"Alabama","Calhoun County",5,4,1312,677,635
050,01,015,"Alabama","Calhoun County",5,5,1333,692,641
050,01,015,"Alabama","Calhoun County",5,6,1379,693,686
050,01,015,"Alabama","Calhoun County",5,7,1368,683,685
050,01,015,"Alabama","Calhoun County",5,8,1396,709,687
050,01,015,"Alabama","Calhoun County",5,9,1352,689,663
050,01,015,"Alabama","Calhoun County",5,10,1328,663,665
050,01,015,"Alabama","Calhoun County",5,11,1356,676,680
050,01,015,"Alabama","Calhoun County",5,12,1301,638,663
050,01,015,"Alabama","Calhoun County",5,13,1407,734,673
050,01,015,"Alabama","Calhoun County",5,14,1473,782,691
050,01,015,"Alabama","Calhoun County",5,15,1567,827,740
050,01,015,"Alabama","Calhoun County",5,16,1589,814,775
050,01,015,"Alabama","Calhoun County",5,17,1502,790,712
050,01,015,"Alabama","Calhoun County",5,18,1912,886,1026
050,01,015,"Alabama","Calhoun County",5,19,2303,1181,1122
050,01,015,"Alabama","Calhoun County",5,20,1880,937,943
050,01,015,"Alabama","Calhoun County",5,21,1686,842,844
050,01,015,"Alabama","Calhoun County",5,22,1721,841,880
050,01,015,"Alabama","Calhoun County",5,23,1682,883,799
050,01,015,"Alabama","Calhoun County",5,24,1532,768,764
050,01,015,"Alabama","Calhoun County",5,25,1505,778,727
050,01,015,"Alabama","Calhoun County",5,26,1441,693,748
050,01,015,"Alabama","Calhoun County",5,27,1415,717,698
050,01,015,"Alabama","Calhoun County",5,28,1386,706,680
050,01,015,"Alabama","Calhoun County",5,29,1407,692,715
050,01,015,"Alabama","Calhoun County",5,30,1419,685,734
050,01,015,"Alabama","Calhoun County",5,31,1552,749,803
050,01,015,"Alabama","Calhoun County",5,32,1596,774,822
050,01,015,"Alabama","Calhoun County",5,33,1603,815,788
050,01,015,"Alabama","Calhoun County",5,34,1487,756,731
050,01,015,"Alabama","Calhoun County",5,35,1418,718,700
050,01,015,"Alabama","Calhoun County",5,36,1385,659,726
050,01,015,"Alabama","Calhoun County",5,37,1398,679,719
050,01,015,"Alabama","Calhoun County",5,38,1322,625,697
050,01,015,"Alabama","Calhoun County",5,39,1307,647,660
050,01,015,"Alabama","Calhoun County",5,40,1409,695,714
050,01,015,"Alabama","Calhoun County",5,41,1433,703,730
050,01,015,"Alabama","Calhoun County",5,42,1420,658,762
050,01,015,"Alabama","Calhoun County",5,43,1461,706,755
050,01,015,"Alabama","Calhoun County",5,44,1386,663,723
050,01,015,"Alabama","Calhoun County",5,45,1379,666,713
050,01,015,"Alabama","Calhoun County",5,46,1358,689,669
050,01,015,"Alabama","Calhoun County",5,47,1358,665,693
050,01,015,"Alabama","Calhoun County",5,48,1334,655,679
050,01,015,"Alabama","Calhoun County",5,49,1263,615,648
050,01,015,"Alabama","Calhoun County",5,50,1303,668,635
050,01,015,"Alabama","Calhoun County",5,51,1343,685,658
050,01,015,"Alabama","Calhoun County",5,52,1459,717,742
050,01,015,"Alabama","Calhoun County",5,53,1409,673,736
050,01,015,"Alabama","Calhoun County",5,54,1446,685,761
050,01,015,"Alabama","Calhoun County",5,55,1387,675,712
050,01,015,"Alabama","Calhoun County",5,56,1359,680,679
050,01,015,"Alabama","Calhoun County",5,57,1377,666,711
050,01,015,"Alabama","Calhoun County",5,58,1437,705,732
050,01,015,"Alabama","Calhoun County",5,59,1455,705,750
050,01,015,"Alabama","Calhoun County",5,60,1501,751,750
050,01,015,"Alabama","Calhoun County",5,61,1572,763,809
050,01,015,"Alabama","Calhoun County",5,62,1569,752,817
050,01,015,"Alabama","Calhoun County",5,63,1478,680,798
050,01,015,"Alabama","Calhoun County",5,64,1477,686,791
050,01,015,"Alabama","Calhoun County",5,65,1481,695,786
050,01,015,"Alabama","Calhoun County",5,66,1502,705,797
050,01,015,"Alabama","Calhoun County",5,67,1457,698,759
050,01,015,"Alabama","Calhoun County",5,68,1407,657,750
050,01,015,"Alabama","Calhoun County",5,69,1330,602,728
050,01,015,"Alabama","Calhoun County",5,70,1268,563,705
050,01,015,"Alabama","Calhoun County",5,71,1275,587,688
050,01,015,"Alabama","Calhoun County",5,72,1195,522,673
050,01,015,"Alabama","Calhoun County",5,73,1072,449,623
050,01,015,"Alabama","Calhoun County",5,74,1079,477,602
050,01,015,"Alabama","Calhoun County",5,75,1072,475,597
050,01,015,"Alabama","Calhoun County",5,76,1122,489,633
050,01,015,"Alabama","Calhoun County",5,77,749,328,421
050,01,015,"Alabama","Calhoun County",5,78,701,283,418
050,01,015,"Alabama","Calhoun County",5,79,653,286,367
050,01,015,"Alabama","Calhoun County",5,80,617,247,370
050,01,015,"Alabama","Calhoun County",5,81,570,235,335
050,01,015,"Alabama","Calhoun County",5,82,474,199,275
050,01,015,"Alabama","Calhoun County",5,83,429,175,254
050,01,015,"Alabama","Calhoun County",5,84,363,154,209
050,01,015,"Alabama","Calhoun County",5,85,2009,599,1410
050,01,017,"Alabama","Chambers County",1,0,351,180,171
050,01,017,"Alabama","Chambers County",1,1,371,192,179
050,01,017,"Alabama","Chambers County",1,2,385,189,196
050,01,017,"Alabama","Chambers County",1,3,396,209,187
050,01,017,"Alabama","Chambers County",1,4,385,199,186
050,01,017,"Alabama","Chambers County",1,5,415,221,194
050,01,017,"Alabama","Chambers County",1,6,414,210,204
050,01,017,"Alabama","Chambers County",1,7,403,201,202
050,01,017,"Alabama","Chambers County",1,8,407,212,195
050,01,017,"Alabama","Chambers County",1,9,399,193,206
050,01,017,"Alabama","Chambers County",1,10,390,177,213
050,01,017,"Alabama","Chambers County",1,11,452,238,214
050,01,017,"Alabama","Chambers County",1,12,431,231,200
050,01,017,"Alabama","Chambers County",1,13,415,216,199
050,01,017,"Alabama","Chambers County",1,14,423,196,227
050,01,017,"Alabama","Chambers County",1,15,407,202,205
050,01,017,"Alabama","Chambers County",1,16,399,210,189
050,01,017,"Alabama","Chambers County",1,17,404,222,182
050,01,017,"Alabama","Chambers County",1,18,422,225,197
050,01,017,"Alabama","Chambers County",1,19,441,229,212
050,01,017,"Alabama","Chambers County",1,20,414,211,203
050,01,017,"Alabama","Chambers County",1,21,393,207,186
050,01,017,"Alabama","Chambers County",1,22,393,191,202
050,01,017,"Alabama","Chambers County",1,23,416,200,216
050,01,017,"Alabama","Chambers County",1,24,435,211,224
050,01,017,"Alabama","Chambers County",1,25,438,204,234
050,01,017,"Alabama","Chambers County",1,26,461,219,242
050,01,017,"Alabama","Chambers County",1,27,482,236,246
050,01,017,"Alabama","Chambers County",1,28,491,241,250
050,01,017,"Alabama","Chambers County",1,29,466,231,235
050,01,017,"Alabama","Chambers County",1,30,475,236,239
050,01,017,"Alabama","Chambers County",1,31,434,223,211
050,01,017,"Alabama","Chambers County",1,32,357,178,179
050,01,017,"Alabama","Chambers County",1,33,357,176,181
050,01,017,"Alabama","Chambers County",1,34,398,172,226
050,01,017,"Alabama","Chambers County",1,35,366,157,209
050,01,017,"Alabama","Chambers County",1,36,382,168,214
050,01,017,"Alabama","Chambers County",1,37,401,197,204
050,01,017,"Alabama","Chambers County",1,38,369,181,188
050,01,017,"Alabama","Chambers County",1,39,356,171,185
050,01,017,"Alabama","Chambers County",1,40,388,184,204
050,01,017,"Alabama","Chambers County",1,41,387,186,201
050,01,017,"Alabama","Chambers County",1,42,374,181,193
050,01,017,"Alabama","Chambers County",1,43,393,190,203
050,01,017,"Alabama","Chambers County",1,44,400,177,223
050,01,017,"Alabama","Chambers County",1,45,378,190,188
050,01,017,"Alabama","Chambers County",1,46,432,207,225
050,01,017,"Alabama","Chambers County",1,47,431,203,228
050,01,017,"Alabama","Chambers County",1,48,462,200,262
050,01,017,"Alabama","Chambers County",1,49,478,235,243
050,01,017,"Alabama","Chambers County",1,50,460,232,228
050,01,017,"Alabama","Chambers County",1,51,458,228,230
050,01,017,"Alabama","Chambers County",1,52,464,230,234
050,01,017,"Alabama","Chambers County",1,53,452,224,228
050,01,017,"Alabama","Chambers County",1,54,475,232,243
050,01,017,"Alabama","Chambers County",1,55,468,224,244
050,01,017,"Alabama","Chambers County",1,56,487,238,249
050,01,017,"Alabama","Chambers County",1,57,539,255,284
050,01,017,"Alabama","Chambers County",1,58,530,260,270
050,01,017,"Alabama","Chambers County",1,59,508,261,247
050,01,017,"Alabama","Chambers County",1,60,528,257,271
050,01,017,"Alabama","Chambers County",1,61,499,232,267
050,01,017,"Alabama","Chambers County",1,62,497,233,264
050,01,017,"Alabama","Chambers County",1,63,510,251,259
050,01,017,"Alabama","Chambers County",1,64,464,221,243
050,01,017,"Alabama","Chambers County",1,65,490,229,261
050,01,017,"Alabama","Chambers County",1,66,464,207,257
050,01,017,"Alabama","Chambers County",1,67,446,197,249
050,01,017,"Alabama","Chambers County",1,68,429,207,222
050,01,017,"Alabama","Chambers County",1,69,395,188,207
050,01,017,"Alabama","Chambers County",1,70,392,194,198
050,01,017,"Alabama","Chambers County",1,71,381,171,210
050,01,017,"Alabama","Chambers County",1,72,381,171,210
050,01,017,"Alabama","Chambers County",1,73,425,199,226
050,01,017,"Alabama","Chambers County",1,74,295,132,163
050,01,017,"Alabama","Chambers County",1,75,287,125,162
050,01,017,"Alabama","Chambers County",1,76,314,136,178
050,01,017,"Alabama","Chambers County",1,77,275,118,157
050,01,017,"Alabama","Chambers County",1,78,234,91,143
050,01,017,"Alabama","Chambers County",1,79,215,96,119
050,01,017,"Alabama","Chambers County",1,80,188,85,103
050,01,017,"Alabama","Chambers County",1,81,142,59,83
050,01,017,"Alabama","Chambers County",1,82,157,62,95
050,01,017,"Alabama","Chambers County",1,83,142,61,81
050,01,017,"Alabama","Chambers County",1,84,138,52,86
050,01,017,"Alabama","Chambers County",1,85,726,209,517
050,01,017,"Alabama","Chambers County",2,0,354,183,171
050,01,017,"Alabama","Chambers County",2,1,367,189,178
050,01,017,"Alabama","Chambers County",2,2,384,192,192
050,01,017,"Alabama","Chambers County",2,3,388,201,187
050,01,017,"Alabama","Chambers County",2,4,382,200,182
050,01,017,"Alabama","Chambers County",2,5,400,211,189
050,01,017,"Alabama","Chambers County",2,6,411,210,201
050,01,017,"Alabama","Chambers County",2,7,402,201,201
050,01,017,"Alabama","Chambers County",2,8,406,210,196
050,01,017,"Alabama","Chambers County",2,9,398,196,202
050,01,017,"Alabama","Chambers County",2,10,391,180,211
050,01,017,"Alabama","Chambers County",2,11,434,222,212
050,01,017,"Alabama","Chambers County",2,12,438,234,204
050,01,017,"Alabama","Chambers County",2,13,418,217,201
050,01,017,"Alabama","Chambers County",2,14,420,200,220
050,01,017,"Alabama","Chambers County",2,15,413,202,211
050,01,017,"Alabama","Chambers County",2,16,398,207,191
050,01,017,"Alabama","Chambers County",2,17,401,217,184
050,01,017,"Alabama","Chambers County",2,18,418,223,195
050,01,017,"Alabama","Chambers County",2,19,440,229,211
050,01,017,"Alabama","Chambers County",2,20,416,213,203
050,01,017,"Alabama","Chambers County",2,21,397,206,191
050,01,017,"Alabama","Chambers County",2,22,392,192,200
050,01,017,"Alabama","Chambers County",2,23,414,197,217
050,01,017,"Alabama","Chambers County",2,24,427,206,221
050,01,017,"Alabama","Chambers County",2,25,433,205,228
050,01,017,"Alabama","Chambers County",2,26,456,216,240
050,01,017,"Alabama","Chambers County",2,27,479,233,246
050,01,017,"Alabama","Chambers County",2,28,487,237,250
050,01,017,"Alabama","Chambers County",2,29,470,232,238
050,01,017,"Alabama","Chambers County",2,30,474,234,240
050,01,017,"Alabama","Chambers County",2,31,438,223,215
050,01,017,"Alabama","Chambers County",2,32,371,188,183
050,01,017,"Alabama","Chambers County",2,33,356,175,181
050,01,017,"Alabama","Chambers County",2,34,387,174,213
050,01,017,"Alabama","Chambers County",2,35,376,161,215
050,01,017,"Alabama","Chambers County",2,36,376,165,211
050,01,017,"Alabama","Chambers County",2,37,396,186,210
050,01,017,"Alabama","Chambers County",2,38,379,185,194
050,01,017,"Alabama","Chambers County",2,39,355,172,183
050,01,017,"Alabama","Chambers County",2,40,384,184,200
050,01,017,"Alabama","Chambers County",2,41,385,184,201
050,01,017,"Alabama","Chambers County",2,42,373,179,194
050,01,017,"Alabama","Chambers County",2,43,392,188,204
050,01,017,"Alabama","Chambers County",2,44,393,179,214
050,01,017,"Alabama","Chambers County",2,45,387,187,200
050,01,017,"Alabama","Chambers County",2,46,417,201,216
050,01,017,"Alabama","Chambers County",2,47,430,202,228
050,01,017,"Alabama","Chambers County",2,48,455,201,254
050,01,017,"Alabama","Chambers County",2,49,474,228,246
050,01,017,"Alabama","Chambers County",2,50,465,235,230
050,01,017,"Alabama","Chambers County",2,51,457,228,229
050,01,017,"Alabama","Chambers County",2,52,465,233,232
050,01,017,"Alabama","Chambers County",2,53,454,225,229
050,01,017,"Alabama","Chambers County",2,54,463,227,236
050,01,017,"Alabama","Chambers County",2,55,469,225,244
050,01,017,"Alabama","Chambers County",2,56,486,236,250
050,01,017,"Alabama","Chambers County",2,57,526,250,276
050,01,017,"Alabama","Chambers County",2,58,530,259,271
050,01,017,"Alabama","Chambers County",2,59,512,261,251
050,01,017,"Alabama","Chambers County",2,60,522,258,264
050,01,017,"Alabama","Chambers County",2,61,503,238,265
050,01,017,"Alabama","Chambers County",2,62,498,233,265
050,01,017,"Alabama","Chambers County",2,63,514,250,264
050,01,017,"Alabama","Chambers County",2,64,471,225,246
050,01,017,"Alabama","Chambers County",2,65,479,225,254
050,01,017,"Alabama","Chambers County",2,66,467,210,257
050,01,017,"Alabama","Chambers County",2,67,447,198,249
050,01,017,"Alabama","Chambers County",2,68,429,202,227
050,01,017,"Alabama","Chambers County",2,69,405,192,213
050,01,017,"Alabama","Chambers County",2,70,386,190,196
050,01,017,"Alabama","Chambers County",2,71,379,174,205
050,01,017,"Alabama","Chambers County",2,72,371,166,205
050,01,017,"Alabama","Chambers County",2,73,431,200,231
050,01,017,"Alabama","Chambers County",2,74,301,135,166
050,01,017,"Alabama","Chambers County",2,75,288,123,165
050,01,017,"Alabama","Chambers County",2,76,299,128,171
050,01,017,"Alabama","Chambers County",2,77,281,122,159
050,01,017,"Alabama","Chambers County",2,78,240,93,147
050,01,017,"Alabama","Chambers County",2,79,211,92,119
050,01,017,"Alabama","Chambers County",2,80,192,86,106
050,01,017,"Alabama","Chambers County",2,81,146,62,84
050,01,017,"Alabama","Chambers County",2,82,153,62,91
050,01,017,"Alabama","Chambers County",2,83,140,57,83
050,01,017,"Alabama","Chambers County",2,84,130,52,78
050,01,017,"Alabama","Chambers County",2,85,709,208,501
050,01,017,"Alabama","Chambers County",3,0,386,192,194
050,01,017,"Alabama","Chambers County",3,1,378,202,176
050,01,017,"Alabama","Chambers County",3,2,373,192,181
050,01,017,"Alabama","Chambers County",3,3,386,194,192
050,01,017,"Alabama","Chambers County",3,4,380,191,189
050,01,017,"Alabama","Chambers County",3,5,384,204,180
050,01,017,"Alabama","Chambers County",3,6,400,209,191
050,01,017,"Alabama","Chambers County",3,7,412,209,203
050,01,017,"Alabama","Chambers County",3,8,397,198,199
050,01,017,"Alabama","Chambers County",3,9,391,198,193
050,01,017,"Alabama","Chambers County",3,10,388,197,191
050,01,017,"Alabama","Chambers County",3,11,387,178,209
050,01,017,"Alabama","Chambers County",3,12,441,233,208
050,01,017,"Alabama","Chambers County",3,13,437,229,208
050,01,017,"Alabama","Chambers County",3,14,425,218,207
050,01,017,"Alabama","Chambers County",3,15,404,189,215
050,01,017,"Alabama","Chambers County",3,16,405,203,202
050,01,017,"Alabama","Chambers County",3,17,403,206,197
050,01,017,"Alabama","Chambers County",3,18,414,215,199
050,01,017,"Alabama","Chambers County",3,19,417,218,199
050,01,017,"Alabama","Chambers County",3,20,408,215,193
050,01,017,"Alabama","Chambers County",3,21,411,211,200
050,01,017,"Alabama","Chambers County",3,22,394,204,190
050,01,017,"Alabama","Chambers County",3,23,395,192,203
050,01,017,"Alabama","Chambers County",3,24,421,194,227
050,01,017,"Alabama","Chambers County",3,25,421,211,210
050,01,017,"Alabama","Chambers County",3,26,437,210,227
050,01,017,"Alabama","Chambers County",3,27,440,198,242
050,01,017,"Alabama","Chambers County",3,28,465,225,240
050,01,017,"Alabama","Chambers County",3,29,463,225,238
050,01,017,"Alabama","Chambers County",3,30,456,230,226
050,01,017,"Alabama","Chambers County",3,31,483,237,246
050,01,017,"Alabama","Chambers County",3,32,427,219,208
050,01,017,"Alabama","Chambers County",3,33,365,191,174
050,01,017,"Alabama","Chambers County",3,34,346,169,177
050,01,017,"Alabama","Chambers County",3,35,380,172,208
050,01,017,"Alabama","Chambers County",3,36,379,165,214
050,01,017,"Alabama","Chambers County",3,37,359,156,203
050,01,017,"Alabama","Chambers County",3,38,388,185,203
050,01,017,"Alabama","Chambers County",3,39,366,174,192
050,01,017,"Alabama","Chambers County",3,40,354,171,183
050,01,017,"Alabama","Chambers County",3,41,390,183,207
050,01,017,"Alabama","Chambers County",3,42,396,192,204
050,01,017,"Alabama","Chambers County",3,43,379,183,196
050,01,017,"Alabama","Chambers County",3,44,409,192,217
050,01,017,"Alabama","Chambers County",3,45,403,181,222
050,01,017,"Alabama","Chambers County",3,46,394,191,203
050,01,017,"Alabama","Chambers County",3,47,417,200,217
050,01,017,"Alabama","Chambers County",3,48,440,202,238
050,01,017,"Alabama","Chambers County",3,49,462,201,261
050,01,017,"Alabama","Chambers County",3,50,490,234,256
050,01,017,"Alabama","Chambers County",3,51,477,242,235
050,01,017,"Alabama","Chambers County",3,52,464,235,229
050,01,017,"Alabama","Chambers County",3,53,474,231,243
050,01,017,"Alabama","Chambers County",3,54,450,219,231
050,01,017,"Alabama","Chambers County",3,55,468,231,237
050,01,017,"Alabama","Chambers County",3,56,482,227,255
050,01,017,"Alabama","Chambers County",3,57,501,236,265
050,01,017,"Alabama","Chambers County",3,58,501,243,258
050,01,017,"Alabama","Chambers County",3,59,518,240,278
050,01,017,"Alabama","Chambers County",3,60,496,259,237
050,01,017,"Alabama","Chambers County",3,61,522,262,260
050,01,017,"Alabama","Chambers County",3,62,492,228,264
050,01,017,"Alabama","Chambers County",3,63,485,224,261
050,01,017,"Alabama","Chambers County",3,64,503,239,264
050,01,017,"Alabama","Chambers County",3,65,467,213,254
050,01,017,"Alabama","Chambers County",3,66,477,222,255
050,01,017,"Alabama","Chambers County",3,67,450,205,245
050,01,017,"Alabama","Chambers County",3,68,434,191,243
050,01,017,"Alabama","Chambers County",3,69,412,188,224
050,01,017,"Alabama","Chambers County",3,70,387,182,205
050,01,017,"Alabama","Chambers County",3,71,372,182,190
050,01,017,"Alabama","Chambers County",3,72,358,167,191
050,01,017,"Alabama","Chambers County",3,73,362,161,201
050,01,017,"Alabama","Chambers County",3,74,406,186,220
050,01,017,"Alabama","Chambers County",3,75,286,117,169
050,01,017,"Alabama","Chambers County",3,76,275,117,158
050,01,017,"Alabama","Chambers County",3,77,274,116,158
050,01,017,"Alabama","Chambers County",3,78,272,111,161
050,01,017,"Alabama","Chambers County",3,79,211,87,124
050,01,017,"Alabama","Chambers County",3,80,193,82,111
050,01,017,"Alabama","Chambers County",3,81,170,72,98
050,01,017,"Alabama","Chambers County",3,82,143,56,87
050,01,017,"Alabama","Chambers County",3,83,141,53,88
050,01,017,"Alabama","Chambers County",3,84,135,54,81
050,01,017,"Alabama","Chambers County",3,85,684,219,465
050,01,017,"Alabama","Chambers County",4,0,397,204,193
050,01,017,"Alabama","Chambers County",4,1,339,157,182
050,01,017,"Alabama","Chambers County",4,2,346,185,161
050,01,017,"Alabama","Chambers County",4,3,379,193,186
050,01,017,"Alabama","Chambers County",4,4,389,190,199
050,01,017,"Alabama","Chambers County",4,5,376,183,193
050,01,017,"Alabama","Chambers County",4,6,381,200,181
050,01,017,"Alabama","Chambers County",4,7,429,216,213
050,01,017,"Alabama","Chambers County",4,8,422,213,209
050,01,017,"Alabama","Chambers County",4,9,405,201,204
050,01,017,"Alabama","Chambers County",4,10,391,198,193
050,01,017,"Alabama","Chambers County",4,11,391,207,184
050,01,017,"Alabama","Chambers County",4,12,386,181,205
050,01,017,"Alabama","Chambers County",4,13,435,227,208
050,01,017,"Alabama","Chambers County",4,14,430,223,207
050,01,017,"Alabama","Chambers County",4,15,427,217,210
050,01,017,"Alabama","Chambers County",4,16,406,185,221
050,01,017,"Alabama","Chambers County",4,17,413,211,202
050,01,017,"Alabama","Chambers County",4,18,400,198,202
050,01,017,"Alabama","Chambers County",4,19,402,202,200
050,01,017,"Alabama","Chambers County",4,20,369,192,177
050,01,017,"Alabama","Chambers County",4,21,419,218,201
050,01,017,"Alabama","Chambers County",4,22,404,202,202
050,01,017,"Alabama","Chambers County",4,23,387,207,180
050,01,017,"Alabama","Chambers County",4,24,414,200,214
050,01,017,"Alabama","Chambers County",4,25,386,185,201
050,01,017,"Alabama","Chambers County",4,26,406,202,204
050,01,017,"Alabama","Chambers County",4,27,431,202,229
050,01,017,"Alabama","Chambers County",4,28,433,193,240
050,01,017,"Alabama","Chambers County",4,29,441,221,220
050,01,017,"Alabama","Chambers County",4,30,462,228,234
050,01,017,"Alabama","Chambers County",4,31,452,226,226
050,01,017,"Alabama","Chambers County",4,32,459,221,238
050,01,017,"Alabama","Chambers County",4,33,424,204,220
050,01,017,"Alabama","Chambers County",4,34,361,184,177
050,01,017,"Alabama","Chambers County",4,35,333,160,173
050,01,017,"Alabama","Chambers County",4,36,391,181,210
050,01,017,"Alabama","Chambers County",4,37,379,168,211
050,01,017,"Alabama","Chambers County",4,38,347,150,197
050,01,017,"Alabama","Chambers County",4,39,389,186,203
050,01,017,"Alabama","Chambers County",4,40,372,176,196
050,01,017,"Alabama","Chambers County",4,41,359,178,181
050,01,017,"Alabama","Chambers County",4,42,391,181,210
050,01,017,"Alabama","Chambers County",4,43,393,192,201
050,01,017,"Alabama","Chambers County",4,44,381,179,202
050,01,017,"Alabama","Chambers County",4,45,395,180,215
050,01,017,"Alabama","Chambers County",4,46,406,186,220
050,01,017,"Alabama","Chambers County",4,47,392,191,201
050,01,017,"Alabama","Chambers County",4,48,410,192,218
050,01,017,"Alabama","Chambers County",4,49,424,186,238
050,01,017,"Alabama","Chambers County",4,50,447,204,243
050,01,017,"Alabama","Chambers County",4,51,480,223,257
050,01,017,"Alabama","Chambers County",4,52,482,240,242
050,01,017,"Alabama","Chambers County",4,53,453,230,223
050,01,017,"Alabama","Chambers County",4,54,456,216,240
050,01,017,"Alabama","Chambers County",4,55,454,215,239
050,01,017,"Alabama","Chambers County",4,56,471,231,240
050,01,017,"Alabama","Chambers County",4,57,481,230,251
050,01,017,"Alabama","Chambers County",4,58,496,234,262
050,01,017,"Alabama","Chambers County",4,59,504,237,267
050,01,017,"Alabama","Chambers County",4,60,503,239,264
050,01,017,"Alabama","Chambers County",4,61,487,259,228
050,01,017,"Alabama","Chambers County",4,62,495,244,251
050,01,017,"Alabama","Chambers County",4,63,483,221,262
050,01,017,"Alabama","Chambers County",4,64,478,214,264
050,01,017,"Alabama","Chambers County",4,65,492,233,259
050,01,017,"Alabama","Chambers County",4,66,474,211,263
050,01,017,"Alabama","Chambers County",4,67,460,214,246
050,01,017,"Alabama","Chambers County",4,68,440,202,238
050,01,017,"Alabama","Chambers County",4,69,428,183,245
050,01,017,"Alabama","Chambers County",4,70,395,181,214
050,01,017,"Alabama","Chambers County",4,71,384,185,199
050,01,017,"Alabama","Chambers County",4,72,357,172,185
050,01,017,"Alabama","Chambers County",4,73,356,165,191
050,01,017,"Alabama","Chambers County",4,74,344,148,196
050,01,017,"Alabama","Chambers County",4,75,392,173,219
050,01,017,"Alabama","Chambers County",4,76,282,119,163
050,01,017,"Alabama","Chambers County",4,77,245,101,144
050,01,017,"Alabama","Chambers County",4,78,268,106,162
050,01,017,"Alabama","Chambers County",4,79,244,102,142
050,01,017,"Alabama","Chambers County",4,80,194,79,115
050,01,017,"Alabama","Chambers County",4,81,172,65,107
050,01,017,"Alabama","Chambers County",4,82,160,67,93
050,01,017,"Alabama","Chambers County",4,83,132,43,89
050,01,017,"Alabama","Chambers County",4,84,135,51,84
050,01,017,"Alabama","Chambers County",4,85,686,226,460
050,01,017,"Alabama","Chambers County",5,0,390,199,191
050,01,017,"Alabama","Chambers County",5,1,386,199,187
050,01,017,"Alabama","Chambers County",5,2,337,160,177
050,01,017,"Alabama","Chambers County",5,3,354,185,169
050,01,017,"Alabama","Chambers County",5,4,377,201,176
050,01,017,"Alabama","Chambers County",5,5,381,196,185
050,01,017,"Alabama","Chambers County",5,6,357,173,184
050,01,017,"Alabama","Chambers County",5,7,420,202,218
050,01,017,"Alabama","Chambers County",5,8,428,213,215
050,01,017,"Alabama","Chambers County",5,9,417,213,204
050,01,017,"Alabama","Chambers County",5,10,408,199,209
050,01,017,"Alabama","Chambers County",5,11,406,200,206
050,01,017,"Alabama","Chambers County",5,12,411,218,193
050,01,017,"Alabama","Chambers County",5,13,376,176,200
050,01,017,"Alabama","Chambers County",5,14,421,220,201
050,01,017,"Alabama","Chambers County",5,15,423,219,204
050,01,017,"Alabama","Chambers County",5,16,412,209,203
050,01,017,"Alabama","Chambers County",5,17,405,183,222
050,01,017,"Alabama","Chambers County",5,18,394,197,197
050,01,017,"Alabama","Chambers County",5,19,399,195,204
050,01,017,"Alabama","Chambers County",5,20,371,189,182
050,01,017,"Alabama","Chambers County",5,21,385,201,184
050,01,017,"Alabama","Chambers County",5,22,401,210,191
050,01,017,"Alabama","Chambers County",5,23,384,198,186
050,01,017,"Alabama","Chambers County",5,24,387,207,180
050,01,017,"Alabama","Chambers County",5,25,395,176,219
050,01,017,"Alabama","Chambers County",5,26,383,186,197
050,01,017,"Alabama","Chambers County",5,27,404,201,203
050,01,017,"Alabama","Chambers County",5,28,409,183,226
050,01,017,"Alabama","Chambers County",5,29,414,185,229
050,01,017,"Alabama","Chambers County",5,30,447,222,225
050,01,017,"Alabama","Chambers County",5,31,458,226,232
050,01,017,"Alabama","Chambers County",5,32,445,219,226
050,01,017,"Alabama","Chambers County",5,33,467,214,253
050,01,017,"Alabama","Chambers County",5,34,418,199,219
050,01,017,"Alabama","Chambers County",5,35,364,179,185
050,01,017,"Alabama","Chambers County",5,36,337,159,178
050,01,017,"Alabama","Chambers County",5,37,386,168,218
050,01,017,"Alabama","Chambers County",5,38,350,148,202
050,01,017,"Alabama","Chambers County",5,39,329,150,179
050,01,017,"Alabama","Chambers County",5,40,378,174,204
050,01,017,"Alabama","Chambers County",5,41,372,177,195
050,01,017,"Alabama","Chambers County",5,42,366,178,188
050,01,017,"Alabama","Chambers County",5,43,402,180,222
050,01,017,"Alabama","Chambers County",5,44,407,197,210
050,01,017,"Alabama","Chambers County",5,45,388,181,207
050,01,017,"Alabama","Chambers County",5,46,400,177,223
050,01,017,"Alabama","Chambers County",5,47,400,178,222
050,01,017,"Alabama","Chambers County",5,48,400,188,212
050,01,017,"Alabama","Chambers County",5,49,412,196,216
050,01,017,"Alabama","Chambers County",5,50,422,191,231
050,01,017,"Alabama","Chambers County",5,51,459,209,250
050,01,017,"Alabama","Chambers County",5,52,485,226,259
050,01,017,"Alabama","Chambers County",5,53,469,240,229
050,01,017,"Alabama","Chambers County",5,54,444,223,221
050,01,017,"Alabama","Chambers County",5,55,461,216,245
050,01,017,"Alabama","Chambers County",5,56,455,217,238
050,01,017,"Alabama","Chambers County",5,57,486,237,249
050,01,017,"Alabama","Chambers County",5,58,476,230,246
050,01,017,"Alabama","Chambers County",5,59,494,224,270
050,01,017,"Alabama","Chambers County",5,60,504,243,261
050,01,017,"Alabama","Chambers County",5,61,505,244,261
050,01,017,"Alabama","Chambers County",5,62,484,251,233
050,01,017,"Alabama","Chambers County",5,63,487,242,245
050,01,017,"Alabama","Chambers County",5,64,482,220,262
050,01,017,"Alabama","Chambers County",5,65,480,216,264
050,01,017,"Alabama","Chambers County",5,66,488,226,262
050,01,017,"Alabama","Chambers County",5,67,457,206,251
050,01,017,"Alabama","Chambers County",5,68,449,210,239
050,01,017,"Alabama","Chambers County",5,69,438,197,241
050,01,017,"Alabama","Chambers County",5,70,413,177,236
050,01,017,"Alabama","Chambers County",5,71,388,176,212
050,01,017,"Alabama","Chambers County",5,72,374,179,195
050,01,017,"Alabama","Chambers County",5,73,365,177,188
050,01,017,"Alabama","Chambers County",5,74,339,156,183
050,01,017,"Alabama","Chambers County",5,75,341,139,202
050,01,017,"Alabama","Chambers County",5,76,383,167,216
050,01,017,"Alabama","Chambers County",5,77,260,106,154
050,01,017,"Alabama","Chambers County",5,78,241,92,149
050,01,017,"Alabama","Chambers County",5,79,242,96,146
050,01,017,"Alabama","Chambers County",5,80,225,96,129
050,01,017,"Alabama","Chambers County",5,81,178,65,113
050,01,017,"Alabama","Chambers County",5,82,164,61,103
050,01,017,"Alabama","Chambers County",5,83,148,58,90
050,01,017,"Alabama","Chambers County",5,84,123,42,81
050,01,017,"Alabama","Chambers County",5,85,709,234,475
050,01,019,"Alabama","Cherokee County",1,0,221,114,107
050,01,019,"Alabama","Cherokee County",1,1,223,108,115
050,01,019,"Alabama","Cherokee County",1,2,217,100,117
050,01,019,"Alabama","Cherokee County",1,3,241,119,122
050,01,019,"Alabama","Cherokee County",1,4,243,120,123
050,01,019,"Alabama","Cherokee County",1,5,247,120,127
050,01,019,"Alabama","Cherokee County",1,6,247,125,122
050,01,019,"Alabama","Cherokee County",1,7,240,131,109
050,01,019,"Alabama","Cherokee County",1,8,252,139,113
050,01,019,"Alabama","Cherokee County",1,9,259,139,120
050,01,019,"Alabama","Cherokee County",1,10,270,139,131
050,01,019,"Alabama","Cherokee County",1,11,284,144,140
050,01,019,"Alabama","Cherokee County",1,12,299,164,135
050,01,019,"Alabama","Cherokee County",1,13,299,156,143
050,01,019,"Alabama","Cherokee County",1,14,292,146,146
050,01,019,"Alabama","Cherokee County",1,15,296,143,153
050,01,019,"Alabama","Cherokee County",1,16,306,145,161
050,01,019,"Alabama","Cherokee County",1,17,281,136,145
050,01,019,"Alabama","Cherokee County",1,18,268,126,142
050,01,019,"Alabama","Cherokee County",1,19,226,121,105
050,01,019,"Alabama","Cherokee County",1,20,240,125,115
050,01,019,"Alabama","Cherokee County",1,21,249,123,126
050,01,019,"Alabama","Cherokee County",1,22,269,134,135
050,01,019,"Alabama","Cherokee County",1,23,250,117,133
050,01,019,"Alabama","Cherokee County",1,24,257,134,123
050,01,019,"Alabama","Cherokee County",1,25,265,146,119
050,01,019,"Alabama","Cherokee County",1,26,275,137,138
050,01,019,"Alabama","Cherokee County",1,27,274,152,122
050,01,019,"Alabama","Cherokee County",1,28,307,165,142
050,01,019,"Alabama","Cherokee County",1,29,321,166,155
050,01,019,"Alabama","Cherokee County",1,30,260,137,123
050,01,019,"Alabama","Cherokee County",1,31,268,144,124
050,01,019,"Alabama","Cherokee County",1,32,247,119,128
050,01,019,"Alabama","Cherokee County",1,33,241,114,127
050,01,019,"Alabama","Cherokee County",1,34,245,125,120
050,01,019,"Alabama","Cherokee County",1,35,205,89,116
050,01,019,"Alabama","Cherokee County",1,36,231,102,129
050,01,019,"Alabama","Cherokee County",1,37,253,113,140
050,01,019,"Alabama","Cherokee County",1,38,233,128,105
050,01,019,"Alabama","Cherokee County",1,39,259,141,118
050,01,019,"Alabama","Cherokee County",1,40,258,121,137
050,01,019,"Alabama","Cherokee County",1,41,269,134,135
050,01,019,"Alabama","Cherokee County",1,42,279,133,146
050,01,019,"Alabama","Cherokee County",1,43,259,131,128
050,01,019,"Alabama","Cherokee County",1,44,266,140,126
050,01,019,"Alabama","Cherokee County",1,45,314,161,153
050,01,019,"Alabama","Cherokee County",1,46,310,162,148
050,01,019,"Alabama","Cherokee County",1,47,313,149,164
050,01,019,"Alabama","Cherokee County",1,48,354,172,182
050,01,019,"Alabama","Cherokee County",1,49,365,198,167
050,01,019,"Alabama","Cherokee County",1,50,330,172,158
050,01,019,"Alabama","Cherokee County",1,51,346,176,170
050,01,019,"Alabama","Cherokee County",1,52,350,187,163
050,01,019,"Alabama","Cherokee County",1,53,347,180,167
050,01,019,"Alabama","Cherokee County",1,54,368,200,168
050,01,019,"Alabama","Cherokee County",1,55,397,212,185
050,01,019,"Alabama","Cherokee County",1,56,389,203,186
050,01,019,"Alabama","Cherokee County",1,57,376,183,193
050,01,019,"Alabama","Cherokee County",1,58,397,193,204
050,01,019,"Alabama","Cherokee County",1,59,378,182,196
050,01,019,"Alabama","Cherokee County",1,60,393,193,200
050,01,019,"Alabama","Cherokee County",1,61,441,223,218
050,01,019,"Alabama","Cherokee County",1,62,447,209,238
050,01,019,"Alabama","Cherokee County",1,63,426,222,204
050,01,019,"Alabama","Cherokee County",1,64,397,205,192
050,01,019,"Alabama","Cherokee County",1,65,383,189,194
050,01,019,"Alabama","Cherokee County",1,66,385,191,194
050,01,019,"Alabama","Cherokee County",1,67,352,170,182
050,01,019,"Alabama","Cherokee County",1,68,373,178,195
050,01,019,"Alabama","Cherokee County",1,69,342,180,162
050,01,019,"Alabama","Cherokee County",1,70,353,184,169
050,01,019,"Alabama","Cherokee County",1,71,376,192,184
050,01,019,"Alabama","Cherokee County",1,72,373,181,192
050,01,019,"Alabama","Cherokee County",1,73,377,199,178
050,01,019,"Alabama","Cherokee County",1,74,245,118,127
050,01,019,"Alabama","Cherokee County",1,75,249,111,138
050,01,019,"Alabama","Cherokee County",1,76,254,114,140
050,01,019,"Alabama","Cherokee County",1,77,252,114,138
050,01,019,"Alabama","Cherokee County",1,78,181,86,95
050,01,019,"Alabama","Cherokee County",1,79,175,84,91
050,01,019,"Alabama","Cherokee County",1,80,157,79,78
050,01,019,"Alabama","Cherokee County",1,81,141,64,77
050,01,019,"Alabama","Cherokee County",1,82,147,66,81
050,01,019,"Alabama","Cherokee County",1,83,123,50,73
050,01,019,"Alabama","Cherokee County",1,84,107,49,58
050,01,019,"Alabama","Cherokee County",1,85,499,197,302
050,01,019,"Alabama","Cherokee County",2,0,233,121,112
050,01,019,"Alabama","Cherokee County",2,1,222,110,112
050,01,019,"Alabama","Cherokee County",2,2,220,104,116
050,01,019,"Alabama","Cherokee County",2,3,234,115,119
050,01,019,"Alabama","Cherokee County",2,4,242,120,122
050,01,019,"Alabama","Cherokee County",2,5,247,122,125
050,01,019,"Alabama","Cherokee County",2,6,246,124,122
050,01,019,"Alabama","Cherokee County",2,7,242,130,112
050,01,019,"Alabama","Cherokee County",2,8,246,135,111
050,01,019,"Alabama","Cherokee County",2,9,258,140,118
050,01,019,"Alabama","Cherokee County",2,10,267,139,128
050,01,019,"Alabama","Cherokee County",2,11,278,142,136
050,01,019,"Alabama","Cherokee County",2,12,294,159,135
050,01,019,"Alabama","Cherokee County",2,13,296,157,139
050,01,019,"Alabama","Cherokee County",2,14,292,147,145
050,01,019,"Alabama","Cherokee County",2,15,295,144,151
050,01,019,"Alabama","Cherokee County",2,16,303,144,159
050,01,019,"Alabama","Cherokee County",2,17,287,137,150
050,01,019,"Alabama","Cherokee County",2,18,258,125,133
050,01,019,"Alabama","Cherokee County",2,19,223,115,108
050,01,019,"Alabama","Cherokee County",2,20,245,128,117
050,01,019,"Alabama","Cherokee County",2,21,253,126,127
050,01,019,"Alabama","Cherokee County",2,22,269,131,138
050,01,019,"Alabama","Cherokee County",2,23,261,125,136
050,01,019,"Alabama","Cherokee County",2,24,256,132,124
050,01,019,"Alabama","Cherokee County",2,25,264,144,120
050,01,019,"Alabama","Cherokee County",2,26,274,140,134
050,01,019,"Alabama","Cherokee County",2,27,276,151,125
050,01,019,"Alabama","Cherokee County",2,28,300,161,139
050,01,019,"Alabama","Cherokee County",2,29,318,167,151
050,01,019,"Alabama","Cherokee County",2,30,273,142,131
050,01,019,"Alabama","Cherokee County",2,31,268,145,123
050,01,019,"Alabama","Cherokee County",2,32,248,123,125
050,01,019,"Alabama","Cherokee County",2,33,241,115,126
050,01,019,"Alabama","Cherokee County",2,34,243,122,121
050,01,019,"Alabama","Cherokee County",2,35,216,97,119
050,01,019,"Alabama","Cherokee County",2,36,227,101,126
050,01,019,"Alabama","Cherokee County",2,37,246,110,136
050,01,019,"Alabama","Cherokee County",2,38,234,122,112
050,01,019,"Alabama","Cherokee County",2,39,251,137,114
050,01,019,"Alabama","Cherokee County",2,40,261,127,134
050,01,019,"Alabama","Cherokee County",2,41,265,131,134
050,01,019,"Alabama","Cherokee County",2,42,276,134,142
050,01,019,"Alabama","Cherokee County",2,43,269,133,136
050,01,019,"Alabama","Cherokee County",2,44,264,138,126
050,01,019,"Alabama","Cherokee County",2,45,306,157,149
050,01,019,"Alabama","Cherokee County",2,46,309,160,149
050,01,019,"Alabama","Cherokee County",2,47,307,149,158
050,01,019,"Alabama","Cherokee County",2,48,344,167,177
050,01,019,"Alabama","Cherokee County",2,49,366,195,171
050,01,019,"Alabama","Cherokee County",2,50,340,180,160
050,01,019,"Alabama","Cherokee County",2,51,344,177,167
050,01,019,"Alabama","Cherokee County",2,52,344,182,162
050,01,019,"Alabama","Cherokee County",2,53,346,180,166
050,01,019,"Alabama","Cherokee County",2,54,364,196,168
050,01,019,"Alabama","Cherokee County",2,55,392,210,182
050,01,019,"Alabama","Cherokee County",2,56,395,206,189
050,01,019,"Alabama","Cherokee County",2,57,381,189,192
050,01,019,"Alabama","Cherokee County",2,58,393,190,203
050,01,019,"Alabama","Cherokee County",2,59,385,185,200
050,01,019,"Alabama","Cherokee County",2,60,384,186,198
050,01,019,"Alabama","Cherokee County",2,61,432,217,215
050,01,019,"Alabama","Cherokee County",2,62,446,213,233
050,01,019,"Alabama","Cherokee County",2,63,436,222,214
050,01,019,"Alabama","Cherokee County",2,64,401,207,194
050,01,019,"Alabama","Cherokee County",2,65,390,195,195
050,01,019,"Alabama","Cherokee County",2,66,386,191,195
050,01,019,"Alabama","Cherokee County",2,67,363,177,186
050,01,019,"Alabama","Cherokee County",2,68,363,173,190
050,01,019,"Alabama","Cherokee County",2,69,351,180,171
050,01,019,"Alabama","Cherokee County",2,70,347,181,166
050,01,019,"Alabama","Cherokee County",2,71,371,189,182
050,01,019,"Alabama","Cherokee County",2,72,363,180,183
050,01,019,"Alabama","Cherokee County",2,73,395,205,190
050,01,019,"Alabama","Cherokee County",2,74,259,128,131
050,01,019,"Alabama","Cherokee County",2,75,245,113,132
050,01,019,"Alabama","Cherokee County",2,76,247,111,136
050,01,019,"Alabama","Cherokee County",2,77,252,113,139
050,01,019,"Alabama","Cherokee County",2,78,194,91,103
050,01,019,"Alabama","Cherokee County",2,79,175,84,91
050,01,019,"Alabama","Cherokee County",2,80,154,76,78
050,01,019,"Alabama","Cherokee County",2,81,142,67,75
050,01,019,"Alabama","Cherokee County",2,82,146,65,81
050,01,019,"Alabama","Cherokee County",2,83,126,52,74
050,01,019,"Alabama","Cherokee County",2,84,105,47,58
050,01,019,"Alabama","Cherokee County",2,85,499,201,298
050,01,019,"Alabama","Cherokee County",3,0,251,147,104
050,01,019,"Alabama","Cherokee County",3,1,238,129,109
050,01,019,"Alabama","Cherokee County",3,2,219,104,115
050,01,019,"Alabama","Cherokee County",3,3,223,113,110
050,01,019,"Alabama","Cherokee County",3,4,242,114,128
050,01,019,"Alabama","Cherokee County",3,5,242,115,127
050,01,019,"Alabama","Cherokee County",3,6,256,126,130
050,01,019,"Alabama","Cherokee County",3,7,252,129,123
050,01,019,"Alabama","Cherokee County",3,8,241,125,116
050,01,019,"Alabama","Cherokee County",3,9,262,135,127
050,01,019,"Alabama","Cherokee County",3,10,260,144,116
050,01,019,"Alabama","Cherokee County",3,11,258,132,126
050,01,019,"Alabama","Cherokee County",3,12,270,139,131
050,01,019,"Alabama","Cherokee County",3,13,293,161,132
050,01,019,"Alabama","Cherokee County",3,14,305,164,141
050,01,019,"Alabama","Cherokee County",3,15,297,149,148
050,01,019,"Alabama","Cherokee County",3,16,302,151,151
050,01,019,"Alabama","Cherokee County",3,17,302,146,156
050,01,019,"Alabama","Cherokee County",3,18,245,126,119
050,01,019,"Alabama","Cherokee County",3,19,209,100,109
050,01,019,"Alabama","Cherokee County",3,20,249,128,121
050,01,019,"Alabama","Cherokee County",3,21,253,134,119
050,01,019,"Alabama","Cherokee County",3,22,256,119,137
050,01,019,"Alabama","Cherokee County",3,23,282,139,143
050,01,019,"Alabama","Cherokee County",3,24,267,137,130
050,01,019,"Alabama","Cherokee County",3,25,261,137,124
050,01,019,"Alabama","Cherokee County",3,26,272,147,125
050,01,019,"Alabama","Cherokee County",3,27,272,145,127
050,01,019,"Alabama","Cherokee County",3,28,277,141,136
050,01,019,"Alabama","Cherokee County",3,29,309,165,144
050,01,019,"Alabama","Cherokee County",3,30,292,151,141
050,01,019,"Alabama","Cherokee County",3,31,272,146,126
050,01,019,"Alabama","Cherokee County",3,32,260,137,123
050,01,019,"Alabama","Cherokee County",3,33,262,131,131
050,01,019,"Alabama","Cherokee County",3,34,244,115,129
050,01,019,"Alabama","Cherokee County",3,35,241,120,121
050,01,019,"Alabama","Cherokee County",3,36,228,105,123
050,01,019,"Alabama","Cherokee County",3,37,227,96,131
050,01,019,"Alabama","Cherokee County",3,38,253,116,137
050,01,019,"Alabama","Cherokee County",3,39,242,127,115
050,01,019,"Alabama","Cherokee County",3,40,247,128,119
050,01,019,"Alabama","Cherokee County",3,41,260,131,129
050,01,019,"Alabama","Cherokee County",3,42,266,132,134
050,01,019,"Alabama","Cherokee County",3,43,277,132,145
050,01,019,"Alabama","Cherokee County",3,44,268,133,135
050,01,019,"Alabama","Cherokee County",3,45,268,136,132
050,01,019,"Alabama","Cherokee County",3,46,311,160,151
050,01,019,"Alabama","Cherokee County",3,47,311,163,148
050,01,019,"Alabama","Cherokee County",3,48,322,157,165
050,01,019,"Alabama","Cherokee County",3,49,359,173,186
050,01,019,"Alabama","Cherokee County",3,50,362,194,168
050,01,019,"Alabama","Cherokee County",3,51,347,186,161
050,01,019,"Alabama","Cherokee County",3,52,351,174,177
050,01,019,"Alabama","Cherokee County",3,53,348,180,168
050,01,019,"Alabama","Cherokee County",3,54,359,188,171
050,01,019,"Alabama","Cherokee County",3,55,375,198,177
050,01,019,"Alabama","Cherokee County",3,56,395,206,189
050,01,019,"Alabama","Cherokee County",3,57,405,216,189
050,01,019,"Alabama","Cherokee County",3,58,386,192,194
050,01,019,"Alabama","Cherokee County",3,59,399,192,207
050,01,019,"Alabama","Cherokee County",3,60,387,186,201
050,01,019,"Alabama","Cherokee County",3,61,392,186,206
050,01,019,"Alabama","Cherokee County",3,62,429,223,206
050,01,019,"Alabama","Cherokee County",3,63,459,217,242
050,01,019,"Alabama","Cherokee County",3,64,430,216,214
050,01,019,"Alabama","Cherokee County",3,65,414,209,205
050,01,019,"Alabama","Cherokee County",3,66,406,200,206
050,01,019,"Alabama","Cherokee County",3,67,378,182,196
050,01,019,"Alabama","Cherokee County",3,68,358,173,185
050,01,019,"Alabama","Cherokee County",3,69,347,164,183
050,01,019,"Alabama","Cherokee County",3,70,337,166,171
050,01,019,"Alabama","Cherokee County",3,71,333,170,163
050,01,019,"Alabama","Cherokee County",3,72,358,180,178
050,01,019,"Alabama","Cherokee County",3,73,350,173,177
050,01,019,"Alabama","Cherokee County",3,74,382,201,181
050,01,019,"Alabama","Cherokee County",3,75,243,120,123
050,01,019,"Alabama","Cherokee County",3,76,237,107,130
050,01,019,"Alabama","Cherokee County",3,77,231,105,126
050,01,019,"Alabama","Cherokee County",3,78,238,106,132
050,01,019,"Alabama","Cherokee County",3,79,176,79,97
050,01,019,"Alabama","Cherokee County",3,80,162,74,88
050,01,019,"Alabama","Cherokee County",3,81,139,70,69
050,01,019,"Alabama","Cherokee County",3,82,126,59,67
050,01,019,"Alabama","Cherokee County",3,83,137,61,76
050,01,019,"Alabama","Cherokee County",3,84,105,44,61
050,01,019,"Alabama","Cherokee County",3,85,518,218,300
050,01,019,"Alabama","Cherokee County",4,0,235,128,107
050,01,019,"Alabama","Cherokee County",4,1,251,145,106
050,01,019,"Alabama","Cherokee County",4,2,247,135,112
050,01,019,"Alabama","Cherokee County",4,3,222,107,115
050,01,019,"Alabama","Cherokee County",4,4,231,122,109
050,01,019,"Alabama","Cherokee County",4,5,250,118,132
050,01,019,"Alabama","Cherokee County",4,6,253,127,126
050,01,019,"Alabama","Cherokee County",4,7,268,138,130
050,01,019,"Alabama","Cherokee County",4,8,254,129,125
050,01,019,"Alabama","Cherokee County",4,9,245,127,118
050,01,019,"Alabama","Cherokee County",4,10,262,135,127
050,01,019,"Alabama","Cherokee County",4,11,269,144,125
050,01,019,"Alabama","Cherokee County",4,12,268,144,124
050,01,019,"Alabama","Cherokee County",4,13,278,142,136
050,01,019,"Alabama","Cherokee County",4,14,298,162,136
050,01,019,"Alabama","Cherokee County",4,15,308,165,143
050,01,019,"Alabama","Cherokee County",4,16,294,148,146
050,01,019,"Alabama","Cherokee County",4,17,319,164,155
050,01,019,"Alabama","Cherokee County",4,18,268,131,137
050,01,019,"Alabama","Cherokee County",4,19,184,92,92
050,01,019,"Alabama","Cherokee County",4,20,225,113,112
050,01,019,"Alabama","Cherokee County",4,21,258,136,122
050,01,019,"Alabama","Cherokee County",4,22,266,133,133
050,01,019,"Alabama","Cherokee County",4,23,269,126,143
050,01,019,"Alabama","Cherokee County",4,24,269,134,135
050,01,019,"Alabama","Cherokee County",4,25,270,144,126
050,01,019,"Alabama","Cherokee County",4,26,267,148,119
050,01,019,"Alabama","Cherokee County",4,27,275,143,132
050,01,019,"Alabama","Cherokee County",4,28,269,140,129
050,01,019,"Alabama","Cherokee County",4,29,286,149,137
050,01,019,"Alabama","Cherokee County",4,30,313,161,152
050,01,019,"Alabama","Cherokee County",4,31,302,162,140
050,01,019,"Alabama","Cherokee County",4,32,271,142,129
050,01,019,"Alabama","Cherokee County",4,33,244,130,114
050,01,019,"Alabama","Cherokee County",4,34,255,126,129
050,01,019,"Alabama","Cherokee County",4,35,239,108,131
050,01,019,"Alabama","Cherokee County",4,36,246,120,126
050,01,019,"Alabama","Cherokee County",4,37,233,107,126
050,01,019,"Alabama","Cherokee County",4,38,238,102,136
050,01,019,"Alabama","Cherokee County",4,39,253,113,140
050,01,019,"Alabama","Cherokee County",4,40,241,121,120
050,01,019,"Alabama","Cherokee County",4,41,259,136,123
050,01,019,"Alabama","Cherokee County",4,42,278,149,129
050,01,019,"Alabama","Cherokee County",4,43,275,133,142
050,01,019,"Alabama","Cherokee County",4,44,286,140,146
050,01,019,"Alabama","Cherokee County",4,45,265,131,134
050,01,019,"Alabama","Cherokee County",4,46,277,146,131
050,01,019,"Alabama","Cherokee County",4,47,314,165,149
050,01,019,"Alabama","Cherokee County",4,48,311,165,146
050,01,019,"Alabama","Cherokee County",4,49,338,164,174
050,01,019,"Alabama","Cherokee County",4,50,362,176,186
050,01,019,"Alabama","Cherokee County",4,51,378,205,173
050,01,019,"Alabama","Cherokee County",4,52,357,192,165
050,01,019,"Alabama","Cherokee County",4,53,347,162,185
050,01,019,"Alabama","Cherokee County",4,54,349,181,168
050,01,019,"Alabama","Cherokee County",4,55,372,196,176
050,01,019,"Alabama","Cherokee County",4,56,370,189,181
050,01,019,"Alabama","Cherokee County",4,57,392,207,185
050,01,019,"Alabama","Cherokee County",4,58,415,216,199
050,01,019,"Alabama","Cherokee County",4,59,398,203,195
050,01,019,"Alabama","Cherokee County",4,60,399,195,204
050,01,019,"Alabama","Cherokee County",4,61,403,194,209
050,01,019,"Alabama","Cherokee County",4,62,397,188,209
050,01,019,"Alabama","Cherokee County",4,63,433,226,207
050,01,019,"Alabama","Cherokee County",4,64,458,217,241
050,01,019,"Alabama","Cherokee County",4,65,438,217,221
050,01,019,"Alabama","Cherokee County",4,66,418,209,209
050,01,019,"Alabama","Cherokee County",4,67,408,203,205
050,01,019,"Alabama","Cherokee County",4,68,396,192,204
050,01,019,"Alabama","Cherokee County",4,69,357,170,187
050,01,019,"Alabama","Cherokee County",4,70,343,160,183
050,01,019,"Alabama","Cherokee County",4,71,335,169,166
050,01,019,"Alabama","Cherokee County",4,72,325,168,157
050,01,019,"Alabama","Cherokee County",4,73,339,169,170
050,01,019,"Alabama","Cherokee County",4,74,351,170,181
050,01,019,"Alabama","Cherokee County",4,75,362,191,171
050,01,019,"Alabama","Cherokee County",4,76,244,118,126
050,01,019,"Alabama","Cherokee County",4,77,228,100,128
050,01,019,"Alabama","Cherokee County",4,78,218,96,122
050,01,019,"Alabama","Cherokee County",4,79,224,100,124
050,01,019,"Alabama","Cherokee County",4,80,176,77,99
050,01,019,"Alabama","Cherokee County",4,81,155,70,85
050,01,019,"Alabama","Cherokee County",4,82,129,64,65
050,01,019,"Alabama","Cherokee County",4,83,119,56,63
050,01,019,"Alabama","Cherokee County",4,84,122,57,65
050,01,019,"Alabama","Cherokee County",4,85,540,225,315
050,01,019,"Alabama","Cherokee County",5,0,226,125,101
050,01,019,"Alabama","Cherokee County",5,1,236,123,113
050,01,019,"Alabama","Cherokee County",5,2,263,147,116
050,01,019,"Alabama","Cherokee County",5,3,252,138,114
050,01,019,"Alabama","Cherokee County",5,4,231,112,119
050,01,019,"Alabama","Cherokee County",5,5,232,121,111
050,01,019,"Alabama","Cherokee County",5,6,266,128,138
050,01,019,"Alabama","Cherokee County",5,7,271,133,138
050,01,019,"Alabama","Cherokee County",5,8,276,137,139
050,01,019,"Alabama","Cherokee County",5,9,264,138,126
050,01,019,"Alabama","Cherokee County",5,10,240,125,115
050,01,019,"Alabama","Cherokee County",5,11,262,131,131
050,01,019,"Alabama","Cherokee County",5,12,281,151,130
050,01,019,"Alabama","Cherokee County",5,13,274,148,126
050,01,019,"Alabama","Cherokee County",5,14,283,152,131
050,01,019,"Alabama","Cherokee County",5,15,304,167,137
050,01,019,"Alabama","Cherokee County",5,16,320,169,151
050,01,019,"Alabama","Cherokee County",5,17,308,155,153
050,01,019,"Alabama","Cherokee County",5,18,277,146,131
050,01,019,"Alabama","Cherokee County",5,19,206,95,111
050,01,019,"Alabama","Cherokee County",5,20,197,96,101
050,01,019,"Alabama","Cherokee County",5,21,252,119,133
050,01,019,"Alabama","Cherokee County",5,22,284,141,143
050,01,019,"Alabama","Cherokee County",5,23,262,133,129
050,01,019,"Alabama","Cherokee County",5,24,276,136,140
050,01,019,"Alabama","Cherokee County",5,25,285,149,136
050,01,019,"Alabama","Cherokee County",5,26,283,147,136
050,01,019,"Alabama","Cherokee County",5,27,280,145,135
050,01,019,"Alabama","Cherokee County",5,28,280,150,130
050,01,019,"Alabama","Cherokee County",5,29,281,149,132
050,01,019,"Alabama","Cherokee County",5,30,290,141,149
050,01,019,"Alabama","Cherokee County",5,31,338,174,164
050,01,019,"Alabama","Cherokee County",5,32,299,154,145
050,01,019,"Alabama","Cherokee County",5,33,263,142,121
050,01,019,"Alabama","Cherokee County",5,34,258,143,115
050,01,019,"Alabama","Cherokee County",5,35,261,126,135
050,01,019,"Alabama","Cherokee County",5,36,244,109,135
050,01,019,"Alabama","Cherokee County",5,37,236,111,125
050,01,019,"Alabama","Cherokee County",5,38,237,110,127
050,01,019,"Alabama","Cherokee County",5,39,249,109,140
050,01,019,"Alabama","Cherokee County",5,40,249,110,139
050,01,019,"Alabama","Cherokee County",5,41,258,132,126
050,01,019,"Alabama","Cherokee County",5,42,262,139,123
050,01,019,"Alabama","Cherokee County",5,43,278,147,131
050,01,019,"Alabama","Cherokee County",5,44,278,138,140
050,01,019,"Alabama","Cherokee County",5,45,273,134,139
050,01,019,"Alabama","Cherokee County",5,46,281,138,143
050,01,019,"Alabama","Cherokee County",5,47,286,147,139
050,01,019,"Alabama","Cherokee County",5,48,321,171,150
050,01,019,"Alabama","Cherokee County",5,49,324,176,148
050,01,019,"Alabama","Cherokee County",5,50,337,158,179
050,01,019,"Alabama","Cherokee County",5,51,377,182,195
050,01,019,"Alabama","Cherokee County",5,52,379,200,179
050,01,019,"Alabama","Cherokee County",5,53,362,196,166
050,01,019,"Alabama","Cherokee County",5,54,341,157,184
050,01,019,"Alabama","Cherokee County",5,55,352,174,178
050,01,019,"Alabama","Cherokee County",5,56,377,192,185
050,01,019,"Alabama","Cherokee County",5,57,380,202,178
050,01,019,"Alabama","Cherokee County",5,58,408,214,194
050,01,019,"Alabama","Cherokee County",5,59,409,216,193
050,01,019,"Alabama","Cherokee County",5,60,404,213,191
050,01,019,"Alabama","Cherokee County",5,61,396,190,206
050,01,019,"Alabama","Cherokee County",5,62,407,195,212
050,01,019,"Alabama","Cherokee County",5,63,403,192,211
050,01,019,"Alabama","Cherokee County",5,64,437,228,209
050,01,019,"Alabama","Cherokee County",5,65,467,218,249
050,01,019,"Alabama","Cherokee County",5,66,436,211,225
050,01,019,"Alabama","Cherokee County",5,67,425,211,214
050,01,019,"Alabama","Cherokee County",5,68,420,207,213
050,01,019,"Alabama","Cherokee County",5,69,387,190,197
050,01,019,"Alabama","Cherokee County",5,70,347,164,183
050,01,019,"Alabama","Cherokee County",5,71,335,157,178
050,01,019,"Alabama","Cherokee County",5,72,325,168,157
050,01,019,"Alabama","Cherokee County",5,73,313,159,154
050,01,019,"Alabama","Cherokee County",5,74,338,167,171
050,01,019,"Alabama","Cherokee County",5,75,334,163,171
050,01,019,"Alabama","Cherokee County",5,76,347,180,167
050,01,019,"Alabama","Cherokee County",5,77,231,110,121
050,01,019,"Alabama","Cherokee County",5,78,219,96,123
050,01,019,"Alabama","Cherokee County",5,79,202,83,119
050,01,019,"Alabama","Cherokee County",5,80,213,92,121
050,01,019,"Alabama","Cherokee County",5,81,165,70,95
050,01,019,"Alabama","Cherokee County",5,82,141,61,80
050,01,019,"Alabama","Cherokee County",5,83,125,61,64
050,01,019,"Alabama","Cherokee County",5,84,104,51,53
050,01,019,"Alabama","Cherokee County",5,85,586,248,338
050,01,021,"Alabama","Chilton County",1,0,543,278,265
050,01,021,"Alabama","Chilton County",1,1,531,280,251
050,01,021,"Alabama","Chilton County",1,2,560,293,267
050,01,021,"Alabama","Chilton County",1,3,559,284,275
050,01,021,"Alabama","Chilton County",1,4,591,281,310
050,01,021,"Alabama","Chilton County",1,5,565,287,278
050,01,021,"Alabama","Chilton County",1,6,603,313,290
050,01,021,"Alabama","Chilton County",1,7,582,289,293
050,01,021,"Alabama","Chilton County",1,8,598,290,308
050,01,021,"Alabama","Chilton County",1,9,637,305,332
050,01,021,"Alabama","Chilton County",1,10,665,321,344
050,01,021,"Alabama","Chilton County",1,11,689,333,356
050,01,021,"Alabama","Chilton County",1,12,665,327,338
050,01,021,"Alabama","Chilton County",1,13,656,311,345
050,01,021,"Alabama","Chilton County",1,14,613,312,301
050,01,021,"Alabama","Chilton County",1,15,631,326,305
050,01,021,"Alabama","Chilton County",1,16,659,327,332
050,01,021,"Alabama","Chilton County",1,17,668,320,348
050,01,021,"Alabama","Chilton County",1,18,545,286,259
050,01,021,"Alabama","Chilton County",1,19,451,244,207
050,01,021,"Alabama","Chilton County",1,20,482,258,224
050,01,021,"Alabama","Chilton County",1,21,480,259,221
050,01,021,"Alabama","Chilton County",1,22,487,256,231
050,01,021,"Alabama","Chilton County",1,23,546,275,271
050,01,021,"Alabama","Chilton County",1,24,555,279,276
050,01,021,"Alabama","Chilton County",1,25,539,265,274
050,01,021,"Alabama","Chilton County",1,26,562,277,285
050,01,021,"Alabama","Chilton County",1,27,612,315,297
050,01,021,"Alabama","Chilton County",1,28,545,263,282
050,01,021,"Alabama","Chilton County",1,29,623,317,306
050,01,021,"Alabama","Chilton County",1,30,576,280,296
050,01,021,"Alabama","Chilton County",1,31,542,272,270
050,01,021,"Alabama","Chilton County",1,32,506,261,245
050,01,021,"Alabama","Chilton County",1,33,520,271,249
050,01,021,"Alabama","Chilton County",1,34,562,275,287
050,01,021,"Alabama","Chilton County",1,35,537,259,278
050,01,021,"Alabama","Chilton County",1,36,515,259,256
050,01,021,"Alabama","Chilton County",1,37,540,270,270
050,01,021,"Alabama","Chilton County",1,38,518,265,253
050,01,021,"Alabama","Chilton County",1,39,571,294,277
050,01,021,"Alabama","Chilton County",1,40,567,272,295
050,01,021,"Alabama","Chilton County",1,41,553,259,294
050,01,021,"Alabama","Chilton County",1,42,589,276,313
050,01,021,"Alabama","Chilton County",1,43,586,284,302
050,01,021,"Alabama","Chilton County",1,44,540,283,257
050,01,021,"Alabama","Chilton County",1,45,566,277,289
050,01,021,"Alabama","Chilton County",1,46,546,274,272
050,01,021,"Alabama","Chilton County",1,47,564,299,265
050,01,021,"Alabama","Chilton County",1,48,594,304,290
050,01,021,"Alabama","Chilton County",1,49,633,339,294
050,01,021,"Alabama","Chilton County",1,50,582,313,269
050,01,021,"Alabama","Chilton County",1,51,598,325,273
050,01,021,"Alabama","Chilton County",1,52,578,293,285
050,01,021,"Alabama","Chilton County",1,53,594,294,300
050,01,021,"Alabama","Chilton County",1,54,571,276,295
050,01,021,"Alabama","Chilton County",1,55,611,319,292
050,01,021,"Alabama","Chilton County",1,56,636,323,313
050,01,021,"Alabama","Chilton County",1,57,578,281,297
050,01,021,"Alabama","Chilton County",1,58,635,306,329
050,01,021,"Alabama","Chilton County",1,59,622,317,305
050,01,021,"Alabama","Chilton County",1,60,590,306,284
050,01,021,"Alabama","Chilton County",1,61,600,305,295
050,01,021,"Alabama","Chilton County",1,62,597,287,310
050,01,021,"Alabama","Chilton County",1,63,585,272,313
050,01,021,"Alabama","Chilton County",1,64,564,263,301
050,01,021,"Alabama","Chilton County",1,65,527,251,276
050,01,021,"Alabama","Chilton County",1,66,522,252,270
050,01,021,"Alabama","Chilton County",1,67,516,255,261
050,01,021,"Alabama","Chilton County",1,68,520,242,278
050,01,021,"Alabama","Chilton County",1,69,460,208,252
050,01,021,"Alabama","Chilton County",1,70,434,202,232
050,01,021,"Alabama","Chilton County",1,71,447,218,229
050,01,021,"Alabama","Chilton County",1,72,429,214,215
050,01,021,"Alabama","Chilton County",1,73,415,183,232
050,01,021,"Alabama","Chilton County",1,74,321,135,186
050,01,021,"Alabama","Chilton County",1,75,315,143,172
050,01,021,"Alabama","Chilton County",1,76,304,151,153
050,01,021,"Alabama","Chilton County",1,77,293,140,153
050,01,021,"Alabama","Chilton County",1,78,247,120,127
050,01,021,"Alabama","Chilton County",1,79,219,98,121
050,01,021,"Alabama","Chilton County",1,80,213,88,125
050,01,021,"Alabama","Chilton County",1,81,193,79,114
050,01,021,"Alabama","Chilton County",1,82,167,65,102
050,01,021,"Alabama","Chilton County",1,83,133,61,72
050,01,021,"Alabama","Chilton County",1,84,120,52,68
050,01,021,"Alabama","Chilton County",1,85,708,271,437
050,01,021,"Alabama","Chilton County",2,0,554,281,273
050,01,021,"Alabama","Chilton County",2,1,534,279,255
050,01,021,"Alabama","Chilton County",2,2,556,289,267
050,01,021,"Alabama","Chilton County",2,3,559,285,274
050,01,021,"Alabama","Chilton County",2,4,586,283,303
050,01,021,"Alabama","Chilton County",2,5,572,288,284
050,01,021,"Alabama","Chilton County",2,6,598,308,290
050,01,021,"Alabama","Chilton County",2,7,587,293,294
050,01,021,"Alabama","Chilton County",2,8,592,289,303
050,01,021,"Alabama","Chilton County",2,9,623,297,326
050,01,021,"Alabama","Chilton County",2,10,659,314,345
050,01,021,"Alabama","Chilton County",2,11,678,327,351
050,01,021,"Alabama","Chilton County",2,12,675,330,345
050,01,021,"Alabama","Chilton County",2,13,660,316,344
050,01,021,"Alabama","Chilton County",2,14,622,311,311
050,01,021,"Alabama","Chilton County",2,15,632,328,304
050,01,021,"Alabama","Chilton County",2,16,655,328,327
050,01,021,"Alabama","Chilton County",2,17,665,320,345
050,01,021,"Alabama","Chilton County",2,18,545,282,263
050,01,021,"Alabama","Chilton County",2,19,455,245,210
050,01,021,"Alabama","Chilton County",2,20,485,259,226
050,01,021,"Alabama","Chilton County",2,21,490,263,227
050,01,021,"Alabama","Chilton County",2,22,496,261,235
050,01,021,"Alabama","Chilton County",2,23,544,277,267
050,01,021,"Alabama","Chilton County",2,24,555,279,276
050,01,021,"Alabama","Chilton County",2,25,543,267,276
050,01,021,"Alabama","Chilton County",2,26,555,273,282
050,01,021,"Alabama","Chilton County",2,27,592,300,292
050,01,021,"Alabama","Chilton County",2,28,568,280,288
050,01,021,"Alabama","Chilton County",2,29,608,306,302
050,01,021,"Alabama","Chilton County",2,30,592,292,300
050,01,021,"Alabama","Chilton County",2,31,552,275,277
050,01,021,"Alabama","Chilton County",2,32,514,261,253
050,01,021,"Alabama","Chilton County",2,33,521,272,249
050,01,021,"Alabama","Chilton County",2,34,549,273,276
050,01,021,"Alabama","Chilton County",2,35,550,266,284
050,01,021,"Alabama","Chilton County",2,36,517,257,260
050,01,021,"Alabama","Chilton County",2,37,536,270,266
050,01,021,"Alabama","Chilton County",2,38,525,268,257
050,01,021,"Alabama","Chilton County",2,39,552,283,269
050,01,021,"Alabama","Chilton County",2,40,569,276,293
050,01,021,"Alabama","Chilton County",2,41,554,260,294
050,01,021,"Alabama","Chilton County",2,42,574,268,306
050,01,021,"Alabama","Chilton County",2,43,588,283,305
050,01,021,"Alabama","Chilton County",2,44,547,282,265
050,01,021,"Alabama","Chilton County",2,45,563,280,283
050,01,021,"Alabama","Chilton County",2,46,550,275,275
050,01,021,"Alabama","Chilton County",2,47,557,292,265
050,01,021,"Alabama","Chilton County",2,48,587,303,284
050,01,021,"Alabama","Chilton County",2,49,626,333,293
050,01,021,"Alabama","Chilton County",2,50,597,322,275
050,01,021,"Alabama","Chilton County",2,51,591,320,271
050,01,021,"Alabama","Chilton County",2,52,581,301,280
050,01,021,"Alabama","Chilton County",2,53,590,293,297
050,01,021,"Alabama","Chilton County",2,54,575,279,296
050,01,021,"Alabama","Chilton County",2,55,604,310,294
050,01,021,"Alabama","Chilton County",2,56,633,324,309
050,01,021,"Alabama","Chilton County",2,57,593,292,301
050,01,021,"Alabama","Chilton County",2,58,620,301,319
050,01,021,"Alabama","Chilton County",2,59,624,313,311
050,01,021,"Alabama","Chilton County",2,60,596,308,288
050,01,021,"Alabama","Chilton County",2,61,593,304,289
050,01,021,"Alabama","Chilton County",2,62,596,289,307
050,01,021,"Alabama","Chilton County",2,63,591,277,314
050,01,021,"Alabama","Chilton County",2,64,563,260,303
050,01,021,"Alabama","Chilton County",2,65,532,252,280
050,01,021,"Alabama","Chilton County",2,66,523,250,273
050,01,021,"Alabama","Chilton County",2,67,511,251,260
050,01,021,"Alabama","Chilton County",2,68,512,242,270
050,01,021,"Alabama","Chilton County",2,69,475,216,259
050,01,021,"Alabama","Chilton County",2,70,438,203,235
050,01,021,"Alabama","Chilton County",2,71,440,212,228
050,01,021,"Alabama","Chilton County",2,72,420,209,211
050,01,021,"Alabama","Chilton County",2,73,439,199,240
050,01,021,"Alabama","Chilton County",2,74,322,137,185
050,01,021,"Alabama","Chilton County",2,75,310,139,171
050,01,021,"Alabama","Chilton County",2,76,300,145,155
050,01,021,"Alabama","Chilton County",2,77,306,147,159
050,01,021,"Alabama","Chilton County",2,78,250,122,128
050,01,021,"Alabama","Chilton County",2,79,223,103,120
050,01,021,"Alabama","Chilton County",2,80,214,90,124
050,01,021,"Alabama","Chilton County",2,81,194,80,114
050,01,021,"Alabama","Chilton County",2,82,169,65,104
050,01,021,"Alabama","Chilton County",2,83,138,61,77
050,01,021,"Alabama","Chilton County",2,84,122,54,68
050,01,021,"Alabama","Chilton County",2,85,706,274,432
050,01,021,"Alabama","Chilton County",3,0,533,286,247
050,01,021,"Alabama","Chilton County",3,1,541,285,256
050,01,021,"Alabama","Chilton County",3,2,538,287,251
050,01,021,"Alabama","Chilton County",3,3,562,292,270
050,01,021,"Alabama","Chilton County",3,4,571,296,275
050,01,021,"Alabama","Chilton County",3,5,604,289,315
050,01,021,"Alabama","Chilton County",3,6,566,281,285
050,01,021,"Alabama","Chilton County",3,7,607,308,299
050,01,021,"Alabama","Chilton County",3,8,570,282,288
050,01,021,"Alabama","Chilton County",3,9,591,285,306
050,01,021,"Alabama","Chilton County",3,10,625,297,328
050,01,021,"Alabama","Chilton County",3,11,669,320,349
050,01,021,"Alabama","Chilton County",3,12,677,328,349
050,01,021,"Alabama","Chilton County",3,13,675,330,345
050,01,021,"Alabama","Chilton County",3,14,652,314,338
050,01,021,"Alabama","Chilton County",3,15,626,318,308
050,01,021,"Alabama","Chilton County",3,16,637,330,307
050,01,021,"Alabama","Chilton County",3,17,661,335,326
050,01,021,"Alabama","Chilton County",3,18,577,289,288
050,01,021,"Alabama","Chilton County",3,19,472,241,231
050,01,021,"Alabama","Chilton County",3,20,506,263,243
050,01,021,"Alabama","Chilton County",3,21,504,267,237
050,01,021,"Alabama","Chilton County",3,22,524,268,256
050,01,021,"Alabama","Chilton County",3,23,532,289,243
050,01,021,"Alabama","Chilton County",3,24,553,284,269
050,01,021,"Alabama","Chilton County",3,25,556,276,280
050,01,021,"Alabama","Chilton County",3,26,549,261,288
050,01,021,"Alabama","Chilton County",3,27,554,257,297
050,01,021,"Alabama","Chilton County",3,28,589,299,290
050,01,021,"Alabama","Chilton County",3,29,575,288,287
050,01,021,"Alabama","Chilton County",3,30,601,303,298
050,01,021,"Alabama","Chilton County",3,31,596,297,299
050,01,021,"Alabama","Chilton County",3,32,542,265,277
050,01,021,"Alabama","Chilton County",3,33,526,272,254
050,01,021,"Alabama","Chilton County",3,34,516,261,255
050,01,021,"Alabama","Chilton County",3,35,537,272,265
050,01,021,"Alabama","Chilton County",3,36,559,272,287
050,01,021,"Alabama","Chilton County",3,37,514,259,255
050,01,021,"Alabama","Chilton County",3,38,548,274,274
050,01,021,"Alabama","Chilton County",3,39,525,263,262
050,01,021,"Alabama","Chilton County",3,40,564,280,284
050,01,021,"Alabama","Chilton County",3,41,583,282,301
050,01,021,"Alabama","Chilton County",3,42,558,259,299
050,01,021,"Alabama","Chilton County",3,43,568,264,304
050,01,021,"Alabama","Chilton County",3,44,602,285,317
050,01,021,"Alabama","Chilton County",3,45,548,280,268
050,01,021,"Alabama","Chilton County",3,46,562,272,290
050,01,021,"Alabama","Chilton County",3,47,549,279,270
050,01,021,"Alabama","Chilton County",3,48,552,294,258
050,01,021,"Alabama","Chilton County",3,49,598,314,284
050,01,021,"Alabama","Chilton County",3,50,625,327,298
050,01,021,"Alabama","Chilton County",3,51,596,326,270
050,01,021,"Alabama","Chilton County",3,52,597,329,268
050,01,021,"Alabama","Chilton County",3,53,582,298,284
050,01,021,"Alabama","Chilton County",3,54,576,282,294
050,01,021,"Alabama","Chilton County",3,55,581,281,300
050,01,021,"Alabama","Chilton County",3,56,613,307,306
050,01,021,"Alabama","Chilton County",3,57,629,323,306
050,01,021,"Alabama","Chilton County",3,58,595,292,303
050,01,021,"Alabama","Chilton County",3,59,621,300,321
050,01,021,"Alabama","Chilton County",3,60,629,319,310
050,01,021,"Alabama","Chilton County",3,61,598,305,293
050,01,021,"Alabama","Chilton County",3,62,590,300,290
050,01,021,"Alabama","Chilton County",3,63,592,287,305
050,01,021,"Alabama","Chilton County",3,64,575,268,307
050,01,021,"Alabama","Chilton County",3,65,557,250,307
050,01,021,"Alabama","Chilton County",3,66,529,247,282
050,01,021,"Alabama","Chilton County",3,67,523,251,272
050,01,021,"Alabama","Chilton County",3,68,500,246,254
050,01,021,"Alabama","Chilton County",3,69,493,232,261
050,01,021,"Alabama","Chilton County",3,70,457,206,251
050,01,021,"Alabama","Chilton County",3,71,423,196,227
050,01,021,"Alabama","Chilton County",3,72,435,209,226
050,01,021,"Alabama","Chilton County",3,73,400,194,206
050,01,021,"Alabama","Chilton County",3,74,430,193,237
050,01,021,"Alabama","Chilton County",3,75,302,128,174
050,01,021,"Alabama","Chilton County",3,76,303,137,166
050,01,021,"Alabama","Chilton County",3,77,292,139,153
050,01,021,"Alabama","Chilton County",3,78,286,139,147
050,01,021,"Alabama","Chilton County",3,79,232,109,123
050,01,021,"Alabama","Chilton County",3,80,218,94,124
050,01,021,"Alabama","Chilton County",3,81,198,80,118
050,01,021,"Alabama","Chilton County",3,82,176,69,107
050,01,021,"Alabama","Chilton County",3,83,162,59,103
050,01,021,"Alabama","Chilton County",3,84,124,55,69
050,01,021,"Alabama","Chilton County",3,85,676,258,418
050,01,021,"Alabama","Chilton County",4,0,538,289,249
050,01,021,"Alabama","Chilton County",4,1,547,294,253
050,01,021,"Alabama","Chilton County",4,2,580,305,275
050,01,021,"Alabama","Chilton County",4,3,539,278,261
050,01,021,"Alabama","Chilton County",4,4,602,302,300
050,01,021,"Alabama","Chilton County",4,5,571,304,267
050,01,021,"Alabama","Chilton County",4,6,621,294,327
050,01,021,"Alabama","Chilton County",4,7,575,270,305
050,01,021,"Alabama","Chilton County",4,8,596,294,302
050,01,021,"Alabama","Chilton County",4,9,590,294,296
050,01,021,"Alabama","Chilton County",4,10,597,289,308
050,01,021,"Alabama","Chilton County",4,11,642,305,337
050,01,021,"Alabama","Chilton County",4,12,697,331,366
050,01,021,"Alabama","Chilton County",4,13,692,328,364
050,01,021,"Alabama","Chilton County",4,14,697,343,354
050,01,021,"Alabama","Chilton County",4,15,657,324,333
050,01,021,"Alabama","Chilton County",4,16,632,319,313
050,01,021,"Alabama","Chilton County",4,17,636,329,307
050,01,021,"Alabama","Chilton County",4,18,558,291,267
050,01,021,"Alabama","Chilton County",4,19,462,234,228
050,01,021,"Alabama","Chilton County",4,20,495,253,242
050,01,021,"Alabama","Chilton County",4,21,540,281,259
050,01,021,"Alabama","Chilton County",4,22,560,287,273
050,01,021,"Alabama","Chilton County",4,23,601,296,305
050,01,021,"Alabama","Chilton County",4,24,540,293,247
050,01,021,"Alabama","Chilton County",4,25,559,281,278
050,01,021,"Alabama","Chilton County",4,26,571,277,294
050,01,021,"Alabama","Chilton County",4,27,555,267,288
050,01,021,"Alabama","Chilton County",4,28,565,261,304
050,01,021,"Alabama","Chilton County",4,29,602,313,289
050,01,021,"Alabama","Chilton County",4,30,570,296,274
050,01,021,"Alabama","Chilton County",4,31,609,307,302
050,01,021,"Alabama","Chilton County",4,32,601,292,309
050,01,021,"Alabama","Chilton County",4,33,550,271,279
050,01,021,"Alabama","Chilton County",4,34,559,278,281
050,01,021,"Alabama","Chilton County",4,35,539,268,271
050,01,021,"Alabama","Chilton County",4,36,547,274,273
050,01,021,"Alabama","Chilton County",4,37,565,273,292
050,01,021,"Alabama","Chilton County",4,38,534,274,260
050,01,021,"Alabama","Chilton County",4,39,560,277,283
050,01,021,"Alabama","Chilton County",4,40,547,278,269
050,01,021,"Alabama","Chilton County",4,41,568,285,283
050,01,021,"Alabama","Chilton County",4,42,582,279,303
050,01,021,"Alabama","Chilton County",4,43,552,270,282
050,01,021,"Alabama","Chilton County",4,44,569,259,310
050,01,021,"Alabama","Chilton County",4,45,607,286,321
050,01,021,"Alabama","Chilton County",4,46,553,284,269
050,01,021,"Alabama","Chilton County",4,47,569,270,299
050,01,021,"Alabama","Chilton County",4,48,560,285,275
050,01,021,"Alabama","Chilton County",4,49,546,285,261
050,01,021,"Alabama","Chilton County",4,50,602,316,286
050,01,021,"Alabama","Chilton County",4,51,640,334,306
050,01,021,"Alabama","Chilton County",4,52,601,329,272
050,01,021,"Alabama","Chilton County",4,53,610,337,273
050,01,021,"Alabama","Chilton County",4,54,577,295,282
050,01,021,"Alabama","Chilton County",4,55,579,282,297
050,01,021,"Alabama","Chilton County",4,56,576,279,297
050,01,021,"Alabama","Chilton County",4,57,607,306,301
050,01,021,"Alabama","Chilton County",4,58,633,327,306
050,01,021,"Alabama","Chilton County",4,59,606,298,308
050,01,021,"Alabama","Chilton County",4,60,615,293,322
050,01,021,"Alabama","Chilton County",4,61,625,311,314
050,01,021,"Alabama","Chilton County",4,62,591,303,288
050,01,021,"Alabama","Chilton County",4,63,580,294,286
050,01,021,"Alabama","Chilton County",4,64,579,278,301
050,01,021,"Alabama","Chilton County",4,65,553,254,299
050,01,021,"Alabama","Chilton County",4,66,562,257,305
050,01,021,"Alabama","Chilton County",4,67,515,238,277
050,01,021,"Alabama","Chilton County",4,68,507,238,269
050,01,021,"Alabama","Chilton County",4,69,493,242,251
050,01,021,"Alabama","Chilton County",4,70,476,219,257
050,01,021,"Alabama","Chilton County",4,71,452,203,249
050,01,021,"Alabama","Chilton County",4,72,418,189,229
050,01,021,"Alabama","Chilton County",4,73,422,202,220
050,01,021,"Alabama","Chilton County",4,74,386,187,199
050,01,021,"Alabama","Chilton County",4,75,411,181,230
050,01,021,"Alabama","Chilton County",4,76,292,121,171
050,01,021,"Alabama","Chilton County",4,77,291,131,160
050,01,021,"Alabama","Chilton County",4,78,271,124,147
050,01,021,"Alabama","Chilton County",4,79,276,130,146
050,01,021,"Alabama","Chilton County",4,80,221,99,122
050,01,021,"Alabama","Chilton County",4,81,200,87,113
050,01,021,"Alabama","Chilton County",4,82,177,70,107
050,01,021,"Alabama","Chilton County",4,83,172,61,111
050,01,021,"Alabama","Chilton County",4,84,144,52,92
050,01,021,"Alabama","Chilton County",4,85,684,269,415
050,01,021,"Alabama","Chilton County",5,0,548,293,255
050,01,021,"Alabama","Chilton County",5,1,553,291,262
050,01,021,"Alabama","Chilton County",5,2,589,312,277
050,01,021,"Alabama","Chilton County",5,3,598,303,295
050,01,021,"Alabama","Chilton County",5,4,558,291,267
050,01,021,"Alabama","Chilton County",5,5,602,305,297
050,01,021,"Alabama","Chilton County",5,6,569,300,269
050,01,021,"Alabama","Chilton County",5,7,653,306,347
050,01,021,"Alabama","Chilton County",5,8,600,285,315
050,01,021,"Alabama","Chilton County",5,9,627,308,319
050,01,021,"Alabama","Chilton County",5,10,597,287,310
050,01,021,"Alabama","Chilton County",5,11,615,297,318
050,01,021,"Alabama","Chilton County",5,12,637,304,333
050,01,021,"Alabama","Chilton County",5,13,709,339,370
050,01,021,"Alabama","Chilton County",5,14,705,342,363
050,01,021,"Alabama","Chilton County",5,15,704,347,357
050,01,021,"Alabama","Chilton County",5,16,660,321,339
050,01,021,"Alabama","Chilton County",5,17,638,315,323
050,01,021,"Alabama","Chilton County",5,18,545,296,249
050,01,021,"Alabama","Chilton County",5,19,467,246,221
050,01,021,"Alabama","Chilton County",5,20,508,257,251
050,01,021,"Alabama","Chilton County",5,21,532,269,263
050,01,021,"Alabama","Chilton County",5,22,592,303,289
050,01,021,"Alabama","Chilton County",5,23,613,316,297
050,01,021,"Alabama","Chilton County",5,24,602,307,295
050,01,021,"Alabama","Chilton County",5,25,540,293,247
050,01,021,"Alabama","Chilton County",5,26,559,290,269
050,01,021,"Alabama","Chilton County",5,27,581,271,310
050,01,021,"Alabama","Chilton County",5,28,559,267,292
050,01,021,"Alabama","Chilton County",5,29,589,277,312
050,01,021,"Alabama","Chilton County",5,30,614,323,291
050,01,021,"Alabama","Chilton County",5,31,592,305,287
050,01,021,"Alabama","Chilton County",5,32,596,289,307
050,01,021,"Alabama","Chilton County",5,33,628,316,312
050,01,021,"Alabama","Chilton County",5,34,587,277,310
050,01,021,"Alabama","Chilton County",5,35,575,293,282
050,01,021,"Alabama","Chilton County",5,36,542,267,275
050,01,021,"Alabama","Chilton County",5,37,562,281,281
050,01,021,"Alabama","Chilton County",5,38,569,283,286
050,01,021,"Alabama","Chilton County",5,39,530,274,256
050,01,021,"Alabama","Chilton County",5,40,572,279,293
050,01,021,"Alabama","Chilton County",5,41,561,289,272
050,01,021,"Alabama","Chilton County",5,42,564,283,281
050,01,021,"Alabama","Chilton County",5,43,578,277,301
050,01,021,"Alabama","Chilton County",5,44,568,276,292
050,01,021,"Alabama","Chilton County",5,45,571,262,309
050,01,021,"Alabama","Chilton County",5,46,598,286,312
050,01,021,"Alabama","Chilton County",5,47,556,284,272
050,01,021,"Alabama","Chilton County",5,48,570,271,299
050,01,021,"Alabama","Chilton County",5,49,562,285,277
050,01,021,"Alabama","Chilton County",5,50,533,274,259
050,01,021,"Alabama","Chilton County",5,51,608,316,292
050,01,021,"Alabama","Chilton County",5,52,641,332,309
050,01,021,"Alabama","Chilton County",5,53,608,328,280
050,01,021,"Alabama","Chilton County",5,54,608,332,276
050,01,021,"Alabama","Chilton County",5,55,577,292,285
050,01,021,"Alabama","Chilton County",5,56,582,284,298
050,01,021,"Alabama","Chilton County",5,57,573,277,296
050,01,021,"Alabama","Chilton County",5,58,596,297,299
050,01,021,"Alabama","Chilton County",5,59,639,334,305
050,01,021,"Alabama","Chilton County",5,60,612,302,310
050,01,021,"Alabama","Chilton County",5,61,607,293,314
050,01,021,"Alabama","Chilton County",5,62,612,302,310
050,01,021,"Alabama","Chilton County",5,63,577,297,280
050,01,021,"Alabama","Chilton County",5,64,562,277,285
050,01,021,"Alabama","Chilton County",5,65,554,264,290
050,01,021,"Alabama","Chilton County",5,66,563,256,307
050,01,021,"Alabama","Chilton County",5,67,558,255,303
050,01,021,"Alabama","Chilton County",5,68,510,233,277
050,01,021,"Alabama","Chilton County",5,69,503,230,273
050,01,021,"Alabama","Chilton County",5,70,481,233,248
050,01,021,"Alabama","Chilton County",5,71,470,213,257
050,01,021,"Alabama","Chilton County",5,72,445,197,248
050,01,021,"Alabama","Chilton County",5,73,400,181,219
050,01,021,"Alabama","Chilton County",5,74,410,199,211
050,01,021,"Alabama","Chilton County",5,75,362,173,189
050,01,021,"Alabama","Chilton County",5,76,411,179,232
050,01,021,"Alabama","Chilton County",5,77,274,113,161
050,01,021,"Alabama","Chilton County",5,78,272,119,153
050,01,021,"Alabama","Chilton County",5,79,253,114,139
050,01,021,"Alabama","Chilton County",5,80,265,121,144
050,01,021,"Alabama","Chilton County",5,81,203,96,107
050,01,021,"Alabama","Chilton County",5,82,178,76,102
050,01,021,"Alabama","Chilton County",5,83,167,63,104
050,01,021,"Alabama","Chilton County",5,84,155,55,100
050,01,021,"Alabama","Chilton County",5,85,718,274,444
050,01,023,"Alabama","Choctaw County",1,0,139,70,69
050,01,023,"Alabama","Choctaw County",1,1,136,64,72
050,01,023,"Alabama","Choctaw County",1,2,132,62,70
050,01,023,"Alabama","Choctaw County",1,3,116,54,62
050,01,023,"Alabama","Choctaw County",1,4,141,79,62
050,01,023,"Alabama","Choctaw County",1,5,151,74,77
050,01,023,"Alabama","Choctaw County",1,6,137,63,74
050,01,023,"Alabama","Choctaw County",1,7,134,58,76
050,01,023,"Alabama","Choctaw County",1,8,115,58,57
050,01,023,"Alabama","Choctaw County",1,9,126,69,57
050,01,023,"Alabama","Choctaw County",1,10,133,69,64
050,01,023,"Alabama","Choctaw County",1,11,148,79,69
050,01,023,"Alabama","Choctaw County",1,12,143,76,67
050,01,023,"Alabama","Choctaw County",1,13,152,85,67
050,01,023,"Alabama","Choctaw County",1,14,162,88,74
050,01,023,"Alabama","Choctaw County",1,15,163,91,72
050,01,023,"Alabama","Choctaw County",1,16,160,94,66
050,01,023,"Alabama","Choctaw County",1,17,161,87,74
050,01,023,"Alabama","Choctaw County",1,18,147,80,67
050,01,023,"Alabama","Choctaw County",1,19,122,63,59
050,01,023,"Alabama","Choctaw County",1,20,118,51,67
050,01,023,"Alabama","Choctaw County",1,21,119,49,70
050,01,023,"Alabama","Choctaw County",1,22,123,56,67
050,01,023,"Alabama","Choctaw County",1,23,133,62,71
050,01,023,"Alabama","Choctaw County",1,24,140,76,64
050,01,023,"Alabama","Choctaw County",1,25,127,64,63
050,01,023,"Alabama","Choctaw County",1,26,152,83,69
050,01,023,"Alabama","Choctaw County",1,27,153,75,78
050,01,023,"Alabama","Choctaw County",1,28,130,65,65
050,01,023,"Alabama","Choctaw County",1,29,148,72,76
050,01,023,"Alabama","Choctaw County",1,30,131,62,69
050,01,023,"Alabama","Choctaw County",1,31,127,56,71
050,01,023,"Alabama","Choctaw County",1,32,111,55,56
050,01,023,"Alabama","Choctaw County",1,33,109,56,53
050,01,023,"Alabama","Choctaw County",1,34,123,54,69
050,01,023,"Alabama","Choctaw County",1,35,111,52,59
050,01,023,"Alabama","Choctaw County",1,36,127,60,67
050,01,023,"Alabama","Choctaw County",1,37,132,61,71
050,01,023,"Alabama","Choctaw County",1,38,149,70,79
050,01,023,"Alabama","Choctaw County",1,39,137,61,76
050,01,023,"Alabama","Choctaw County",1,40,138,56,82
050,01,023,"Alabama","Choctaw County",1,41,146,70,76
050,01,023,"Alabama","Choctaw County",1,42,120,53,67
050,01,023,"Alabama","Choctaw County",1,43,125,54,71
050,01,023,"Alabama","Choctaw County",1,44,156,74,82
050,01,023,"Alabama","Choctaw County",1,45,157,79,78
050,01,023,"Alabama","Choctaw County",1,46,145,69,76
050,01,023,"Alabama","Choctaw County",1,47,143,70,73
050,01,023,"Alabama","Choctaw County",1,48,160,73,87
050,01,023,"Alabama","Choctaw County",1,49,167,76,91
050,01,023,"Alabama","Choctaw County",1,50,160,78,82
050,01,023,"Alabama","Choctaw County",1,51,156,77,79
050,01,023,"Alabama","Choctaw County",1,52,158,75,83
050,01,023,"Alabama","Choctaw County",1,53,175,83,92
050,01,023,"Alabama","Choctaw County",1,54,192,94,98
050,01,023,"Alabama","Choctaw County",1,55,187,88,99
050,01,023,"Alabama","Choctaw County",1,56,193,93,100
050,01,023,"Alabama","Choctaw County",1,57,204,100,104
050,01,023,"Alabama","Choctaw County",1,58,213,110,103
050,01,023,"Alabama","Choctaw County",1,59,223,110,113
050,01,023,"Alabama","Choctaw County",1,60,207,102,105
050,01,023,"Alabama","Choctaw County",1,61,198,87,111
050,01,023,"Alabama","Choctaw County",1,62,199,94,105
050,01,023,"Alabama","Choctaw County",1,63,207,94,113
050,01,023,"Alabama","Choctaw County",1,64,198,94,104
050,01,023,"Alabama","Choctaw County",1,65,177,86,91
050,01,023,"Alabama","Choctaw County",1,66,169,70,99
050,01,023,"Alabama","Choctaw County",1,67,158,67,91
050,01,023,"Alabama","Choctaw County",1,68,187,78,109
050,01,023,"Alabama","Choctaw County",1,69,184,85,99
050,01,023,"Alabama","Choctaw County",1,70,166,73,93
050,01,023,"Alabama","Choctaw County",1,71,158,74,84
050,01,023,"Alabama","Choctaw County",1,72,159,68,91
050,01,023,"Alabama","Choctaw County",1,73,159,70,89
050,01,023,"Alabama","Choctaw County",1,74,133,61,72
050,01,023,"Alabama","Choctaw County",1,75,156,71,85
050,01,023,"Alabama","Choctaw County",1,76,129,55,74
050,01,023,"Alabama","Choctaw County",1,77,114,50,64
050,01,023,"Alabama","Choctaw County",1,78,109,53,56
050,01,023,"Alabama","Choctaw County",1,79,97,50,47
050,01,023,"Alabama","Choctaw County",1,80,88,49,39
050,01,023,"Alabama","Choctaw County",1,81,78,31,47
050,01,023,"Alabama","Choctaw County",1,82,71,28,43
050,01,023,"Alabama","Choctaw County",1,83,61,24,37
050,01,023,"Alabama","Choctaw County",1,84,57,25,32
050,01,023,"Alabama","Choctaw County",1,85,314,112,202
050,01,023,"Alabama","Choctaw County",2,0,137,70,67
050,01,023,"Alabama","Choctaw County",2,1,137,65,72
050,01,023,"Alabama","Choctaw County",2,2,133,62,71
050,01,023,"Alabama","Choctaw County",2,3,120,57,63
050,01,023,"Alabama","Choctaw County",2,4,137,74,63
050,01,023,"Alabama","Choctaw County",2,5,149,76,73
050,01,023,"Alabama","Choctaw County",2,6,140,64,76
050,01,023,"Alabama","Choctaw County",2,7,134,60,74
050,01,023,"Alabama","Choctaw County",2,8,120,58,62
050,01,023,"Alabama","Choctaw County",2,9,123,67,56
050,01,023,"Alabama","Choctaw County",2,10,130,68,62
050,01,023,"Alabama","Choctaw County",2,11,144,79,65
050,01,023,"Alabama","Choctaw County",2,12,147,78,69
050,01,023,"Alabama","Choctaw County",2,13,149,82,67
050,01,023,"Alabama","Choctaw County",2,14,158,87,71
050,01,023,"Alabama","Choctaw County",2,15,162,89,73
050,01,023,"Alabama","Choctaw County",2,16,160,93,67
050,01,023,"Alabama","Choctaw County",2,17,160,88,72
050,01,023,"Alabama","Choctaw County",2,18,144,79,65
050,01,023,"Alabama","Choctaw County",2,19,122,63,59
050,01,023,"Alabama","Choctaw County",2,20,120,53,67
050,01,023,"Alabama","Choctaw County",2,21,117,49,68
050,01,023,"Alabama","Choctaw County",2,22,123,55,68
050,01,023,"Alabama","Choctaw County",2,23,130,63,67
050,01,023,"Alabama","Choctaw County",2,24,139,73,66
050,01,023,"Alabama","Choctaw County",2,25,132,68,64
050,01,023,"Alabama","Choctaw County",2,26,144,78,66
050,01,023,"Alabama","Choctaw County",2,27,151,76,75
050,01,023,"Alabama","Choctaw County",2,28,136,67,69
050,01,023,"Alabama","Choctaw County",2,29,143,69,74
050,01,023,"Alabama","Choctaw County",2,30,134,64,70
050,01,023,"Alabama","Choctaw County",2,31,126,57,69
050,01,023,"Alabama","Choctaw County",2,32,115,56,59
050,01,023,"Alabama","Choctaw County",2,33,109,55,54
050,01,023,"Alabama","Choctaw County",2,34,119,54,65
050,01,023,"Alabama","Choctaw County",2,35,115,53,62
050,01,023,"Alabama","Choctaw County",2,36,120,56,64
050,01,023,"Alabama","Choctaw County",2,37,132,61,71
050,01,023,"Alabama","Choctaw County",2,38,146,69,77
050,01,023,"Alabama","Choctaw County",2,39,139,63,76
050,01,023,"Alabama","Choctaw County",2,40,138,57,81
050,01,023,"Alabama","Choctaw County",2,41,143,66,77
050,01,023,"Alabama","Choctaw County",2,42,124,56,68
050,01,023,"Alabama","Choctaw County",2,43,125,54,71
050,01,023,"Alabama","Choctaw County",2,44,147,68,79
050,01,023,"Alabama","Choctaw County",2,45,157,77,80
050,01,023,"Alabama","Choctaw County",2,46,147,71,76
050,01,023,"Alabama","Choctaw County",2,47,143,70,73
050,01,023,"Alabama","Choctaw County",2,48,157,74,83
050,01,023,"Alabama","Choctaw County",2,49,166,76,90
050,01,023,"Alabama","Choctaw County",2,50,162,79,83
050,01,023,"Alabama","Choctaw County",2,51,156,77,79
050,01,023,"Alabama","Choctaw County",2,52,157,75,82
050,01,023,"Alabama","Choctaw County",2,53,169,80,89
050,01,023,"Alabama","Choctaw County",2,54,187,91,96
050,01,023,"Alabama","Choctaw County",2,55,189,91,98
050,01,023,"Alabama","Choctaw County",2,56,191,92,99
050,01,023,"Alabama","Choctaw County",2,57,202,99,103
050,01,023,"Alabama","Choctaw County",2,58,210,107,103
050,01,023,"Alabama","Choctaw County",2,59,220,109,111
050,01,023,"Alabama","Choctaw County",2,60,210,103,107
050,01,023,"Alabama","Choctaw County",2,61,199,89,110
050,01,023,"Alabama","Choctaw County",2,62,198,91,107
050,01,023,"Alabama","Choctaw County",2,63,205,94,111
050,01,023,"Alabama","Choctaw County",2,64,198,92,106
050,01,023,"Alabama","Choctaw County",2,65,182,87,95
050,01,023,"Alabama","Choctaw County",2,66,169,73,96
050,01,023,"Alabama","Choctaw County",2,67,159,65,94
050,01,023,"Alabama","Choctaw County",2,68,176,74,102
050,01,023,"Alabama","Choctaw County",2,69,186,83,103
050,01,023,"Alabama","Choctaw County",2,70,170,76,94
050,01,023,"Alabama","Choctaw County",2,71,159,74,85
050,01,023,"Alabama","Choctaw County",2,72,157,69,88
050,01,023,"Alabama","Choctaw County",2,73,166,73,93
050,01,023,"Alabama","Choctaw County",2,74,131,59,72
050,01,023,"Alabama","Choctaw County",2,75,151,69,82
050,01,023,"Alabama","Choctaw County",2,76,134,58,76
050,01,023,"Alabama","Choctaw County",2,77,117,50,67
050,01,023,"Alabama","Choctaw County",2,78,108,52,56
050,01,023,"Alabama","Choctaw County",2,79,99,52,47
050,01,023,"Alabama","Choctaw County",2,80,91,50,41
050,01,023,"Alabama","Choctaw County",2,81,77,34,43
050,01,023,"Alabama","Choctaw County",2,82,72,28,44
050,01,023,"Alabama","Choctaw County",2,83,62,23,39
050,01,023,"Alabama","Choctaw County",2,84,55,22,33
050,01,023,"Alabama","Choctaw County",2,85,309,110,199
050,01,023,"Alabama","Choctaw County",3,0,130,76,54
050,01,023,"Alabama","Choctaw County",3,1,149,78,71
050,01,023,"Alabama","Choctaw County",3,2,138,69,69
050,01,023,"Alabama","Choctaw County",3,3,137,61,76
050,01,023,"Alabama","Choctaw County",3,4,126,60,66
050,01,023,"Alabama","Choctaw County",3,5,134,71,63
050,01,023,"Alabama","Choctaw County",3,6,150,76,74
050,01,023,"Alabama","Choctaw County",3,7,135,64,71
050,01,023,"Alabama","Choctaw County",3,8,139,61,78
050,01,023,"Alabama","Choctaw County",3,9,125,58,67
050,01,023,"Alabama","Choctaw County",3,10,125,68,57
050,01,023,"Alabama","Choctaw County",3,11,129,67,62
050,01,023,"Alabama","Choctaw County",3,12,141,73,68
050,01,023,"Alabama","Choctaw County",3,13,140,75,65
050,01,023,"Alabama","Choctaw County",3,14,144,76,68
050,01,023,"Alabama","Choctaw County",3,15,153,87,66
050,01,023,"Alabama","Choctaw County",3,16,162,89,73
050,01,023,"Alabama","Choctaw County",3,17,160,94,66
050,01,023,"Alabama","Choctaw County",3,18,136,76,60
050,01,023,"Alabama","Choctaw County",3,19,119,65,54
050,01,023,"Alabama","Choctaw County",3,20,127,66,61
050,01,023,"Alabama","Choctaw County",3,21,121,53,68
050,01,023,"Alabama","Choctaw County",3,22,129,54,75
050,01,023,"Alabama","Choctaw County",3,23,127,58,69
050,01,023,"Alabama","Choctaw County",3,24,126,59,67
050,01,023,"Alabama","Choctaw County",3,25,139,69,70
050,01,023,"Alabama","Choctaw County",3,26,133,67,66
050,01,023,"Alabama","Choctaw County",3,27,140,77,63
050,01,023,"Alabama","Choctaw County",3,28,148,78,70
050,01,023,"Alabama","Choctaw County",3,29,134,66,68
050,01,023,"Alabama","Choctaw County",3,30,138,66,72
050,01,023,"Alabama","Choctaw County",3,31,131,62,69
050,01,023,"Alabama","Choctaw County",3,32,127,58,69
050,01,023,"Alabama","Choctaw County",3,33,110,52,58
050,01,023,"Alabama","Choctaw County",3,34,110,55,55
050,01,023,"Alabama","Choctaw County",3,35,119,55,64
050,01,023,"Alabama","Choctaw County",3,36,113,50,63
050,01,023,"Alabama","Choctaw County",3,37,116,52,64
050,01,023,"Alabama","Choctaw County",3,38,130,57,73
050,01,023,"Alabama","Choctaw County",3,39,141,65,76
050,01,023,"Alabama","Choctaw County",3,40,137,64,73
050,01,023,"Alabama","Choctaw County",3,41,137,58,79
050,01,023,"Alabama","Choctaw County",3,42,139,66,73
050,01,023,"Alabama","Choctaw County",3,43,121,57,64
050,01,023,"Alabama","Choctaw County",3,44,120,49,71
050,01,023,"Alabama","Choctaw County",3,45,148,72,76
050,01,023,"Alabama","Choctaw County",3,46,152,76,76
050,01,023,"Alabama","Choctaw County",3,47,146,70,76
050,01,023,"Alabama","Choctaw County",3,48,142,67,75
050,01,023,"Alabama","Choctaw County",3,49,159,74,85
050,01,023,"Alabama","Choctaw County",3,50,165,75,90
050,01,023,"Alabama","Choctaw County",3,51,163,80,83
050,01,023,"Alabama","Choctaw County",3,52,160,75,85
050,01,023,"Alabama","Choctaw County",3,53,162,77,85
050,01,023,"Alabama","Choctaw County",3,54,170,86,84
050,01,023,"Alabama","Choctaw County",3,55,193,92,101
050,01,023,"Alabama","Choctaw County",3,56,195,98,97
050,01,023,"Alabama","Choctaw County",3,57,190,91,99
050,01,023,"Alabama","Choctaw County",3,58,195,94,101
050,01,023,"Alabama","Choctaw County",3,59,209,106,103
050,01,023,"Alabama","Choctaw County",3,60,223,109,114
050,01,023,"Alabama","Choctaw County",3,61,214,104,110
050,01,023,"Alabama","Choctaw County",3,62,195,89,106
050,01,023,"Alabama","Choctaw County",3,63,194,90,104
050,01,023,"Alabama","Choctaw County",3,64,208,95,113
050,01,023,"Alabama","Choctaw County",3,65,202,93,109
050,01,023,"Alabama","Choctaw County",3,66,179,82,97
050,01,023,"Alabama","Choctaw County",3,67,168,73,95
050,01,023,"Alabama","Choctaw County",3,68,161,67,94
050,01,023,"Alabama","Choctaw County",3,69,170,70,100
050,01,023,"Alabama","Choctaw County",3,70,178,78,100
050,01,023,"Alabama","Choctaw County",3,71,167,75,92
050,01,023,"Alabama","Choctaw County",3,72,158,75,83
050,01,023,"Alabama","Choctaw County",3,73,146,60,86
050,01,023,"Alabama","Choctaw County",3,74,155,69,86
050,01,023,"Alabama","Choctaw County",3,75,122,55,67
050,01,023,"Alabama","Choctaw County",3,76,144,68,76
050,01,023,"Alabama","Choctaw County",3,77,123,52,71
050,01,023,"Alabama","Choctaw County",3,78,109,44,65
050,01,023,"Alabama","Choctaw County",3,79,101,50,51
050,01,023,"Alabama","Choctaw County",3,80,92,47,45
050,01,023,"Alabama","Choctaw County",3,81,83,45,38
050,01,023,"Alabama","Choctaw County",3,82,74,34,40
050,01,023,"Alabama","Choctaw County",3,83,71,26,45
050,01,023,"Alabama","Choctaw County",3,84,54,22,32
050,01,023,"Alabama","Choctaw County",3,85,323,113,210
050,01,023,"Alabama","Choctaw County",4,0,140,80,60
050,01,023,"Alabama","Choctaw County",4,1,130,71,59
050,01,023,"Alabama","Choctaw County",4,2,140,72,68
050,01,023,"Alabama","Choctaw County",4,3,134,65,69
050,01,023,"Alabama","Choctaw County",4,4,135,61,74
050,01,023,"Alabama","Choctaw County",4,5,132,66,66
050,01,023,"Alabama","Choctaw County",4,6,141,75,66
050,01,023,"Alabama","Choctaw County",4,7,156,77,79
050,01,023,"Alabama","Choctaw County",4,8,137,65,72
050,01,023,"Alabama","Choctaw County",4,9,135,62,73
050,01,023,"Alabama","Choctaw County",4,10,124,59,65
050,01,023,"Alabama","Choctaw County",4,11,123,66,57
050,01,023,"Alabama","Choctaw County",4,12,127,64,63
050,01,023,"Alabama","Choctaw County",4,13,141,73,68
050,01,023,"Alabama","Choctaw County",4,14,139,75,64
050,01,023,"Alabama","Choctaw County",4,15,146,79,67
050,01,023,"Alabama","Choctaw County",4,16,153,87,66
050,01,023,"Alabama","Choctaw County",4,17,161,89,72
050,01,023,"Alabama","Choctaw County",4,18,131,79,52
050,01,023,"Alabama","Choctaw County",4,19,110,65,45
050,01,023,"Alabama","Choctaw County",4,20,122,66,56
050,01,023,"Alabama","Choctaw County",4,21,130,69,61
050,01,023,"Alabama","Choctaw County",4,22,129,59,70
050,01,023,"Alabama","Choctaw County",4,23,125,55,70
050,01,023,"Alabama","Choctaw County",4,24,123,57,66
050,01,023,"Alabama","Choctaw County",4,25,113,54,59
050,01,023,"Alabama","Choctaw County",4,26,136,67,69
050,01,023,"Alabama","Choctaw County",4,27,130,62,68
050,01,023,"Alabama","Choctaw County",4,28,134,75,59
050,01,023,"Alabama","Choctaw County",4,29,156,77,79
050,01,023,"Alabama","Choctaw County",4,30,145,71,74
050,01,023,"Alabama","Choctaw County",4,31,132,61,71
050,01,023,"Alabama","Choctaw County",4,32,136,62,74
050,01,023,"Alabama","Choctaw County",4,33,128,52,76
050,01,023,"Alabama","Choctaw County",4,34,116,60,56
050,01,023,"Alabama","Choctaw County",4,35,113,52,61
050,01,023,"Alabama","Choctaw County",4,36,118,54,64
050,01,023,"Alabama","Choctaw County",4,37,120,53,67
050,01,023,"Alabama","Choctaw County",4,38,114,52,62
050,01,023,"Alabama","Choctaw County",4,39,132,59,73
050,01,023,"Alabama","Choctaw County",4,40,138,63,75
050,01,023,"Alabama","Choctaw County",4,41,130,59,71
050,01,023,"Alabama","Choctaw County",4,42,136,58,78
050,01,023,"Alabama","Choctaw County",4,43,133,62,71
050,01,023,"Alabama","Choctaw County",4,44,122,55,67
050,01,023,"Alabama","Choctaw County",4,45,120,51,69
050,01,023,"Alabama","Choctaw County",4,46,147,70,77
050,01,023,"Alabama","Choctaw County",4,47,150,76,74
050,01,023,"Alabama","Choctaw County",4,48,142,69,73
050,01,023,"Alabama","Choctaw County",4,49,145,69,76
050,01,023,"Alabama","Choctaw County",4,50,162,74,88
050,01,023,"Alabama","Choctaw County",4,51,167,73,94
050,01,023,"Alabama","Choctaw County",4,52,170,82,88
050,01,023,"Alabama","Choctaw County",4,53,159,73,86
050,01,023,"Alabama","Choctaw County",4,54,160,79,81
050,01,023,"Alabama","Choctaw County",4,55,166,83,83
050,01,023,"Alabama","Choctaw County",4,56,182,91,91
050,01,023,"Alabama","Choctaw County",4,57,198,100,98
050,01,023,"Alabama","Choctaw County",4,58,186,92,94
050,01,023,"Alabama","Choctaw County",4,59,192,93,99
050,01,023,"Alabama","Choctaw County",4,60,213,107,106
050,01,023,"Alabama","Choctaw County",4,61,215,106,109
050,01,023,"Alabama","Choctaw County",4,62,218,106,112
050,01,023,"Alabama","Choctaw County",4,63,194,92,102
050,01,023,"Alabama","Choctaw County",4,64,190,90,100
050,01,023,"Alabama","Choctaw County",4,65,206,94,112
050,01,023,"Alabama","Choctaw County",4,66,189,84,105
050,01,023,"Alabama","Choctaw County",4,67,176,81,95
050,01,023,"Alabama","Choctaw County",4,68,159,69,90
050,01,023,"Alabama","Choctaw County",4,69,156,63,93
050,01,023,"Alabama","Choctaw County",4,70,164,66,98
050,01,023,"Alabama","Choctaw County",4,71,175,76,99
050,01,023,"Alabama","Choctaw County",4,72,168,76,92
050,01,023,"Alabama","Choctaw County",4,73,149,67,82
050,01,023,"Alabama","Choctaw County",4,74,136,53,83
050,01,023,"Alabama","Choctaw County",4,75,146,66,80
050,01,023,"Alabama","Choctaw County",4,76,118,53,65
050,01,023,"Alabama","Choctaw County",4,77,136,65,71
050,01,023,"Alabama","Choctaw County",4,78,113,44,69
050,01,023,"Alabama","Choctaw County",4,79,105,42,63
050,01,023,"Alabama","Choctaw County",4,80,95,46,49
050,01,023,"Alabama","Choctaw County",4,81,85,42,43
050,01,023,"Alabama","Choctaw County",4,82,78,42,36
050,01,023,"Alabama","Choctaw County",4,83,70,28,42
050,01,023,"Alabama","Choctaw County",4,84,62,23,39
050,01,023,"Alabama","Choctaw County",4,85,323,114,209
050,01,023,"Alabama","Choctaw County",5,0,108,60,48
050,01,023,"Alabama","Choctaw County",5,1,138,76,62
050,01,023,"Alabama","Choctaw County",5,2,118,66,52
050,01,023,"Alabama","Choctaw County",5,3,152,83,69
050,01,023,"Alabama","Choctaw County",5,4,128,64,64
050,01,023,"Alabama","Choctaw County",5,5,123,63,60
050,01,023,"Alabama","Choctaw County",5,6,124,60,64
050,01,023,"Alabama","Choctaw County",5,7,143,78,65
050,01,023,"Alabama","Choctaw County",5,8,151,76,75
050,01,023,"Alabama","Choctaw County",5,9,135,63,72
050,01,023,"Alabama","Choctaw County",5,10,130,62,68
050,01,023,"Alabama","Choctaw County",5,11,126,58,68
050,01,023,"Alabama","Choctaw County",5,12,125,65,60
050,01,023,"Alabama","Choctaw County",5,13,133,65,68
050,01,023,"Alabama","Choctaw County",5,14,140,74,66
050,01,023,"Alabama","Choctaw County",5,15,143,80,63
050,01,023,"Alabama","Choctaw County",5,16,144,78,66
050,01,023,"Alabama","Choctaw County",5,17,152,87,65
050,01,023,"Alabama","Choctaw County",5,18,134,76,58
050,01,023,"Alabama","Choctaw County",5,19,108,62,46
050,01,023,"Alabama","Choctaw County",5,20,116,68,48
050,01,023,"Alabama","Choctaw County",5,21,129,66,63
050,01,023,"Alabama","Choctaw County",5,22,145,72,73
050,01,023,"Alabama","Choctaw County",5,23,123,56,67
050,01,023,"Alabama","Choctaw County",5,24,120,50,70
050,01,023,"Alabama","Choctaw County",5,25,121,57,64
050,01,023,"Alabama","Choctaw County",5,26,109,57,52
050,01,023,"Alabama","Choctaw County",5,27,141,72,69
050,01,023,"Alabama","Choctaw County",5,28,131,64,67
050,01,023,"Alabama","Choctaw County",5,29,129,72,57
050,01,023,"Alabama","Choctaw County",5,30,157,78,79
050,01,023,"Alabama","Choctaw County",5,31,144,68,76
050,01,023,"Alabama","Choctaw County",5,32,123,59,64
050,01,023,"Alabama","Choctaw County",5,33,132,60,72
050,01,023,"Alabama","Choctaw County",5,34,128,55,73
050,01,023,"Alabama","Choctaw County",5,35,119,59,60
050,01,023,"Alabama","Choctaw County",5,36,119,53,66
050,01,023,"Alabama","Choctaw County",5,37,115,54,61
050,01,023,"Alabama","Choctaw County",5,38,120,52,68
050,01,023,"Alabama","Choctaw County",5,39,115,52,63
050,01,023,"Alabama","Choctaw County",5,40,129,60,69
050,01,023,"Alabama","Choctaw County",5,41,135,63,72
050,01,023,"Alabama","Choctaw County",5,42,128,59,69
050,01,023,"Alabama","Choctaw County",5,43,135,58,77
050,01,023,"Alabama","Choctaw County",5,44,133,63,70
050,01,023,"Alabama","Choctaw County",5,45,118,51,67
050,01,023,"Alabama","Choctaw County",5,46,121,52,69
050,01,023,"Alabama","Choctaw County",5,47,145,70,75
050,01,023,"Alabama","Choctaw County",5,48,148,75,73
050,01,023,"Alabama","Choctaw County",5,49,147,69,78
050,01,023,"Alabama","Choctaw County",5,50,136,65,71
050,01,023,"Alabama","Choctaw County",5,51,159,72,87
050,01,023,"Alabama","Choctaw County",5,52,162,71,91
050,01,023,"Alabama","Choctaw County",5,53,171,87,84
050,01,023,"Alabama","Choctaw County",5,54,162,76,86
050,01,023,"Alabama","Choctaw County",5,55,153,73,80
050,01,023,"Alabama","Choctaw County",5,56,163,82,81
050,01,023,"Alabama","Choctaw County",5,57,183,91,92
050,01,023,"Alabama","Choctaw County",5,58,190,97,93
050,01,023,"Alabama","Choctaw County",5,59,183,85,98
050,01,023,"Alabama","Choctaw County",5,60,187,92,95
050,01,023,"Alabama","Choctaw County",5,61,208,103,105
050,01,023,"Alabama","Choctaw County",5,62,217,106,111
050,01,023,"Alabama","Choctaw County",5,63,215,106,109
050,01,023,"Alabama","Choctaw County",5,64,193,92,101
050,01,023,"Alabama","Choctaw County",5,65,191,92,99
050,01,023,"Alabama","Choctaw County",5,66,194,84,110
050,01,023,"Alabama","Choctaw County",5,67,188,85,103
050,01,023,"Alabama","Choctaw County",5,68,172,78,94
050,01,023,"Alabama","Choctaw County",5,69,152,63,89
050,01,023,"Alabama","Choctaw County",5,70,150,61,89
050,01,023,"Alabama","Choctaw County",5,71,161,65,96
050,01,023,"Alabama","Choctaw County",5,72,173,76,97
050,01,023,"Alabama","Choctaw County",5,73,161,69,92
050,01,023,"Alabama","Choctaw County",5,74,141,61,80
050,01,023,"Alabama","Choctaw County",5,75,129,51,78
050,01,023,"Alabama","Choctaw County",5,76,140,62,78
050,01,023,"Alabama","Choctaw County",5,77,111,50,61
050,01,023,"Alabama","Choctaw County",5,78,129,59,70
050,01,023,"Alabama","Choctaw County",5,79,106,41,65
050,01,023,"Alabama","Choctaw County",5,80,98,37,61
050,01,023,"Alabama","Choctaw County",5,81,87,40,47
050,01,023,"Alabama","Choctaw County",5,82,77,39,38
050,01,023,"Alabama","Choctaw County",5,83,75,37,38
050,01,023,"Alabama","Choctaw County",5,84,61,25,36
050,01,023,"Alabama","Choctaw County",5,85,344,122,222
050,01,025,"Alabama","Clarke County",1,0,257,133,124
050,01,025,"Alabama","Clarke County",1,1,252,129,123
050,01,025,"Alabama","Clarke County",1,2,264,125,139
050,01,025,"Alabama","Clarke County",1,3,249,122,127
050,01,025,"Alabama","Clarke County",1,4,259,128,131
050,01,025,"Alabama","Clarke County",1,5,285,139,146
050,01,025,"Alabama","Clarke County",1,6,263,132,131
050,01,025,"Alabama","Clarke County",1,7,256,124,132
050,01,025,"Alabama","Clarke County",1,8,257,128,129
050,01,025,"Alabama","Clarke County",1,9,246,125,121
050,01,025,"Alabama","Clarke County",1,10,273,151,122
050,01,025,"Alabama","Clarke County",1,11,279,145,134
050,01,025,"Alabama","Clarke County",1,12,298,154,144
050,01,025,"Alabama","Clarke County",1,13,279,144,135
050,01,025,"Alabama","Clarke County",1,14,304,163,141
050,01,025,"Alabama","Clarke County",1,15,304,150,154
050,01,025,"Alabama","Clarke County",1,16,312,153,159
050,01,025,"Alabama","Clarke County",1,17,327,166,161
050,01,025,"Alabama","Clarke County",1,18,283,137,146
050,01,025,"Alabama","Clarke County",1,19,252,132,120
050,01,025,"Alabama","Clarke County",1,20,244,120,124
050,01,025,"Alabama","Clarke County",1,21,265,122,143
050,01,025,"Alabama","Clarke County",1,22,273,134,139
050,01,025,"Alabama","Clarke County",1,23,284,135,149
050,01,025,"Alabama","Clarke County",1,24,272,130,142
050,01,025,"Alabama","Clarke County",1,25,277,142,135
050,01,025,"Alabama","Clarke County",1,26,289,148,141
050,01,025,"Alabama","Clarke County",1,27,301,154,147
050,01,025,"Alabama","Clarke County",1,28,313,155,158
050,01,025,"Alabama","Clarke County",1,29,258,120,138
050,01,025,"Alabama","Clarke County",1,30,271,126,145
050,01,025,"Alabama","Clarke County",1,31,237,106,131
050,01,025,"Alabama","Clarke County",1,32,231,106,125
050,01,025,"Alabama","Clarke County",1,33,234,110,124
050,01,025,"Alabama","Clarke County",1,34,220,106,114
050,01,025,"Alabama","Clarke County",1,35,216,101,115
050,01,025,"Alabama","Clarke County",1,36,232,108,124
050,01,025,"Alabama","Clarke County",1,37,237,113,124
050,01,025,"Alabama","Clarke County",1,38,278,138,140
050,01,025,"Alabama","Clarke County",1,39,299,135,164
050,01,025,"Alabama","Clarke County",1,40,279,130,149
050,01,025,"Alabama","Clarke County",1,41,260,124,136
050,01,025,"Alabama","Clarke County",1,42,269,122,147
050,01,025,"Alabama","Clarke County",1,43,268,126,142
050,01,025,"Alabama","Clarke County",1,44,258,122,136
050,01,025,"Alabama","Clarke County",1,45,254,113,141
050,01,025,"Alabama","Clarke County",1,46,280,125,155
050,01,025,"Alabama","Clarke County",1,47,261,114,147
050,01,025,"Alabama","Clarke County",1,48,308,141,167
050,01,025,"Alabama","Clarke County",1,49,310,150,160
050,01,025,"Alabama","Clarke County",1,50,297,158,139
050,01,025,"Alabama","Clarke County",1,51,304,149,155
050,01,025,"Alabama","Clarke County",1,52,303,148,155
050,01,025,"Alabama","Clarke County",1,53,304,135,169
050,01,025,"Alabama","Clarke County",1,54,326,153,173
050,01,025,"Alabama","Clarke County",1,55,322,154,168
050,01,025,"Alabama","Clarke County",1,56,351,168,183
050,01,025,"Alabama","Clarke County",1,57,360,169,191
050,01,025,"Alabama","Clarke County",1,58,342,167,175
050,01,025,"Alabama","Clarke County",1,59,348,176,172
050,01,025,"Alabama","Clarke County",1,60,352,173,179
050,01,025,"Alabama","Clarke County",1,61,349,168,181
050,01,025,"Alabama","Clarke County",1,62,322,156,166
050,01,025,"Alabama","Clarke County",1,63,301,139,162
050,01,025,"Alabama","Clarke County",1,64,308,134,174
050,01,025,"Alabama","Clarke County",1,65,321,143,178
050,01,025,"Alabama","Clarke County",1,66,312,150,162
050,01,025,"Alabama","Clarke County",1,67,273,129,144
050,01,025,"Alabama","Clarke County",1,68,256,119,137
050,01,025,"Alabama","Clarke County",1,69,239,118,121
050,01,025,"Alabama","Clarke County",1,70,231,115,116
050,01,025,"Alabama","Clarke County",1,71,256,136,120
050,01,025,"Alabama","Clarke County",1,72,268,126,142
050,01,025,"Alabama","Clarke County",1,73,263,123,140
050,01,025,"Alabama","Clarke County",1,74,184,82,102
050,01,025,"Alabama","Clarke County",1,75,202,85,117
050,01,025,"Alabama","Clarke County",1,76,203,98,105
050,01,025,"Alabama","Clarke County",1,77,188,82,106
050,01,025,"Alabama","Clarke County",1,78,185,76,109
050,01,025,"Alabama","Clarke County",1,79,155,68,87
050,01,025,"Alabama","Clarke County",1,80,155,67,88
050,01,025,"Alabama","Clarke County",1,81,152,69,83
050,01,025,"Alabama","Clarke County",1,82,131,48,83
050,01,025,"Alabama","Clarke County",1,83,95,39,56
050,01,025,"Alabama","Clarke County",1,84,100,45,55
050,01,025,"Alabama","Clarke County",1,85,556,166,390
050,01,025,"Alabama","Clarke County",2,0,251,134,117
050,01,025,"Alabama","Clarke County",2,1,247,126,121
050,01,025,"Alabama","Clarke County",2,2,260,126,134
050,01,025,"Alabama","Clarke County",2,3,249,121,128
050,01,025,"Alabama","Clarke County",2,4,255,126,129
050,01,025,"Alabama","Clarke County",2,5,280,138,142
050,01,025,"Alabama","Clarke County",2,6,267,134,133
050,01,025,"Alabama","Clarke County",2,7,255,126,129
050,01,025,"Alabama","Clarke County",2,8,254,125,129
050,01,025,"Alabama","Clarke County",2,9,249,126,123
050,01,025,"Alabama","Clarke County",2,10,268,144,124
050,01,025,"Alabama","Clarke County",2,11,277,145,132
050,01,025,"Alabama","Clarke County",2,12,295,152,143
050,01,025,"Alabama","Clarke County",2,13,283,147,136
050,01,025,"Alabama","Clarke County",2,14,298,159,139
050,01,025,"Alabama","Clarke County",2,15,303,153,150
050,01,025,"Alabama","Clarke County",2,16,312,153,159
050,01,025,"Alabama","Clarke County",2,17,324,162,162
050,01,025,"Alabama","Clarke County",2,18,282,140,142
050,01,025,"Alabama","Clarke County",2,19,249,128,121
050,01,025,"Alabama","Clarke County",2,20,251,126,125
050,01,025,"Alabama","Clarke County",2,21,261,122,139
050,01,025,"Alabama","Clarke County",2,22,272,130,142
050,01,025,"Alabama","Clarke County",2,23,279,133,146
050,01,025,"Alabama","Clarke County",2,24,273,131,142
050,01,025,"Alabama","Clarke County",2,25,271,137,134
050,01,025,"Alabama","Clarke County",2,26,289,149,140
050,01,025,"Alabama","Clarke County",2,27,298,151,147
050,01,025,"Alabama","Clarke County",2,28,307,153,154
050,01,025,"Alabama","Clarke County",2,29,270,127,143
050,01,025,"Alabama","Clarke County",2,30,270,124,146
050,01,025,"Alabama","Clarke County",2,31,245,110,135
050,01,025,"Alabama","Clarke County",2,32,234,106,128
050,01,025,"Alabama","Clarke County",2,33,231,109,122
050,01,025,"Alabama","Clarke County",2,34,223,106,117
050,01,025,"Alabama","Clarke County",2,35,219,103,116
050,01,025,"Alabama","Clarke County",2,36,224,105,119
050,01,025,"Alabama","Clarke County",2,37,235,111,124
050,01,025,"Alabama","Clarke County",2,38,270,134,136
050,01,025,"Alabama","Clarke County",2,39,288,133,155
050,01,025,"Alabama","Clarke County",2,40,283,131,152
050,01,025,"Alabama","Clarke County",2,41,262,123,139
050,01,025,"Alabama","Clarke County",2,42,263,121,142
050,01,025,"Alabama","Clarke County",2,43,271,126,145
050,01,025,"Alabama","Clarke County",2,44,254,118,136
050,01,025,"Alabama","Clarke County",2,45,258,118,140
050,01,025,"Alabama","Clarke County",2,46,270,120,150
050,01,025,"Alabama","Clarke County",2,47,264,117,147
050,01,025,"Alabama","Clarke County",2,48,296,136,160
050,01,025,"Alabama","Clarke County",2,49,310,147,163
050,01,025,"Alabama","Clarke County",2,50,299,157,142
050,01,025,"Alabama","Clarke County",2,51,300,151,149
050,01,025,"Alabama","Clarke County",2,52,300,146,154
050,01,025,"Alabama","Clarke County",2,53,303,137,166
050,01,025,"Alabama","Clarke County",2,54,320,148,172
050,01,025,"Alabama","Clarke County",2,55,323,154,169
050,01,025,"Alabama","Clarke County",2,56,347,167,180
050,01,025,"Alabama","Clarke County",2,57,359,170,189
050,01,025,"Alabama","Clarke County",2,58,344,169,175
050,01,025,"Alabama","Clarke County",2,59,348,175,173
050,01,025,"Alabama","Clarke County",2,60,346,170,176
050,01,025,"Alabama","Clarke County",2,61,344,165,179
050,01,025,"Alabama","Clarke County",2,62,322,155,167
050,01,025,"Alabama","Clarke County",2,63,305,141,164
050,01,025,"Alabama","Clarke County",2,64,303,133,170
050,01,025,"Alabama","Clarke County",2,65,317,140,177
050,01,025,"Alabama","Clarke County",2,66,312,147,165
050,01,025,"Alabama","Clarke County",2,67,279,132,147
050,01,025,"Alabama","Clarke County",2,68,257,121,136
050,01,025,"Alabama","Clarke County",2,69,243,118,125
050,01,025,"Alabama","Clarke County",2,70,228,113,115
050,01,025,"Alabama","Clarke County",2,71,251,132,119
050,01,025,"Alabama","Clarke County",2,72,256,122,134
050,01,025,"Alabama","Clarke County",2,73,273,130,143
050,01,025,"Alabama","Clarke County",2,74,190,85,105
050,01,025,"Alabama","Clarke County",2,75,195,81,114
050,01,025,"Alabama","Clarke County",2,76,195,93,102
050,01,025,"Alabama","Clarke County",2,77,196,87,109
050,01,025,"Alabama","Clarke County",2,78,181,76,105
050,01,025,"Alabama","Clarke County",2,79,158,68,90
050,01,025,"Alabama","Clarke County",2,80,156,68,88
050,01,025,"Alabama","Clarke County",2,81,150,68,82
050,01,025,"Alabama","Clarke County",2,82,134,50,84
050,01,025,"Alabama","Clarke County",2,83,100,39,61
050,01,025,"Alabama","Clarke County",2,84,98,43,55
050,01,025,"Alabama","Clarke County",2,85,556,172,384
050,01,025,"Alabama","Clarke County",3,0,294,142,152
050,01,025,"Alabama","Clarke County",3,1,254,140,114
050,01,025,"Alabama","Clarke County",3,2,238,126,112
050,01,025,"Alabama","Clarke County",3,3,269,131,138
050,01,025,"Alabama","Clarke County",3,4,258,130,128
050,01,025,"Alabama","Clarke County",3,5,247,122,125
050,01,025,"Alabama","Clarke County",3,6,293,147,146
050,01,025,"Alabama","Clarke County",3,7,259,130,129
050,01,025,"Alabama","Clarke County",3,8,242,118,124
050,01,025,"Alabama","Clarke County",3,9,251,120,131
050,01,025,"Alabama","Clarke County",3,10,262,135,127
050,01,025,"Alabama","Clarke County",3,11,259,135,124
050,01,025,"Alabama","Clarke County",3,12,269,140,129
050,01,025,"Alabama","Clarke County",3,13,308,156,152
050,01,025,"Alabama","Clarke County",3,14,282,145,137
050,01,025,"Alabama","Clarke County",3,15,294,152,142
050,01,025,"Alabama","Clarke County",3,16,300,154,146
050,01,025,"Alabama","Clarke County",3,17,311,152,159
050,01,025,"Alabama","Clarke County",3,18,276,141,135
050,01,025,"Alabama","Clarke County",3,19,226,114,112
050,01,025,"Alabama","Clarke County",3,20,259,131,128
050,01,025,"Alabama","Clarke County",3,21,250,120,130
050,01,025,"Alabama","Clarke County",3,22,284,133,151
050,01,025,"Alabama","Clarke County",3,23,281,132,149
050,01,025,"Alabama","Clarke County",3,24,276,133,143
050,01,025,"Alabama","Clarke County",3,25,258,123,135
050,01,025,"Alabama","Clarke County",3,26,282,136,146
050,01,025,"Alabama","Clarke County",3,27,280,140,140
050,01,025,"Alabama","Clarke County",3,28,273,135,138
050,01,025,"Alabama","Clarke County",3,29,304,150,154
050,01,025,"Alabama","Clarke County",3,30,265,119,146
050,01,025,"Alabama","Clarke County",3,31,270,118,152
050,01,025,"Alabama","Clarke County",3,32,243,111,132
050,01,025,"Alabama","Clarke County",3,33,236,106,130
050,01,025,"Alabama","Clarke County",3,34,232,113,119
050,01,025,"Alabama","Clarke County",3,35,236,114,122
050,01,025,"Alabama","Clarke County",3,36,230,114,116
050,01,025,"Alabama","Clarke County",3,37,216,97,119
050,01,025,"Alabama","Clarke County",3,38,235,118,117
050,01,025,"Alabama","Clarke County",3,39,266,128,138
050,01,025,"Alabama","Clarke County",3,40,294,136,158
050,01,025,"Alabama","Clarke County",3,41,281,129,152
050,01,025,"Alabama","Clarke County",3,42,270,121,149
050,01,025,"Alabama","Clarke County",3,43,270,127,143
050,01,025,"Alabama","Clarke County",3,44,260,117,143
050,01,025,"Alabama","Clarke County",3,45,261,123,138
050,01,025,"Alabama","Clarke County",3,46,249,110,139
050,01,025,"Alabama","Clarke County",3,47,269,121,148
050,01,025,"Alabama","Clarke County",3,48,265,120,145
050,01,025,"Alabama","Clarke County",3,49,292,129,163
050,01,025,"Alabama","Clarke County",3,50,306,151,155
050,01,025,"Alabama","Clarke County",3,51,287,152,135
050,01,025,"Alabama","Clarke County",3,52,295,153,142
050,01,025,"Alabama","Clarke County",3,53,290,140,150
050,01,025,"Alabama","Clarke County",3,54,305,144,161
050,01,025,"Alabama","Clarke County",3,55,305,141,164
050,01,025,"Alabama","Clarke County",3,56,325,154,171
050,01,025,"Alabama","Clarke County",3,57,345,169,176
050,01,025,"Alabama","Clarke County",3,58,346,164,182
050,01,025,"Alabama","Clarke County",3,59,342,166,176
050,01,025,"Alabama","Clarke County",3,60,341,175,166
050,01,025,"Alabama","Clarke County",3,61,342,166,176
050,01,025,"Alabama","Clarke County",3,62,343,165,178
050,01,025,"Alabama","Clarke County",3,63,303,144,159
050,01,025,"Alabama","Clarke County",3,64,295,133,162
050,01,025,"Alabama","Clarke County",3,65,302,131,171
050,01,025,"Alabama","Clarke County",3,66,308,135,173
050,01,025,"Alabama","Clarke County",3,67,297,141,156
050,01,025,"Alabama","Clarke County",3,68,280,132,148
050,01,025,"Alabama","Clarke County",3,69,233,110,123
050,01,025,"Alabama","Clarke County",3,70,237,115,122
050,01,025,"Alabama","Clarke County",3,71,231,115,116
050,01,025,"Alabama","Clarke County",3,72,227,114,113
050,01,025,"Alabama","Clarke County",3,73,244,115,129
050,01,025,"Alabama","Clarke County",3,74,252,116,136
050,01,025,"Alabama","Clarke County",3,75,188,82,106
050,01,025,"Alabama","Clarke County",3,76,181,72,109
050,01,025,"Alabama","Clarke County",3,77,193,90,103
050,01,025,"Alabama","Clarke County",3,78,187,81,106
050,01,025,"Alabama","Clarke County",3,79,158,69,89
050,01,025,"Alabama","Clarke County",3,80,147,61,86
050,01,025,"Alabama","Clarke County",3,81,142,57,85
050,01,025,"Alabama","Clarke County",3,82,133,55,78
050,01,025,"Alabama","Clarke County",3,83,119,42,77
050,01,025,"Alabama","Clarke County",3,84,91,36,55
050,01,025,"Alabama","Clarke County",3,85,541,173,368
050,01,025,"Alabama","Clarke County",4,0,286,137,149
050,01,025,"Alabama","Clarke County",4,1,309,146,163
050,01,025,"Alabama","Clarke County",4,2,237,128,109
050,01,025,"Alabama","Clarke County",4,3,249,134,115
050,01,025,"Alabama","Clarke County",4,4,276,137,139
050,01,025,"Alabama","Clarke County",4,5,261,129,132
050,01,025,"Alabama","Clarke County",4,6,257,128,129
050,01,025,"Alabama","Clarke County",4,7,296,147,149
050,01,025,"Alabama","Clarke County",4,8,268,136,132
050,01,025,"Alabama","Clarke County",4,9,251,128,123
050,01,025,"Alabama","Clarke County",4,10,250,121,129
050,01,025,"Alabama","Clarke County",4,11,257,128,129
050,01,025,"Alabama","Clarke County",4,12,267,141,126
050,01,025,"Alabama","Clarke County",4,13,270,143,127
050,01,025,"Alabama","Clarke County",4,14,304,152,152
050,01,025,"Alabama","Clarke County",4,15,285,154,131
050,01,025,"Alabama","Clarke County",4,16,301,158,143
050,01,025,"Alabama","Clarke County",4,17,301,156,145
050,01,025,"Alabama","Clarke County",4,18,268,135,133
050,01,025,"Alabama","Clarke County",4,19,231,112,119
050,01,025,"Alabama","Clarke County",4,20,222,116,106
050,01,025,"Alabama","Clarke County",4,21,260,133,127
050,01,025,"Alabama","Clarke County",4,22,265,125,140
050,01,025,"Alabama","Clarke County",4,23,286,140,146
050,01,025,"Alabama","Clarke County",4,24,287,130,157
050,01,025,"Alabama","Clarke County",4,25,274,133,141
050,01,025,"Alabama","Clarke County",4,26,262,124,138
050,01,025,"Alabama","Clarke County",4,27,283,141,142
050,01,025,"Alabama","Clarke County",4,28,272,131,141
050,01,025,"Alabama","Clarke County",4,29,270,131,139
050,01,025,"Alabama","Clarke County",4,30,289,145,144
050,01,025,"Alabama","Clarke County",4,31,265,116,149
050,01,025,"Alabama","Clarke County",4,32,261,117,144
050,01,025,"Alabama","Clarke County",4,33,246,110,136
050,01,025,"Alabama","Clarke County",4,34,239,105,134
050,01,025,"Alabama","Clarke County",4,35,237,112,125
050,01,025,"Alabama","Clarke County",4,36,234,114,120
050,01,025,"Alabama","Clarke County",4,37,220,103,117
050,01,025,"Alabama","Clarke County",4,38,223,101,122
050,01,025,"Alabama","Clarke County",4,39,232,115,117
050,01,025,"Alabama","Clarke County",4,40,273,133,140
050,01,025,"Alabama","Clarke County",4,41,277,122,155
050,01,025,"Alabama","Clarke County",4,42,276,129,147
050,01,025,"Alabama","Clarke County",4,43,273,127,146
050,01,025,"Alabama","Clarke County",4,44,271,126,145
050,01,025,"Alabama","Clarke County",4,45,266,120,146
050,01,025,"Alabama","Clarke County",4,46,254,118,136
050,01,025,"Alabama","Clarke County",4,47,242,107,135
050,01,025,"Alabama","Clarke County",4,48,265,123,142
050,01,025,"Alabama","Clarke County",4,49,258,112,146
050,01,025,"Alabama","Clarke County",4,50,294,132,162
050,01,025,"Alabama","Clarke County",4,51,290,144,146
050,01,025,"Alabama","Clarke County",4,52,281,151,130
050,01,025,"Alabama","Clarke County",4,53,293,156,137
050,01,025,"Alabama","Clarke County",4,54,296,142,154
050,01,025,"Alabama","Clarke County",4,55,297,141,156
050,01,025,"Alabama","Clarke County",4,56,313,140,173
050,01,025,"Alabama","Clarke County",4,57,332,158,174
050,01,025,"Alabama","Clarke County",4,58,337,163,174
050,01,025,"Alabama","Clarke County",4,59,332,154,178
050,01,025,"Alabama","Clarke County",4,60,339,169,170
050,01,025,"Alabama","Clarke County",4,61,330,169,161
050,01,025,"Alabama","Clarke County",4,62,333,164,169
050,01,025,"Alabama","Clarke County",4,63,333,157,176
050,01,025,"Alabama","Clarke County",4,64,290,136,154
050,01,025,"Alabama","Clarke County",4,65,293,128,165
050,01,025,"Alabama","Clarke County",4,66,288,122,166
050,01,025,"Alabama","Clarke County",4,67,292,125,167
050,01,025,"Alabama","Clarke County",4,68,301,143,158
050,01,025,"Alabama","Clarke County",4,69,261,120,141
050,01,025,"Alabama","Clarke County",4,70,225,107,118
050,01,025,"Alabama","Clarke County",4,71,238,114,124
050,01,025,"Alabama","Clarke County",4,72,218,107,111
050,01,025,"Alabama","Clarke County",4,73,217,107,110
050,01,025,"Alabama","Clarke County",4,74,221,102,119
050,01,025,"Alabama","Clarke County",4,75,246,110,136
050,01,025,"Alabama","Clarke County",4,76,173,75,98
050,01,025,"Alabama","Clarke County",4,77,182,71,111
050,01,025,"Alabama","Clarke County",4,78,181,84,97
050,01,025,"Alabama","Clarke County",4,79,160,71,89
050,01,025,"Alabama","Clarke County",4,80,155,67,88
050,01,025,"Alabama","Clarke County",4,81,135,54,81
050,01,025,"Alabama","Clarke County",4,82,123,42,81
050,01,025,"Alabama","Clarke County",4,83,119,50,69
050,01,025,"Alabama","Clarke County",4,84,114,39,75
050,01,025,"Alabama","Clarke County",4,85,536,184,352
050,01,025,"Alabama","Clarke County",5,0,291,138,153
050,01,025,"Alabama","Clarke County",5,1,255,122,133
050,01,025,"Alabama","Clarke County",5,2,305,145,160
050,01,025,"Alabama","Clarke County",5,3,246,131,115
050,01,025,"Alabama","Clarke County",5,4,259,142,117
050,01,025,"Alabama","Clarke County",5,5,274,134,140
050,01,025,"Alabama","Clarke County",5,6,270,130,140
050,01,025,"Alabama","Clarke County",5,7,253,125,128
050,01,025,"Alabama","Clarke County",5,8,295,146,149
050,01,025,"Alabama","Clarke County",5,9,261,129,132
050,01,025,"Alabama","Clarke County",5,10,237,120,117
050,01,025,"Alabama","Clarke County",5,11,255,126,129
050,01,025,"Alabama","Clarke County",5,12,257,130,127
050,01,025,"Alabama","Clarke County",5,13,269,142,127
050,01,025,"Alabama","Clarke County",5,14,270,141,129
050,01,025,"Alabama","Clarke County",5,15,309,155,154
050,01,025,"Alabama","Clarke County",5,16,290,157,133
050,01,025,"Alabama","Clarke County",5,17,297,156,141
050,01,025,"Alabama","Clarke County",5,18,265,144,121
050,01,025,"Alabama","Clarke County",5,19,220,112,108
050,01,025,"Alabama","Clarke County",5,20,234,118,116
050,01,025,"Alabama","Clarke County",5,21,237,119,118
050,01,025,"Alabama","Clarke County",5,22,275,134,141
050,01,025,"Alabama","Clarke County",5,23,265,127,138
050,01,025,"Alabama","Clarke County",5,24,287,139,148
050,01,025,"Alabama","Clarke County",5,25,263,119,144
050,01,025,"Alabama","Clarke County",5,26,281,138,143
050,01,025,"Alabama","Clarke County",5,27,258,129,129
050,01,025,"Alabama","Clarke County",5,28,273,134,139
050,01,025,"Alabama","Clarke County",5,29,244,112,132
050,01,025,"Alabama","Clarke County",5,30,269,127,142
050,01,025,"Alabama","Clarke County",5,31,291,141,150
050,01,025,"Alabama","Clarke County",5,32,268,108,160
050,01,025,"Alabama","Clarke County",5,33,266,116,150
050,01,025,"Alabama","Clarke County",5,34,253,112,141
050,01,025,"Alabama","Clarke County",5,35,238,106,132
050,01,025,"Alabama","Clarke County",5,36,231,109,122
050,01,025,"Alabama","Clarke County",5,37,237,114,123
050,01,025,"Alabama","Clarke County",5,38,223,106,117
050,01,025,"Alabama","Clarke County",5,39,212,95,117
050,01,025,"Alabama","Clarke County",5,40,227,115,112
050,01,025,"Alabama","Clarke County",5,41,267,131,136
050,01,025,"Alabama","Clarke County",5,42,275,126,149
050,01,025,"Alabama","Clarke County",5,43,277,130,147
050,01,025,"Alabama","Clarke County",5,44,262,122,140
050,01,025,"Alabama","Clarke County",5,45,270,125,145
050,01,025,"Alabama","Clarke County",5,46,258,114,144
050,01,025,"Alabama","Clarke County",5,47,260,118,142
050,01,025,"Alabama","Clarke County",5,48,236,107,129
050,01,025,"Alabama","Clarke County",5,49,256,117,139
050,01,025,"Alabama","Clarke County",5,50,260,120,140
050,01,025,"Alabama","Clarke County",5,51,293,128,165
050,01,025,"Alabama","Clarke County",5,52,298,147,151
050,01,025,"Alabama","Clarke County",5,53,278,148,130
050,01,025,"Alabama","Clarke County",5,54,295,158,137
050,01,025,"Alabama","Clarke County",5,55,281,135,146
050,01,025,"Alabama","Clarke County",5,56,302,145,157
050,01,025,"Alabama","Clarke County",5,57,313,142,171
050,01,025,"Alabama","Clarke County",5,58,317,154,163
050,01,025,"Alabama","Clarke County",5,59,328,152,176
050,01,025,"Alabama","Clarke County",5,60,332,156,176
050,01,025,"Alabama","Clarke County",5,61,315,155,160
050,01,025,"Alabama","Clarke County",5,62,321,162,159
050,01,025,"Alabama","Clarke County",5,63,332,165,167
050,01,025,"Alabama","Clarke County",5,64,318,146,172
050,01,025,"Alabama","Clarke County",5,65,285,133,152
050,01,025,"Alabama","Clarke County",5,66,286,123,163
050,01,025,"Alabama","Clarke County",5,67,277,119,158
050,01,025,"Alabama","Clarke County",5,68,288,125,163
050,01,025,"Alabama","Clarke County",5,69,287,136,151
050,01,025,"Alabama","Clarke County",5,70,253,116,137
050,01,025,"Alabama","Clarke County",5,71,223,107,116
050,01,025,"Alabama","Clarke County",5,72,222,105,117
050,01,025,"Alabama","Clarke County",5,73,202,100,102
050,01,025,"Alabama","Clarke County",5,74,194,93,101
050,01,025,"Alabama","Clarke County",5,75,220,99,121
050,01,025,"Alabama","Clarke County",5,76,232,103,129
050,01,025,"Alabama","Clarke County",5,77,169,71,98
050,01,025,"Alabama","Clarke County",5,78,173,70,103
050,01,025,"Alabama","Clarke County",5,79,156,76,80
050,01,025,"Alabama","Clarke County",5,80,159,68,91
050,01,025,"Alabama","Clarke County",5,81,145,60,85
050,01,025,"Alabama","Clarke County",5,82,115,40,75
050,01,025,"Alabama","Clarke County",5,83,109,39,70
050,01,025,"Alabama","Clarke County",5,84,115,49,66
050,01,025,"Alabama","Clarke County",5,85,573,203,370
050,01,027,"Alabama","Clay County",1,0,166,86,80
050,01,027,"Alabama","Clay County",1,1,160,85,75
050,01,027,"Alabama","Clay County",1,2,153,75,78
050,01,027,"Alabama","Clay County",1,3,142,70,72
050,01,027,"Alabama","Clay County",1,4,151,83,68
050,01,027,"Alabama","Clay County",1,5,157,86,71
050,01,027,"Alabama","Clay County",1,6,151,77,74
050,01,027,"Alabama","Clay County",1,7,145,70,75
050,01,027,"Alabama","Clay County",1,8,169,80,89
050,01,027,"Alabama","Clay County",1,9,162,87,75
050,01,027,"Alabama","Clay County",1,10,172,95,77
050,01,027,"Alabama","Clay County",1,11,177,101,76
050,01,027,"Alabama","Clay County",1,12,180,90,90
050,01,027,"Alabama","Clay County",1,13,181,87,94
050,01,027,"Alabama","Clay County",1,14,181,104,77
050,01,027,"Alabama","Clay County",1,15,149,83,66
050,01,027,"Alabama","Clay County",1,16,162,86,76
050,01,027,"Alabama","Clay County",1,17,179,102,77
050,01,027,"Alabama","Clay County",1,18,147,81,66
050,01,027,"Alabama","Clay County",1,19,143,76,67
050,01,027,"Alabama","Clay County",1,20,151,81,70
050,01,027,"Alabama","Clay County",1,21,160,82,78
050,01,027,"Alabama","Clay County",1,22,177,88,89
050,01,027,"Alabama","Clay County",1,23,171,85,86
050,01,027,"Alabama","Clay County",1,24,159,78,81
050,01,027,"Alabama","Clay County",1,25,165,76,89
050,01,027,"Alabama","Clay County",1,26,164,77,87
050,01,027,"Alabama","Clay County",1,27,163,78,85
050,01,027,"Alabama","Clay County",1,28,154,77,77
050,01,027,"Alabama","Clay County",1,29,148,67,81
050,01,027,"Alabama","Clay County",1,30,164,75,89
050,01,027,"Alabama","Clay County",1,31,159,65,94
050,01,027,"Alabama","Clay County",1,32,152,64,88
050,01,027,"Alabama","Clay County",1,33,151,75,76
050,01,027,"Alabama","Clay County",1,34,146,66,80
050,01,027,"Alabama","Clay County",1,35,142,61,81
050,01,027,"Alabama","Clay County",1,36,156,80,76
050,01,027,"Alabama","Clay County",1,37,182,96,86
050,01,027,"Alabama","Clay County",1,38,163,82,81
050,01,027,"Alabama","Clay County",1,39,174,80,94
050,01,027,"Alabama","Clay County",1,40,170,85,85
050,01,027,"Alabama","Clay County",1,41,157,85,72
050,01,027,"Alabama","Clay County",1,42,167,83,84
050,01,027,"Alabama","Clay County",1,43,155,72,83
050,01,027,"Alabama","Clay County",1,44,145,65,80
050,01,027,"Alabama","Clay County",1,45,168,82,86
050,01,027,"Alabama","Clay County",1,46,176,88,88
050,01,027,"Alabama","Clay County",1,47,200,91,109
050,01,027,"Alabama","Clay County",1,48,200,96,104
050,01,027,"Alabama","Clay County",1,49,186,95,91
050,01,027,"Alabama","Clay County",1,50,182,99,83
050,01,027,"Alabama","Clay County",1,51,194,108,86
050,01,027,"Alabama","Clay County",1,52,207,102,105
050,01,027,"Alabama","Clay County",1,53,213,108,105
050,01,027,"Alabama","Clay County",1,54,206,93,113
050,01,027,"Alabama","Clay County",1,55,217,112,105
050,01,027,"Alabama","Clay County",1,56,217,107,110
050,01,027,"Alabama","Clay County",1,57,229,108,121
050,01,027,"Alabama","Clay County",1,58,226,115,111
050,01,027,"Alabama","Clay County",1,59,223,112,111
050,01,027,"Alabama","Clay County",1,60,218,113,105
050,01,027,"Alabama","Clay County",1,61,199,103,96
050,01,027,"Alabama","Clay County",1,62,206,104,102
050,01,027,"Alabama","Clay County",1,63,207,95,112
050,01,027,"Alabama","Clay County",1,64,198,94,104
050,01,027,"Alabama","Clay County",1,65,188,97,91
050,01,027,"Alabama","Clay County",1,66,179,83,96
050,01,027,"Alabama","Clay County",1,67,161,80,81
050,01,027,"Alabama","Clay County",1,68,174,77,97
050,01,027,"Alabama","Clay County",1,69,183,90,93
050,01,027,"Alabama","Clay County",1,70,192,97,95
050,01,027,"Alabama","Clay County",1,71,163,78,85
050,01,027,"Alabama","Clay County",1,72,157,74,83
050,01,027,"Alabama","Clay County",1,73,162,81,81
050,01,027,"Alabama","Clay County",1,74,96,46,50
050,01,027,"Alabama","Clay County",1,75,131,60,71
050,01,027,"Alabama","Clay County",1,76,136,68,68
050,01,027,"Alabama","Clay County",1,77,121,53,68
050,01,027,"Alabama","Clay County",1,78,107,41,66
050,01,027,"Alabama","Clay County",1,79,89,35,54
050,01,027,"Alabama","Clay County",1,80,94,41,53
050,01,027,"Alabama","Clay County",1,81,84,35,49
050,01,027,"Alabama","Clay County",1,82,76,31,45
050,01,027,"Alabama","Clay County",1,83,87,35,52
050,01,027,"Alabama","Clay County",1,84,71,32,39
050,01,027,"Alabama","Clay County",1,85,292,108,184
050,01,027,"Alabama","Clay County",2,0,156,78,78
050,01,027,"Alabama","Clay County",2,1,159,84,75
050,01,027,"Alabama","Clay County",2,2,155,77,78
050,01,027,"Alabama","Clay County",2,3,146,71,75
050,01,027,"Alabama","Clay County",2,4,148,80,68
050,01,027,"Alabama","Clay County",2,5,155,85,70
050,01,027,"Alabama","Clay County",2,6,151,79,72
050,01,027,"Alabama","Clay County",2,7,143,69,74
050,01,027,"Alabama","Clay County",2,8,162,77,85
050,01,027,"Alabama","Clay County",2,9,164,85,79
050,01,027,"Alabama","Clay County",2,10,168,93,75
050,01,027,"Alabama","Clay County",2,11,175,100,75
050,01,027,"Alabama","Clay County",2,12,180,93,87
050,01,027,"Alabama","Clay County",2,13,179,88,91
050,01,027,"Alabama","Clay County",2,14,183,101,82
050,01,027,"Alabama","Clay County",2,15,158,90,68
050,01,027,"Alabama","Clay County",2,16,160,86,74
050,01,027,"Alabama","Clay County",2,17,173,97,76
050,01,027,"Alabama","Clay County",2,18,149,83,66
050,01,027,"Alabama","Clay County",2,19,138,75,63
050,01,027,"Alabama","Clay County",2,20,153,82,71
050,01,027,"Alabama","Clay County",2,21,159,81,78
050,01,027,"Alabama","Clay County",2,22,175,87,88
050,01,027,"Alabama","Clay County",2,23,175,87,88
050,01,027,"Alabama","Clay County",2,24,161,78,83
050,01,027,"Alabama","Clay County",2,25,164,78,86
050,01,027,"Alabama","Clay County",2,26,165,78,87
050,01,027,"Alabama","Clay County",2,27,165,79,86
050,01,027,"Alabama","Clay County",2,28,155,77,78
050,01,027,"Alabama","Clay County",2,29,151,71,80
050,01,027,"Alabama","Clay County",2,30,163,74,89
050,01,027,"Alabama","Clay County",2,31,158,66,92
050,01,027,"Alabama","Clay County",2,32,154,65,89
050,01,027,"Alabama","Clay County",2,33,151,72,79
050,01,027,"Alabama","Clay County",2,34,146,67,79
050,01,027,"Alabama","Clay County",2,35,142,62,80
050,01,027,"Alabama","Clay County",2,36,149,73,76
050,01,027,"Alabama","Clay County",2,37,176,92,84
050,01,027,"Alabama","Clay County",2,38,168,85,83
050,01,027,"Alabama","Clay County",2,39,169,79,90
050,01,027,"Alabama","Clay County",2,40,172,85,87
050,01,027,"Alabama","Clay County",2,41,158,85,73
050,01,027,"Alabama","Clay County",2,42,163,82,81
050,01,027,"Alabama","Clay County",2,43,158,75,83
050,01,027,"Alabama","Clay County",2,44,144,65,79
050,01,027,"Alabama","Clay County",2,45,163,78,85
050,01,027,"Alabama","Clay County",2,46,174,86,88
050,01,027,"Alabama","Clay County",2,47,194,90,104
050,01,027,"Alabama","Clay County",2,48,198,95,103
050,01,027,"Alabama","Clay County",2,49,189,95,94
050,01,027,"Alabama","Clay County",2,50,184,100,84
050,01,027,"Alabama","Clay County",2,51,187,104,83
050,01,027,"Alabama","Clay County",2,52,203,102,101
050,01,027,"Alabama","Clay County",2,53,211,107,104
050,01,027,"Alabama","Clay County",2,54,206,95,111
050,01,027,"Alabama","Clay County",2,55,212,105,107
050,01,027,"Alabama","Clay County",2,56,218,109,109
050,01,027,"Alabama","Clay County",2,57,226,108,118
050,01,027,"Alabama","Clay County",2,58,227,113,114
050,01,027,"Alabama","Clay County",2,59,225,114,111
050,01,027,"Alabama","Clay County",2,60,219,112,107
050,01,027,"Alabama","Clay County",2,61,202,105,97
050,01,027,"Alabama","Clay County",2,62,206,105,101
050,01,027,"Alabama","Clay County",2,63,208,98,110
050,01,027,"Alabama","Clay County",2,64,198,92,106
050,01,027,"Alabama","Clay County",2,65,192,97,95
050,01,027,"Alabama","Clay County",2,66,182,87,95
050,01,027,"Alabama","Clay County",2,67,165,80,85
050,01,027,"Alabama","Clay County",2,68,169,77,92
050,01,027,"Alabama","Clay County",2,69,181,87,94
050,01,027,"Alabama","Clay County",2,70,189,95,94
050,01,027,"Alabama","Clay County",2,71,171,84,87
050,01,027,"Alabama","Clay County",2,72,155,73,82
050,01,027,"Alabama","Clay County",2,73,169,84,85
050,01,027,"Alabama","Clay County",2,74,105,52,53
050,01,027,"Alabama","Clay County",2,75,120,57,63
050,01,027,"Alabama","Clay County",2,76,131,65,66
050,01,027,"Alabama","Clay County",2,77,126,58,68
050,01,027,"Alabama","Clay County",2,78,108,43,65
050,01,027,"Alabama","Clay County",2,79,91,34,57
050,01,027,"Alabama","Clay County",2,80,92,40,52
050,01,027,"Alabama","Clay County",2,81,83,35,48
050,01,027,"Alabama","Clay County",2,82,78,32,46
050,01,027,"Alabama","Clay County",2,83,83,32,51
050,01,027,"Alabama","Clay County",2,84,76,34,42
050,01,027,"Alabama","Clay County",2,85,300,112,188
050,01,027,"Alabama","Clay County",3,0,142,61,81
050,01,027,"Alabama","Clay County",3,1,149,80,69
050,01,027,"Alabama","Clay County",3,2,152,77,75
050,01,027,"Alabama","Clay County",3,3,157,69,88
050,01,027,"Alabama","Clay County",3,4,139,72,67
050,01,027,"Alabama","Clay County",3,5,147,81,66
050,01,027,"Alabama","Clay County",3,6,159,86,73
050,01,027,"Alabama","Clay County",3,7,155,77,78
050,01,027,"Alabama","Clay County",3,8,152,72,80
050,01,027,"Alabama","Clay County",3,9,170,87,83
050,01,027,"Alabama","Clay County",3,10,166,85,81
050,01,027,"Alabama","Clay County",3,11,172,95,77
050,01,027,"Alabama","Clay County",3,12,177,101,76
050,01,027,"Alabama","Clay County",3,13,182,101,81
050,01,027,"Alabama","Clay County",3,14,182,91,91
050,01,027,"Alabama","Clay County",3,15,191,100,91
050,01,027,"Alabama","Clay County",3,16,167,97,70
050,01,027,"Alabama","Clay County",3,17,156,86,70
050,01,027,"Alabama","Clay County",3,18,152,91,61
050,01,027,"Alabama","Clay County",3,19,113,63,50
050,01,027,"Alabama","Clay County",3,20,149,82,67
050,01,027,"Alabama","Clay County",3,21,157,80,77
050,01,027,"Alabama","Clay County",3,22,162,84,78
050,01,027,"Alabama","Clay County",3,23,182,90,92
050,01,027,"Alabama","Clay County",3,24,180,89,91
050,01,027,"Alabama","Clay County",3,25,152,76,76
050,01,027,"Alabama","Clay County",3,26,156,73,83
050,01,027,"Alabama","Clay County",3,27,165,76,89
050,01,027,"Alabama","Clay County",3,28,160,82,78
050,01,027,"Alabama","Clay County",3,29,141,67,74
050,01,027,"Alabama","Clay County",3,30,148,70,78
050,01,027,"Alabama","Clay County",3,31,160,74,86
050,01,027,"Alabama","Clay County",3,32,155,67,88
050,01,027,"Alabama","Clay County",3,33,152,61,91
050,01,027,"Alabama","Clay County",3,34,148,70,78
050,01,027,"Alabama","Clay County",3,35,154,69,85
050,01,027,"Alabama","Clay County",3,36,139,61,78
050,01,027,"Alabama","Clay County",3,37,156,75,81
050,01,027,"Alabama","Clay County",3,38,171,88,83
050,01,027,"Alabama","Clay County",3,39,174,90,84
050,01,027,"Alabama","Clay County",3,40,166,78,88
050,01,027,"Alabama","Clay County",3,41,169,85,84
050,01,027,"Alabama","Clay County",3,42,159,83,76
050,01,027,"Alabama","Clay County",3,43,170,83,87
050,01,027,"Alabama","Clay County",3,44,155,73,82
050,01,027,"Alabama","Clay County",3,45,154,70,84
050,01,027,"Alabama","Clay County",3,46,170,79,91
050,01,027,"Alabama","Clay County",3,47,178,90,88
050,01,027,"Alabama","Clay County",3,48,188,89,99
050,01,027,"Alabama","Clay County",3,49,195,94,101
050,01,027,"Alabama","Clay County",3,50,201,100,101
050,01,027,"Alabama","Clay County",3,51,183,98,85
050,01,027,"Alabama","Clay County",3,52,190,99,91
050,01,027,"Alabama","Clay County",3,53,205,106,99
050,01,027,"Alabama","Clay County",3,54,215,106,109
050,01,027,"Alabama","Clay County",3,55,211,98,113
050,01,027,"Alabama","Clay County",3,56,211,104,107
050,01,027,"Alabama","Clay County",3,57,231,118,113
050,01,027,"Alabama","Clay County",3,58,225,108,117
050,01,027,"Alabama","Clay County",3,59,224,113,111
050,01,027,"Alabama","Clay County",3,60,224,115,109
050,01,027,"Alabama","Clay County",3,61,216,115,101
050,01,027,"Alabama","Clay County",3,62,200,104,96
050,01,027,"Alabama","Clay County",3,63,208,109,99
050,01,027,"Alabama","Clay County",3,64,206,97,109
050,01,027,"Alabama","Clay County",3,65,202,96,106
050,01,027,"Alabama","Clay County",3,66,191,93,98
050,01,027,"Alabama","Clay County",3,67,180,85,95
050,01,027,"Alabama","Clay County",3,68,165,80,85
050,01,027,"Alabama","Clay County",3,69,159,75,84
050,01,027,"Alabama","Clay County",3,70,170,79,91
050,01,027,"Alabama","Clay County",3,71,184,91,93
050,01,027,"Alabama","Clay County",3,72,165,80,85
050,01,027,"Alabama","Clay County",3,73,145,69,76
050,01,027,"Alabama","Clay County",3,74,166,84,82
050,01,027,"Alabama","Clay County",3,75,100,45,55
050,01,027,"Alabama","Clay County",3,76,108,51,57
050,01,027,"Alabama","Clay County",3,77,122,61,61
050,01,027,"Alabama","Clay County",3,78,120,53,67
050,01,027,"Alabama","Clay County",3,79,95,37,58
050,01,027,"Alabama","Clay County",3,80,87,32,55
050,01,027,"Alabama","Clay County",3,81,83,32,51
050,01,027,"Alabama","Clay County",3,82,76,31,45
050,01,027,"Alabama","Clay County",3,83,66,23,43
050,01,027,"Alabama","Clay County",3,84,75,30,45
050,01,027,"Alabama","Clay County",3,85,316,122,194
050,01,027,"Alabama","Clay County",4,0,152,70,82
050,01,027,"Alabama","Clay County",4,1,155,72,83
050,01,027,"Alabama","Clay County",4,2,146,74,72
050,01,027,"Alabama","Clay County",4,3,157,84,73
050,01,027,"Alabama","Clay County",4,4,162,70,92
050,01,027,"Alabama","Clay County",4,5,142,72,70
050,01,027,"Alabama","Clay County",4,6,151,82,69
050,01,027,"Alabama","Clay County",4,7,173,92,81
050,01,027,"Alabama","Clay County",4,8,155,76,79
050,01,027,"Alabama","Clay County",4,9,150,72,78
050,01,027,"Alabama","Clay County",4,10,165,82,83
050,01,027,"Alabama","Clay County",4,11,173,95,78
050,01,027,"Alabama","Clay County",4,12,174,94,80
050,01,027,"Alabama","Clay County",4,13,184,102,82
050,01,027,"Alabama","Clay County",4,14,185,100,85
050,01,027,"Alabama","Clay County",4,15,184,93,91
050,01,027,"Alabama","Clay County",4,16,194,106,88
050,01,027,"Alabama","Clay County",4,17,171,99,72
050,01,027,"Alabama","Clay County",4,18,128,72,56
050,01,027,"Alabama","Clay County",4,19,117,70,47
050,01,027,"Alabama","Clay County",4,20,122,67,55
050,01,027,"Alabama","Clay County",4,21,155,82,73
050,01,027,"Alabama","Clay County",4,22,159,78,81
050,01,027,"Alabama","Clay County",4,23,158,79,79
050,01,027,"Alabama","Clay County",4,24,181,87,94
050,01,027,"Alabama","Clay County",4,25,166,81,85
050,01,027,"Alabama","Clay County",4,26,155,73,82
050,01,027,"Alabama","Clay County",4,27,171,80,91
050,01,027,"Alabama","Clay County",4,28,166,78,88
050,01,027,"Alabama","Clay County",4,29,165,82,83
050,01,027,"Alabama","Clay County",4,30,152,70,82
050,01,027,"Alabama","Clay County",4,31,146,70,76
050,01,027,"Alabama","Clay County",4,32,156,74,82
050,01,027,"Alabama","Clay County",4,33,157,69,88
050,01,027,"Alabama","Clay County",4,34,149,61,88
050,01,027,"Alabama","Clay County",4,35,152,72,80
050,01,027,"Alabama","Clay County",4,36,155,68,87
050,01,027,"Alabama","Clay County",4,37,146,67,79
050,01,027,"Alabama","Clay County",4,38,167,78,89
050,01,027,"Alabama","Clay County",4,39,178,93,85
050,01,027,"Alabama","Clay County",4,40,173,89,84
050,01,027,"Alabama","Clay County",4,41,159,78,81
050,01,027,"Alabama","Clay County",4,42,162,78,84
050,01,027,"Alabama","Clay County",4,43,156,84,72
050,01,027,"Alabama","Clay County",4,44,167,84,83
050,01,027,"Alabama","Clay County",4,45,159,74,85
050,01,027,"Alabama","Clay County",4,46,156,66,90
050,01,027,"Alabama","Clay County",4,47,169,79,90
050,01,027,"Alabama","Clay County",4,48,169,89,80
050,01,027,"Alabama","Clay County",4,49,187,86,101
050,01,027,"Alabama","Clay County",4,50,194,95,99
050,01,027,"Alabama","Clay County",4,51,202,99,103
050,01,027,"Alabama","Clay County",4,52,187,93,94
050,01,027,"Alabama","Clay County",4,53,192,103,89
050,01,027,"Alabama","Clay County",4,54,201,102,99
050,01,027,"Alabama","Clay County",4,55,215,107,108
050,01,027,"Alabama","Clay County",4,56,204,98,106
050,01,027,"Alabama","Clay County",4,57,206,104,102
050,01,027,"Alabama","Clay County",4,58,233,118,115
050,01,027,"Alabama","Clay County",4,59,229,111,118
050,01,027,"Alabama","Clay County",4,60,225,110,115
050,01,027,"Alabama","Clay County",4,61,223,114,109
050,01,027,"Alabama","Clay County",4,62,212,110,102
050,01,027,"Alabama","Clay County",4,63,196,105,91
050,01,027,"Alabama","Clay County",4,64,211,111,100
050,01,027,"Alabama","Clay County",4,65,201,92,109
050,01,027,"Alabama","Clay County",4,66,200,94,106
050,01,027,"Alabama","Clay County",4,67,184,90,94
050,01,027,"Alabama","Clay County",4,68,178,86,92
050,01,027,"Alabama","Clay County",4,69,156,77,79
050,01,027,"Alabama","Clay County",4,70,153,72,81
050,01,027,"Alabama","Clay County",4,71,160,74,86
050,01,027,"Alabama","Clay County",4,72,183,85,98
050,01,027,"Alabama","Clay County",4,73,153,74,79
050,01,027,"Alabama","Clay County",4,74,140,66,74
050,01,027,"Alabama","Clay County",4,75,162,76,86
050,01,027,"Alabama","Clay County",4,76,91,43,48
050,01,027,"Alabama","Clay County",4,77,101,45,56
050,01,027,"Alabama","Clay County",4,78,117,58,59
050,01,027,"Alabama","Clay County",4,79,115,51,64
050,01,027,"Alabama","Clay County",4,80,92,36,56
050,01,027,"Alabama","Clay County",4,81,84,27,57
050,01,027,"Alabama","Clay County",4,82,71,27,44
050,01,027,"Alabama","Clay County",4,83,73,27,46
050,01,027,"Alabama","Clay County",4,84,64,24,40
050,01,027,"Alabama","Clay County",4,85,344,132,212
050,01,027,"Alabama","Clay County",5,0,157,74,83
050,01,027,"Alabama","Clay County",5,1,155,72,83
050,01,027,"Alabama","Clay County",5,2,165,77,88
050,01,027,"Alabama","Clay County",5,3,145,69,76
050,01,027,"Alabama","Clay County",5,4,158,85,73
050,01,027,"Alabama","Clay County",5,5,170,74,96
050,01,027,"Alabama","Clay County",5,6,149,80,69
050,01,027,"Alabama","Clay County",5,7,154,80,74
050,01,027,"Alabama","Clay County",5,8,166,90,76
050,01,027,"Alabama","Clay County",5,9,156,71,85
050,01,027,"Alabama","Clay County",5,10,151,74,77
050,01,027,"Alabama","Clay County",5,11,169,86,83
050,01,027,"Alabama","Clay County",5,12,169,92,77
050,01,027,"Alabama","Clay County",5,13,165,91,74
050,01,027,"Alabama","Clay County",5,14,175,100,75
050,01,027,"Alabama","Clay County",5,15,181,94,87
050,01,027,"Alabama","Clay County",5,16,176,85,91
050,01,027,"Alabama","Clay County",5,17,193,105,88
050,01,027,"Alabama","Clay County",5,18,139,81,58
050,01,027,"Alabama","Clay County",5,19,103,56,47
050,01,027,"Alabama","Clay County",5,20,130,79,51
050,01,027,"Alabama","Clay County",5,21,121,69,52
050,01,027,"Alabama","Clay County",5,22,162,86,76
050,01,027,"Alabama","Clay County",5,23,165,81,84
050,01,027,"Alabama","Clay County",5,24,154,69,85
050,01,027,"Alabama","Clay County",5,25,182,83,99
050,01,027,"Alabama","Clay County",5,26,160,76,84
050,01,027,"Alabama","Clay County",5,27,161,83,78
050,01,027,"Alabama","Clay County",5,28,165,81,84
050,01,027,"Alabama","Clay County",5,29,163,75,88
050,01,027,"Alabama","Clay County",5,30,171,90,81
050,01,027,"Alabama","Clay County",5,31,151,71,80
050,01,027,"Alabama","Clay County",5,32,156,75,81
050,01,027,"Alabama","Clay County",5,33,163,79,84
050,01,027,"Alabama","Clay County",5,34,156,67,89
050,01,027,"Alabama","Clay County",5,35,154,60,94
050,01,027,"Alabama","Clay County",5,36,149,72,77
050,01,027,"Alabama","Clay County",5,37,145,65,80
050,01,027,"Alabama","Clay County",5,38,149,70,79
050,01,027,"Alabama","Clay County",5,39,175,84,91
050,01,027,"Alabama","Clay County",5,40,174,91,83
050,01,027,"Alabama","Clay County",5,41,167,86,81
050,01,027,"Alabama","Clay County",5,42,158,78,80
050,01,027,"Alabama","Clay County",5,43,157,75,82
050,01,027,"Alabama","Clay County",5,44,151,81,70
050,01,027,"Alabama","Clay County",5,45,171,86,85
050,01,027,"Alabama","Clay County",5,46,159,71,88
050,01,027,"Alabama","Clay County",5,47,161,76,85
050,01,027,"Alabama","Clay County",5,48,157,70,87
050,01,027,"Alabama","Clay County",5,49,167,85,82
050,01,027,"Alabama","Clay County",5,50,182,88,94
050,01,027,"Alabama","Clay County",5,51,192,94,98
050,01,027,"Alabama","Clay County",5,52,197,95,102
050,01,027,"Alabama","Clay County",5,53,191,98,93
050,01,027,"Alabama","Clay County",5,54,183,99,84
050,01,027,"Alabama","Clay County",5,55,210,100,110
050,01,027,"Alabama","Clay County",5,56,216,108,108
050,01,027,"Alabama","Clay County",5,57,204,100,104
050,01,027,"Alabama","Clay County",5,58,206,103,103
050,01,027,"Alabama","Clay County",5,59,225,114,111
050,01,027,"Alabama","Clay County",5,60,223,109,114
050,01,027,"Alabama","Clay County",5,61,222,108,114
050,01,027,"Alabama","Clay County",5,62,223,112,111
050,01,027,"Alabama","Clay County",5,63,212,115,97
050,01,027,"Alabama","Clay County",5,64,191,103,88
050,01,027,"Alabama","Clay County",5,65,206,109,97
050,01,027,"Alabama","Clay County",5,66,204,94,110
050,01,027,"Alabama","Clay County",5,67,190,88,102
050,01,027,"Alabama","Clay County",5,68,183,89,94
050,01,027,"Alabama","Clay County",5,69,175,83,92
050,01,027,"Alabama","Clay County",5,70,155,73,82
050,01,027,"Alabama","Clay County",5,71,144,67,77
050,01,027,"Alabama","Clay County",5,72,155,67,88
050,01,027,"Alabama","Clay County",5,73,173,80,93
050,01,027,"Alabama","Clay County",5,74,150,72,78
050,01,027,"Alabama","Clay County",5,75,137,62,75
050,01,027,"Alabama","Clay County",5,76,146,72,74
050,01,027,"Alabama","Clay County",5,77,82,36,46
050,01,027,"Alabama","Clay County",5,78,98,43,55
050,01,027,"Alabama","Clay County",5,79,110,56,54
050,01,027,"Alabama","Clay County",5,80,110,48,62
050,01,027,"Alabama","Clay County",5,81,89,30,59
050,01,027,"Alabama","Clay County",5,82,74,23,51
050,01,027,"Alabama","Clay County",5,83,68,24,44
050,01,027,"Alabama","Clay County",5,84,70,28,42
050,01,027,"Alabama","Clay County",5,85,365,135,230
050,01,029,"Alabama","Cleburne County",1,0,172,88,84
050,01,029,"Alabama","Cleburne County",1,1,173,86,87
050,01,029,"Alabama","Cleburne County",1,2,204,104,100
050,01,029,"Alabama","Cleburne County",1,3,178,88,90
050,01,029,"Alabama","Cleburne County",1,4,181,93,88
050,01,029,"Alabama","Cleburne County",1,5,168,85,83
050,01,029,"Alabama","Cleburne County",1,6,195,96,99
050,01,029,"Alabama","Cleburne County",1,7,175,86,89
050,01,029,"Alabama","Cleburne County",1,8,209,105,104
050,01,029,"Alabama","Cleburne County",1,9,195,103,92
050,01,029,"Alabama","Cleburne County",1,10,185,93,92
050,01,029,"Alabama","Cleburne County",1,11,202,100,102
050,01,029,"Alabama","Cleburne County",1,12,215,103,112
050,01,029,"Alabama","Cleburne County",1,13,197,106,91
050,01,029,"Alabama","Cleburne County",1,14,202,107,95
050,01,029,"Alabama","Cleburne County",1,15,202,98,104
050,01,029,"Alabama","Cleburne County",1,16,208,107,101
050,01,029,"Alabama","Cleburne County",1,17,191,114,77
050,01,029,"Alabama","Cleburne County",1,18,168,102,66
050,01,029,"Alabama","Cleburne County",1,19,138,80,58
050,01,029,"Alabama","Cleburne County",1,20,141,78,63
050,01,029,"Alabama","Cleburne County",1,21,143,71,72
050,01,029,"Alabama","Cleburne County",1,22,145,66,79
050,01,029,"Alabama","Cleburne County",1,23,151,82,69
050,01,029,"Alabama","Cleburne County",1,24,162,84,78
050,01,029,"Alabama","Cleburne County",1,25,154,76,78
050,01,029,"Alabama","Cleburne County",1,26,160,82,78
050,01,029,"Alabama","Cleburne County",1,27,192,93,99
050,01,029,"Alabama","Cleburne County",1,28,180,78,102
050,01,029,"Alabama","Cleburne County",1,29,190,101,89
050,01,029,"Alabama","Cleburne County",1,30,176,97,79
050,01,029,"Alabama","Cleburne County",1,31,177,102,75
050,01,029,"Alabama","Cleburne County",1,32,158,77,81
050,01,029,"Alabama","Cleburne County",1,33,165,77,88
050,01,029,"Alabama","Cleburne County",1,34,157,74,83
050,01,029,"Alabama","Cleburne County",1,35,164,71,93
050,01,029,"Alabama","Cleburne County",1,36,174,83,91
050,01,029,"Alabama","Cleburne County",1,37,173,78,95
050,01,029,"Alabama","Cleburne County",1,38,189,93,96
050,01,029,"Alabama","Cleburne County",1,39,184,107,77
050,01,029,"Alabama","Cleburne County",1,40,163,79,84
050,01,029,"Alabama","Cleburne County",1,41,156,87,69
050,01,029,"Alabama","Cleburne County",1,42,159,84,75
050,01,029,"Alabama","Cleburne County",1,43,167,83,84
050,01,029,"Alabama","Cleburne County",1,44,169,78,91
050,01,029,"Alabama","Cleburne County",1,45,195,99,96
050,01,029,"Alabama","Cleburne County",1,46,217,117,100
050,01,029,"Alabama","Cleburne County",1,47,200,103,97
050,01,029,"Alabama","Cleburne County",1,48,202,100,102
050,01,029,"Alabama","Cleburne County",1,49,232,111,121
050,01,029,"Alabama","Cleburne County",1,50,223,115,108
050,01,029,"Alabama","Cleburne County",1,51,197,108,89
050,01,029,"Alabama","Cleburne County",1,52,203,113,90
050,01,029,"Alabama","Cleburne County",1,53,209,108,101
050,01,029,"Alabama","Cleburne County",1,54,208,102,106
050,01,029,"Alabama","Cleburne County",1,55,209,100,109
050,01,029,"Alabama","Cleburne County",1,56,225,109,116
050,01,029,"Alabama","Cleburne County",1,57,206,108,98
050,01,029,"Alabama","Cleburne County",1,58,230,119,111
050,01,029,"Alabama","Cleburne County",1,59,241,126,115
050,01,029,"Alabama","Cleburne County",1,60,227,109,118
050,01,029,"Alabama","Cleburne County",1,61,189,95,94
050,01,029,"Alabama","Cleburne County",1,62,198,82,116
050,01,029,"Alabama","Cleburne County",1,63,175,84,91
050,01,029,"Alabama","Cleburne County",1,64,169,73,96
050,01,029,"Alabama","Cleburne County",1,65,185,84,101
050,01,029,"Alabama","Cleburne County",1,66,219,110,109
050,01,029,"Alabama","Cleburne County",1,67,207,103,104
050,01,029,"Alabama","Cleburne County",1,68,175,83,92
050,01,029,"Alabama","Cleburne County",1,69,148,74,74
050,01,029,"Alabama","Cleburne County",1,70,172,82,90
050,01,029,"Alabama","Cleburne County",1,71,183,86,97
050,01,029,"Alabama","Cleburne County",1,72,180,84,96
050,01,029,"Alabama","Cleburne County",1,73,178,82,96
050,01,029,"Alabama","Cleburne County",1,74,119,54,65
050,01,029,"Alabama","Cleburne County",1,75,134,54,80
050,01,029,"Alabama","Cleburne County",1,76,111,47,64
050,01,029,"Alabama","Cleburne County",1,77,131,62,69
050,01,029,"Alabama","Cleburne County",1,78,108,50,58
050,01,029,"Alabama","Cleburne County",1,79,101,49,52
050,01,029,"Alabama","Cleburne County",1,80,82,40,42
050,01,029,"Alabama","Cleburne County",1,81,71,38,33
050,01,029,"Alabama","Cleburne County",1,82,65,30,35
050,01,029,"Alabama","Cleburne County",1,83,58,18,40
050,01,029,"Alabama","Cleburne County",1,84,47,18,29
050,01,029,"Alabama","Cleburne County",1,85,321,101,220
050,01,029,"Alabama","Cleburne County",2,0,163,82,81
050,01,029,"Alabama","Cleburne County",2,1,173,87,86
050,01,029,"Alabama","Cleburne County",2,2,199,101,98
050,01,029,"Alabama","Cleburne County",2,3,185,93,92
050,01,029,"Alabama","Cleburne County",2,4,179,89,90
050,01,029,"Alabama","Cleburne County",2,5,170,86,84
050,01,029,"Alabama","Cleburne County",2,6,190,93,97
050,01,029,"Alabama","Cleburne County",2,7,182,89,93
050,01,029,"Alabama","Cleburne County",2,8,204,103,101
050,01,029,"Alabama","Cleburne County",2,9,198,103,95
050,01,029,"Alabama","Cleburne County",2,10,189,95,94
050,01,029,"Alabama","Cleburne County",2,11,202,101,101
050,01,029,"Alabama","Cleburne County",2,12,213,104,109
050,01,029,"Alabama","Cleburne County",2,13,201,106,95
050,01,029,"Alabama","Cleburne County",2,14,201,106,95
050,01,029,"Alabama","Cleburne County",2,15,204,101,103
050,01,029,"Alabama","Cleburne County",2,16,207,106,101
050,01,029,"Alabama","Cleburne County",2,17,194,112,82
050,01,029,"Alabama","Cleburne County",2,18,165,101,64
050,01,029,"Alabama","Cleburne County",2,19,135,80,55
050,01,029,"Alabama","Cleburne County",2,20,144,81,63
050,01,029,"Alabama","Cleburne County",2,21,145,74,71
050,01,029,"Alabama","Cleburne County",2,22,146,67,79
050,01,029,"Alabama","Cleburne County",2,23,153,80,73
050,01,029,"Alabama","Cleburne County",2,24,159,84,75
050,01,029,"Alabama","Cleburne County",2,25,155,78,77
050,01,029,"Alabama","Cleburne County",2,26,159,81,78
050,01,029,"Alabama","Cleburne County",2,27,185,89,96
050,01,029,"Alabama","Cleburne County",2,28,181,80,101
050,01,029,"Alabama","Cleburne County",2,29,187,95,92
050,01,029,"Alabama","Cleburne County",2,30,182,101,81
050,01,029,"Alabama","Cleburne County",2,31,174,98,76
050,01,029,"Alabama","Cleburne County",2,32,161,81,80
050,01,029,"Alabama","Cleburne County",2,33,162,76,86
050,01,029,"Alabama","Cleburne County",2,34,162,76,86
050,01,029,"Alabama","Cleburne County",2,35,166,73,93
050,01,029,"Alabama","Cleburne County",2,36,169,79,90
050,01,029,"Alabama","Cleburne County",2,37,175,81,94
050,01,029,"Alabama","Cleburne County",2,38,188,92,96
050,01,029,"Alabama","Cleburne County",2,39,184,104,80
050,01,029,"Alabama","Cleburne County",2,40,170,86,84
050,01,029,"Alabama","Cleburne County",2,41,158,85,73
050,01,029,"Alabama","Cleburne County",2,42,159,85,74
050,01,029,"Alabama","Cleburne County",2,43,167,84,83
050,01,029,"Alabama","Cleburne County",2,44,166,78,88
050,01,029,"Alabama","Cleburne County",2,45,190,95,95
050,01,029,"Alabama","Cleburne County",2,46,211,112,99
050,01,029,"Alabama","Cleburne County",2,47,202,105,97
050,01,029,"Alabama","Cleburne County",2,48,203,101,102
050,01,029,"Alabama","Cleburne County",2,49,224,109,115
050,01,029,"Alabama","Cleburne County",2,50,225,114,111
050,01,029,"Alabama","Cleburne County",2,51,201,108,93
050,01,029,"Alabama","Cleburne County",2,52,201,112,89
050,01,029,"Alabama","Cleburne County",2,53,206,109,97
050,01,029,"Alabama","Cleburne County",2,54,209,104,105
050,01,029,"Alabama","Cleburne County",2,55,210,100,110
050,01,029,"Alabama","Cleburne County",2,56,223,107,116
050,01,029,"Alabama","Cleburne County",2,57,208,106,102
050,01,029,"Alabama","Cleburne County",2,58,224,117,107
050,01,029,"Alabama","Cleburne County",2,59,241,126,115
050,01,029,"Alabama","Cleburne County",2,60,229,112,117
050,01,029,"Alabama","Cleburne County",2,61,197,97,100
050,01,029,"Alabama","Cleburne County",2,62,197,85,112
050,01,029,"Alabama","Cleburne County",2,63,181,84,97
050,01,029,"Alabama","Cleburne County",2,64,171,76,95
050,01,029,"Alabama","Cleburne County",2,65,181,82,99
050,01,029,"Alabama","Cleburne County",2,66,211,104,107
050,01,029,"Alabama","Cleburne County",2,67,210,105,105
050,01,029,"Alabama","Cleburne County",2,68,181,87,94
050,01,029,"Alabama","Cleburne County",2,69,156,77,79
050,01,029,"Alabama","Cleburne County",2,70,165,81,84
050,01,029,"Alabama","Cleburne County",2,71,182,86,96
050,01,029,"Alabama","Cleburne County",2,72,174,83,91
050,01,029,"Alabama","Cleburne County",2,73,187,85,102
050,01,029,"Alabama","Cleburne County",2,74,123,56,67
050,01,029,"Alabama","Cleburne County",2,75,130,52,78
050,01,029,"Alabama","Cleburne County",2,76,113,48,65
050,01,029,"Alabama","Cleburne County",2,77,128,58,70
050,01,029,"Alabama","Cleburne County",2,78,110,51,59
050,01,029,"Alabama","Cleburne County",2,79,103,50,53
050,01,029,"Alabama","Cleburne County",2,80,85,41,44
050,01,029,"Alabama","Cleburne County",2,81,74,38,36
050,01,029,"Alabama","Cleburne County",2,82,65,32,33
050,01,029,"Alabama","Cleburne County",2,83,57,20,37
050,01,029,"Alabama","Cleburne County",2,84,48,17,31
050,01,029,"Alabama","Cleburne County",2,85,317,101,216
050,01,029,"Alabama","Cleburne County",3,0,175,94,81
050,01,029,"Alabama","Cleburne County",3,1,179,93,86
050,01,029,"Alabama","Cleburne County",3,2,171,83,88
050,01,029,"Alabama","Cleburne County",3,3,206,105,101
050,01,029,"Alabama","Cleburne County",3,4,200,103,97
050,01,029,"Alabama","Cleburne County",3,5,185,92,93
050,01,029,"Alabama","Cleburne County",3,6,181,86,95
050,01,029,"Alabama","Cleburne County",3,7,197,100,97
050,01,029,"Alabama","Cleburne County",3,8,180,85,95
050,01,029,"Alabama","Cleburne County",3,9,205,105,100
050,01,029,"Alabama","Cleburne County",3,10,201,106,95
050,01,029,"Alabama","Cleburne County",3,11,187,99,88
050,01,029,"Alabama","Cleburne County",3,12,207,108,99
050,01,029,"Alabama","Cleburne County",3,13,208,96,112
050,01,029,"Alabama","Cleburne County",3,14,204,104,100
050,01,029,"Alabama","Cleburne County",3,15,205,105,100
050,01,029,"Alabama","Cleburne County",3,16,206,99,107
050,01,029,"Alabama","Cleburne County",3,17,203,103,100
050,01,029,"Alabama","Cleburne County",3,18,157,94,63
050,01,029,"Alabama","Cleburne County",3,19,126,73,53
050,01,029,"Alabama","Cleburne County",3,20,151,87,64
050,01,029,"Alabama","Cleburne County",3,21,153,83,70
050,01,029,"Alabama","Cleburne County",3,22,166,80,86
050,01,029,"Alabama","Cleburne County",3,23,162,80,82
050,01,029,"Alabama","Cleburne County",3,24,163,90,73
050,01,029,"Alabama","Cleburne County",3,25,156,75,81
050,01,029,"Alabama","Cleburne County",3,26,158,76,82
050,01,029,"Alabama","Cleburne County",3,27,159,79,80
050,01,029,"Alabama","Cleburne County",3,28,190,91,99
050,01,029,"Alabama","Cleburne County",3,29,184,85,99
050,01,029,"Alabama","Cleburne County",3,30,184,91,93
050,01,029,"Alabama","Cleburne County",3,31,188,104,84
050,01,029,"Alabama","Cleburne County",3,32,176,100,76
050,01,029,"Alabama","Cleburne County",3,33,162,83,79
050,01,029,"Alabama","Cleburne County",3,34,164,76,88
050,01,029,"Alabama","Cleburne County",3,35,166,76,90
050,01,029,"Alabama","Cleburne County",3,36,173,80,93
050,01,029,"Alabama","Cleburne County",3,37,181,82,99
050,01,029,"Alabama","Cleburne County",3,38,181,82,99
050,01,029,"Alabama","Cleburne County",3,39,191,97,94
050,01,029,"Alabama","Cleburne County",3,40,175,93,82
050,01,029,"Alabama","Cleburne County",3,41,167,87,80
050,01,029,"Alabama","Cleburne County",3,42,160,88,72
050,01,029,"Alabama","Cleburne County",3,43,166,89,77
050,01,029,"Alabama","Cleburne County",3,44,167,82,85
050,01,029,"Alabama","Cleburne County",3,45,170,84,86
050,01,029,"Alabama","Cleburne County",3,46,185,88,97
050,01,029,"Alabama","Cleburne County",3,47,216,115,101
050,01,029,"Alabama","Cleburne County",3,48,203,104,99
050,01,029,"Alabama","Cleburne County",3,49,210,99,111
050,01,029,"Alabama","Cleburne County",3,50,221,112,109
050,01,029,"Alabama","Cleburne County",3,51,224,113,111
050,01,029,"Alabama","Cleburne County",3,52,199,109,90
050,01,029,"Alabama","Cleburne County",3,53,206,115,91
050,01,029,"Alabama","Cleburne County",3,54,199,104,95
050,01,029,"Alabama","Cleburne County",3,55,203,102,101
050,01,029,"Alabama","Cleburne County",3,56,210,97,113
050,01,029,"Alabama","Cleburne County",3,57,232,112,120
050,01,029,"Alabama","Cleburne County",3,58,206,106,100
050,01,029,"Alabama","Cleburne County",3,59,227,117,110
050,01,029,"Alabama","Cleburne County",3,60,239,124,115
050,01,029,"Alabama","Cleburne County",3,61,227,109,118
050,01,029,"Alabama","Cleburne County",3,62,199,96,103
050,01,029,"Alabama","Cleburne County",3,63,195,85,110
050,01,029,"Alabama","Cleburne County",3,64,173,80,93
050,01,029,"Alabama","Cleburne County",3,65,168,72,96
050,01,029,"Alabama","Cleburne County",3,66,178,80,98
050,01,029,"Alabama","Cleburne County",3,67,208,102,106
050,01,029,"Alabama","Cleburne County",3,68,203,101,102
050,01,029,"Alabama","Cleburne County",3,69,175,84,91
050,01,029,"Alabama","Cleburne County",3,70,151,75,76
050,01,029,"Alabama","Cleburne County",3,71,163,80,83
050,01,029,"Alabama","Cleburne County",3,72,174,80,94
050,01,029,"Alabama","Cleburne County",3,73,171,82,89
050,01,029,"Alabama","Cleburne County",3,74,175,81,94
050,01,029,"Alabama","Cleburne County",3,75,124,53,71
050,01,029,"Alabama","Cleburne County",3,76,114,44,70
050,01,029,"Alabama","Cleburne County",3,77,118,48,70
050,01,029,"Alabama","Cleburne County",3,78,120,54,66
050,01,029,"Alabama","Cleburne County",3,79,100,44,56
050,01,029,"Alabama","Cleburne County",3,80,88,41,47
050,01,029,"Alabama","Cleburne County",3,81,86,40,46
050,01,029,"Alabama","Cleburne County",3,82,58,32,26
050,01,029,"Alabama","Cleburne County",3,83,53,27,26
050,01,029,"Alabama","Cleburne County",3,84,45,18,27
050,01,029,"Alabama","Cleburne County",3,85,314,101,213
050,01,029,"Alabama","Cleburne County",4,0,182,79,103
050,01,029,"Alabama","Cleburne County",4,1,185,106,79
050,01,029,"Alabama","Cleburne County",4,2,195,106,89
050,01,029,"Alabama","Cleburne County",4,3,166,82,84
050,01,029,"Alabama","Cleburne County",4,4,203,104,99
050,01,029,"Alabama","Cleburne County",4,5,203,100,103
050,01,029,"Alabama","Cleburne County",4,6,189,101,88
050,01,029,"Alabama","Cleburne County",4,7,182,82,100
050,01,029,"Alabama","Cleburne County",4,8,207,104,103
050,01,029,"Alabama","Cleburne County",4,9,190,92,98
050,01,029,"Alabama","Cleburne County",4,10,208,111,97
050,01,029,"Alabama","Cleburne County",4,11,202,104,98
050,01,029,"Alabama","Cleburne County",4,12,187,100,87
050,01,029,"Alabama","Cleburne County",4,13,209,108,101
050,01,029,"Alabama","Cleburne County",4,14,217,107,110
050,01,029,"Alabama","Cleburne County",4,15,218,112,106
050,01,029,"Alabama","Cleburne County",4,16,210,105,105
050,01,029,"Alabama","Cleburne County",4,17,195,94,101
050,01,029,"Alabama","Cleburne County",4,18,166,88,78
050,01,029,"Alabama","Cleburne County",4,19,119,69,50
050,01,029,"Alabama","Cleburne County",4,20,133,74,59
050,01,029,"Alabama","Cleburne County",4,21,153,91,62
050,01,029,"Alabama","Cleburne County",4,22,154,84,70
050,01,029,"Alabama","Cleburne County",4,23,172,83,89
050,01,029,"Alabama","Cleburne County",4,24,166,80,86
050,01,029,"Alabama","Cleburne County",4,25,182,99,83
050,01,029,"Alabama","Cleburne County",4,26,153,81,72
050,01,029,"Alabama","Cleburne County",4,27,162,77,85
050,01,029,"Alabama","Cleburne County",4,28,173,92,81
050,01,029,"Alabama","Cleburne County",4,29,197,92,105
050,01,029,"Alabama","Cleburne County",4,30,186,86,100
050,01,029,"Alabama","Cleburne County",4,31,185,90,95
050,01,029,"Alabama","Cleburne County",4,32,208,111,97
050,01,029,"Alabama","Cleburne County",4,33,185,106,79
050,01,029,"Alabama","Cleburne County",4,34,172,85,87
050,01,029,"Alabama","Cleburne County",4,35,162,77,85
050,01,029,"Alabama","Cleburne County",4,36,169,76,93
050,01,029,"Alabama","Cleburne County",4,37,173,79,94
050,01,029,"Alabama","Cleburne County",4,38,191,89,102
050,01,029,"Alabama","Cleburne County",4,39,191,89,102
050,01,029,"Alabama","Cleburne County",4,40,198,101,97
050,01,029,"Alabama","Cleburne County",4,41,181,98,83
050,01,029,"Alabama","Cleburne County",4,42,166,86,80
050,01,029,"Alabama","Cleburne County",4,43,161,90,71
050,01,029,"Alabama","Cleburne County",4,44,170,85,85
050,01,029,"Alabama","Cleburne County",4,45,173,87,86
050,01,029,"Alabama","Cleburne County",4,46,174,87,87
050,01,029,"Alabama","Cleburne County",4,47,188,86,102
050,01,029,"Alabama","Cleburne County",4,48,217,115,102
050,01,029,"Alabama","Cleburne County",4,49,208,112,96
050,01,029,"Alabama","Cleburne County",4,50,204,100,104
050,01,029,"Alabama","Cleburne County",4,51,232,113,119
050,01,029,"Alabama","Cleburne County",4,52,227,115,112
050,01,029,"Alabama","Cleburne County",4,53,198,108,90
050,01,029,"Alabama","Cleburne County",4,54,212,118,94
050,01,029,"Alabama","Cleburne County",4,55,207,110,97
050,01,029,"Alabama","Cleburne County",4,56,208,103,105
050,01,029,"Alabama","Cleburne County",4,57,211,95,116
050,01,029,"Alabama","Cleburne County",4,58,235,113,122
050,01,029,"Alabama","Cleburne County",4,59,205,106,99
050,01,029,"Alabama","Cleburne County",4,60,231,122,109
050,01,029,"Alabama","Cleburne County",4,61,230,119,111
050,01,029,"Alabama","Cleburne County",4,62,229,112,117
050,01,029,"Alabama","Cleburne County",4,63,196,98,98
050,01,029,"Alabama","Cleburne County",4,64,199,88,111
050,01,029,"Alabama","Cleburne County",4,65,176,82,94
050,01,029,"Alabama","Cleburne County",4,66,174,75,99
050,01,029,"Alabama","Cleburne County",4,67,174,79,95
050,01,029,"Alabama","Cleburne County",4,68,204,100,104
050,01,029,"Alabama","Cleburne County",4,69,196,96,100
050,01,029,"Alabama","Cleburne County",4,70,174,84,90
050,01,029,"Alabama","Cleburne County",4,71,147,70,77
050,01,029,"Alabama","Cleburne County",4,72,157,78,79
050,01,029,"Alabama","Cleburne County",4,73,168,76,92
050,01,029,"Alabama","Cleburne County",4,74,166,78,88
050,01,029,"Alabama","Cleburne County",4,75,173,79,94
050,01,029,"Alabama","Cleburne County",4,76,115,50,65
050,01,029,"Alabama","Cleburne County",4,77,114,44,70
050,01,029,"Alabama","Cleburne County",4,78,110,44,66
050,01,029,"Alabama","Cleburne County",4,79,114,50,64
050,01,029,"Alabama","Cleburne County",4,80,89,40,49
050,01,029,"Alabama","Cleburne County",4,81,87,39,48
050,01,029,"Alabama","Cleburne County",4,82,77,36,41
050,01,029,"Alabama","Cleburne County",4,83,47,26,21
050,01,029,"Alabama","Cleburne County",4,84,46,26,20
050,01,029,"Alabama","Cleburne County",4,85,304,100,204
050,01,029,"Alabama","Cleburne County",5,0,176,75,101
050,01,029,"Alabama","Cleburne County",5,1,188,84,104
050,01,029,"Alabama","Cleburne County",5,2,185,106,79
050,01,029,"Alabama","Cleburne County",5,3,192,103,89
050,01,029,"Alabama","Cleburne County",5,4,184,88,96
050,01,029,"Alabama","Cleburne County",5,5,207,109,98
050,01,029,"Alabama","Cleburne County",5,6,220,117,103
050,01,029,"Alabama","Cleburne County",5,7,192,105,87
050,01,029,"Alabama","Cleburne County",5,8,195,92,103
050,01,029,"Alabama","Cleburne County",5,9,204,99,105
050,01,029,"Alabama","Cleburne County",5,10,205,97,108
050,01,029,"Alabama","Cleburne County",5,11,207,107,100
050,01,029,"Alabama","Cleburne County",5,12,200,104,96
050,01,029,"Alabama","Cleburne County",5,13,189,99,90
050,01,029,"Alabama","Cleburne County",5,14,209,108,101
050,01,029,"Alabama","Cleburne County",5,15,234,119,115
050,01,029,"Alabama","Cleburne County",5,16,225,116,109
050,01,029,"Alabama","Cleburne County",5,17,211,111,100
050,01,029,"Alabama","Cleburne County",5,18,160,79,81
050,01,029,"Alabama","Cleburne County",5,19,132,69,63
050,01,029,"Alabama","Cleburne County",5,20,133,78,55
050,01,029,"Alabama","Cleburne County",5,21,146,79,67
050,01,029,"Alabama","Cleburne County",5,22,165,91,74
050,01,029,"Alabama","Cleburne County",5,23,177,96,81
050,01,029,"Alabama","Cleburne County",5,24,162,84,78
050,01,029,"Alabama","Cleburne County",5,25,164,78,86
050,01,029,"Alabama","Cleburne County",5,26,188,108,80
050,01,029,"Alabama","Cleburne County",5,27,174,92,82
050,01,029,"Alabama","Cleburne County",5,28,157,76,81
050,01,029,"Alabama","Cleburne County",5,29,187,102,85
050,01,029,"Alabama","Cleburne County",5,30,202,96,106
050,01,029,"Alabama","Cleburne County",5,31,200,97,103
050,01,029,"Alabama","Cleburne County",5,32,204,101,103
050,01,029,"Alabama","Cleburne County",5,33,215,117,98
050,01,029,"Alabama","Cleburne County",5,34,193,109,84
050,01,029,"Alabama","Cleburne County",5,35,176,87,89
050,01,029,"Alabama","Cleburne County",5,36,158,79,79
050,01,029,"Alabama","Cleburne County",5,37,173,76,97
050,01,029,"Alabama","Cleburne County",5,38,177,81,96
050,01,029,"Alabama","Cleburne County",5,39,194,92,102
050,01,029,"Alabama","Cleburne County",5,40,187,87,100
050,01,029,"Alabama","Cleburne County",5,41,193,98,95
050,01,029,"Alabama","Cleburne County",5,42,190,105,85
050,01,029,"Alabama","Cleburne County",5,43,180,90,90
050,01,029,"Alabama","Cleburne County",5,44,160,89,71
050,01,029,"Alabama","Cleburne County",5,45,187,97,90
050,01,029,"Alabama","Cleburne County",5,46,175,84,91
050,01,029,"Alabama","Cleburne County",5,47,169,86,83
050,01,029,"Alabama","Cleburne County",5,48,185,83,102
050,01,029,"Alabama","Cleburne County",5,49,218,116,102
050,01,029,"Alabama","Cleburne County",5,50,210,112,98
050,01,029,"Alabama","Cleburne County",5,51,202,101,101
050,01,029,"Alabama","Cleburne County",5,52,230,108,122
050,01,029,"Alabama","Cleburne County",5,53,225,111,114
050,01,029,"Alabama","Cleburne County",5,54,209,115,94
050,01,029,"Alabama","Cleburne County",5,55,221,121,100
050,01,029,"Alabama","Cleburne County",5,56,225,118,107
050,01,029,"Alabama","Cleburne County",5,57,214,106,108
050,01,029,"Alabama","Cleburne County",5,58,213,95,118
050,01,029,"Alabama","Cleburne County",5,59,231,108,123
050,01,029,"Alabama","Cleburne County",5,60,202,101,101
050,01,029,"Alabama","Cleburne County",5,61,224,117,107
050,01,029,"Alabama","Cleburne County",5,62,242,127,115
050,01,029,"Alabama","Cleburne County",5,63,239,116,123
050,01,029,"Alabama","Cleburne County",5,64,195,98,97
050,01,029,"Alabama","Cleburne County",5,65,193,86,107
050,01,029,"Alabama","Cleburne County",5,66,173,82,91
050,01,029,"Alabama","Cleburne County",5,67,166,71,95
050,01,029,"Alabama","Cleburne County",5,68,169,73,96
050,01,029,"Alabama","Cleburne County",5,69,198,95,103
050,01,029,"Alabama","Cleburne County",5,70,186,92,94
050,01,029,"Alabama","Cleburne County",5,71,172,81,91
050,01,029,"Alabama","Cleburne County",5,72,142,65,77
050,01,029,"Alabama","Cleburne County",5,73,156,78,78
050,01,029,"Alabama","Cleburne County",5,74,158,72,86
050,01,029,"Alabama","Cleburne County",5,75,166,77,89
050,01,029,"Alabama","Cleburne County",5,76,160,74,86
050,01,029,"Alabama","Cleburne County",5,77,114,47,67
050,01,029,"Alabama","Cleburne County",5,78,109,41,68
050,01,029,"Alabama","Cleburne County",5,79,108,41,67
050,01,029,"Alabama","Cleburne County",5,80,101,44,57
050,01,029,"Alabama","Cleburne County",5,81,88,39,49
050,01,029,"Alabama","Cleburne County",5,82,80,35,45
050,01,029,"Alabama","Cleburne County",5,83,69,31,38
050,01,029,"Alabama","Cleburne County",5,84,39,25,14
050,01,029,"Alabama","Cleburne County",5,85,306,109,197
050,01,031,"Alabama","Coffee County",1,0,566,291,275
050,01,031,"Alabama","Coffee County",1,1,592,302,290
050,01,031,"Alabama","Coffee County",1,2,644,354,290
050,01,031,"Alabama","Coffee County",1,3,697,357,340
050,01,031,"Alabama","Coffee County",1,4,714,361,353
050,01,031,"Alabama","Coffee County",1,5,673,361,312
050,01,031,"Alabama","Coffee County",1,6,702,375,327
050,01,031,"Alabama","Coffee County",1,7,713,370,343
050,01,031,"Alabama","Coffee County",1,8,695,341,354
050,01,031,"Alabama","Coffee County",1,9,722,368,354
050,01,031,"Alabama","Coffee County",1,10,721,356,365
050,01,031,"Alabama","Coffee County",1,11,768,371,397
050,01,031,"Alabama","Coffee County",1,12,769,397,372
050,01,031,"Alabama","Coffee County",1,13,787,405,382
050,01,031,"Alabama","Coffee County",1,14,782,416,366
050,01,031,"Alabama","Coffee County",1,15,730,369,361
050,01,031,"Alabama","Coffee County",1,16,732,368,364
050,01,031,"Alabama","Coffee County",1,17,741,376,365
050,01,031,"Alabama","Coffee County",1,18,630,330,300
050,01,031,"Alabama","Coffee County",1,19,518,278,240
050,01,031,"Alabama","Coffee County",1,20,558,292,266
050,01,031,"Alabama","Coffee County",1,21,573,295,278
050,01,031,"Alabama","Coffee County",1,22,619,323,296
050,01,031,"Alabama","Coffee County",1,23,678,368,310
050,01,031,"Alabama","Coffee County",1,24,678,368,310
050,01,031,"Alabama","Coffee County",1,25,647,318,329
050,01,031,"Alabama","Coffee County",1,26,621,311,310
050,01,031,"Alabama","Coffee County",1,27,660,341,319
050,01,031,"Alabama","Coffee County",1,28,695,366,329
050,01,031,"Alabama","Coffee County",1,29,679,341,338
050,01,031,"Alabama","Coffee County",1,30,738,371,367
050,01,031,"Alabama","Coffee County",1,31,704,367,337
050,01,031,"Alabama","Coffee County",1,32,685,350,335
050,01,031,"Alabama","Coffee County",1,33,637,337,300
050,01,031,"Alabama","Coffee County",1,34,678,343,335
050,01,031,"Alabama","Coffee County",1,35,694,360,334
050,01,031,"Alabama","Coffee County",1,36,715,385,330
050,01,031,"Alabama","Coffee County",1,37,711,363,348
050,01,031,"Alabama","Coffee County",1,38,706,339,367
050,01,031,"Alabama","Coffee County",1,39,719,342,377
050,01,031,"Alabama","Coffee County",1,40,725,365,360
050,01,031,"Alabama","Coffee County",1,41,661,342,319
050,01,031,"Alabama","Coffee County",1,42,667,348,319
050,01,031,"Alabama","Coffee County",1,43,655,334,321
050,01,031,"Alabama","Coffee County",1,44,674,339,335
050,01,031,"Alabama","Coffee County",1,45,745,378,367
050,01,031,"Alabama","Coffee County",1,46,714,360,354
050,01,031,"Alabama","Coffee County",1,47,706,336,370
050,01,031,"Alabama","Coffee County",1,48,745,362,383
050,01,031,"Alabama","Coffee County",1,49,774,393,381
050,01,031,"Alabama","Coffee County",1,50,704,366,338
050,01,031,"Alabama","Coffee County",1,51,662,333,329
050,01,031,"Alabama","Coffee County",1,52,693,355,338
050,01,031,"Alabama","Coffee County",1,53,648,315,333
050,01,031,"Alabama","Coffee County",1,54,687,335,352
050,01,031,"Alabama","Coffee County",1,55,710,361,349
050,01,031,"Alabama","Coffee County",1,56,687,365,322
050,01,031,"Alabama","Coffee County",1,57,634,325,309
050,01,031,"Alabama","Coffee County",1,58,669,343,326
050,01,031,"Alabama","Coffee County",1,59,682,356,326
050,01,031,"Alabama","Coffee County",1,60,660,318,342
050,01,031,"Alabama","Coffee County",1,61,687,318,369
050,01,031,"Alabama","Coffee County",1,62,673,325,348
050,01,031,"Alabama","Coffee County",1,63,657,308,349
050,01,031,"Alabama","Coffee County",1,64,606,287,319
050,01,031,"Alabama","Coffee County",1,65,618,273,345
050,01,031,"Alabama","Coffee County",1,66,617,297,320
050,01,031,"Alabama","Coffee County",1,67,554,274,280
050,01,031,"Alabama","Coffee County",1,68,533,237,296
050,01,031,"Alabama","Coffee County",1,69,530,242,288
050,01,031,"Alabama","Coffee County",1,70,530,258,272
050,01,031,"Alabama","Coffee County",1,71,529,258,271
050,01,031,"Alabama","Coffee County",1,72,557,268,289
050,01,031,"Alabama","Coffee County",1,73,552,265,287
050,01,031,"Alabama","Coffee County",1,74,390,183,207
050,01,031,"Alabama","Coffee County",1,75,384,169,215
050,01,031,"Alabama","Coffee County",1,76,370,167,203
050,01,031,"Alabama","Coffee County",1,77,346,150,196
050,01,031,"Alabama","Coffee County",1,78,281,122,159
050,01,031,"Alabama","Coffee County",1,79,251,104,147
050,01,031,"Alabama","Coffee County",1,80,224,83,141
050,01,031,"Alabama","Coffee County",1,81,231,89,142
050,01,031,"Alabama","Coffee County",1,82,226,96,130
050,01,031,"Alabama","Coffee County",1,83,206,86,120
050,01,031,"Alabama","Coffee County",1,84,196,73,123
050,01,031,"Alabama","Coffee County",1,85,918,320,598
050,01,031,"Alabama","Coffee County",2,0,587,288,299
050,01,031,"Alabama","Coffee County",2,1,589,302,287
050,01,031,"Alabama","Coffee County",2,2,639,344,295
050,01,031,"Alabama","Coffee County",2,3,690,360,330
050,01,031,"Alabama","Coffee County",2,4,713,362,351
050,01,031,"Alabama","Coffee County",2,5,685,361,324
050,01,031,"Alabama","Coffee County",2,6,698,371,327
050,01,031,"Alabama","Coffee County",2,7,717,375,342
050,01,031,"Alabama","Coffee County",2,8,707,353,354
050,01,031,"Alabama","Coffee County",2,9,716,360,356
050,01,031,"Alabama","Coffee County",2,10,721,359,362
050,01,031,"Alabama","Coffee County",2,11,757,373,384
050,01,031,"Alabama","Coffee County",2,12,771,394,377
050,01,031,"Alabama","Coffee County",2,13,786,405,381
050,01,031,"Alabama","Coffee County",2,14,780,412,368
050,01,031,"Alabama","Coffee County",2,15,742,379,363
050,01,031,"Alabama","Coffee County",2,16,732,370,362
050,01,031,"Alabama","Coffee County",2,17,741,376,365
050,01,031,"Alabama","Coffee County",2,18,623,325,298
050,01,031,"Alabama","Coffee County",2,19,523,278,245
050,01,031,"Alabama","Coffee County",2,20,563,296,267
050,01,031,"Alabama","Coffee County",2,21,580,298,282
050,01,031,"Alabama","Coffee County",2,22,625,326,299
050,01,031,"Alabama","Coffee County",2,23,675,363,312
050,01,031,"Alabama","Coffee County",2,24,672,359,313
050,01,031,"Alabama","Coffee County",2,25,651,327,324
050,01,031,"Alabama","Coffee County",2,26,633,317,316
050,01,031,"Alabama","Coffee County",2,27,659,341,318
050,01,031,"Alabama","Coffee County",2,28,687,359,328
050,01,031,"Alabama","Coffee County",2,29,695,350,345
050,01,031,"Alabama","Coffee County",2,30,732,366,366
050,01,031,"Alabama","Coffee County",2,31,707,364,343
050,01,031,"Alabama","Coffee County",2,32,688,354,334
050,01,031,"Alabama","Coffee County",2,33,649,338,311
050,01,031,"Alabama","Coffee County",2,34,664,338,326
050,01,031,"Alabama","Coffee County",2,35,705,362,343
050,01,031,"Alabama","Coffee County",2,36,700,374,326
050,01,031,"Alabama","Coffee County",2,37,715,370,345
050,01,031,"Alabama","Coffee County",2,38,708,343,365
050,01,031,"Alabama","Coffee County",2,39,713,338,375
050,01,031,"Alabama","Coffee County",2,40,727,361,366
050,01,031,"Alabama","Coffee County",2,41,673,346,327
050,01,031,"Alabama","Coffee County",2,42,656,340,316
050,01,031,"Alabama","Coffee County",2,43,660,336,324
050,01,031,"Alabama","Coffee County",2,44,664,334,330
050,01,031,"Alabama","Coffee County",2,45,733,371,362
050,01,031,"Alabama","Coffee County",2,46,718,362,356
050,01,031,"Alabama","Coffee County",2,47,700,335,365
050,01,031,"Alabama","Coffee County",2,48,738,356,382
050,01,031,"Alabama","Coffee County",2,49,776,388,388
050,01,031,"Alabama","Coffee County",2,50,719,372,347
050,01,031,"Alabama","Coffee County",2,51,672,343,329
050,01,031,"Alabama","Coffee County",2,52,685,348,337
050,01,031,"Alabama","Coffee County",2,53,655,318,337
050,01,031,"Alabama","Coffee County",2,54,677,332,345
050,01,031,"Alabama","Coffee County",2,55,705,354,351
050,01,031,"Alabama","Coffee County",2,56,695,363,332
050,01,031,"Alabama","Coffee County",2,57,653,336,317
050,01,031,"Alabama","Coffee County",2,58,662,341,321
050,01,031,"Alabama","Coffee County",2,59,679,355,324
050,01,031,"Alabama","Coffee County",2,60,669,329,340
050,01,031,"Alabama","Coffee County",2,61,676,314,362
050,01,031,"Alabama","Coffee County",2,62,672,320,352
050,01,031,"Alabama","Coffee County",2,63,664,314,350
050,01,031,"Alabama","Coffee County",2,64,614,288,326
050,01,031,"Alabama","Coffee County",2,65,616,277,339
050,01,031,"Alabama","Coffee County",2,66,622,294,328
050,01,031,"Alabama","Coffee County",2,67,566,278,288
050,01,031,"Alabama","Coffee County",2,68,529,242,287
050,01,031,"Alabama","Coffee County",2,69,534,243,291
050,01,031,"Alabama","Coffee County",2,70,528,253,275
050,01,031,"Alabama","Coffee County",2,71,528,256,272
050,01,031,"Alabama","Coffee County",2,72,538,259,279
050,01,031,"Alabama","Coffee County",2,73,576,277,299
050,01,031,"Alabama","Coffee County",2,74,400,186,214
050,01,031,"Alabama","Coffee County",2,75,381,171,210
050,01,031,"Alabama","Coffee County",2,76,362,164,198
050,01,031,"Alabama","Coffee County",2,77,355,154,201
050,01,031,"Alabama","Coffee County",2,78,285,121,164
050,01,031,"Alabama","Coffee County",2,79,252,106,146
050,01,031,"Alabama","Coffee County",2,80,228,87,141
050,01,031,"Alabama","Coffee County",2,81,222,83,139
050,01,031,"Alabama","Coffee County",2,82,225,95,130
050,01,031,"Alabama","Coffee County",2,83,205,86,119
050,01,031,"Alabama","Coffee County",2,84,193,73,120
050,01,031,"Alabama","Coffee County",2,85,924,328,596
050,01,031,"Alabama","Coffee County",3,0,722,342,380
050,01,031,"Alabama","Coffee County",3,1,614,301,313
050,01,031,"Alabama","Coffee County",3,2,650,329,321
050,01,031,"Alabama","Coffee County",3,3,657,359,298
050,01,031,"Alabama","Coffee County",3,4,704,373,331
050,01,031,"Alabama","Coffee County",3,5,712,361,351
050,01,031,"Alabama","Coffee County",3,6,695,369,326
050,01,031,"Alabama","Coffee County",3,7,723,379,344
050,01,031,"Alabama","Coffee County",3,8,721,375,346
050,01,031,"Alabama","Coffee County",3,9,727,359,368
050,01,031,"Alabama","Coffee County",3,10,724,361,363
050,01,031,"Alabama","Coffee County",3,11,746,359,387
050,01,031,"Alabama","Coffee County",3,12,782,379,403
050,01,031,"Alabama","Coffee County",3,13,798,402,396
050,01,031,"Alabama","Coffee County",3,14,787,409,378
050,01,031,"Alabama","Coffee County",3,15,804,428,376
050,01,031,"Alabama","Coffee County",3,16,771,390,381
050,01,031,"Alabama","Coffee County",3,17,755,383,372
050,01,031,"Alabama","Coffee County",3,18,653,329,324
050,01,031,"Alabama","Coffee County",3,19,524,275,249
050,01,031,"Alabama","Coffee County",3,20,542,282,260
050,01,031,"Alabama","Coffee County",3,21,566,287,279
050,01,031,"Alabama","Coffee County",3,22,614,319,295
050,01,031,"Alabama","Coffee County",3,23,732,398,334
050,01,031,"Alabama","Coffee County",3,24,684,360,324
050,01,031,"Alabama","Coffee County",3,25,643,340,303
050,01,031,"Alabama","Coffee County",3,26,634,314,320
050,01,031,"Alabama","Coffee County",3,27,663,344,319
050,01,031,"Alabama","Coffee County",3,28,717,363,354
050,01,031,"Alabama","Coffee County",3,29,669,338,331
050,01,031,"Alabama","Coffee County",3,30,671,353,318
050,01,031,"Alabama","Coffee County",3,31,749,371,378
050,01,031,"Alabama","Coffee County",3,32,737,374,363
050,01,031,"Alabama","Coffee County",3,33,685,346,339
050,01,031,"Alabama","Coffee County",3,34,668,357,311
050,01,031,"Alabama","Coffee County",3,35,715,360,355
050,01,031,"Alabama","Coffee County",3,36,708,370,338
050,01,031,"Alabama","Coffee County",3,37,719,377,342
050,01,031,"Alabama","Coffee County",3,38,686,345,341
050,01,031,"Alabama","Coffee County",3,39,719,341,378
050,01,031,"Alabama","Coffee County",3,40,723,354,369
050,01,031,"Alabama","Coffee County",3,41,738,369,369
050,01,031,"Alabama","Coffee County",3,42,668,334,334
050,01,031,"Alabama","Coffee County",3,43,648,333,315
050,01,031,"Alabama","Coffee County",3,44,667,341,326
050,01,031,"Alabama","Coffee County",3,45,696,359,337
050,01,031,"Alabama","Coffee County",3,46,765,393,372
050,01,031,"Alabama","Coffee County",3,47,697,344,353
050,01,031,"Alabama","Coffee County",3,48,711,341,370
050,01,031,"Alabama","Coffee County",3,49,748,351,397
050,01,031,"Alabama","Coffee County",3,50,781,389,392
050,01,031,"Alabama","Coffee County",3,51,712,359,353
050,01,031,"Alabama","Coffee County",3,52,700,351,349
050,01,031,"Alabama","Coffee County",3,53,664,337,327
050,01,031,"Alabama","Coffee County",3,54,654,337,317
050,01,031,"Alabama","Coffee County",3,55,638,308,330
050,01,031,"Alabama","Coffee County",3,56,697,351,346
050,01,031,"Alabama","Coffee County",3,57,685,362,323
050,01,031,"Alabama","Coffee County",3,58,658,338,320
050,01,031,"Alabama","Coffee County",3,59,648,333,315
050,01,031,"Alabama","Coffee County",3,60,683,360,323
050,01,031,"Alabama","Coffee County",3,61,661,321,340
050,01,031,"Alabama","Coffee County",3,62,665,309,356
050,01,031,"Alabama","Coffee County",3,63,662,308,354
050,01,031,"Alabama","Coffee County",3,64,651,301,350
050,01,031,"Alabama","Coffee County",3,65,600,276,324
050,01,031,"Alabama","Coffee County",3,66,620,277,343
050,01,031,"Alabama","Coffee County",3,67,604,283,321
050,01,031,"Alabama","Coffee County",3,68,553,269,284
050,01,031,"Alabama","Coffee County",3,69,518,235,283
050,01,031,"Alabama","Coffee County",3,70,513,232,281
050,01,031,"Alabama","Coffee County",3,71,511,238,273
050,01,031,"Alabama","Coffee County",3,72,515,253,262
050,01,031,"Alabama","Coffee County",3,73,522,251,271
050,01,031,"Alabama","Coffee County",3,74,563,265,298
050,01,031,"Alabama","Coffee County",3,75,389,176,213
050,01,031,"Alabama","Coffee County",3,76,353,155,198
050,01,031,"Alabama","Coffee County",3,77,353,162,191
050,01,031,"Alabama","Coffee County",3,78,333,133,200
050,01,031,"Alabama","Coffee County",3,79,259,112,147
050,01,031,"Alabama","Coffee County",3,80,231,101,130
050,01,031,"Alabama","Coffee County",3,81,207,76,131
050,01,031,"Alabama","Coffee County",3,82,206,79,127
050,01,031,"Alabama","Coffee County",3,83,213,87,126
050,01,031,"Alabama","Coffee County",3,84,181,73,108
050,01,031,"Alabama","Coffee County",3,85,945,349,596
050,01,031,"Alabama","Coffee County",4,0,669,338,331
050,01,031,"Alabama","Coffee County",4,1,723,345,378
050,01,031,"Alabama","Coffee County",4,2,626,306,320
050,01,031,"Alabama","Coffee County",4,3,663,339,324
050,01,031,"Alabama","Coffee County",4,4,654,364,290
050,01,031,"Alabama","Coffee County",4,5,684,348,336
050,01,031,"Alabama","Coffee County",4,6,757,385,372
050,01,031,"Alabama","Coffee County",4,7,711,384,327
050,01,031,"Alabama","Coffee County",4,8,741,391,350
050,01,031,"Alabama","Coffee County",4,9,726,373,353
050,01,031,"Alabama","Coffee County",4,10,737,374,363
050,01,031,"Alabama","Coffee County",4,11,756,386,370
050,01,031,"Alabama","Coffee County",4,12,755,373,382
050,01,031,"Alabama","Coffee County",4,13,797,404,393
050,01,031,"Alabama","Coffee County",4,14,804,406,398
050,01,031,"Alabama","Coffee County",4,15,833,436,397
050,01,031,"Alabama","Coffee County",4,16,805,429,376
050,01,031,"Alabama","Coffee County",4,17,772,381,391
050,01,031,"Alabama","Coffee County",4,18,650,334,316
050,01,031,"Alabama","Coffee County",4,19,538,271,267
050,01,031,"Alabama","Coffee County",4,20,559,291,268
050,01,031,"Alabama","Coffee County",4,21,544,283,261
050,01,031,"Alabama","Coffee County",4,22,605,320,285
050,01,031,"Alabama","Coffee County",4,23,723,385,338
050,01,031,"Alabama","Coffee County",4,24,759,425,334
050,01,031,"Alabama","Coffee County",4,25,659,332,327
050,01,031,"Alabama","Coffee County",4,26,633,333,300
050,01,031,"Alabama","Coffee County",4,27,640,323,317
050,01,031,"Alabama","Coffee County",4,28,679,338,341
050,01,031,"Alabama","Coffee County",4,29,715,358,357
050,01,031,"Alabama","Coffee County",4,30,692,353,339
050,01,031,"Alabama","Coffee County",4,31,671,356,315
050,01,031,"Alabama","Coffee County",4,32,731,358,373
050,01,031,"Alabama","Coffee County",4,33,732,367,365
050,01,031,"Alabama","Coffee County",4,34,688,351,337
050,01,031,"Alabama","Coffee County",4,35,654,336,318
050,01,031,"Alabama","Coffee County",4,36,708,352,356
050,01,031,"Alabama","Coffee County",4,37,730,389,341
050,01,031,"Alabama","Coffee County",4,38,755,396,359
050,01,031,"Alabama","Coffee County",4,39,692,356,336
050,01,031,"Alabama","Coffee County",4,40,776,384,392
050,01,031,"Alabama","Coffee County",4,41,742,366,376
050,01,031,"Alabama","Coffee County",4,42,751,366,385
050,01,031,"Alabama","Coffee County",4,43,684,346,338
050,01,031,"Alabama","Coffee County",4,44,690,353,337
050,01,031,"Alabama","Coffee County",4,45,654,331,323
050,01,031,"Alabama","Coffee County",4,46,716,382,334
050,01,031,"Alabama","Coffee County",4,47,758,369,389
050,01,031,"Alabama","Coffee County",4,48,695,339,356
050,01,031,"Alabama","Coffee County",4,49,729,344,385
050,01,031,"Alabama","Coffee County",4,50,748,365,383
050,01,031,"Alabama","Coffee County",4,51,773,386,387
050,01,031,"Alabama","Coffee County",4,52,725,367,358
050,01,031,"Alabama","Coffee County",4,53,672,336,336
050,01,031,"Alabama","Coffee County",4,54,680,349,331
050,01,031,"Alabama","Coffee County",4,55,646,318,328
050,01,031,"Alabama","Coffee County",4,56,634,305,329
050,01,031,"Alabama","Coffee County",4,57,714,366,348
050,01,031,"Alabama","Coffee County",4,58,673,361,312
050,01,031,"Alabama","Coffee County",4,59,651,326,325
050,01,031,"Alabama","Coffee County",4,60,658,332,326
050,01,031,"Alabama","Coffee County",4,61,674,357,317
050,01,031,"Alabama","Coffee County",4,62,642,312,330
050,01,031,"Alabama","Coffee County",4,63,678,312,366
050,01,031,"Alabama","Coffee County",4,64,673,311,362
050,01,031,"Alabama","Coffee County",4,65,650,301,349
050,01,031,"Alabama","Coffee County",4,66,598,275,323
050,01,031,"Alabama","Coffee County",4,67,612,273,339
050,01,031,"Alabama","Coffee County",4,68,595,273,322
050,01,031,"Alabama","Coffee County",4,69,537,263,274
050,01,031,"Alabama","Coffee County",4,70,519,237,282
050,01,031,"Alabama","Coffee County",4,71,495,218,277
050,01,031,"Alabama","Coffee County",4,72,505,236,269
050,01,031,"Alabama","Coffee County",4,73,502,240,262
050,01,031,"Alabama","Coffee County",4,74,498,240,258
050,01,031,"Alabama","Coffee County",4,75,547,254,293
050,01,031,"Alabama","Coffee County",4,76,372,167,205
050,01,031,"Alabama","Coffee County",4,77,332,141,191
050,01,031,"Alabama","Coffee County",4,78,349,160,189
050,01,031,"Alabama","Coffee County",4,79,317,129,188
050,01,031,"Alabama","Coffee County",4,80,240,104,136
050,01,031,"Alabama","Coffee County",4,81,214,89,125
050,01,031,"Alabama","Coffee County",4,82,196,72,124
050,01,031,"Alabama","Coffee County",4,83,198,73,125
050,01,031,"Alabama","Coffee County",4,84,191,75,116
050,01,031,"Alabama","Coffee County",4,85,967,363,604
050,01,031,"Alabama","Coffee County",5,0,675,343,332
050,01,031,"Alabama","Coffee County",5,1,672,345,327
050,01,031,"Alabama","Coffee County",5,2,726,350,376
050,01,031,"Alabama","Coffee County",5,3,633,307,326
050,01,031,"Alabama","Coffee County",5,4,679,344,335
050,01,031,"Alabama","Coffee County",5,5,631,351,280
050,01,031,"Alabama","Coffee County",5,6,729,374,355
050,01,031,"Alabama","Coffee County",5,7,756,387,369
050,01,031,"Alabama","Coffee County",5,8,732,403,329
050,01,031,"Alabama","Coffee County",5,9,747,400,347
050,01,031,"Alabama","Coffee County",5,10,780,404,376
050,01,031,"Alabama","Coffee County",5,11,754,385,369
050,01,031,"Alabama","Coffee County",5,12,767,390,377
050,01,031,"Alabama","Coffee County",5,13,769,376,393
050,01,031,"Alabama","Coffee County",5,14,813,404,409
050,01,031,"Alabama","Coffee County",5,15,855,414,441
050,01,031,"Alabama","Coffee County",5,16,871,457,414
050,01,031,"Alabama","Coffee County",5,17,819,422,397
050,01,031,"Alabama","Coffee County",5,18,662,330,332
050,01,031,"Alabama","Coffee County",5,19,522,269,253
050,01,031,"Alabama","Coffee County",5,20,577,287,290
050,01,031,"Alabama","Coffee County",5,21,585,298,287
050,01,031,"Alabama","Coffee County",5,22,590,305,285
050,01,031,"Alabama","Coffee County",5,23,709,386,323
050,01,031,"Alabama","Coffee County",5,24,720,392,328
050,01,031,"Alabama","Coffee County",5,25,730,390,340
050,01,031,"Alabama","Coffee County",5,26,637,315,322
050,01,031,"Alabama","Coffee County",5,27,644,333,311
050,01,031,"Alabama","Coffee County",5,28,659,332,327
050,01,031,"Alabama","Coffee County",5,29,676,334,342
050,01,031,"Alabama","Coffee County",5,30,702,358,344
050,01,031,"Alabama","Coffee County",5,31,708,359,349
050,01,031,"Alabama","Coffee County",5,32,683,367,316
050,01,031,"Alabama","Coffee County",5,33,736,346,390
050,01,031,"Alabama","Coffee County",5,34,718,362,356
050,01,031,"Alabama","Coffee County",5,35,720,359,361
050,01,031,"Alabama","Coffee County",5,36,641,326,315
050,01,031,"Alabama","Coffee County",5,37,720,358,362
050,01,031,"Alabama","Coffee County",5,38,748,387,361
050,01,031,"Alabama","Coffee County",5,39,763,402,361
050,01,031,"Alabama","Coffee County",5,40,721,368,353
050,01,031,"Alabama","Coffee County",5,41,784,391,393
050,01,031,"Alabama","Coffee County",5,42,780,385,395
050,01,031,"Alabama","Coffee County",5,43,777,386,391
050,01,031,"Alabama","Coffee County",5,44,700,353,347
050,01,031,"Alabama","Coffee County",5,45,708,375,333
050,01,031,"Alabama","Coffee County",5,46,681,353,328
050,01,031,"Alabama","Coffee County",5,47,703,367,336
050,01,031,"Alabama","Coffee County",5,48,748,363,385
050,01,031,"Alabama","Coffee County",5,49,711,341,370
050,01,031,"Alabama","Coffee County",5,50,733,348,385
050,01,031,"Alabama","Coffee County",5,51,758,380,378
050,01,031,"Alabama","Coffee County",5,52,796,396,400
050,01,031,"Alabama","Coffee County",5,53,725,367,358
050,01,031,"Alabama","Coffee County",5,54,696,358,338
050,01,031,"Alabama","Coffee County",5,55,679,350,329
050,01,031,"Alabama","Coffee County",5,56,644,321,323
050,01,031,"Alabama","Coffee County",5,57,630,297,333
050,01,031,"Alabama","Coffee County",5,58,695,350,345
050,01,031,"Alabama","Coffee County",5,59,666,349,317
050,01,031,"Alabama","Coffee County",5,60,638,318,320
050,01,031,"Alabama","Coffee County",5,61,667,326,341
050,01,031,"Alabama","Coffee County",5,62,664,356,308
050,01,031,"Alabama","Coffee County",5,63,642,311,331
050,01,031,"Alabama","Coffee County",5,64,675,303,372
050,01,031,"Alabama","Coffee County",5,65,664,309,355
050,01,031,"Alabama","Coffee County",5,66,659,304,355
050,01,031,"Alabama","Coffee County",5,67,587,272,315
050,01,031,"Alabama","Coffee County",5,68,608,271,337
050,01,031,"Alabama","Coffee County",5,69,588,271,317
050,01,031,"Alabama","Coffee County",5,70,535,261,274
050,01,031,"Alabama","Coffee County",5,71,512,228,284
050,01,031,"Alabama","Coffee County",5,72,480,208,272
050,01,031,"Alabama","Coffee County",5,73,496,232,264
050,01,031,"Alabama","Coffee County",5,74,497,234,263
050,01,031,"Alabama","Coffee County",5,75,494,236,258
050,01,031,"Alabama","Coffee County",5,76,529,239,290
050,01,031,"Alabama","Coffee County",5,77,359,164,195
050,01,031,"Alabama","Coffee County",5,78,332,130,202
050,01,031,"Alabama","Coffee County",5,79,338,156,182
050,01,031,"Alabama","Coffee County",5,80,305,123,182
050,01,031,"Alabama","Coffee County",5,81,219,90,129
050,01,031,"Alabama","Coffee County",5,82,202,84,118
050,01,031,"Alabama","Coffee County",5,83,180,65,115
050,01,031,"Alabama","Coffee County",5,84,174,59,115
050,01,031,"Alabama","Coffee County",5,85,1006,382,624
050,01,033,"Alabama","Colbert County",1,0,644,329,315
050,01,033,"Alabama","Colbert County",1,1,647,333,314
050,01,033,"Alabama","Colbert County",1,2,635,314,321
050,01,033,"Alabama","Colbert County",1,3,678,335,343
050,01,033,"Alabama","Colbert County",1,4,661,350,311
050,01,033,"Alabama","Colbert County",1,5,662,327,335
050,01,033,"Alabama","Colbert County",1,6,661,338,323
050,01,033,"Alabama","Colbert County",1,7,669,348,321
050,01,033,"Alabama","Colbert County",1,8,636,311,325
050,01,033,"Alabama","Colbert County",1,9,662,333,329
050,01,033,"Alabama","Colbert County",1,10,693,354,339
050,01,033,"Alabama","Colbert County",1,11,717,357,360
050,01,033,"Alabama","Colbert County",1,12,745,370,375
050,01,033,"Alabama","Colbert County",1,13,742,384,358
050,01,033,"Alabama","Colbert County",1,14,695,346,349
050,01,033,"Alabama","Colbert County",1,15,674,337,337
050,01,033,"Alabama","Colbert County",1,16,671,353,318
050,01,033,"Alabama","Colbert County",1,17,679,343,336
050,01,033,"Alabama","Colbert County",1,18,577,302,275
050,01,033,"Alabama","Colbert County",1,19,497,256,241
050,01,033,"Alabama","Colbert County",1,20,597,288,309
050,01,033,"Alabama","Colbert County",1,21,615,294,321
050,01,033,"Alabama","Colbert County",1,22,612,294,318
050,01,033,"Alabama","Colbert County",1,23,672,337,335
050,01,033,"Alabama","Colbert County",1,24,650,335,315
050,01,033,"Alabama","Colbert County",1,25,710,359,351
050,01,033,"Alabama","Colbert County",1,26,727,358,369
050,01,033,"Alabama","Colbert County",1,27,726,350,376
050,01,033,"Alabama","Colbert County",1,28,765,375,390
050,01,033,"Alabama","Colbert County",1,29,824,426,398
050,01,033,"Alabama","Colbert County",1,30,767,389,378
050,01,033,"Alabama","Colbert County",1,31,731,364,367
050,01,033,"Alabama","Colbert County",1,32,730,340,390
050,01,033,"Alabama","Colbert County",1,33,676,339,337
050,01,033,"Alabama","Colbert County",1,34,702,362,340
050,01,033,"Alabama","Colbert County",1,35,653,309,344
050,01,033,"Alabama","Colbert County",1,36,657,318,339
050,01,033,"Alabama","Colbert County",1,37,683,348,335
050,01,033,"Alabama","Colbert County",1,38,682,342,340
050,01,033,"Alabama","Colbert County",1,39,673,317,356
050,01,033,"Alabama","Colbert County",1,40,684,310,374
050,01,033,"Alabama","Colbert County",1,41,643,313,330
050,01,033,"Alabama","Colbert County",1,42,670,333,337
050,01,033,"Alabama","Colbert County",1,43,653,307,346
050,01,033,"Alabama","Colbert County",1,44,635,315,320
050,01,033,"Alabama","Colbert County",1,45,671,336,335
050,01,033,"Alabama","Colbert County",1,46,662,319,343
050,01,033,"Alabama","Colbert County",1,47,664,307,357
050,01,033,"Alabama","Colbert County",1,48,727,339,388
050,01,033,"Alabama","Colbert County",1,49,805,384,421
050,01,033,"Alabama","Colbert County",1,50,783,386,397
050,01,033,"Alabama","Colbert County",1,51,756,373,383
050,01,033,"Alabama","Colbert County",1,52,764,373,391
050,01,033,"Alabama","Colbert County",1,53,737,368,369
050,01,033,"Alabama","Colbert County",1,54,777,372,405
050,01,033,"Alabama","Colbert County",1,55,804,388,416
050,01,033,"Alabama","Colbert County",1,56,848,410,438
050,01,033,"Alabama","Colbert County",1,57,878,436,442
050,01,033,"Alabama","Colbert County",1,58,810,407,403
050,01,033,"Alabama","Colbert County",1,59,779,374,405
050,01,033,"Alabama","Colbert County",1,60,751,345,406
050,01,033,"Alabama","Colbert County",1,61,788,356,432
050,01,033,"Alabama","Colbert County",1,62,839,396,443
050,01,033,"Alabama","Colbert County",1,63,816,384,432
050,01,033,"Alabama","Colbert County",1,64,787,393,394
050,01,033,"Alabama","Colbert County",1,65,780,384,396
050,01,033,"Alabama","Colbert County",1,66,712,342,370
050,01,033,"Alabama","Colbert County",1,67,715,334,381
050,01,033,"Alabama","Colbert County",1,68,695,315,380
050,01,033,"Alabama","Colbert County",1,69,693,320,373
050,01,033,"Alabama","Colbert County",1,70,697,308,389
050,01,033,"Alabama","Colbert County",1,71,640,293,347
050,01,033,"Alabama","Colbert County",1,72,630,282,348
050,01,033,"Alabama","Colbert County",1,73,631,293,338
050,01,033,"Alabama","Colbert County",1,74,444,195,249
050,01,033,"Alabama","Colbert County",1,75,442,182,260
050,01,033,"Alabama","Colbert County",1,76,448,186,262
050,01,033,"Alabama","Colbert County",1,77,473,206,267
050,01,033,"Alabama","Colbert County",1,78,408,170,238
050,01,033,"Alabama","Colbert County",1,79,381,165,216
050,01,033,"Alabama","Colbert County",1,80,316,125,191
050,01,033,"Alabama","Colbert County",1,81,317,124,193
050,01,033,"Alabama","Colbert County",1,82,269,99,170
050,01,033,"Alabama","Colbert County",1,83,236,87,149
050,01,033,"Alabama","Colbert County",1,84,245,105,140
050,01,033,"Alabama","Colbert County",1,85,1232,469,763
050,01,033,"Alabama","Colbert County",2,0,648,335,313
050,01,033,"Alabama","Colbert County",2,1,647,331,316
050,01,033,"Alabama","Colbert County",2,2,640,320,320
050,01,033,"Alabama","Colbert County",2,3,663,329,334
050,01,033,"Alabama","Colbert County",2,4,671,350,321
050,01,033,"Alabama","Colbert County",2,5,662,334,328
050,01,033,"Alabama","Colbert County",2,6,662,336,326
050,01,033,"Alabama","Colbert County",2,7,663,344,319
050,01,033,"Alabama","Colbert County",2,8,639,318,321
050,01,033,"Alabama","Colbert County",2,9,658,329,329
050,01,033,"Alabama","Colbert County",2,10,687,350,337
050,01,033,"Alabama","Colbert County",2,11,714,357,357
050,01,033,"Alabama","Colbert County",2,12,742,369,373
050,01,033,"Alabama","Colbert County",2,13,743,381,362
050,01,033,"Alabama","Colbert County",2,14,712,358,354
050,01,033,"Alabama","Colbert County",2,15,682,343,339
050,01,033,"Alabama","Colbert County",2,16,673,352,321
050,01,033,"Alabama","Colbert County",2,17,678,347,331
050,01,033,"Alabama","Colbert County",2,18,574,299,275
050,01,033,"Alabama","Colbert County",2,19,495,254,241
050,01,033,"Alabama","Colbert County",2,20,594,287,307
050,01,033,"Alabama","Colbert County",2,21,613,292,321
050,01,033,"Alabama","Colbert County",2,22,619,296,323
050,01,033,"Alabama","Colbert County",2,23,666,333,333
050,01,033,"Alabama","Colbert County",2,24,664,341,323
050,01,033,"Alabama","Colbert County",2,25,699,356,343
050,01,033,"Alabama","Colbert County",2,26,723,359,364
050,01,033,"Alabama","Colbert County",2,27,722,351,371
050,01,033,"Alabama","Colbert County",2,28,758,373,385
050,01,033,"Alabama","Colbert County",2,29,807,411,396
050,01,033,"Alabama","Colbert County",2,30,787,401,386
050,01,033,"Alabama","Colbert County",2,31,743,370,373
050,01,033,"Alabama","Colbert County",2,32,730,345,385
050,01,033,"Alabama","Colbert County",2,33,690,340,350
050,01,033,"Alabama","Colbert County",2,34,696,358,338
050,01,033,"Alabama","Colbert County",2,35,667,323,344
050,01,033,"Alabama","Colbert County",2,36,652,314,338
050,01,033,"Alabama","Colbert County",2,37,678,343,335
050,01,033,"Alabama","Colbert County",2,38,682,342,340
050,01,033,"Alabama","Colbert County",2,39,676,323,353
050,01,033,"Alabama","Colbert County",2,40,686,314,372
050,01,033,"Alabama","Colbert County",2,41,652,313,339
050,01,033,"Alabama","Colbert County",2,42,663,330,333
050,01,033,"Alabama","Colbert County",2,43,659,314,345
050,01,033,"Alabama","Colbert County",2,44,631,309,322
050,01,033,"Alabama","Colbert County",2,45,666,332,334
050,01,033,"Alabama","Colbert County",2,46,659,321,338
050,01,033,"Alabama","Colbert County",2,47,664,310,354
050,01,033,"Alabama","Colbert County",2,48,712,330,382
050,01,033,"Alabama","Colbert County",2,49,795,376,419
050,01,033,"Alabama","Colbert County",2,50,785,385,400
050,01,033,"Alabama","Colbert County",2,51,765,377,388
050,01,033,"Alabama","Colbert County",2,52,758,372,386
050,01,033,"Alabama","Colbert County",2,53,745,369,376
050,01,033,"Alabama","Colbert County",2,54,769,371,398
050,01,033,"Alabama","Colbert County",2,55,798,385,413
050,01,033,"Alabama","Colbert County",2,56,840,408,432
050,01,033,"Alabama","Colbert County",2,57,873,430,443
050,01,033,"Alabama","Colbert County",2,58,828,413,415
050,01,033,"Alabama","Colbert County",2,59,791,383,408
050,01,033,"Alabama","Colbert County",2,60,760,354,406
050,01,033,"Alabama","Colbert County",2,61,777,350,427
050,01,033,"Alabama","Colbert County",2,62,826,387,439
050,01,033,"Alabama","Colbert County",2,63,827,390,437
050,01,033,"Alabama","Colbert County",2,64,788,387,401
050,01,033,"Alabama","Colbert County",2,65,783,388,395
050,01,033,"Alabama","Colbert County",2,66,726,350,376
050,01,033,"Alabama","Colbert County",2,67,715,336,379
050,01,033,"Alabama","Colbert County",2,68,688,314,374
050,01,033,"Alabama","Colbert County",2,69,700,321,379
050,01,033,"Alabama","Colbert County",2,70,697,312,385
050,01,033,"Alabama","Colbert County",2,71,650,294,356
050,01,033,"Alabama","Colbert County",2,72,622,280,342
050,01,033,"Alabama","Colbert County",2,73,661,305,356
050,01,033,"Alabama","Colbert County",2,74,457,204,253
050,01,033,"Alabama","Colbert County",2,75,435,183,252
050,01,033,"Alabama","Colbert County",2,76,439,181,258
050,01,033,"Alabama","Colbert County",2,77,467,198,269
050,01,033,"Alabama","Colbert County",2,78,414,176,238
050,01,033,"Alabama","Colbert County",2,79,384,164,220
050,01,033,"Alabama","Colbert County",2,80,328,134,194
050,01,033,"Alabama","Colbert County",2,81,308,124,184
050,01,033,"Alabama","Colbert County",2,82,274,105,169
050,01,033,"Alabama","Colbert County",2,83,236,89,147
050,01,033,"Alabama","Colbert County",2,84,235,99,136
050,01,033,"Alabama","Colbert County",2,85,1249,481,768
050,01,033,"Alabama","Colbert County",3,0,646,332,314
050,01,033,"Alabama","Colbert County",3,1,670,351,319
050,01,033,"Alabama","Colbert County",3,2,639,331,308
050,01,033,"Alabama","Colbert County",3,3,652,325,327
050,01,033,"Alabama","Colbert County",3,4,678,336,342
050,01,033,"Alabama","Colbert County",3,5,673,360,313
050,01,033,"Alabama","Colbert County",3,6,664,329,335
050,01,033,"Alabama","Colbert County",3,7,671,344,327
050,01,033,"Alabama","Colbert County",3,8,694,346,348
050,01,033,"Alabama","Colbert County",3,9,656,327,329
050,01,033,"Alabama","Colbert County",3,10,652,328,324
050,01,033,"Alabama","Colbert County",3,11,715,360,355
050,01,033,"Alabama","Colbert County",3,12,721,361,360
050,01,033,"Alabama","Colbert County",3,13,741,374,367
050,01,033,"Alabama","Colbert County",3,14,738,380,358
050,01,033,"Alabama","Colbert County",3,15,712,352,360
050,01,033,"Alabama","Colbert County",3,16,704,348,356
050,01,033,"Alabama","Colbert County",3,17,672,343,329
050,01,033,"Alabama","Colbert County",3,18,570,300,270
050,01,033,"Alabama","Colbert County",3,19,489,256,233
050,01,033,"Alabama","Colbert County",3,20,567,293,274
050,01,033,"Alabama","Colbert County",3,21,620,303,317
050,01,033,"Alabama","Colbert County",3,22,673,324,349
050,01,033,"Alabama","Colbert County",3,23,676,329,347
050,01,033,"Alabama","Colbert County",3,24,691,348,343
050,01,033,"Alabama","Colbert County",3,25,639,327,312
050,01,033,"Alabama","Colbert County",3,26,695,351,344
050,01,033,"Alabama","Colbert County",3,27,713,349,364
050,01,033,"Alabama","Colbert County",3,28,730,346,384
050,01,033,"Alabama","Colbert County",3,29,767,380,387
050,01,033,"Alabama","Colbert County",3,30,793,391,402
050,01,033,"Alabama","Colbert County",3,31,806,416,390
050,01,033,"Alabama","Colbert County",3,32,723,357,366
050,01,033,"Alabama","Colbert County",3,33,743,354,389
050,01,033,"Alabama","Colbert County",3,34,710,348,362
050,01,033,"Alabama","Colbert County",3,35,688,343,345
050,01,033,"Alabama","Colbert County",3,36,666,328,338
050,01,033,"Alabama","Colbert County",3,37,665,317,348
050,01,033,"Alabama","Colbert County",3,38,663,332,331
050,01,033,"Alabama","Colbert County",3,39,688,338,350
050,01,033,"Alabama","Colbert County",3,40,674,324,350
050,01,033,"Alabama","Colbert County",3,41,694,321,373
050,01,033,"Alabama","Colbert County",3,42,658,321,337
050,01,033,"Alabama","Colbert County",3,43,655,315,340
050,01,033,"Alabama","Colbert County",3,44,666,317,349
050,01,033,"Alabama","Colbert County",3,45,634,305,329
050,01,033,"Alabama","Colbert County",3,46,689,341,348
050,01,033,"Alabama","Colbert County",3,47,681,330,351
050,01,033,"Alabama","Colbert County",3,48,671,322,349
050,01,033,"Alabama","Colbert County",3,49,730,335,395
050,01,033,"Alabama","Colbert County",3,50,798,379,419
050,01,033,"Alabama","Colbert County",3,51,801,397,404
050,01,033,"Alabama","Colbert County",3,52,769,376,393
050,01,033,"Alabama","Colbert County",3,53,765,377,388
050,01,033,"Alabama","Colbert County",3,54,751,377,374
050,01,033,"Alabama","Colbert County",3,55,774,364,410
050,01,033,"Alabama","Colbert County",3,56,797,393,404
050,01,033,"Alabama","Colbert County",3,57,833,407,426
050,01,033,"Alabama","Colbert County",3,58,860,422,438
050,01,033,"Alabama","Colbert County",3,59,822,412,410
050,01,033,"Alabama","Colbert County",3,60,797,385,412
050,01,033,"Alabama","Colbert County",3,61,770,346,424
050,01,033,"Alabama","Colbert County",3,62,779,345,434
050,01,033,"Alabama","Colbert County",3,63,830,391,439
050,01,033,"Alabama","Colbert County",3,64,821,386,435
050,01,033,"Alabama","Colbert County",3,65,791,390,401
050,01,033,"Alabama","Colbert County",3,66,765,376,389
050,01,033,"Alabama","Colbert County",3,67,727,346,381
050,01,033,"Alabama","Colbert County",3,68,697,321,376
050,01,033,"Alabama","Colbert County",3,69,679,308,371
050,01,033,"Alabama","Colbert County",3,70,686,306,380
050,01,033,"Alabama","Colbert County",3,71,656,288,368
050,01,033,"Alabama","Colbert County",3,72,634,280,354
050,01,033,"Alabama","Colbert County",3,73,604,268,336
050,01,033,"Alabama","Colbert County",3,74,648,297,351
050,01,033,"Alabama","Colbert County",3,75,423,195,228
050,01,033,"Alabama","Colbert County",3,76,414,176,238
050,01,033,"Alabama","Colbert County",3,77,416,164,252
050,01,033,"Alabama","Colbert County",3,78,444,190,254
050,01,033,"Alabama","Colbert County",3,79,391,161,230
050,01,033,"Alabama","Colbert County",3,80,360,149,211
050,01,033,"Alabama","Colbert County",3,81,286,117,169
050,01,033,"Alabama","Colbert County",3,82,286,111,175
050,01,033,"Alabama","Colbert County",3,83,255,101,154
050,01,033,"Alabama","Colbert County",3,84,208,78,130
050,01,033,"Alabama","Colbert County",3,85,1282,498,784
050,01,033,"Alabama","Colbert County",4,0,626,327,299
050,01,033,"Alabama","Colbert County",4,1,660,358,302
050,01,033,"Alabama","Colbert County",4,2,675,352,323
050,01,033,"Alabama","Colbert County",4,3,673,339,334
050,01,033,"Alabama","Colbert County",4,4,651,331,320
050,01,033,"Alabama","Colbert County",4,5,686,351,335
050,01,033,"Alabama","Colbert County",4,6,662,341,321
050,01,033,"Alabama","Colbert County",4,7,665,330,335
050,01,033,"Alabama","Colbert County",4,8,673,339,334
050,01,033,"Alabama","Colbert County",4,9,683,350,333
050,01,033,"Alabama","Colbert County",4,10,672,333,339
050,01,033,"Alabama","Colbert County",4,11,663,333,330
050,01,033,"Alabama","Colbert County",4,12,708,355,353
050,01,033,"Alabama","Colbert County",4,13,731,364,367
050,01,033,"Alabama","Colbert County",4,14,761,383,378
050,01,033,"Alabama","Colbert County",4,15,751,379,372
050,01,033,"Alabama","Colbert County",4,16,723,350,373
050,01,033,"Alabama","Colbert County",4,17,693,340,353
050,01,033,"Alabama","Colbert County",4,18,562,299,263
050,01,033,"Alabama","Colbert County",4,19,468,248,220
050,01,033,"Alabama","Colbert County",4,20,557,279,278
050,01,033,"Alabama","Colbert County",4,21,586,299,287
050,01,033,"Alabama","Colbert County",4,22,635,303,332
050,01,033,"Alabama","Colbert County",4,23,710,351,359
050,01,033,"Alabama","Colbert County",4,24,709,342,367
050,01,033,"Alabama","Colbert County",4,25,708,348,360
050,01,033,"Alabama","Colbert County",4,26,646,328,318
050,01,033,"Alabama","Colbert County",4,27,717,372,345
050,01,033,"Alabama","Colbert County",4,28,727,357,370
050,01,033,"Alabama","Colbert County",4,29,731,336,395
050,01,033,"Alabama","Colbert County",4,30,754,370,384
050,01,033,"Alabama","Colbert County",4,31,802,392,410
050,01,033,"Alabama","Colbert County",4,32,813,417,396
050,01,033,"Alabama","Colbert County",4,33,728,370,358
050,01,033,"Alabama","Colbert County",4,34,778,364,414
050,01,033,"Alabama","Colbert County",4,35,714,348,366
050,01,033,"Alabama","Colbert County",4,36,692,339,353
050,01,033,"Alabama","Colbert County",4,37,681,333,348
050,01,033,"Alabama","Colbert County",4,38,671,319,352
050,01,033,"Alabama","Colbert County",4,39,684,345,339
050,01,033,"Alabama","Colbert County",4,40,695,344,351
050,01,033,"Alabama","Colbert County",4,41,681,327,354
050,01,033,"Alabama","Colbert County",4,42,692,314,378
050,01,033,"Alabama","Colbert County",4,43,657,317,340
050,01,033,"Alabama","Colbert County",4,44,677,332,345
050,01,033,"Alabama","Colbert County",4,45,667,306,361
050,01,033,"Alabama","Colbert County",4,46,631,298,333
050,01,033,"Alabama","Colbert County",4,47,680,335,345
050,01,033,"Alabama","Colbert County",4,48,668,327,341
050,01,033,"Alabama","Colbert County",4,49,679,328,351
050,01,033,"Alabama","Colbert County",4,50,728,339,389
050,01,033,"Alabama","Colbert County",4,51,802,383,419
050,01,033,"Alabama","Colbert County",4,52,801,396,405
050,01,033,"Alabama","Colbert County",4,53,781,376,405
050,01,033,"Alabama","Colbert County",4,54,786,385,401
050,01,033,"Alabama","Colbert County",4,55,772,386,386
050,01,033,"Alabama","Colbert County",4,56,763,365,398
050,01,033,"Alabama","Colbert County",4,57,789,390,399
050,01,033,"Alabama","Colbert County",4,58,821,393,428
050,01,033,"Alabama","Colbert County",4,59,866,420,446
050,01,033,"Alabama","Colbert County",4,60,806,403,403
050,01,033,"Alabama","Colbert County",4,61,797,384,413
050,01,033,"Alabama","Colbert County",4,62,774,347,427
050,01,033,"Alabama","Colbert County",4,63,769,337,432
050,01,033,"Alabama","Colbert County",4,64,826,390,436
050,01,033,"Alabama","Colbert County",4,65,824,387,437
050,01,033,"Alabama","Colbert County",4,66,791,385,406
050,01,033,"Alabama","Colbert County",4,67,765,368,397
050,01,033,"Alabama","Colbert County",4,68,709,331,378
050,01,033,"Alabama","Colbert County",4,69,692,313,379
050,01,033,"Alabama","Colbert County",4,70,669,299,370
050,01,033,"Alabama","Colbert County",4,71,655,294,361
050,01,033,"Alabama","Colbert County",4,72,646,281,365
050,01,033,"Alabama","Colbert County",4,73,617,275,342
050,01,033,"Alabama","Colbert County",4,74,598,263,335
050,01,033,"Alabama","Colbert County",4,75,617,284,333
050,01,033,"Alabama","Colbert County",4,76,401,187,214
050,01,033,"Alabama","Colbert County",4,77,398,165,233
050,01,033,"Alabama","Colbert County",4,78,398,155,243
050,01,033,"Alabama","Colbert County",4,79,426,180,246
050,01,033,"Alabama","Colbert County",4,80,366,141,225
050,01,033,"Alabama","Colbert County",4,81,331,141,190
050,01,033,"Alabama","Colbert County",4,82,270,106,164
050,01,033,"Alabama","Colbert County",4,83,271,109,162
050,01,033,"Alabama","Colbert County",4,84,231,94,137
050,01,033,"Alabama","Colbert County",4,85,1281,498,783
050,01,033,"Alabama","Colbert County",5,0,630,327,303
050,01,033,"Alabama","Colbert County",5,1,637,329,308
050,01,033,"Alabama","Colbert County",5,2,679,361,318
050,01,033,"Alabama","Colbert County",5,3,684,347,337
050,01,033,"Alabama","Colbert County",5,4,687,343,344
050,01,033,"Alabama","Colbert County",5,5,680,342,338
050,01,033,"Alabama","Colbert County",5,6,711,360,351
050,01,033,"Alabama","Colbert County",5,7,671,335,336
050,01,033,"Alabama","Colbert County",5,8,656,316,340
050,01,033,"Alabama","Colbert County",5,9,687,345,342
050,01,033,"Alabama","Colbert County",5,10,681,351,330
050,01,033,"Alabama","Colbert County",5,11,681,327,354
050,01,033,"Alabama","Colbert County",5,12,686,345,341
050,01,033,"Alabama","Colbert County",5,13,710,356,354
050,01,033,"Alabama","Colbert County",5,14,750,372,378
050,01,033,"Alabama","Colbert County",5,15,758,377,381
050,01,033,"Alabama","Colbert County",5,16,751,382,369
050,01,033,"Alabama","Colbert County",5,17,732,351,381
050,01,033,"Alabama","Colbert County",5,18,574,284,290
050,01,033,"Alabama","Colbert County",5,19,459,242,217
050,01,033,"Alabama","Colbert County",5,20,514,261,253
050,01,033,"Alabama","Colbert County",5,21,584,299,285
050,01,033,"Alabama","Colbert County",5,22,619,316,303
050,01,033,"Alabama","Colbert County",5,23,723,351,372
050,01,033,"Alabama","Colbert County",5,24,747,365,382
050,01,033,"Alabama","Colbert County",5,25,723,361,362
050,01,033,"Alabama","Colbert County",5,26,738,346,392
050,01,033,"Alabama","Colbert County",5,27,646,333,313
050,01,033,"Alabama","Colbert County",5,28,724,365,359
050,01,033,"Alabama","Colbert County",5,29,736,366,370
050,01,033,"Alabama","Colbert County",5,30,736,344,392
050,01,033,"Alabama","Colbert County",5,31,765,380,385
050,01,033,"Alabama","Colbert County",5,32,806,392,414
050,01,033,"Alabama","Colbert County",5,33,796,401,395
050,01,033,"Alabama","Colbert County",5,34,756,374,382
050,01,033,"Alabama","Colbert County",5,35,782,357,425
050,01,033,"Alabama","Colbert County",5,36,731,365,366
050,01,033,"Alabama","Colbert County",5,37,719,344,375
050,01,033,"Alabama","Colbert County",5,38,671,327,344
050,01,033,"Alabama","Colbert County",5,39,675,323,352
050,01,033,"Alabama","Colbert County",5,40,709,366,343
050,01,033,"Alabama","Colbert County",5,41,708,348,360
050,01,033,"Alabama","Colbert County",5,42,692,338,354
050,01,033,"Alabama","Colbert County",5,43,714,322,392
050,01,033,"Alabama","Colbert County",5,44,647,306,341
050,01,033,"Alabama","Colbert County",5,45,670,326,344
050,01,033,"Alabama","Colbert County",5,46,675,310,365
050,01,033,"Alabama","Colbert County",5,47,630,287,343
050,01,033,"Alabama","Colbert County",5,48,654,317,337
050,01,033,"Alabama","Colbert County",5,49,671,318,353
050,01,033,"Alabama","Colbert County",5,50,676,330,346
050,01,033,"Alabama","Colbert County",5,51,728,342,386
050,01,033,"Alabama","Colbert County",5,52,800,384,416
050,01,033,"Alabama","Colbert County",5,53,789,389,400
050,01,033,"Alabama","Colbert County",5,54,787,375,412
050,01,033,"Alabama","Colbert County",5,55,786,387,399
050,01,033,"Alabama","Colbert County",5,56,758,385,373
050,01,033,"Alabama","Colbert County",5,57,764,370,394
050,01,033,"Alabama","Colbert County",5,58,775,379,396
050,01,033,"Alabama","Colbert County",5,59,812,385,427
050,01,033,"Alabama","Colbert County",5,60,870,431,439
050,01,033,"Alabama","Colbert County",5,61,808,402,406
050,01,033,"Alabama","Colbert County",5,62,783,376,407
050,01,033,"Alabama","Colbert County",5,63,759,341,418
050,01,033,"Alabama","Colbert County",5,64,763,332,431
050,01,033,"Alabama","Colbert County",5,65,823,392,431
050,01,033,"Alabama","Colbert County",5,66,803,371,432
050,01,033,"Alabama","Colbert County",5,67,788,380,408
050,01,033,"Alabama","Colbert County",5,68,755,353,402
050,01,033,"Alabama","Colbert County",5,69,704,324,380
050,01,033,"Alabama","Colbert County",5,70,684,305,379
050,01,033,"Alabama","Colbert County",5,71,636,282,354
050,01,033,"Alabama","Colbert County",5,72,641,286,355
050,01,033,"Alabama","Colbert County",5,73,635,277,358
050,01,033,"Alabama","Colbert County",5,74,601,265,336
050,01,033,"Alabama","Colbert County",5,75,574,254,320
050,01,033,"Alabama","Colbert County",5,76,591,276,315
050,01,033,"Alabama","Colbert County",5,77,387,175,212
050,01,033,"Alabama","Colbert County",5,78,387,163,224
050,01,033,"Alabama","Colbert County",5,79,381,144,237
050,01,033,"Alabama","Colbert County",5,80,401,160,241
050,01,033,"Alabama","Colbert County",5,81,338,134,204
050,01,033,"Alabama","Colbert County",5,82,303,124,179
050,01,033,"Alabama","Colbert County",5,83,251,101,150
050,01,033,"Alabama","Colbert County",5,84,247,103,144
050,01,033,"Alabama","Colbert County",5,85,1308,518,790
050,01,035,"Alabama","Conecuh County",1,0,115,57,58
050,01,035,"Alabama","Conecuh County",1,1,114,56,58
050,01,035,"Alabama","Conecuh County",1,2,124,59,65
050,01,035,"Alabama","Conecuh County",1,3,117,57,60
050,01,035,"Alabama","Conecuh County",1,4,121,54,67
050,01,035,"Alabama","Conecuh County",1,5,134,66,68
050,01,035,"Alabama","Conecuh County",1,6,132,64,68
050,01,035,"Alabama","Conecuh County",1,7,146,68,78
050,01,035,"Alabama","Conecuh County",1,8,139,70,69
050,01,035,"Alabama","Conecuh County",1,9,143,71,72
050,01,035,"Alabama","Conecuh County",1,10,125,62,63
050,01,035,"Alabama","Conecuh County",1,11,123,60,63
050,01,035,"Alabama","Conecuh County",1,12,147,81,66
050,01,035,"Alabama","Conecuh County",1,13,159,79,80
050,01,035,"Alabama","Conecuh County",1,14,144,68,76
050,01,035,"Alabama","Conecuh County",1,15,125,65,60
050,01,035,"Alabama","Conecuh County",1,16,143,77,66
050,01,035,"Alabama","Conecuh County",1,17,147,75,72
050,01,035,"Alabama","Conecuh County",1,18,128,59,69
050,01,035,"Alabama","Conecuh County",1,19,116,61,55
050,01,035,"Alabama","Conecuh County",1,20,114,58,56
050,01,035,"Alabama","Conecuh County",1,21,117,56,61
050,01,035,"Alabama","Conecuh County",1,22,127,68,59
050,01,035,"Alabama","Conecuh County",1,23,127,64,63
050,01,035,"Alabama","Conecuh County",1,24,127,67,60
050,01,035,"Alabama","Conecuh County",1,25,126,68,58
050,01,035,"Alabama","Conecuh County",1,26,112,55,57
050,01,035,"Alabama","Conecuh County",1,27,138,69,69
050,01,035,"Alabama","Conecuh County",1,28,128,64,64
050,01,035,"Alabama","Conecuh County",1,29,143,64,79
050,01,035,"Alabama","Conecuh County",1,30,120,59,61
050,01,035,"Alabama","Conecuh County",1,31,144,74,70
050,01,035,"Alabama","Conecuh County",1,32,112,59,53
050,01,035,"Alabama","Conecuh County",1,33,99,50,49
050,01,035,"Alabama","Conecuh County",1,34,110,58,52
050,01,035,"Alabama","Conecuh County",1,35,129,58,71
050,01,035,"Alabama","Conecuh County",1,36,129,55,74
050,01,035,"Alabama","Conecuh County",1,37,102,51,51
050,01,035,"Alabama","Conecuh County",1,38,105,57,48
050,01,035,"Alabama","Conecuh County",1,39,125,55,70
050,01,035,"Alabama","Conecuh County",1,40,123,57,66
050,01,035,"Alabama","Conecuh County",1,41,137,61,76
050,01,035,"Alabama","Conecuh County",1,42,130,61,69
050,01,035,"Alabama","Conecuh County",1,43,112,52,60
050,01,035,"Alabama","Conecuh County",1,44,119,59,60
050,01,035,"Alabama","Conecuh County",1,45,128,58,70
050,01,035,"Alabama","Conecuh County",1,46,132,59,73
050,01,035,"Alabama","Conecuh County",1,47,134,52,82
050,01,035,"Alabama","Conecuh County",1,48,138,60,78
050,01,035,"Alabama","Conecuh County",1,49,133,64,69
050,01,035,"Alabama","Conecuh County",1,50,149,64,85
050,01,035,"Alabama","Conecuh County",1,51,152,88,64
050,01,035,"Alabama","Conecuh County",1,52,144,73,71
050,01,035,"Alabama","Conecuh County",1,53,138,61,77
050,01,035,"Alabama","Conecuh County",1,54,150,65,85
050,01,035,"Alabama","Conecuh County",1,55,164,79,85
050,01,035,"Alabama","Conecuh County",1,56,175,84,91
050,01,035,"Alabama","Conecuh County",1,57,166,77,89
050,01,035,"Alabama","Conecuh County",1,58,184,93,91
050,01,035,"Alabama","Conecuh County",1,59,183,87,96
050,01,035,"Alabama","Conecuh County",1,60,183,91,92
050,01,035,"Alabama","Conecuh County",1,61,180,92,88
050,01,035,"Alabama","Conecuh County",1,62,173,88,85
050,01,035,"Alabama","Conecuh County",1,63,185,89,96
050,01,035,"Alabama","Conecuh County",1,64,176,83,93
050,01,035,"Alabama","Conecuh County",1,65,174,92,82
050,01,035,"Alabama","Conecuh County",1,66,185,85,100
050,01,035,"Alabama","Conecuh County",1,67,160,66,94
050,01,035,"Alabama","Conecuh County",1,68,140,62,78
050,01,035,"Alabama","Conecuh County",1,69,138,70,68
050,01,035,"Alabama","Conecuh County",1,70,144,74,70
050,01,035,"Alabama","Conecuh County",1,71,151,72,79
050,01,035,"Alabama","Conecuh County",1,72,161,79,82
050,01,035,"Alabama","Conecuh County",1,73,168,83,85
050,01,035,"Alabama","Conecuh County",1,74,128,57,71
050,01,035,"Alabama","Conecuh County",1,75,124,56,68
050,01,035,"Alabama","Conecuh County",1,76,105,47,58
050,01,035,"Alabama","Conecuh County",1,77,123,62,61
050,01,035,"Alabama","Conecuh County",1,78,101,50,51
050,01,035,"Alabama","Conecuh County",1,79,79,36,43
050,01,035,"Alabama","Conecuh County",1,80,73,28,45
050,01,035,"Alabama","Conecuh County",1,81,75,30,45
050,01,035,"Alabama","Conecuh County",1,82,77,36,41
050,01,035,"Alabama","Conecuh County",1,83,68,32,36
050,01,035,"Alabama","Conecuh County",1,84,60,21,39
050,01,035,"Alabama","Conecuh County",1,85,299,118,181
050,01,035,"Alabama","Conecuh County",2,0,113,54,59
050,01,035,"Alabama","Conecuh County",2,1,113,55,58
050,01,035,"Alabama","Conecuh County",2,2,122,58,64
050,01,035,"Alabama","Conecuh County",2,3,117,57,60
050,01,035,"Alabama","Conecuh County",2,4,120,54,66
050,01,035,"Alabama","Conecuh County",2,5,130,63,67
050,01,035,"Alabama","Conecuh County",2,6,134,65,69
050,01,035,"Alabama","Conecuh County",2,7,144,68,76
050,01,035,"Alabama","Conecuh County",2,8,141,70,71
050,01,035,"Alabama","Conecuh County",2,9,141,69,72
050,01,035,"Alabama","Conecuh County",2,10,128,63,65
050,01,035,"Alabama","Conecuh County",2,11,124,60,64
050,01,035,"Alabama","Conecuh County",2,12,140,75,65
050,01,035,"Alabama","Conecuh County",2,13,153,78,75
050,01,035,"Alabama","Conecuh County",2,14,147,70,77
050,01,035,"Alabama","Conecuh County",2,15,127,65,62
050,01,035,"Alabama","Conecuh County",2,16,138,74,64
050,01,035,"Alabama","Conecuh County",2,17,146,75,71
050,01,035,"Alabama","Conecuh County",2,18,128,61,67
050,01,035,"Alabama","Conecuh County",2,19,116,60,56
050,01,035,"Alabama","Conecuh County",2,20,118,59,59
050,01,035,"Alabama","Conecuh County",2,21,121,59,62
050,01,035,"Alabama","Conecuh County",2,22,127,66,61
050,01,035,"Alabama","Conecuh County",2,23,127,65,62
050,01,035,"Alabama","Conecuh County",2,24,126,65,61
050,01,035,"Alabama","Conecuh County",2,25,122,67,55
050,01,035,"Alabama","Conecuh County",2,26,116,58,58
050,01,035,"Alabama","Conecuh County",2,27,134,68,66
050,01,035,"Alabama","Conecuh County",2,28,129,64,65
050,01,035,"Alabama","Conecuh County",2,29,136,62,74
050,01,035,"Alabama","Conecuh County",2,30,127,61,66
050,01,035,"Alabama","Conecuh County",2,31,139,71,68
050,01,035,"Alabama","Conecuh County",2,32,116,60,56
050,01,035,"Alabama","Conecuh County",2,33,102,52,50
050,01,035,"Alabama","Conecuh County",2,34,108,56,52
050,01,035,"Alabama","Conecuh County",2,35,123,58,65
050,01,035,"Alabama","Conecuh County",2,36,127,55,72
050,01,035,"Alabama","Conecuh County",2,37,105,52,53
050,01,035,"Alabama","Conecuh County",2,38,102,54,48
050,01,035,"Alabama","Conecuh County",2,39,117,54,63
050,01,035,"Alabama","Conecuh County",2,40,125,59,66
050,01,035,"Alabama","Conecuh County",2,41,135,60,75
050,01,035,"Alabama","Conecuh County",2,42,130,61,69
050,01,035,"Alabama","Conecuh County",2,43,118,56,62
050,01,035,"Alabama","Conecuh County",2,44,115,56,59
050,01,035,"Alabama","Conecuh County",2,45,125,58,67
050,01,035,"Alabama","Conecuh County",2,46,131,57,74
050,01,035,"Alabama","Conecuh County",2,47,135,54,81
050,01,035,"Alabama","Conecuh County",2,48,137,60,77
050,01,035,"Alabama","Conecuh County",2,49,137,64,73
050,01,035,"Alabama","Conecuh County",2,50,145,63,82
050,01,035,"Alabama","Conecuh County",2,51,152,83,69
050,01,035,"Alabama","Conecuh County",2,52,144,76,68
050,01,035,"Alabama","Conecuh County",2,53,139,63,76
050,01,035,"Alabama","Conecuh County",2,54,147,64,83
050,01,035,"Alabama","Conecuh County",2,55,162,77,85
050,01,035,"Alabama","Conecuh County",2,56,172,83,89
050,01,035,"Alabama","Conecuh County",2,57,168,78,90
050,01,035,"Alabama","Conecuh County",2,58,181,90,91
050,01,035,"Alabama","Conecuh County",2,59,184,88,96
050,01,035,"Alabama","Conecuh County",2,60,181,89,92
050,01,035,"Alabama","Conecuh County",2,61,180,91,89
050,01,035,"Alabama","Conecuh County",2,62,175,89,86
050,01,035,"Alabama","Conecuh County",2,63,181,87,94
050,01,035,"Alabama","Conecuh County",2,64,173,83,90
050,01,035,"Alabama","Conecuh County",2,65,176,91,85
050,01,035,"Alabama","Conecuh County",2,66,185,88,97
050,01,035,"Alabama","Conecuh County",2,67,163,71,92
050,01,035,"Alabama","Conecuh County",2,68,143,63,80
050,01,035,"Alabama","Conecuh County",2,69,140,69,71
050,01,035,"Alabama","Conecuh County",2,70,142,73,69
050,01,035,"Alabama","Conecuh County",2,71,146,72,74
050,01,035,"Alabama","Conecuh County",2,72,155,75,80
050,01,035,"Alabama","Conecuh County",2,73,172,84,88
050,01,035,"Alabama","Conecuh County",2,74,130,60,70
050,01,035,"Alabama","Conecuh County",2,75,124,56,68
050,01,035,"Alabama","Conecuh County",2,76,107,48,59
050,01,035,"Alabama","Conecuh County",2,77,118,57,61
050,01,035,"Alabama","Conecuh County",2,78,103,51,52
050,01,035,"Alabama","Conecuh County",2,79,82,37,45
050,01,035,"Alabama","Conecuh County",2,80,73,30,43
050,01,035,"Alabama","Conecuh County",2,81,74,30,44
050,01,035,"Alabama","Conecuh County",2,82,77,35,42
050,01,035,"Alabama","Conecuh County",2,83,68,32,36
050,01,035,"Alabama","Conecuh County",2,84,59,22,37
050,01,035,"Alabama","Conecuh County",2,85,301,116,185
050,01,035,"Alabama","Conecuh County",3,0,111,61,50
050,01,035,"Alabama","Conecuh County",3,1,125,63,62
050,01,035,"Alabama","Conecuh County",3,2,114,58,56
050,01,035,"Alabama","Conecuh County",3,3,125,67,58
050,01,035,"Alabama","Conecuh County",3,4,109,54,55
050,01,035,"Alabama","Conecuh County",3,5,119,57,62
050,01,035,"Alabama","Conecuh County",3,6,130,62,68
050,01,035,"Alabama","Conecuh County",3,7,120,60,60
050,01,035,"Alabama","Conecuh County",3,8,132,62,70
050,01,035,"Alabama","Conecuh County",3,9,127,68,59
050,01,035,"Alabama","Conecuh County",3,10,132,68,64
050,01,035,"Alabama","Conecuh County",3,11,122,63,59
050,01,035,"Alabama","Conecuh County",3,12,114,55,59
050,01,035,"Alabama","Conecuh County",3,13,134,70,64
050,01,035,"Alabama","Conecuh County",3,14,146,75,71
050,01,035,"Alabama","Conecuh County",3,15,141,67,74
050,01,035,"Alabama","Conecuh County",3,16,123,62,61
050,01,035,"Alabama","Conecuh County",3,17,128,70,58
050,01,035,"Alabama","Conecuh County",3,18,121,61,60
050,01,035,"Alabama","Conecuh County",3,19,111,53,58
050,01,035,"Alabama","Conecuh County",3,20,125,58,67
050,01,035,"Alabama","Conecuh County",3,21,114,51,63
050,01,035,"Alabama","Conecuh County",3,22,130,68,62
050,01,035,"Alabama","Conecuh County",3,23,125,64,61
050,01,035,"Alabama","Conecuh County",3,24,124,63,61
050,01,035,"Alabama","Conecuh County",3,25,121,61,60
050,01,035,"Alabama","Conecuh County",3,26,132,66,66
050,01,035,"Alabama","Conecuh County",3,27,111,60,51
050,01,035,"Alabama","Conecuh County",3,28,123,62,61
050,01,035,"Alabama","Conecuh County",3,29,131,64,67
050,01,035,"Alabama","Conecuh County",3,30,133,58,75
050,01,035,"Alabama","Conecuh County",3,31,130,68,62
050,01,035,"Alabama","Conecuh County",3,32,134,71,63
050,01,035,"Alabama","Conecuh County",3,33,108,56,52
050,01,035,"Alabama","Conecuh County",3,34,96,47,49
050,01,035,"Alabama","Conecuh County",3,35,102,52,50
050,01,035,"Alabama","Conecuh County",3,36,120,61,59
050,01,035,"Alabama","Conecuh County",3,37,122,50,72
050,01,035,"Alabama","Conecuh County",3,38,105,51,54
050,01,035,"Alabama","Conecuh County",3,39,106,58,48
050,01,035,"Alabama","Conecuh County",3,40,118,54,64
050,01,035,"Alabama","Conecuh County",3,41,120,56,64
050,01,035,"Alabama","Conecuh County",3,42,128,55,73
050,01,035,"Alabama","Conecuh County",3,43,124,59,65
050,01,035,"Alabama","Conecuh County",3,44,115,56,59
050,01,035,"Alabama","Conecuh County",3,45,109,52,57
050,01,035,"Alabama","Conecuh County",3,46,133,60,73
050,01,035,"Alabama","Conecuh County",3,47,126,55,71
050,01,035,"Alabama","Conecuh County",3,48,137,56,81
050,01,035,"Alabama","Conecuh County",3,49,134,58,76
050,01,035,"Alabama","Conecuh County",3,50,134,65,69
050,01,035,"Alabama","Conecuh County",3,51,150,67,83
050,01,035,"Alabama","Conecuh County",3,52,148,82,66
050,01,035,"Alabama","Conecuh County",3,53,144,76,68
050,01,035,"Alabama","Conecuh County",3,54,140,64,76
050,01,035,"Alabama","Conecuh County",3,55,148,65,83
050,01,035,"Alabama","Conecuh County",3,56,165,80,85
050,01,035,"Alabama","Conecuh County",3,57,171,77,94
050,01,035,"Alabama","Conecuh County",3,58,158,74,84
050,01,035,"Alabama","Conecuh County",3,59,184,91,93
050,01,035,"Alabama","Conecuh County",3,60,180,86,94
050,01,035,"Alabama","Conecuh County",3,61,179,88,91
050,01,035,"Alabama","Conecuh County",3,62,178,89,89
050,01,035,"Alabama","Conecuh County",3,63,175,88,87
050,01,035,"Alabama","Conecuh County",3,64,179,85,94
050,01,035,"Alabama","Conecuh County",3,65,168,79,89
050,01,035,"Alabama","Conecuh County",3,66,177,92,85
050,01,035,"Alabama","Conecuh County",3,67,177,85,92
050,01,035,"Alabama","Conecuh County",3,68,165,69,96
050,01,035,"Alabama","Conecuh County",3,69,139,60,79
050,01,035,"Alabama","Conecuh County",3,70,138,70,68
050,01,035,"Alabama","Conecuh County",3,71,136,67,69
050,01,035,"Alabama","Conecuh County",3,72,138,68,70
050,01,035,"Alabama","Conecuh County",3,73,147,73,74
050,01,035,"Alabama","Conecuh County",3,74,165,83,82
050,01,035,"Alabama","Conecuh County",3,75,131,60,71
050,01,035,"Alabama","Conecuh County",3,76,116,52,64
050,01,035,"Alabama","Conecuh County",3,77,102,48,54
050,01,035,"Alabama","Conecuh County",3,78,114,56,58
050,01,035,"Alabama","Conecuh County",3,79,100,50,50
050,01,035,"Alabama","Conecuh County",3,80,73,32,41
050,01,035,"Alabama","Conecuh County",3,81,73,32,41
050,01,035,"Alabama","Conecuh County",3,82,71,28,43
050,01,035,"Alabama","Conecuh County",3,83,74,32,42
050,01,035,"Alabama","Conecuh County",3,84,61,27,34
050,01,035,"Alabama","Conecuh County",3,85,302,110,192
050,01,035,"Alabama","Conecuh County",4,0,131,71,60
050,01,035,"Alabama","Conecuh County",4,1,109,60,49
050,01,035,"Alabama","Conecuh County",4,2,133,62,71
050,01,035,"Alabama","Conecuh County",4,3,110,54,56
050,01,035,"Alabama","Conecuh County",4,4,128,67,61
050,01,035,"Alabama","Conecuh County",4,5,112,59,53
050,01,035,"Alabama","Conecuh County",4,6,121,54,67
050,01,035,"Alabama","Conecuh County",4,7,129,63,66
050,01,035,"Alabama","Conecuh County",4,8,124,61,63
050,01,035,"Alabama","Conecuh County",4,9,134,63,71
050,01,035,"Alabama","Conecuh County",4,10,118,62,56
050,01,035,"Alabama","Conecuh County",4,11,142,76,66
050,01,035,"Alabama","Conecuh County",4,12,121,66,55
050,01,035,"Alabama","Conecuh County",4,13,113,53,60
050,01,035,"Alabama","Conecuh County",4,14,137,72,65
050,01,035,"Alabama","Conecuh County",4,15,148,74,74
050,01,035,"Alabama","Conecuh County",4,16,151,73,78
050,01,035,"Alabama","Conecuh County",4,17,117,61,56
050,01,035,"Alabama","Conecuh County",4,18,103,56,47
050,01,035,"Alabama","Conecuh County",4,19,101,53,48
050,01,035,"Alabama","Conecuh County",4,20,109,48,61
050,01,035,"Alabama","Conecuh County",4,21,121,55,66
050,01,035,"Alabama","Conecuh County",4,22,121,57,64
050,01,035,"Alabama","Conecuh County",4,23,131,66,65
050,01,035,"Alabama","Conecuh County",4,24,117,62,55
050,01,035,"Alabama","Conecuh County",4,25,122,59,63
050,01,035,"Alabama","Conecuh County",4,26,121,60,61
050,01,035,"Alabama","Conecuh County",4,27,133,66,67
050,01,035,"Alabama","Conecuh County",4,28,107,57,50
050,01,035,"Alabama","Conecuh County",4,29,123,62,61
050,01,035,"Alabama","Conecuh County",4,30,129,64,65
050,01,035,"Alabama","Conecuh County",4,31,123,53,70
050,01,035,"Alabama","Conecuh County",4,32,130,66,64
050,01,035,"Alabama","Conecuh County",4,33,125,65,60
050,01,035,"Alabama","Conecuh County",4,34,108,54,54
050,01,035,"Alabama","Conecuh County",4,35,90,39,51
050,01,035,"Alabama","Conecuh County",4,36,109,57,52
050,01,035,"Alabama","Conecuh County",4,37,116,58,58
050,01,035,"Alabama","Conecuh County",4,38,124,51,73
050,01,035,"Alabama","Conecuh County",4,39,103,49,54
050,01,035,"Alabama","Conecuh County",4,40,107,59,48
050,01,035,"Alabama","Conecuh County",4,41,117,54,63
050,01,035,"Alabama","Conecuh County",4,42,119,57,62
050,01,035,"Alabama","Conecuh County",4,43,126,54,72
050,01,035,"Alabama","Conecuh County",4,44,123,63,60
050,01,035,"Alabama","Conecuh County",4,45,112,53,59
050,01,035,"Alabama","Conecuh County",4,46,110,54,56
050,01,035,"Alabama","Conecuh County",4,47,130,60,70
050,01,035,"Alabama","Conecuh County",4,48,129,56,73
050,01,035,"Alabama","Conecuh County",4,49,135,55,80
050,01,035,"Alabama","Conecuh County",4,50,131,57,74
050,01,035,"Alabama","Conecuh County",4,51,140,66,74
050,01,035,"Alabama","Conecuh County",4,52,147,66,81
050,01,035,"Alabama","Conecuh County",4,53,151,80,71
050,01,035,"Alabama","Conecuh County",4,54,140,73,67
050,01,035,"Alabama","Conecuh County",4,55,135,61,74
050,01,035,"Alabama","Conecuh County",4,56,154,71,83
050,01,035,"Alabama","Conecuh County",4,57,162,79,83
050,01,035,"Alabama","Conecuh County",4,58,170,75,95
050,01,035,"Alabama","Conecuh County",4,59,160,79,81
050,01,035,"Alabama","Conecuh County",4,60,172,80,92
050,01,035,"Alabama","Conecuh County",4,61,177,85,92
050,01,035,"Alabama","Conecuh County",4,62,181,88,93
050,01,035,"Alabama","Conecuh County",4,63,174,86,88
050,01,035,"Alabama","Conecuh County",4,64,172,86,86
050,01,035,"Alabama","Conecuh County",4,65,177,85,92
050,01,035,"Alabama","Conecuh County",4,66,167,77,90
050,01,035,"Alabama","Conecuh County",4,67,173,90,83
050,01,035,"Alabama","Conecuh County",4,68,183,88,95
050,01,035,"Alabama","Conecuh County",4,69,160,64,96
050,01,035,"Alabama","Conecuh County",4,70,133,58,75
050,01,035,"Alabama","Conecuh County",4,71,132,65,67
050,01,035,"Alabama","Conecuh County",4,72,133,69,64
050,01,035,"Alabama","Conecuh County",4,73,134,66,68
050,01,035,"Alabama","Conecuh County",4,74,140,73,67
050,01,035,"Alabama","Conecuh County",4,75,158,77,81
050,01,035,"Alabama","Conecuh County",4,76,127,58,69
050,01,035,"Alabama","Conecuh County",4,77,117,51,66
050,01,035,"Alabama","Conecuh County",4,78,96,46,50
050,01,035,"Alabama","Conecuh County",4,79,108,53,55
050,01,035,"Alabama","Conecuh County",4,80,94,46,48
050,01,035,"Alabama","Conecuh County",4,81,69,30,39
050,01,035,"Alabama","Conecuh County",4,82,67,26,41
050,01,035,"Alabama","Conecuh County",4,83,64,25,39
050,01,035,"Alabama","Conecuh County",4,84,68,28,40
050,01,035,"Alabama","Conecuh County",4,85,306,117,189
050,01,035,"Alabama","Conecuh County",5,0,132,71,61
050,01,035,"Alabama","Conecuh County",5,1,148,86,62
050,01,035,"Alabama","Conecuh County",5,2,116,64,52
050,01,035,"Alabama","Conecuh County",5,3,132,59,73
050,01,035,"Alabama","Conecuh County",5,4,105,50,55
050,01,035,"Alabama","Conecuh County",5,5,126,66,60
050,01,035,"Alabama","Conecuh County",5,6,107,56,51
050,01,035,"Alabama","Conecuh County",5,7,118,55,63
050,01,035,"Alabama","Conecuh County",5,8,125,59,66
050,01,035,"Alabama","Conecuh County",5,9,128,64,64
050,01,035,"Alabama","Conecuh County",5,10,127,60,67
050,01,035,"Alabama","Conecuh County",5,11,118,61,57
050,01,035,"Alabama","Conecuh County",5,12,138,76,62
050,01,035,"Alabama","Conecuh County",5,13,127,64,63
050,01,035,"Alabama","Conecuh County",5,14,110,57,53
050,01,035,"Alabama","Conecuh County",5,15,133,69,64
050,01,035,"Alabama","Conecuh County",5,16,146,73,73
050,01,035,"Alabama","Conecuh County",5,17,144,68,76
050,01,035,"Alabama","Conecuh County",5,18,101,53,48
050,01,035,"Alabama","Conecuh County",5,19,93,53,40
050,01,035,"Alabama","Conecuh County",5,20,102,54,48
050,01,035,"Alabama","Conecuh County",5,21,116,51,65
050,01,035,"Alabama","Conecuh County",5,22,127,58,69
050,01,035,"Alabama","Conecuh County",5,23,113,52,61
050,01,035,"Alabama","Conecuh County",5,24,136,72,64
050,01,035,"Alabama","Conecuh County",5,25,128,67,61
050,01,035,"Alabama","Conecuh County",5,26,119,57,62
050,01,035,"Alabama","Conecuh County",5,27,121,60,61
050,01,035,"Alabama","Conecuh County",5,28,122,60,62
050,01,035,"Alabama","Conecuh County",5,29,109,57,52
050,01,035,"Alabama","Conecuh County",5,30,130,67,63
050,01,035,"Alabama","Conecuh County",5,31,129,62,67
050,01,035,"Alabama","Conecuh County",5,32,131,62,69
050,01,035,"Alabama","Conecuh County",5,33,126,66,60
050,01,035,"Alabama","Conecuh County",5,34,127,64,63
050,01,035,"Alabama","Conecuh County",5,35,107,53,54
050,01,035,"Alabama","Conecuh County",5,36,97,44,53
050,01,035,"Alabama","Conecuh County",5,37,101,50,51
050,01,035,"Alabama","Conecuh County",5,38,114,54,60
050,01,035,"Alabama","Conecuh County",5,39,125,55,70
050,01,035,"Alabama","Conecuh County",5,40,102,52,50
050,01,035,"Alabama","Conecuh County",5,41,106,61,45
050,01,035,"Alabama","Conecuh County",5,42,118,53,65
050,01,035,"Alabama","Conecuh County",5,43,119,62,57
050,01,035,"Alabama","Conecuh County",5,44,132,56,76
050,01,035,"Alabama","Conecuh County",5,45,126,61,65
050,01,035,"Alabama","Conecuh County",5,46,114,57,57
050,01,035,"Alabama","Conecuh County",5,47,111,51,60
050,01,035,"Alabama","Conecuh County",5,48,130,58,72
050,01,035,"Alabama","Conecuh County",5,49,125,58,67
050,01,035,"Alabama","Conecuh County",5,50,133,52,81
050,01,035,"Alabama","Conecuh County",5,51,132,59,73
050,01,035,"Alabama","Conecuh County",5,52,140,65,75
050,01,035,"Alabama","Conecuh County",5,53,145,65,80
050,01,035,"Alabama","Conecuh County",5,54,146,79,67
050,01,035,"Alabama","Conecuh County",5,55,144,75,69
050,01,035,"Alabama","Conecuh County",5,56,139,64,75
050,01,035,"Alabama","Conecuh County",5,57,157,71,86
050,01,035,"Alabama","Conecuh County",5,58,157,79,78
050,01,035,"Alabama","Conecuh County",5,59,170,76,94
050,01,035,"Alabama","Conecuh County",5,60,156,76,80
050,01,035,"Alabama","Conecuh County",5,61,173,82,91
050,01,035,"Alabama","Conecuh County",5,62,175,83,92
050,01,035,"Alabama","Conecuh County",5,63,179,88,91
050,01,035,"Alabama","Conecuh County",5,64,172,83,89
050,01,035,"Alabama","Conecuh County",5,65,169,86,83
050,01,035,"Alabama","Conecuh County",5,66,171,82,89
050,01,035,"Alabama","Conecuh County",5,67,168,75,93
050,01,035,"Alabama","Conecuh County",5,68,172,90,82
050,01,035,"Alabama","Conecuh County",5,69,182,88,94
050,01,035,"Alabama","Conecuh County",5,70,155,65,90
050,01,035,"Alabama","Conecuh County",5,71,124,51,73
050,01,035,"Alabama","Conecuh County",5,72,127,64,63
050,01,035,"Alabama","Conecuh County",5,73,128,67,61
050,01,035,"Alabama","Conecuh County",5,74,126,64,62
050,01,035,"Alabama","Conecuh County",5,75,137,69,68
050,01,035,"Alabama","Conecuh County",5,76,146,74,72
050,01,035,"Alabama","Conecuh County",5,77,125,57,68
050,01,035,"Alabama","Conecuh County",5,78,111,47,64
050,01,035,"Alabama","Conecuh County",5,79,87,42,45
050,01,035,"Alabama","Conecuh County",5,80,99,50,49
050,01,035,"Alabama","Conecuh County",5,81,86,44,42
050,01,035,"Alabama","Conecuh County",5,82,65,27,38
050,01,035,"Alabama","Conecuh County",5,83,61,21,40
050,01,035,"Alabama","Conecuh County",5,84,57,21,36
050,01,035,"Alabama","Conecuh County",5,85,323,126,197
050,01,037,"Alabama","Coosa County",1,0,77,40,37
050,01,037,"Alabama","Coosa County",1,1,83,42,41
050,01,037,"Alabama","Coosa County",1,2,102,47,55
050,01,037,"Alabama","Coosa County",1,3,91,48,43
050,01,037,"Alabama","Coosa County",1,4,86,45,41
050,01,037,"Alabama","Coosa County",1,5,92,43,49
050,01,037,"Alabama","Coosa County",1,6,97,55,42
050,01,037,"Alabama","Coosa County",1,7,89,50,39
050,01,037,"Alabama","Coosa County",1,8,100,52,48
050,01,037,"Alabama","Coosa County",1,9,80,44,36
050,01,037,"Alabama","Coosa County",1,10,82,48,34
050,01,037,"Alabama","Coosa County",1,11,100,55,45
050,01,037,"Alabama","Coosa County",1,12,103,52,51
050,01,037,"Alabama","Coosa County",1,13,94,49,45
050,01,037,"Alabama","Coosa County",1,14,109,50,59
050,01,037,"Alabama","Coosa County",1,15,108,53,55
050,01,037,"Alabama","Coosa County",1,16,102,54,48
050,01,037,"Alabama","Coosa County",1,17,100,54,46
050,01,037,"Alabama","Coosa County",1,18,93,50,43
050,01,037,"Alabama","Coosa County",1,19,82,44,38
050,01,037,"Alabama","Coosa County",1,20,81,44,37
050,01,037,"Alabama","Coosa County",1,21,98,53,45
050,01,037,"Alabama","Coosa County",1,22,100,51,49
050,01,037,"Alabama","Coosa County",1,23,101,49,52
050,01,037,"Alabama","Coosa County",1,24,106,61,45
050,01,037,"Alabama","Coosa County",1,25,116,62,54
050,01,037,"Alabama","Coosa County",1,26,112,70,42
050,01,037,"Alabama","Coosa County",1,27,123,66,57
050,01,037,"Alabama","Coosa County",1,28,119,67,52
050,01,037,"Alabama","Coosa County",1,29,105,63,42
050,01,037,"Alabama","Coosa County",1,30,106,51,55
050,01,037,"Alabama","Coosa County",1,31,99,56,43
050,01,037,"Alabama","Coosa County",1,32,94,48,46
050,01,037,"Alabama","Coosa County",1,33,99,42,57
050,01,037,"Alabama","Coosa County",1,34,117,65,52
050,01,037,"Alabama","Coosa County",1,35,110,54,56
050,01,037,"Alabama","Coosa County",1,36,92,42,50
050,01,037,"Alabama","Coosa County",1,37,104,57,47
050,01,037,"Alabama","Coosa County",1,38,121,68,53
050,01,037,"Alabama","Coosa County",1,39,107,51,56
050,01,037,"Alabama","Coosa County",1,40,94,44,50
050,01,037,"Alabama","Coosa County",1,41,110,46,64
050,01,037,"Alabama","Coosa County",1,42,117,60,57
050,01,037,"Alabama","Coosa County",1,43,112,64,48
050,01,037,"Alabama","Coosa County",1,44,114,57,57
050,01,037,"Alabama","Coosa County",1,45,124,62,62
050,01,037,"Alabama","Coosa County",1,46,135,63,72
050,01,037,"Alabama","Coosa County",1,47,138,63,75
050,01,037,"Alabama","Coosa County",1,48,152,69,83
050,01,037,"Alabama","Coosa County",1,49,186,87,99
050,01,037,"Alabama","Coosa County",1,50,156,77,79
050,01,037,"Alabama","Coosa County",1,51,154,70,84
050,01,037,"Alabama","Coosa County",1,52,144,73,71
050,01,037,"Alabama","Coosa County",1,53,150,85,65
050,01,037,"Alabama","Coosa County",1,54,165,92,73
050,01,037,"Alabama","Coosa County",1,55,167,80,87
050,01,037,"Alabama","Coosa County",1,56,172,86,86
050,01,037,"Alabama","Coosa County",1,57,191,102,89
050,01,037,"Alabama","Coosa County",1,58,185,92,93
050,01,037,"Alabama","Coosa County",1,59,183,86,97
050,01,037,"Alabama","Coosa County",1,60,188,86,102
050,01,037,"Alabama","Coosa County",1,61,201,95,106
050,01,037,"Alabama","Coosa County",1,62,199,104,95
050,01,037,"Alabama","Coosa County",1,63,177,100,77
050,01,037,"Alabama","Coosa County",1,64,189,109,80
050,01,037,"Alabama","Coosa County",1,65,174,96,78
050,01,037,"Alabama","Coosa County",1,66,176,97,79
050,01,037,"Alabama","Coosa County",1,67,165,84,81
050,01,037,"Alabama","Coosa County",1,68,177,84,93
050,01,037,"Alabama","Coosa County",1,69,130,67,63
050,01,037,"Alabama","Coosa County",1,70,139,78,61
050,01,037,"Alabama","Coosa County",1,71,145,73,72
050,01,037,"Alabama","Coosa County",1,72,149,70,79
050,01,037,"Alabama","Coosa County",1,73,148,65,83
050,01,037,"Alabama","Coosa County",1,74,92,36,56
050,01,037,"Alabama","Coosa County",1,75,109,49,60
050,01,037,"Alabama","Coosa County",1,76,105,59,46
050,01,037,"Alabama","Coosa County",1,77,96,56,40
050,01,037,"Alabama","Coosa County",1,78,102,55,47
050,01,037,"Alabama","Coosa County",1,79,77,38,39
050,01,037,"Alabama","Coosa County",1,80,59,26,33
050,01,037,"Alabama","Coosa County",1,81,57,24,33
050,01,037,"Alabama","Coosa County",1,82,49,23,26
050,01,037,"Alabama","Coosa County",1,83,49,21,28
050,01,037,"Alabama","Coosa County",1,84,56,23,33
050,01,037,"Alabama","Coosa County",1,85,241,90,151
050,01,037,"Alabama","Coosa County",2,0,85,43,42
050,01,037,"Alabama","Coosa County",2,1,84,42,42
050,01,037,"Alabama","Coosa County",2,2,100,48,52
050,01,037,"Alabama","Coosa County",2,3,94,48,46
050,01,037,"Alabama","Coosa County",2,4,87,45,42
050,01,037,"Alabama","Coosa County",2,5,90,44,46
050,01,037,"Alabama","Coosa County",2,6,95,53,42
050,01,037,"Alabama","Coosa County",2,7,92,52,40
050,01,037,"Alabama","Coosa County",2,8,95,51,44
050,01,037,"Alabama","Coosa County",2,9,85,45,40
050,01,037,"Alabama","Coosa County",2,10,83,47,36
050,01,037,"Alabama","Coosa County",2,11,98,55,43
050,01,037,"Alabama","Coosa County",2,12,102,52,50
050,01,037,"Alabama","Coosa County",2,13,95,49,46
050,01,037,"Alabama","Coosa County",2,14,104,49,55
050,01,037,"Alabama","Coosa County",2,15,108,53,55
050,01,037,"Alabama","Coosa County",2,16,100,52,48
050,01,037,"Alabama","Coosa County",2,17,98,52,46
050,01,037,"Alabama","Coosa County",2,18,92,50,42
050,01,037,"Alabama","Coosa County",2,19,80,43,37
050,01,037,"Alabama","Coosa County",2,20,83,45,38
050,01,037,"Alabama","Coosa County",2,21,93,51,42
050,01,037,"Alabama","Coosa County",2,22,98,49,49
050,01,037,"Alabama","Coosa County",2,23,101,50,51
050,01,037,"Alabama","Coosa County",2,24,105,59,46
050,01,037,"Alabama","Coosa County",2,25,111,60,51
050,01,037,"Alabama","Coosa County",2,26,114,68,46
050,01,037,"Alabama","Coosa County",2,27,116,63,53
050,01,037,"Alabama","Coosa County",2,28,117,64,53
050,01,037,"Alabama","Coosa County",2,29,104,59,45
050,01,037,"Alabama","Coosa County",2,30,107,54,53
050,01,037,"Alabama","Coosa County",2,31,100,54,46
050,01,037,"Alabama","Coosa County",2,32,95,49,46
050,01,037,"Alabama","Coosa County",2,33,95,41,54
050,01,037,"Alabama","Coosa County",2,34,114,59,55
050,01,037,"Alabama","Coosa County",2,35,110,54,56
050,01,037,"Alabama","Coosa County",2,36,93,43,50
050,01,037,"Alabama","Coosa County",2,37,103,54,49
050,01,037,"Alabama","Coosa County",2,38,115,63,52
050,01,037,"Alabama","Coosa County",2,39,105,52,53
050,01,037,"Alabama","Coosa County",2,40,96,43,53
050,01,037,"Alabama","Coosa County",2,41,106,44,62
050,01,037,"Alabama","Coosa County",2,42,112,54,58
050,01,037,"Alabama","Coosa County",2,43,112,61,51
050,01,037,"Alabama","Coosa County",2,44,110,56,54
050,01,037,"Alabama","Coosa County",2,45,123,61,62
050,01,037,"Alabama","Coosa County",2,46,129,60,69
050,01,037,"Alabama","Coosa County",2,47,135,62,73
050,01,037,"Alabama","Coosa County",2,48,148,66,82
050,01,037,"Alabama","Coosa County",2,49,175,81,94
050,01,037,"Alabama","Coosa County",2,50,160,77,83
050,01,037,"Alabama","Coosa County",2,51,152,70,82
050,01,037,"Alabama","Coosa County",2,52,146,73,73
050,01,037,"Alabama","Coosa County",2,53,148,81,67
050,01,037,"Alabama","Coosa County",2,54,160,88,72
050,01,037,"Alabama","Coosa County",2,55,169,84,85
050,01,037,"Alabama","Coosa County",2,56,172,85,87
050,01,037,"Alabama","Coosa County",2,57,186,98,88
050,01,037,"Alabama","Coosa County",2,58,185,93,92
050,01,037,"Alabama","Coosa County",2,59,184,89,95
050,01,037,"Alabama","Coosa County",2,60,186,87,99
050,01,037,"Alabama","Coosa County",2,61,197,92,105
050,01,037,"Alabama","Coosa County",2,62,201,102,99
050,01,037,"Alabama","Coosa County",2,63,183,102,81
050,01,037,"Alabama","Coosa County",2,64,188,108,80
050,01,037,"Alabama","Coosa County",2,65,176,98,78
050,01,037,"Alabama","Coosa County",2,66,177,97,80
050,01,037,"Alabama","Coosa County",2,67,171,88,83
050,01,037,"Alabama","Coosa County",2,68,171,83,88
050,01,037,"Alabama","Coosa County",2,69,143,71,72
050,01,037,"Alabama","Coosa County",2,70,136,75,61
050,01,037,"Alabama","Coosa County",2,71,140,72,68
050,01,037,"Alabama","Coosa County",2,72,148,70,78
050,01,037,"Alabama","Coosa County",2,73,156,70,86
050,01,037,"Alabama","Coosa County",2,74,95,37,58
050,01,037,"Alabama","Coosa County",2,75,106,46,60
050,01,037,"Alabama","Coosa County",2,76,105,56,49
050,01,037,"Alabama","Coosa County",2,77,100,58,42
050,01,037,"Alabama","Coosa County",2,78,99,54,45
050,01,037,"Alabama","Coosa County",2,79,80,40,40
050,01,037,"Alabama","Coosa County",2,80,63,29,34
050,01,037,"Alabama","Coosa County",2,81,58,24,34
050,01,037,"Alabama","Coosa County",2,82,50,24,26
050,01,037,"Alabama","Coosa County",2,83,49,22,27
050,01,037,"Alabama","Coosa County",2,84,53,22,31
050,01,037,"Alabama","Coosa County",2,85,250,94,156
050,01,037,"Alabama","Coosa County",3,0,79,40,39
050,01,037,"Alabama","Coosa County",3,1,90,45,45
050,01,037,"Alabama","Coosa County",3,2,90,47,43
050,01,037,"Alabama","Coosa County",3,3,96,48,48
050,01,037,"Alabama","Coosa County",3,4,97,49,48
050,01,037,"Alabama","Coosa County",3,5,90,48,42
050,01,037,"Alabama","Coosa County",3,6,83,35,48
050,01,037,"Alabama","Coosa County",3,7,96,55,41
050,01,037,"Alabama","Coosa County",3,8,97,56,41
050,01,037,"Alabama","Coosa County",3,9,96,52,44
050,01,037,"Alabama","Coosa County",3,10,78,42,36
050,01,037,"Alabama","Coosa County",3,11,91,53,38
050,01,037,"Alabama","Coosa County",3,12,100,53,47
050,01,037,"Alabama","Coosa County",3,13,103,46,57
050,01,037,"Alabama","Coosa County",3,14,103,49,54
050,01,037,"Alabama","Coosa County",3,15,99,47,52
050,01,037,"Alabama","Coosa County",3,16,110,53,57
050,01,037,"Alabama","Coosa County",3,17,91,49,42
050,01,037,"Alabama","Coosa County",3,18,86,51,35
050,01,037,"Alabama","Coosa County",3,19,75,43,32
050,01,037,"Alabama","Coosa County",3,20,82,43,39
050,01,037,"Alabama","Coosa County",3,21,90,52,38
050,01,037,"Alabama","Coosa County",3,22,96,52,44
050,01,037,"Alabama","Coosa County",3,23,106,52,54
050,01,037,"Alabama","Coosa County",3,24,108,50,58
050,01,037,"Alabama","Coosa County",3,25,115,58,57
050,01,037,"Alabama","Coosa County",3,26,120,68,52
050,01,037,"Alabama","Coosa County",3,27,108,59,49
050,01,037,"Alabama","Coosa County",3,28,113,59,54
050,01,037,"Alabama","Coosa County",3,29,113,61,52
050,01,037,"Alabama","Coosa County",3,30,111,62,49
050,01,037,"Alabama","Coosa County",3,31,106,56,50
050,01,037,"Alabama","Coosa County",3,32,98,56,42
050,01,037,"Alabama","Coosa County",3,33,86,45,41
050,01,037,"Alabama","Coosa County",3,34,104,48,56
050,01,037,"Alabama","Coosa County",3,35,102,53,49
050,01,037,"Alabama","Coosa County",3,36,108,49,59
050,01,037,"Alabama","Coosa County",3,37,99,47,52
050,01,037,"Alabama","Coosa County",3,38,102,53,49
050,01,037,"Alabama","Coosa County",3,39,111,58,53
050,01,037,"Alabama","Coosa County",3,40,104,53,51
050,01,037,"Alabama","Coosa County",3,41,94,42,52
050,01,037,"Alabama","Coosa County",3,42,102,45,57
050,01,037,"Alabama","Coosa County",3,43,108,54,54
050,01,037,"Alabama","Coosa County",3,44,113,57,56
050,01,037,"Alabama","Coosa County",3,45,108,58,50
050,01,037,"Alabama","Coosa County",3,46,122,57,65
050,01,037,"Alabama","Coosa County",3,47,133,60,73
050,01,037,"Alabama","Coosa County",3,48,147,71,76
050,01,037,"Alabama","Coosa County",3,49,150,68,82
050,01,037,"Alabama","Coosa County",3,50,169,81,88
050,01,037,"Alabama","Coosa County",3,51,161,75,86
050,01,037,"Alabama","Coosa County",3,52,157,72,85
050,01,037,"Alabama","Coosa County",3,53,146,76,70
050,01,037,"Alabama","Coosa County",3,54,155,84,71
050,01,037,"Alabama","Coosa County",3,55,162,87,75
050,01,037,"Alabama","Coosa County",3,56,172,85,87
050,01,037,"Alabama","Coosa County",3,57,173,87,86
050,01,037,"Alabama","Coosa County",3,58,195,105,90
050,01,037,"Alabama","Coosa County",3,59,184,94,90
050,01,037,"Alabama","Coosa County",3,60,188,91,97
050,01,037,"Alabama","Coosa County",3,61,189,86,103
050,01,037,"Alabama","Coosa County",3,62,198,94,104
050,01,037,"Alabama","Coosa County",3,63,193,92,101
050,01,037,"Alabama","Coosa County",3,64,187,103,84
050,01,037,"Alabama","Coosa County",3,65,184,100,84
050,01,037,"Alabama","Coosa County",3,66,179,100,79
050,01,037,"Alabama","Coosa County",3,67,172,92,80
050,01,037,"Alabama","Coosa County",3,68,163,86,77
050,01,037,"Alabama","Coosa County",3,69,162,79,83
050,01,037,"Alabama","Coosa County",3,70,139,69,70
050,01,037,"Alabama","Coosa County",3,71,138,75,63
050,01,037,"Alabama","Coosa County",3,72,139,73,66
050,01,037,"Alabama","Coosa County",3,73,139,64,75
050,01,037,"Alabama","Coosa County",3,74,149,66,83
050,01,037,"Alabama","Coosa County",3,75,94,35,59
050,01,037,"Alabama","Coosa County",3,76,97,44,53
050,01,037,"Alabama","Coosa County",3,77,95,51,44
050,01,037,"Alabama","Coosa County",3,78,92,54,38
050,01,037,"Alabama","Coosa County",3,79,95,51,44
050,01,037,"Alabama","Coosa County",3,80,74,37,37
050,01,037,"Alabama","Coosa County",3,81,60,30,30
050,01,037,"Alabama","Coosa County",3,82,52,21,31
050,01,037,"Alabama","Coosa County",3,83,47,22,25
050,01,037,"Alabama","Coosa County",3,84,38,18,20
050,01,037,"Alabama","Coosa County",3,85,268,108,160
050,01,037,"Alabama","Coosa County",4,0,86,44,42
050,01,037,"Alabama","Coosa County",4,1,94,52,42
050,01,037,"Alabama","Coosa County",4,2,88,46,42
050,01,037,"Alabama","Coosa County",4,3,88,48,40
050,01,037,"Alabama","Coosa County",4,4,109,55,54
050,01,037,"Alabama","Coosa County",4,5,96,49,47
050,01,037,"Alabama","Coosa County",4,6,93,49,44
050,01,037,"Alabama","Coosa County",4,7,76,35,41
050,01,037,"Alabama","Coosa County",4,8,96,56,40
050,01,037,"Alabama","Coosa County",4,9,98,54,44
050,01,037,"Alabama","Coosa County",4,10,87,45,42
050,01,037,"Alabama","Coosa County",4,11,78,45,33
050,01,037,"Alabama","Coosa County",4,12,89,49,40
050,01,037,"Alabama","Coosa County",4,13,100,53,47
050,01,037,"Alabama","Coosa County",4,14,101,49,52
050,01,037,"Alabama","Coosa County",4,15,94,41,53
050,01,037,"Alabama","Coosa County",4,16,104,51,53
050,01,037,"Alabama","Coosa County",4,17,110,50,60
050,01,037,"Alabama","Coosa County",4,18,82,43,39
050,01,037,"Alabama","Coosa County",4,19,68,43,25
050,01,037,"Alabama","Coosa County",4,20,77,42,35
050,01,037,"Alabama","Coosa County",4,21,93,54,39
050,01,037,"Alabama","Coosa County",4,22,89,44,45
050,01,037,"Alabama","Coosa County",4,23,99,55,44
050,01,037,"Alabama","Coosa County",4,24,107,58,49
050,01,037,"Alabama","Coosa County",4,25,105,51,54
050,01,037,"Alabama","Coosa County",4,26,128,68,60
050,01,037,"Alabama","Coosa County",4,27,112,63,49
050,01,037,"Alabama","Coosa County",4,28,110,61,49
050,01,037,"Alabama","Coosa County",4,29,117,60,57
050,01,037,"Alabama","Coosa County",4,30,108,60,48
050,01,037,"Alabama","Coosa County",4,31,103,59,44
050,01,037,"Alabama","Coosa County",4,32,109,58,51
050,01,037,"Alabama","Coosa County",4,33,99,56,43
050,01,037,"Alabama","Coosa County",4,34,107,58,49
050,01,037,"Alabama","Coosa County",4,35,105,52,53
050,01,037,"Alabama","Coosa County",4,36,102,55,47
050,01,037,"Alabama","Coosa County",4,37,109,53,56
050,01,037,"Alabama","Coosa County",4,38,104,52,52
050,01,037,"Alabama","Coosa County",4,39,99,53,46
050,01,037,"Alabama","Coosa County",4,40,121,67,54
050,01,037,"Alabama","Coosa County",4,41,113,59,54
050,01,037,"Alabama","Coosa County",4,42,97,47,50
050,01,037,"Alabama","Coosa County",4,43,99,42,57
050,01,037,"Alabama","Coosa County",4,44,105,51,54
050,01,037,"Alabama","Coosa County",4,45,116,62,54
050,01,037,"Alabama","Coosa County",4,46,108,63,45
050,01,037,"Alabama","Coosa County",4,47,122,57,65
050,01,037,"Alabama","Coosa County",4,48,135,62,73
050,01,037,"Alabama","Coosa County",4,49,147,76,71
050,01,037,"Alabama","Coosa County",4,50,149,65,84
050,01,037,"Alabama","Coosa County",4,51,167,79,88
050,01,037,"Alabama","Coosa County",4,52,165,83,82
050,01,037,"Alabama","Coosa County",4,53,159,74,85
050,01,037,"Alabama","Coosa County",4,54,142,72,70
050,01,037,"Alabama","Coosa County",4,55,154,82,72
050,01,037,"Alabama","Coosa County",4,56,154,82,72
050,01,037,"Alabama","Coosa County",4,57,169,82,87
050,01,037,"Alabama","Coosa County",4,58,176,92,84
050,01,037,"Alabama","Coosa County",4,59,190,102,88
050,01,037,"Alabama","Coosa County",4,60,179,89,90
050,01,037,"Alabama","Coosa County",4,61,185,87,98
050,01,037,"Alabama","Coosa County",4,62,187,85,102
050,01,037,"Alabama","Coosa County",4,63,196,93,103
050,01,037,"Alabama","Coosa County",4,64,195,92,103
050,01,037,"Alabama","Coosa County",4,65,182,95,87
050,01,037,"Alabama","Coosa County",4,66,190,100,90
050,01,037,"Alabama","Coosa County",4,67,186,103,83
050,01,037,"Alabama","Coosa County",4,68,165,92,73
050,01,037,"Alabama","Coosa County",4,69,162,85,77
050,01,037,"Alabama","Coosa County",4,70,162,78,84
050,01,037,"Alabama","Coosa County",4,71,141,70,71
050,01,037,"Alabama","Coosa County",4,72,133,73,60
050,01,037,"Alabama","Coosa County",4,73,135,72,63
050,01,037,"Alabama","Coosa County",4,74,136,59,77
050,01,037,"Alabama","Coosa County",4,75,143,61,82
050,01,037,"Alabama","Coosa County",4,76,87,32,55
050,01,037,"Alabama","Coosa County",4,77,92,40,52
050,01,037,"Alabama","Coosa County",4,78,88,49,39
050,01,037,"Alabama","Coosa County",4,79,87,53,34
050,01,037,"Alabama","Coosa County",4,80,91,49,42
050,01,037,"Alabama","Coosa County",4,81,73,37,36
050,01,037,"Alabama","Coosa County",4,82,53,24,29
050,01,037,"Alabama","Coosa County",4,83,48,21,27
050,01,037,"Alabama","Coosa County",4,84,43,20,23
050,01,037,"Alabama","Coosa County",4,85,261,107,154
050,01,037,"Alabama","Coosa County",5,0,87,44,43
050,01,037,"Alabama","Coosa County",5,1,89,52,37
050,01,037,"Alabama","Coosa County",5,2,85,43,42
050,01,037,"Alabama","Coosa County",5,3,96,50,46
050,01,037,"Alabama","Coosa County",5,4,88,49,39
050,01,037,"Alabama","Coosa County",5,5,108,52,56
050,01,037,"Alabama","Coosa County",5,6,90,44,46
050,01,037,"Alabama","Coosa County",5,7,96,54,42
050,01,037,"Alabama","Coosa County",5,8,83,40,43
050,01,037,"Alabama","Coosa County",5,9,101,56,45
050,01,037,"Alabama","Coosa County",5,10,90,50,40
050,01,037,"Alabama","Coosa County",5,11,95,50,45
050,01,037,"Alabama","Coosa County",5,12,71,35,36
050,01,037,"Alabama","Coosa County",5,13,84,46,38
050,01,037,"Alabama","Coosa County",5,14,97,54,43
050,01,037,"Alabama","Coosa County",5,15,106,48,58
050,01,037,"Alabama","Coosa County",5,16,97,48,49
050,01,037,"Alabama","Coosa County",5,17,102,50,52
050,01,037,"Alabama","Coosa County",5,18,94,46,48
050,01,037,"Alabama","Coosa County",5,19,63,34,29
050,01,037,"Alabama","Coosa County",5,20,76,45,31
050,01,037,"Alabama","Coosa County",5,21,83,47,36
050,01,037,"Alabama","Coosa County",5,22,90,49,41
050,01,037,"Alabama","Coosa County",5,23,99,50,49
050,01,037,"Alabama","Coosa County",5,24,101,56,45
050,01,037,"Alabama","Coosa County",5,25,112,61,51
050,01,037,"Alabama","Coosa County",5,26,112,59,53
050,01,037,"Alabama","Coosa County",5,27,107,55,52
050,01,037,"Alabama","Coosa County",5,28,113,63,50
050,01,037,"Alabama","Coosa County",5,29,109,58,51
050,01,037,"Alabama","Coosa County",5,30,117,56,61
050,01,037,"Alabama","Coosa County",5,31,102,55,47
050,01,037,"Alabama","Coosa County",5,32,105,64,41
050,01,037,"Alabama","Coosa County",5,33,106,52,54
050,01,037,"Alabama","Coosa County",5,34,114,67,47
050,01,037,"Alabama","Coosa County",5,35,103,53,50
050,01,037,"Alabama","Coosa County",5,36,102,46,56
050,01,037,"Alabama","Coosa County",5,37,113,62,51
050,01,037,"Alabama","Coosa County",5,38,110,55,55
050,01,037,"Alabama","Coosa County",5,39,99,51,48
050,01,037,"Alabama","Coosa County",5,40,101,56,45
050,01,037,"Alabama","Coosa County",5,41,125,69,56
050,01,037,"Alabama","Coosa County",5,42,114,64,50
050,01,037,"Alabama","Coosa County",5,43,98,44,54
050,01,037,"Alabama","Coosa County",5,44,91,37,54
050,01,037,"Alabama","Coosa County",5,45,98,45,53
050,01,037,"Alabama","Coosa County",5,46,114,62,52
050,01,037,"Alabama","Coosa County",5,47,99,58,41
050,01,037,"Alabama","Coosa County",5,48,131,61,70
050,01,037,"Alabama","Coosa County",5,49,148,65,83
050,01,037,"Alabama","Coosa County",5,50,147,75,72
050,01,037,"Alabama","Coosa County",5,51,146,62,84
050,01,037,"Alabama","Coosa County",5,52,169,82,87
050,01,037,"Alabama","Coosa County",5,53,163,85,78
050,01,037,"Alabama","Coosa County",5,54,157,70,87
050,01,037,"Alabama","Coosa County",5,55,146,70,76
050,01,037,"Alabama","Coosa County",5,56,153,81,72
050,01,037,"Alabama","Coosa County",5,57,148,75,73
050,01,037,"Alabama","Coosa County",5,58,170,83,87
050,01,037,"Alabama","Coosa County",5,59,176,93,83
050,01,037,"Alabama","Coosa County",5,60,196,104,92
050,01,037,"Alabama","Coosa County",5,61,174,88,86
050,01,037,"Alabama","Coosa County",5,62,190,94,96
050,01,037,"Alabama","Coosa County",5,63,183,81,102
050,01,037,"Alabama","Coosa County",5,64,195,93,102
050,01,037,"Alabama","Coosa County",5,65,193,89,104
050,01,037,"Alabama","Coosa County",5,66,184,94,90
050,01,037,"Alabama","Coosa County",5,67,186,95,91
050,01,037,"Alabama","Coosa County",5,68,188,107,81
050,01,037,"Alabama","Coosa County",5,69,162,87,75
050,01,037,"Alabama","Coosa County",5,70,160,83,77
050,01,037,"Alabama","Coosa County",5,71,162,77,85
050,01,037,"Alabama","Coosa County",5,72,137,69,68
050,01,037,"Alabama","Coosa County",5,73,130,71,59
050,01,037,"Alabama","Coosa County",5,74,126,67,59
050,01,037,"Alabama","Coosa County",5,75,129,52,77
050,01,037,"Alabama","Coosa County",5,76,135,58,77
050,01,037,"Alabama","Coosa County",5,77,80,26,54
050,01,037,"Alabama","Coosa County",5,78,86,39,47
050,01,037,"Alabama","Coosa County",5,79,84,47,37
050,01,037,"Alabama","Coosa County",5,80,84,51,33
050,01,037,"Alabama","Coosa County",5,81,86,47,39
050,01,037,"Alabama","Coosa County",5,82,63,32,31
050,01,037,"Alabama","Coosa County",5,83,50,23,27
050,01,037,"Alabama","Coosa County",5,84,44,18,26
050,01,037,"Alabama","Coosa County",5,85,272,114,158
050,01,039,"Alabama","Covington County",1,0,398,201,197
050,01,039,"Alabama","Covington County",1,1,403,198,205
050,01,039,"Alabama","Covington County",1,2,431,228,203
050,01,039,"Alabama","Covington County",1,3,439,216,223
050,01,039,"Alabama","Covington County",1,4,473,246,227
050,01,039,"Alabama","Covington County",1,5,452,230,222
050,01,039,"Alabama","Covington County",1,6,468,245,223
050,01,039,"Alabama","Covington County",1,7,475,244,231
050,01,039,"Alabama","Covington County",1,8,443,227,216
050,01,039,"Alabama","Covington County",1,9,462,237,225
050,01,039,"Alabama","Covington County",1,10,453,250,203
050,01,039,"Alabama","Covington County",1,11,475,253,222
050,01,039,"Alabama","Covington County",1,12,466,234,232
050,01,039,"Alabama","Covington County",1,13,488,239,249
050,01,039,"Alabama","Covington County",1,14,479,242,237
050,01,039,"Alabama","Covington County",1,15,502,254,248
050,01,039,"Alabama","Covington County",1,16,512,275,237
050,01,039,"Alabama","Covington County",1,17,477,244,233
050,01,039,"Alabama","Covington County",1,18,384,205,179
050,01,039,"Alabama","Covington County",1,19,354,179,175
050,01,039,"Alabama","Covington County",1,20,363,185,178
050,01,039,"Alabama","Covington County",1,21,364,177,187
050,01,039,"Alabama","Covington County",1,22,385,191,194
050,01,039,"Alabama","Covington County",1,23,399,197,202
050,01,039,"Alabama","Covington County",1,24,369,182,187
050,01,039,"Alabama","Covington County",1,25,393,185,208
050,01,039,"Alabama","Covington County",1,26,401,207,194
050,01,039,"Alabama","Covington County",1,27,398,202,196
050,01,039,"Alabama","Covington County",1,28,451,232,219
050,01,039,"Alabama","Covington County",1,29,496,257,239
050,01,039,"Alabama","Covington County",1,30,468,238,230
050,01,039,"Alabama","Covington County",1,31,426,211,215
050,01,039,"Alabama","Covington County",1,32,396,195,201
050,01,039,"Alabama","Covington County",1,33,409,210,199
050,01,039,"Alabama","Covington County",1,34,417,197,220
050,01,039,"Alabama","Covington County",1,35,442,194,248
050,01,039,"Alabama","Covington County",1,36,411,186,225
050,01,039,"Alabama","Covington County",1,37,410,190,220
050,01,039,"Alabama","Covington County",1,38,398,183,215
050,01,039,"Alabama","Covington County",1,39,455,222,233
050,01,039,"Alabama","Covington County",1,40,427,204,223
050,01,039,"Alabama","Covington County",1,41,429,212,217
050,01,039,"Alabama","Covington County",1,42,391,200,191
050,01,039,"Alabama","Covington County",1,43,393,197,196
050,01,039,"Alabama","Covington County",1,44,393,190,203
050,01,039,"Alabama","Covington County",1,45,413,192,221
050,01,039,"Alabama","Covington County",1,46,422,209,213
050,01,039,"Alabama","Covington County",1,47,437,212,225
050,01,039,"Alabama","Covington County",1,48,486,242,244
050,01,039,"Alabama","Covington County",1,49,507,269,238
050,01,039,"Alabama","Covington County",1,50,455,232,223
050,01,039,"Alabama","Covington County",1,51,448,226,222
050,01,039,"Alabama","Covington County",1,52,464,218,246
050,01,039,"Alabama","Covington County",1,53,474,231,243
050,01,039,"Alabama","Covington County",1,54,503,244,259
050,01,039,"Alabama","Covington County",1,55,523,254,269
050,01,039,"Alabama","Covington County",1,56,534,253,281
050,01,039,"Alabama","Covington County",1,57,550,284,266
050,01,039,"Alabama","Covington County",1,58,568,271,297
050,01,039,"Alabama","Covington County",1,59,551,260,291
050,01,039,"Alabama","Covington County",1,60,547,278,269
050,01,039,"Alabama","Covington County",1,61,548,269,279
050,01,039,"Alabama","Covington County",1,62,584,279,305
050,01,039,"Alabama","Covington County",1,63,562,298,264
050,01,039,"Alabama","Covington County",1,64,561,271,290
050,01,039,"Alabama","Covington County",1,65,544,254,290
050,01,039,"Alabama","Covington County",1,66,509,237,272
050,01,039,"Alabama","Covington County",1,67,478,220,258
050,01,039,"Alabama","Covington County",1,68,453,214,239
050,01,039,"Alabama","Covington County",1,69,426,220,206
050,01,039,"Alabama","Covington County",1,70,435,209,226
050,01,039,"Alabama","Covington County",1,71,464,218,246
050,01,039,"Alabama","Covington County",1,72,453,202,251
050,01,039,"Alabama","Covington County",1,73,452,211,241
050,01,039,"Alabama","Covington County",1,74,322,153,169
050,01,039,"Alabama","Covington County",1,75,350,166,184
050,01,039,"Alabama","Covington County",1,76,336,153,183
050,01,039,"Alabama","Covington County",1,77,321,148,173
050,01,039,"Alabama","Covington County",1,78,265,122,143
050,01,039,"Alabama","Covington County",1,79,260,101,159
050,01,039,"Alabama","Covington County",1,80,233,87,146
050,01,039,"Alabama","Covington County",1,81,223,80,143
050,01,039,"Alabama","Covington County",1,82,184,67,117
050,01,039,"Alabama","Covington County",1,83,185,61,124
050,01,039,"Alabama","Covington County",1,84,196,79,117
050,01,039,"Alabama","Covington County",1,85,1019,330,689
050,01,039,"Alabama","Covington County",2,0,387,196,191
050,01,039,"Alabama","Covington County",2,1,399,197,202
050,01,039,"Alabama","Covington County",2,2,423,219,204
050,01,039,"Alabama","Covington County",2,3,436,219,217
050,01,039,"Alabama","Covington County",2,4,466,241,225
050,01,039,"Alabama","Covington County",2,5,459,236,223
050,01,039,"Alabama","Covington County",2,6,465,240,225
050,01,039,"Alabama","Covington County",2,7,472,244,228
050,01,039,"Alabama","Covington County",2,8,447,229,218
050,01,039,"Alabama","Covington County",2,9,454,233,221
050,01,039,"Alabama","Covington County",2,10,457,247,210
050,01,039,"Alabama","Covington County",2,11,469,249,220
050,01,039,"Alabama","Covington County",2,12,471,240,231
050,01,039,"Alabama","Covington County",2,13,483,239,244
050,01,039,"Alabama","Covington County",2,14,480,242,238
050,01,039,"Alabama","Covington County",2,15,499,253,246
050,01,039,"Alabama","Covington County",2,16,509,268,241
050,01,039,"Alabama","Covington County",2,17,485,252,233
050,01,039,"Alabama","Covington County",2,18,395,210,185
050,01,039,"Alabama","Covington County",2,19,347,177,170
050,01,039,"Alabama","Covington County",2,20,368,185,183
050,01,039,"Alabama","Covington County",2,21,364,177,187
050,01,039,"Alabama","Covington County",2,22,384,188,196
050,01,039,"Alabama","Covington County",2,23,397,195,202
050,01,039,"Alabama","Covington County",2,24,375,183,192
050,01,039,"Alabama","Covington County",2,25,387,183,204
050,01,039,"Alabama","Covington County",2,26,399,201,198
050,01,039,"Alabama","Covington County",2,27,397,202,195
050,01,039,"Alabama","Covington County",2,28,434,224,210
050,01,039,"Alabama","Covington County",2,29,483,251,232
050,01,039,"Alabama","Covington County",2,30,477,245,232
050,01,039,"Alabama","Covington County",2,31,433,217,216
050,01,039,"Alabama","Covington County",2,32,404,200,204
050,01,039,"Alabama","Covington County",2,33,405,206,199
050,01,039,"Alabama","Covington County",2,34,414,200,214
050,01,039,"Alabama","Covington County",2,35,437,194,243
050,01,039,"Alabama","Covington County",2,36,415,186,229
050,01,039,"Alabama","Covington County",2,37,411,189,222
050,01,039,"Alabama","Covington County",2,38,405,186,219
050,01,039,"Alabama","Covington County",2,39,440,212,228
050,01,039,"Alabama","Covington County",2,40,432,207,225
050,01,039,"Alabama","Covington County",2,41,426,209,217
050,01,039,"Alabama","Covington County",2,42,398,202,196
050,01,039,"Alabama","Covington County",2,43,396,199,197
050,01,039,"Alabama","Covington County",2,44,392,192,200
050,01,039,"Alabama","Covington County",2,45,411,191,220
050,01,039,"Alabama","Covington County",2,46,417,205,212
050,01,039,"Alabama","Covington County",2,47,433,209,224
050,01,039,"Alabama","Covington County",2,48,475,236,239
050,01,039,"Alabama","Covington County",2,49,509,267,242
050,01,039,"Alabama","Covington County",2,50,473,243,230
050,01,039,"Alabama","Covington County",2,51,447,227,220
050,01,039,"Alabama","Covington County",2,52,460,220,240
050,01,039,"Alabama","Covington County",2,53,471,228,243
050,01,039,"Alabama","Covington County",2,54,497,240,257
050,01,039,"Alabama","Covington County",2,55,511,248,263
050,01,039,"Alabama","Covington County",2,56,534,254,280
050,01,039,"Alabama","Covington County",2,57,546,276,270
050,01,039,"Alabama","Covington County",2,58,561,272,289
050,01,039,"Alabama","Covington County",2,59,549,260,289
050,01,039,"Alabama","Covington County",2,60,540,269,271
050,01,039,"Alabama","Covington County",2,61,544,269,275
050,01,039,"Alabama","Covington County",2,62,572,275,297
050,01,039,"Alabama","Covington County",2,63,570,294,276
050,01,039,"Alabama","Covington County",2,64,561,277,284
050,01,039,"Alabama","Covington County",2,65,546,258,288
050,01,039,"Alabama","Covington County",2,66,517,240,277
050,01,039,"Alabama","Covington County",2,67,489,226,263
050,01,039,"Alabama","Covington County",2,68,453,213,240
050,01,039,"Alabama","Covington County",2,69,432,219,213
050,01,039,"Alabama","Covington County",2,70,430,209,221
050,01,039,"Alabama","Covington County",2,71,454,215,239
050,01,039,"Alabama","Covington County",2,72,447,201,246
050,01,039,"Alabama","Covington County",2,73,476,221,255
050,01,039,"Alabama","Covington County",2,74,329,155,174
050,01,039,"Alabama","Covington County",2,75,339,161,178
050,01,039,"Alabama","Covington County",2,76,329,152,177
050,01,039,"Alabama","Covington County",2,77,334,156,178
050,01,039,"Alabama","Covington County",2,78,268,122,146
050,01,039,"Alabama","Covington County",2,79,259,103,156
050,01,039,"Alabama","Covington County",2,80,230,87,143
050,01,039,"Alabama","Covington County",2,81,225,82,143
050,01,039,"Alabama","Covington County",2,82,189,68,121
050,01,039,"Alabama","Covington County",2,83,179,59,120
050,01,039,"Alabama","Covington County",2,84,192,76,116
050,01,039,"Alabama","Covington County",2,85,1032,340,692
050,01,039,"Alabama","Covington County",3,0,454,242,212
050,01,039,"Alabama","Covington County",3,1,397,197,200
050,01,039,"Alabama","Covington County",3,2,413,210,203
050,01,039,"Alabama","Covington County",3,3,441,229,212
050,01,039,"Alabama","Covington County",3,4,432,214,218
050,01,039,"Alabama","Covington County",3,5,467,241,226
050,01,039,"Alabama","Covington County",3,6,470,249,221
050,01,039,"Alabama","Covington County",3,7,473,244,229
050,01,039,"Alabama","Covington County",3,8,476,244,232
050,01,039,"Alabama","Covington County",3,9,440,227,213
050,01,039,"Alabama","Covington County",3,10,441,223,218
050,01,039,"Alabama","Covington County",3,11,456,244,212
050,01,039,"Alabama","Covington County",3,12,479,255,224
050,01,039,"Alabama","Covington County",3,13,474,249,225
050,01,039,"Alabama","Covington County",3,14,490,244,246
050,01,039,"Alabama","Covington County",3,15,484,241,243
050,01,039,"Alabama","Covington County",3,16,497,253,244
050,01,039,"Alabama","Covington County",3,17,498,261,237
050,01,039,"Alabama","Covington County",3,18,443,234,209
050,01,039,"Alabama","Covington County",3,19,352,178,174
050,01,039,"Alabama","Covington County",3,20,372,186,186
050,01,039,"Alabama","Covington County",3,21,381,192,189
050,01,039,"Alabama","Covington County",3,22,383,181,202
050,01,039,"Alabama","Covington County",3,23,399,196,203
050,01,039,"Alabama","Covington County",3,24,408,200,208
050,01,039,"Alabama","Covington County",3,25,383,191,192
050,01,039,"Alabama","Covington County",3,26,403,191,212
050,01,039,"Alabama","Covington County",3,27,413,207,206
050,01,039,"Alabama","Covington County",3,28,414,220,194
050,01,039,"Alabama","Covington County",3,29,431,222,209
050,01,039,"Alabama","Covington County",3,30,478,247,231
050,01,039,"Alabama","Covington County",3,31,483,242,241
050,01,039,"Alabama","Covington County",3,32,414,198,216
050,01,039,"Alabama","Covington County",3,33,414,203,211
050,01,039,"Alabama","Covington County",3,34,419,207,212
050,01,039,"Alabama","Covington County",3,35,414,196,218
050,01,039,"Alabama","Covington County",3,36,441,196,245
050,01,039,"Alabama","Covington County",3,37,405,181,224
050,01,039,"Alabama","Covington County",3,38,427,188,239
050,01,039,"Alabama","Covington County",3,39,399,190,209
050,01,039,"Alabama","Covington County",3,40,449,214,235
050,01,039,"Alabama","Covington County",3,41,447,221,226
050,01,039,"Alabama","Covington County",3,42,434,209,225
050,01,039,"Alabama","Covington County",3,43,398,203,195
050,01,039,"Alabama","Covington County",3,44,403,205,198
050,01,039,"Alabama","Covington County",3,45,385,187,198
050,01,039,"Alabama","Covington County",3,46,410,193,217
050,01,039,"Alabama","Covington County",3,47,421,203,218
050,01,039,"Alabama","Covington County",3,48,436,203,233
050,01,039,"Alabama","Covington County",3,49,467,232,235
050,01,039,"Alabama","Covington County",3,50,502,260,242
050,01,039,"Alabama","Covington County",3,51,470,241,229
050,01,039,"Alabama","Covington County",3,52,463,241,222
050,01,039,"Alabama","Covington County",3,53,459,219,240
050,01,039,"Alabama","Covington County",3,54,466,221,245
050,01,039,"Alabama","Covington County",3,55,482,228,254
050,01,039,"Alabama","Covington County",3,56,516,253,263
050,01,039,"Alabama","Covington County",3,57,522,244,278
050,01,039,"Alabama","Covington County",3,58,533,271,262
050,01,039,"Alabama","Covington County",3,59,548,265,283
050,01,039,"Alabama","Covington County",3,60,532,251,281
050,01,039,"Alabama","Covington County",3,61,540,269,271
050,01,039,"Alabama","Covington County",3,62,528,256,272
050,01,039,"Alabama","Covington County",3,63,555,262,293
050,01,039,"Alabama","Covington County",3,64,577,303,274
050,01,039,"Alabama","Covington County",3,65,540,273,267
050,01,039,"Alabama","Covington County",3,66,543,260,283
050,01,039,"Alabama","Covington County",3,67,525,242,283
050,01,039,"Alabama","Covington County",3,68,469,217,252
050,01,039,"Alabama","Covington County",3,69,433,198,235
050,01,039,"Alabama","Covington County",3,70,430,216,214
050,01,039,"Alabama","Covington County",3,71,417,207,210
050,01,039,"Alabama","Covington County",3,72,429,202,227
050,01,039,"Alabama","Covington County",3,73,436,195,241
050,01,039,"Alabama","Covington County",3,74,456,211,245
050,01,039,"Alabama","Covington County",3,75,309,142,167
050,01,039,"Alabama","Covington County",3,76,308,145,163
050,01,039,"Alabama","Covington County",3,77,333,162,171
050,01,039,"Alabama","Covington County",3,78,315,142,173
050,01,039,"Alabama","Covington County",3,79,270,115,155
050,01,039,"Alabama","Covington County",3,80,227,90,137
050,01,039,"Alabama","Covington County",3,81,230,82,148
050,01,039,"Alabama","Covington County",3,82,203,73,130
050,01,039,"Alabama","Covington County",3,83,173,55,118
050,01,039,"Alabama","Covington County",3,84,166,61,105
050,01,039,"Alabama","Covington County",3,85,1057,353,704
050,01,039,"Alabama","Covington County",4,0,416,215,201
050,01,039,"Alabama","Covington County",4,1,456,242,214
050,01,039,"Alabama","Covington County",4,2,397,203,194
050,01,039,"Alabama","Covington County",4,3,414,213,201
050,01,039,"Alabama","Covington County",4,4,454,235,219
050,01,039,"Alabama","Covington County",4,5,444,223,221
050,01,039,"Alabama","Covington County",4,6,481,249,232
050,01,039,"Alabama","Covington County",4,7,487,257,230
050,01,039,"Alabama","Covington County",4,8,479,255,224
050,01,039,"Alabama","Covington County",4,9,480,251,229
050,01,039,"Alabama","Covington County",4,10,443,231,212
050,01,039,"Alabama","Covington County",4,11,449,228,221
050,01,039,"Alabama","Covington County",4,12,460,247,213
050,01,039,"Alabama","Covington County",4,13,480,255,225
050,01,039,"Alabama","Covington County",4,14,482,251,231
050,01,039,"Alabama","Covington County",4,15,501,250,251
050,01,039,"Alabama","Covington County",4,16,487,240,247
050,01,039,"Alabama","Covington County",4,17,511,261,250
050,01,039,"Alabama","Covington County",4,18,434,235,199
050,01,039,"Alabama","Covington County",4,19,355,185,170
050,01,039,"Alabama","Covington County",4,20,353,184,169
050,01,039,"Alabama","Covington County",4,21,378,190,188
050,01,039,"Alabama","Covington County",4,22,394,207,187
050,01,039,"Alabama","Covington County",4,23,403,187,216
050,01,039,"Alabama","Covington County",4,24,396,189,207
050,01,039,"Alabama","Covington County",4,25,407,198,209
050,01,039,"Alabama","Covington County",4,26,387,191,196
050,01,039,"Alabama","Covington County",4,27,403,195,208
050,01,039,"Alabama","Covington County",4,28,405,210,195
050,01,039,"Alabama","Covington County",4,29,420,212,208
050,01,039,"Alabama","Covington County",4,30,430,221,209
050,01,039,"Alabama","Covington County",4,31,479,249,230
050,01,039,"Alabama","Covington County",4,32,497,238,259
050,01,039,"Alabama","Covington County",4,33,417,201,216
050,01,039,"Alabama","Covington County",4,34,416,203,213
050,01,039,"Alabama","Covington County",4,35,425,216,209
050,01,039,"Alabama","Covington County",4,36,403,194,209
050,01,039,"Alabama","Covington County",4,37,439,197,242
050,01,039,"Alabama","Covington County",4,38,424,191,233
050,01,039,"Alabama","Covington County",4,39,426,185,241
050,01,039,"Alabama","Covington County",4,40,412,198,214
050,01,039,"Alabama","Covington County",4,41,457,222,235
050,01,039,"Alabama","Covington County",4,42,456,221,235
050,01,039,"Alabama","Covington County",4,43,438,200,238
050,01,039,"Alabama","Covington County",4,44,408,210,198
050,01,039,"Alabama","Covington County",4,45,398,199,199
050,01,039,"Alabama","Covington County",4,46,392,187,205
050,01,039,"Alabama","Covington County",4,47,409,189,220
050,01,039,"Alabama","Covington County",4,48,427,215,212
050,01,039,"Alabama","Covington County",4,49,437,205,232
050,01,039,"Alabama","Covington County",4,50,454,214,240
050,01,039,"Alabama","Covington County",4,51,502,255,247
050,01,039,"Alabama","Covington County",4,52,480,247,233
050,01,039,"Alabama","Covington County",4,53,463,246,217
050,01,039,"Alabama","Covington County",4,54,471,226,245
050,01,039,"Alabama","Covington County",4,55,458,214,244
050,01,039,"Alabama","Covington County",4,56,488,234,254
050,01,039,"Alabama","Covington County",4,57,505,249,256
050,01,039,"Alabama","Covington County",4,58,533,257,276
050,01,039,"Alabama","Covington County",4,59,529,261,268
050,01,039,"Alabama","Covington County",4,60,541,261,280
050,01,039,"Alabama","Covington County",4,61,541,254,287
050,01,039,"Alabama","Covington County",4,62,527,259,268
050,01,039,"Alabama","Covington County",4,63,524,250,274
050,01,039,"Alabama","Covington County",4,64,548,257,291
050,01,039,"Alabama","Covington County",4,65,558,297,261
050,01,039,"Alabama","Covington County",4,66,538,266,272
050,01,039,"Alabama","Covington County",4,67,539,258,281
050,01,039,"Alabama","Covington County",4,68,519,239,280
050,01,039,"Alabama","Covington County",4,69,456,202,254
050,01,039,"Alabama","Covington County",4,70,437,200,237
050,01,039,"Alabama","Covington County",4,71,418,213,205
050,01,039,"Alabama","Covington County",4,72,392,189,203
050,01,039,"Alabama","Covington County",4,73,413,195,218
050,01,039,"Alabama","Covington County",4,74,429,194,235
050,01,039,"Alabama","Covington County",4,75,432,198,234
050,01,039,"Alabama","Covington County",4,76,288,132,156
050,01,039,"Alabama","Covington County",4,77,298,148,150
050,01,039,"Alabama","Covington County",4,78,317,154,163
050,01,039,"Alabama","Covington County",4,79,318,136,182
050,01,039,"Alabama","Covington County",4,80,232,100,132
050,01,039,"Alabama","Covington County",4,81,212,78,134
050,01,039,"Alabama","Covington County",4,82,202,73,129
050,01,039,"Alabama","Covington County",4,83,182,60,122
050,01,039,"Alabama","Covington County",4,84,160,51,109
050,01,039,"Alabama","Covington County",4,85,1053,343,710
050,01,039,"Alabama","Covington County",5,0,415,214,201
050,01,039,"Alabama","Covington County",5,1,441,226,215
050,01,039,"Alabama","Covington County",5,2,489,257,232
050,01,039,"Alabama","Covington County",5,3,406,203,203
050,01,039,"Alabama","Covington County",5,4,424,213,211
050,01,039,"Alabama","Covington County",5,5,459,237,222
050,01,039,"Alabama","Covington County",5,6,454,221,233
050,01,039,"Alabama","Covington County",5,7,489,254,235
050,01,039,"Alabama","Covington County",5,8,496,257,239
050,01,039,"Alabama","Covington County",5,9,478,245,233
050,01,039,"Alabama","Covington County",5,10,502,254,248
050,01,039,"Alabama","Covington County",5,11,466,238,228
050,01,039,"Alabama","Covington County",5,12,466,233,233
050,01,039,"Alabama","Covington County",5,13,469,250,219
050,01,039,"Alabama","Covington County",5,14,486,255,231
050,01,039,"Alabama","Covington County",5,15,497,264,233
050,01,039,"Alabama","Covington County",5,16,501,251,250
050,01,039,"Alabama","Covington County",5,17,500,249,251
050,01,039,"Alabama","Covington County",5,18,435,223,212
050,01,039,"Alabama","Covington County",5,19,365,196,169
050,01,039,"Alabama","Covington County",5,20,378,192,186
050,01,039,"Alabama","Covington County",5,21,381,189,192
050,01,039,"Alabama","Covington County",5,22,412,206,206
050,01,039,"Alabama","Covington County",5,23,411,212,199
050,01,039,"Alabama","Covington County",5,24,404,190,214
050,01,039,"Alabama","Covington County",5,25,396,195,201
050,01,039,"Alabama","Covington County",5,26,412,196,216
050,01,039,"Alabama","Covington County",5,27,392,185,207
050,01,039,"Alabama","Covington County",5,28,416,200,216
050,01,039,"Alabama","Covington County",5,29,420,215,205
050,01,039,"Alabama","Covington County",5,30,423,213,210
050,01,039,"Alabama","Covington County",5,31,438,216,222
050,01,039,"Alabama","Covington County",5,32,472,233,239
050,01,039,"Alabama","Covington County",5,33,512,246,266
050,01,039,"Alabama","Covington County",5,34,416,205,211
050,01,039,"Alabama","Covington County",5,35,418,205,213
050,01,039,"Alabama","Covington County",5,36,425,210,215
050,01,039,"Alabama","Covington County",5,37,420,196,224
050,01,039,"Alabama","Covington County",5,38,454,206,248
050,01,039,"Alabama","Covington County",5,39,434,195,239
050,01,039,"Alabama","Covington County",5,40,437,189,248
050,01,039,"Alabama","Covington County",5,41,428,207,221
050,01,039,"Alabama","Covington County",5,42,474,234,240
050,01,039,"Alabama","Covington County",5,43,460,219,241
050,01,039,"Alabama","Covington County",5,44,429,201,228
050,01,039,"Alabama","Covington County",5,45,411,215,196
050,01,039,"Alabama","Covington County",5,46,408,211,197
050,01,039,"Alabama","Covington County",5,47,389,180,209
050,01,039,"Alabama","Covington County",5,48,407,185,222
050,01,039,"Alabama","Covington County",5,49,435,225,210
050,01,039,"Alabama","Covington County",5,50,440,208,232
050,01,039,"Alabama","Covington County",5,51,447,207,240
050,01,039,"Alabama","Covington County",5,52,517,258,259
050,01,039,"Alabama","Covington County",5,53,484,250,234
050,01,039,"Alabama","Covington County",5,54,461,242,219
050,01,039,"Alabama","Covington County",5,55,466,208,258
050,01,039,"Alabama","Covington County",5,56,458,213,245
050,01,039,"Alabama","Covington County",5,57,474,227,247
050,01,039,"Alabama","Covington County",5,58,525,257,268
050,01,039,"Alabama","Covington County",5,59,527,252,275
050,01,039,"Alabama","Covington County",5,60,527,259,268
050,01,039,"Alabama","Covington County",5,61,528,252,276
050,01,039,"Alabama","Covington County",5,62,539,253,286
050,01,039,"Alabama","Covington County",5,63,511,248,263
050,01,039,"Alabama","Covington County",5,64,548,264,284
050,01,039,"Alabama","Covington County",5,65,530,247,283
050,01,039,"Alabama","Covington County",5,66,559,292,267
050,01,039,"Alabama","Covington County",5,67,540,268,272
050,01,039,"Alabama","Covington County",5,68,523,257,266
050,01,039,"Alabama","Covington County",5,69,505,228,277
050,01,039,"Alabama","Covington County",5,70,461,198,263
050,01,039,"Alabama","Covington County",5,71,435,203,232
050,01,039,"Alabama","Covington County",5,72,394,197,197
050,01,039,"Alabama","Covington County",5,73,383,184,199
050,01,039,"Alabama","Covington County",5,74,406,192,214
050,01,039,"Alabama","Covington County",5,75,404,179,225
050,01,039,"Alabama","Covington County",5,76,403,183,220
050,01,039,"Alabama","Covington County",5,77,282,135,147
050,01,039,"Alabama","Covington County",5,78,284,139,145
050,01,039,"Alabama","Covington County",5,79,319,148,171
050,01,039,"Alabama","Covington County",5,80,280,124,156
050,01,039,"Alabama","Covington County",5,81,228,94,134
050,01,039,"Alabama","Covington County",5,82,187,68,119
050,01,039,"Alabama","Covington County",5,83,187,61,126
050,01,039,"Alabama","Covington County",5,84,170,56,114
050,01,039,"Alabama","Covington County",5,85,1070,332,738
050,01,041,"Alabama","Crenshaw County",1,0,126,63,63
050,01,041,"Alabama","Crenshaw County",1,1,127,60,67
050,01,041,"Alabama","Crenshaw County",1,2,152,85,67
050,01,041,"Alabama","Crenshaw County",1,3,149,85,64
050,01,041,"Alabama","Crenshaw County",1,4,160,84,76
050,01,041,"Alabama","Crenshaw County",1,5,169,75,94
050,01,041,"Alabama","Crenshaw County",1,6,153,81,72
050,01,041,"Alabama","Crenshaw County",1,7,153,90,63
050,01,041,"Alabama","Crenshaw County",1,8,175,98,77
050,01,041,"Alabama","Crenshaw County",1,9,181,101,80
050,01,041,"Alabama","Crenshaw County",1,10,183,89,94
050,01,041,"Alabama","Crenshaw County",1,11,169,81,88
050,01,041,"Alabama","Crenshaw County",1,12,179,88,91
050,01,041,"Alabama","Crenshaw County",1,13,184,94,90
050,01,041,"Alabama","Crenshaw County",1,14,179,88,91
050,01,041,"Alabama","Crenshaw County",1,15,175,96,79
050,01,041,"Alabama","Crenshaw County",1,16,196,107,89
050,01,041,"Alabama","Crenshaw County",1,17,176,99,77
050,01,041,"Alabama","Crenshaw County",1,18,154,84,70
050,01,041,"Alabama","Crenshaw County",1,19,128,67,61
050,01,041,"Alabama","Crenshaw County",1,20,120,62,58
050,01,041,"Alabama","Crenshaw County",1,21,128,71,57
050,01,041,"Alabama","Crenshaw County",1,22,135,68,67
050,01,041,"Alabama","Crenshaw County",1,23,140,67,73
050,01,041,"Alabama","Crenshaw County",1,24,161,83,78
050,01,041,"Alabama","Crenshaw County",1,25,153,66,87
050,01,041,"Alabama","Crenshaw County",1,26,148,66,82
050,01,041,"Alabama","Crenshaw County",1,27,160,76,84
050,01,041,"Alabama","Crenshaw County",1,28,182,88,94
050,01,041,"Alabama","Crenshaw County",1,29,184,93,91
050,01,041,"Alabama","Crenshaw County",1,30,190,95,95
050,01,041,"Alabama","Crenshaw County",1,31,155,88,67
050,01,041,"Alabama","Crenshaw County",1,32,140,70,70
050,01,041,"Alabama","Crenshaw County",1,33,149,67,82
050,01,041,"Alabama","Crenshaw County",1,34,151,69,82
050,01,041,"Alabama","Crenshaw County",1,35,135,68,67
050,01,041,"Alabama","Crenshaw County",1,36,129,62,67
050,01,041,"Alabama","Crenshaw County",1,37,138,68,70
050,01,041,"Alabama","Crenshaw County",1,38,159,74,85
050,01,041,"Alabama","Crenshaw County",1,39,163,77,86
050,01,041,"Alabama","Crenshaw County",1,40,153,75,78
050,01,041,"Alabama","Crenshaw County",1,41,152,72,80
050,01,041,"Alabama","Crenshaw County",1,42,130,64,66
050,01,041,"Alabama","Crenshaw County",1,43,148,79,69
050,01,041,"Alabama","Crenshaw County",1,44,154,82,72
050,01,041,"Alabama","Crenshaw County",1,45,153,66,87
050,01,041,"Alabama","Crenshaw County",1,46,163,65,98
050,01,041,"Alabama","Crenshaw County",1,47,165,67,98
050,01,041,"Alabama","Crenshaw County",1,48,180,88,92
050,01,041,"Alabama","Crenshaw County",1,49,192,105,87
050,01,041,"Alabama","Crenshaw County",1,50,157,88,69
050,01,041,"Alabama","Crenshaw County",1,51,144,70,74
050,01,041,"Alabama","Crenshaw County",1,52,159,84,75
050,01,041,"Alabama","Crenshaw County",1,53,173,80,93
050,01,041,"Alabama","Crenshaw County",1,54,186,86,100
050,01,041,"Alabama","Crenshaw County",1,55,188,77,111
050,01,041,"Alabama","Crenshaw County",1,56,195,96,99
050,01,041,"Alabama","Crenshaw County",1,57,202,100,102
050,01,041,"Alabama","Crenshaw County",1,58,206,111,95
050,01,041,"Alabama","Crenshaw County",1,59,195,101,94
050,01,041,"Alabama","Crenshaw County",1,60,182,97,85
050,01,041,"Alabama","Crenshaw County",1,61,186,98,88
050,01,041,"Alabama","Crenshaw County",1,62,200,99,101
050,01,041,"Alabama","Crenshaw County",1,63,194,95,99
050,01,041,"Alabama","Crenshaw County",1,64,190,103,87
050,01,041,"Alabama","Crenshaw County",1,65,188,94,94
050,01,041,"Alabama","Crenshaw County",1,66,156,70,86
050,01,041,"Alabama","Crenshaw County",1,67,154,69,85
050,01,041,"Alabama","Crenshaw County",1,68,163,74,89
050,01,041,"Alabama","Crenshaw County",1,69,159,75,84
050,01,041,"Alabama","Crenshaw County",1,70,151,82,69
050,01,041,"Alabama","Crenshaw County",1,71,155,62,93
050,01,041,"Alabama","Crenshaw County",1,72,164,70,94
050,01,041,"Alabama","Crenshaw County",1,73,176,77,99
050,01,041,"Alabama","Crenshaw County",1,74,103,49,54
050,01,041,"Alabama","Crenshaw County",1,75,105,54,51
050,01,041,"Alabama","Crenshaw County",1,76,100,52,48
050,01,041,"Alabama","Crenshaw County",1,77,83,45,38
050,01,041,"Alabama","Crenshaw County",1,78,65,30,35
050,01,041,"Alabama","Crenshaw County",1,79,70,34,36
050,01,041,"Alabama","Crenshaw County",1,80,70,29,41
050,01,041,"Alabama","Crenshaw County",1,81,61,23,38
050,01,041,"Alabama","Crenshaw County",1,82,57,15,42
050,01,041,"Alabama","Crenshaw County",1,83,54,18,36
050,01,041,"Alabama","Crenshaw County",1,84,44,18,26
050,01,041,"Alabama","Crenshaw County",1,85,280,84,196
050,01,041,"Alabama","Crenshaw County",2,0,137,74,63
050,01,041,"Alabama","Crenshaw County",2,1,127,61,66
050,01,041,"Alabama","Crenshaw County",2,2,146,79,67
050,01,041,"Alabama","Crenshaw County",2,3,149,85,64
050,01,041,"Alabama","Crenshaw County",2,4,160,86,74
050,01,041,"Alabama","Crenshaw County",2,5,167,78,89
050,01,041,"Alabama","Crenshaw County",2,6,157,80,77
050,01,041,"Alabama","Crenshaw County",2,7,152,86,66
050,01,041,"Alabama","Crenshaw County",2,8,170,96,74
050,01,041,"Alabama","Crenshaw County",2,9,181,99,82
050,01,041,"Alabama","Crenshaw County",2,10,181,91,90
050,01,041,"Alabama","Crenshaw County",2,11,170,81,89
050,01,041,"Alabama","Crenshaw County",2,12,178,88,90
050,01,041,"Alabama","Crenshaw County",2,13,182,91,91
050,01,041,"Alabama","Crenshaw County",2,14,181,90,91
050,01,041,"Alabama","Crenshaw County",2,15,178,94,84
050,01,041,"Alabama","Crenshaw County",2,16,191,104,87
050,01,041,"Alabama","Crenshaw County",2,17,179,101,78
050,01,041,"Alabama","Crenshaw County",2,18,152,84,68
050,01,041,"Alabama","Crenshaw County",2,19,129,68,61
050,01,041,"Alabama","Crenshaw County",2,20,126,67,59
050,01,041,"Alabama","Crenshaw County",2,21,128,70,58
050,01,041,"Alabama","Crenshaw County",2,22,135,69,66
050,01,041,"Alabama","Crenshaw County",2,23,142,70,72
050,01,041,"Alabama","Crenshaw County",2,24,154,79,75
050,01,041,"Alabama","Crenshaw County",2,25,158,71,87
050,01,041,"Alabama","Crenshaw County",2,26,152,67,85
050,01,041,"Alabama","Crenshaw County",2,27,159,75,84
050,01,041,"Alabama","Crenshaw County",2,28,175,84,91
050,01,041,"Alabama","Crenshaw County",2,29,187,94,93
050,01,041,"Alabama","Crenshaw County",2,30,189,96,93
050,01,041,"Alabama","Crenshaw County",2,31,161,88,73
050,01,041,"Alabama","Crenshaw County",2,32,142,73,69
050,01,041,"Alabama","Crenshaw County",2,33,146,68,78
050,01,041,"Alabama","Crenshaw County",2,34,148,67,81
050,01,041,"Alabama","Crenshaw County",2,35,141,69,72
050,01,041,"Alabama","Crenshaw County",2,36,131,62,69
050,01,041,"Alabama","Crenshaw County",2,37,135,66,69
050,01,041,"Alabama","Crenshaw County",2,38,153,72,81
050,01,041,"Alabama","Crenshaw County",2,39,160,75,85
050,01,041,"Alabama","Crenshaw County",2,40,156,75,81
050,01,041,"Alabama","Crenshaw County",2,41,150,71,79
050,01,041,"Alabama","Crenshaw County",2,42,132,64,68
050,01,041,"Alabama","Crenshaw County",2,43,143,75,68
050,01,041,"Alabama","Crenshaw County",2,44,151,80,71
050,01,041,"Alabama","Crenshaw County",2,45,155,70,85
050,01,041,"Alabama","Crenshaw County",2,46,159,64,95
050,01,041,"Alabama","Crenshaw County",2,47,163,66,97
050,01,041,"Alabama","Crenshaw County",2,48,175,82,93
050,01,041,"Alabama","Crenshaw County",2,49,190,102,88
050,01,041,"Alabama","Crenshaw County",2,50,162,91,71
050,01,041,"Alabama","Crenshaw County",2,51,146,75,71
050,01,041,"Alabama","Crenshaw County",2,52,155,81,74
050,01,041,"Alabama","Crenshaw County",2,53,168,80,88
050,01,041,"Alabama","Crenshaw County",2,54,183,84,99
050,01,041,"Alabama","Crenshaw County",2,55,186,77,109
050,01,041,"Alabama","Crenshaw County",2,56,192,90,102
050,01,041,"Alabama","Crenshaw County",2,57,202,100,102
050,01,041,"Alabama","Crenshaw County",2,58,205,108,97
050,01,041,"Alabama","Crenshaw County",2,59,197,102,95
050,01,041,"Alabama","Crenshaw County",2,60,185,99,86
050,01,041,"Alabama","Crenshaw County",2,61,182,96,86
050,01,041,"Alabama","Crenshaw County",2,62,198,100,98
050,01,041,"Alabama","Crenshaw County",2,63,193,93,100
050,01,041,"Alabama","Crenshaw County",2,64,189,100,89
050,01,041,"Alabama","Crenshaw County",2,65,185,95,90
050,01,041,"Alabama","Crenshaw County",2,66,164,76,88
050,01,041,"Alabama","Crenshaw County",2,67,151,68,83
050,01,041,"Alabama","Crenshaw County",2,68,159,73,86
050,01,041,"Alabama","Crenshaw County",2,69,160,74,86
050,01,041,"Alabama","Crenshaw County",2,70,153,81,72
050,01,041,"Alabama","Crenshaw County",2,71,153,66,87
050,01,041,"Alabama","Crenshaw County",2,72,161,67,94
050,01,041,"Alabama","Crenshaw County",2,73,178,77,101
050,01,041,"Alabama","Crenshaw County",2,74,112,52,60
050,01,041,"Alabama","Crenshaw County",2,75,104,52,52
050,01,041,"Alabama","Crenshaw County",2,76,100,51,49
050,01,041,"Alabama","Crenshaw County",2,77,85,46,39
050,01,041,"Alabama","Crenshaw County",2,78,65,31,34
050,01,041,"Alabama","Crenshaw County",2,79,68,32,36
050,01,041,"Alabama","Crenshaw County",2,80,67,29,38
050,01,041,"Alabama","Crenshaw County",2,81,62,25,37
050,01,041,"Alabama","Crenshaw County",2,82,57,15,42
050,01,041,"Alabama","Crenshaw County",2,83,50,16,34
050,01,041,"Alabama","Crenshaw County",2,84,45,17,28
050,01,041,"Alabama","Crenshaw County",2,85,278,85,193
050,01,041,"Alabama","Crenshaw County",3,0,144,79,65
050,01,041,"Alabama","Crenshaw County",3,1,134,76,58
050,01,041,"Alabama","Crenshaw County",3,2,126,57,69
050,01,041,"Alabama","Crenshaw County",3,3,147,81,66
050,01,041,"Alabama","Crenshaw County",3,4,153,85,68
050,01,041,"Alabama","Crenshaw County",3,5,158,87,71
050,01,041,"Alabama","Crenshaw County",3,6,177,83,94
050,01,041,"Alabama","Crenshaw County",3,7,160,89,71
050,01,041,"Alabama","Crenshaw County",3,8,152,89,63
050,01,041,"Alabama","Crenshaw County",3,9,176,98,78
050,01,041,"Alabama","Crenshaw County",3,10,187,102,85
050,01,041,"Alabama","Crenshaw County",3,11,183,87,96
050,01,041,"Alabama","Crenshaw County",3,12,162,74,88
050,01,041,"Alabama","Crenshaw County",3,13,176,84,92
050,01,041,"Alabama","Crenshaw County",3,14,175,81,94
050,01,041,"Alabama","Crenshaw County",3,15,178,90,88
050,01,041,"Alabama","Crenshaw County",3,16,181,92,89
050,01,041,"Alabama","Crenshaw County",3,17,187,103,84
050,01,041,"Alabama","Crenshaw County",3,18,150,84,66
050,01,041,"Alabama","Crenshaw County",3,19,126,68,58
050,01,041,"Alabama","Crenshaw County",3,20,127,66,61
050,01,041,"Alabama","Crenshaw County",3,21,124,65,59
050,01,041,"Alabama","Crenshaw County",3,22,146,71,75
050,01,041,"Alabama","Crenshaw County",3,23,142,71,71
050,01,041,"Alabama","Crenshaw County",3,24,142,63,79
050,01,041,"Alabama","Crenshaw County",3,25,144,76,68
050,01,041,"Alabama","Crenshaw County",3,26,160,74,86
050,01,041,"Alabama","Crenshaw County",3,27,156,75,81
050,01,041,"Alabama","Crenshaw County",3,28,160,71,89
050,01,041,"Alabama","Crenshaw County",3,29,175,88,87
050,01,041,"Alabama","Crenshaw County",3,30,197,99,98
050,01,041,"Alabama","Crenshaw County",3,31,188,96,92
050,01,041,"Alabama","Crenshaw County",3,32,164,89,75
050,01,041,"Alabama","Crenshaw County",3,33,154,77,77
050,01,041,"Alabama","Crenshaw County",3,34,143,67,76
050,01,041,"Alabama","Crenshaw County",3,35,140,66,74
050,01,041,"Alabama","Crenshaw County",3,36,138,69,69
050,01,041,"Alabama","Crenshaw County",3,37,131,59,72
050,01,041,"Alabama","Crenshaw County",3,38,128,62,66
050,01,041,"Alabama","Crenshaw County",3,39,156,68,88
050,01,041,"Alabama","Crenshaw County",3,40,165,78,87
050,01,041,"Alabama","Crenshaw County",3,41,157,77,80
050,01,041,"Alabama","Crenshaw County",3,42,147,69,78
050,01,041,"Alabama","Crenshaw County",3,43,144,71,73
050,01,041,"Alabama","Crenshaw County",3,44,137,71,66
050,01,041,"Alabama","Crenshaw County",3,45,159,85,74
050,01,041,"Alabama","Crenshaw County",3,46,149,69,80
050,01,041,"Alabama","Crenshaw County",3,47,152,65,87
050,01,041,"Alabama","Crenshaw County",3,48,172,67,105
050,01,041,"Alabama","Crenshaw County",3,49,172,81,91
050,01,041,"Alabama","Crenshaw County",3,50,193,102,91
050,01,041,"Alabama","Crenshaw County",3,51,159,88,71
050,01,041,"Alabama","Crenshaw County",3,52,140,76,64
050,01,041,"Alabama","Crenshaw County",3,53,155,86,69
050,01,041,"Alabama","Crenshaw County",3,54,165,78,87
050,01,041,"Alabama","Crenshaw County",3,55,177,82,95
050,01,041,"Alabama","Crenshaw County",3,56,180,75,105
050,01,041,"Alabama","Crenshaw County",3,57,191,90,101
050,01,041,"Alabama","Crenshaw County",3,58,196,100,96
050,01,041,"Alabama","Crenshaw County",3,59,198,104,94
050,01,041,"Alabama","Crenshaw County",3,60,192,100,92
050,01,041,"Alabama","Crenshaw County",3,61,191,104,87
050,01,041,"Alabama","Crenshaw County",3,62,182,98,84
050,01,041,"Alabama","Crenshaw County",3,63,193,100,93
050,01,041,"Alabama","Crenshaw County",3,64,193,95,98
050,01,041,"Alabama","Crenshaw County",3,65,178,95,83
050,01,041,"Alabama","Crenshaw County",3,66,182,94,88
050,01,041,"Alabama","Crenshaw County",3,67,160,72,88
050,01,041,"Alabama","Crenshaw County",3,68,145,68,77
050,01,041,"Alabama","Crenshaw County",3,69,149,68,81
050,01,041,"Alabama","Crenshaw County",3,70,153,72,81
050,01,041,"Alabama","Crenshaw County",3,71,148,75,73
050,01,041,"Alabama","Crenshaw County",3,72,139,60,79
050,01,041,"Alabama","Crenshaw County",3,73,149,63,86
050,01,041,"Alabama","Crenshaw County",3,74,165,70,95
050,01,041,"Alabama","Crenshaw County",3,75,106,51,55
050,01,041,"Alabama","Crenshaw County",3,76,103,47,56
050,01,041,"Alabama","Crenshaw County",3,77,95,49,46
050,01,041,"Alabama","Crenshaw County",3,78,82,44,38
050,01,041,"Alabama","Crenshaw County",3,79,62,29,33
050,01,041,"Alabama","Crenshaw County",3,80,57,28,29
050,01,041,"Alabama","Crenshaw County",3,81,60,24,36
050,01,041,"Alabama","Crenshaw County",3,82,56,20,36
050,01,041,"Alabama","Crenshaw County",3,83,59,15,44
050,01,041,"Alabama","Crenshaw County",3,84,44,14,30
050,01,041,"Alabama","Crenshaw County",3,85,271,87,184
050,01,041,"Alabama","Crenshaw County",4,0,154,86,68
050,01,041,"Alabama","Crenshaw County",4,1,154,86,68
050,01,041,"Alabama","Crenshaw County",4,2,144,83,61
050,01,041,"Alabama","Crenshaw County",4,3,133,59,74
050,01,041,"Alabama","Crenshaw County",4,4,150,79,71
050,01,041,"Alabama","Crenshaw County",4,5,151,82,69
050,01,041,"Alabama","Crenshaw County",4,6,163,91,72
050,01,041,"Alabama","Crenshaw County",4,7,181,86,95
050,01,041,"Alabama","Crenshaw County",4,8,165,86,79
050,01,041,"Alabama","Crenshaw County",4,9,164,97,67
050,01,041,"Alabama","Crenshaw County",4,10,169,92,77
050,01,041,"Alabama","Crenshaw County",4,11,192,102,90
050,01,041,"Alabama","Crenshaw County",4,12,192,89,103
050,01,041,"Alabama","Crenshaw County",4,13,171,78,93
050,01,041,"Alabama","Crenshaw County",4,14,171,82,89
050,01,041,"Alabama","Crenshaw County",4,15,169,77,92
050,01,041,"Alabama","Crenshaw County",4,16,196,97,99
050,01,041,"Alabama","Crenshaw County",4,17,177,90,87
050,01,041,"Alabama","Crenshaw County",4,18,152,82,70
050,01,041,"Alabama","Crenshaw County",4,19,116,65,51
050,01,041,"Alabama","Crenshaw County",4,20,129,67,62
050,01,041,"Alabama","Crenshaw County",4,21,139,66,73
050,01,041,"Alabama","Crenshaw County",4,22,123,62,61
050,01,041,"Alabama","Crenshaw County",4,23,155,80,75
050,01,041,"Alabama","Crenshaw County",4,24,137,72,65
050,01,041,"Alabama","Crenshaw County",4,25,136,61,75
050,01,041,"Alabama","Crenshaw County",4,26,142,73,69
050,01,041,"Alabama","Crenshaw County",4,27,162,78,84
050,01,041,"Alabama","Crenshaw County",4,28,152,68,84
050,01,041,"Alabama","Crenshaw County",4,29,169,76,93
050,01,041,"Alabama","Crenshaw County",4,30,168,82,86
050,01,041,"Alabama","Crenshaw County",4,31,192,95,97
050,01,041,"Alabama","Crenshaw County",4,32,189,98,91
050,01,041,"Alabama","Crenshaw County",4,33,156,82,74
050,01,041,"Alabama","Crenshaw County",4,34,160,85,75
050,01,041,"Alabama","Crenshaw County",4,35,147,67,80
050,01,041,"Alabama","Crenshaw County",4,36,146,70,76
050,01,041,"Alabama","Crenshaw County",4,37,132,66,66
050,01,041,"Alabama","Crenshaw County",4,38,128,57,71
050,01,041,"Alabama","Crenshaw County",4,39,129,61,68
050,01,041,"Alabama","Crenshaw County",4,40,156,70,86
050,01,041,"Alabama","Crenshaw County",4,41,166,78,88
050,01,041,"Alabama","Crenshaw County",4,42,155,76,79
050,01,041,"Alabama","Crenshaw County",4,43,146,72,74
050,01,041,"Alabama","Crenshaw County",4,44,144,68,76
050,01,041,"Alabama","Crenshaw County",4,45,136,74,62
050,01,041,"Alabama","Crenshaw County",4,46,163,86,77
050,01,041,"Alabama","Crenshaw County",4,47,142,67,75
050,01,041,"Alabama","Crenshaw County",4,48,149,58,91
050,01,041,"Alabama","Crenshaw County",4,49,165,64,101
050,01,041,"Alabama","Crenshaw County",4,50,179,86,93
050,01,041,"Alabama","Crenshaw County",4,51,185,97,88
050,01,041,"Alabama","Crenshaw County",4,52,163,91,72
050,01,041,"Alabama","Crenshaw County",4,53,140,76,64
050,01,041,"Alabama","Crenshaw County",4,54,151,83,68
050,01,041,"Alabama","Crenshaw County",4,55,172,80,92
050,01,041,"Alabama","Crenshaw County",4,56,178,82,96
050,01,041,"Alabama","Crenshaw County",4,57,175,72,103
050,01,041,"Alabama","Crenshaw County",4,58,193,94,99
050,01,041,"Alabama","Crenshaw County",4,59,194,97,97
050,01,041,"Alabama","Crenshaw County",4,60,195,103,92
050,01,041,"Alabama","Crenshaw County",4,61,194,101,93
050,01,041,"Alabama","Crenshaw County",4,62,189,103,86
050,01,041,"Alabama","Crenshaw County",4,63,170,89,81
050,01,041,"Alabama","Crenshaw County",4,64,195,104,91
050,01,041,"Alabama","Crenshaw County",4,65,186,91,95
050,01,041,"Alabama","Crenshaw County",4,66,173,91,82
050,01,041,"Alabama","Crenshaw County",4,67,179,92,87
050,01,041,"Alabama","Crenshaw County",4,68,157,69,88
050,01,041,"Alabama","Crenshaw County",4,69,147,69,78
050,01,041,"Alabama","Crenshaw County",4,70,148,68,80
050,01,041,"Alabama","Crenshaw County",4,71,152,70,82
050,01,041,"Alabama","Crenshaw County",4,72,142,70,72
050,01,041,"Alabama","Crenshaw County",4,73,127,57,70
050,01,041,"Alabama","Crenshaw County",4,74,138,58,80
050,01,041,"Alabama","Crenshaw County",4,75,154,68,86
050,01,041,"Alabama","Crenshaw County",4,76,107,49,58
050,01,041,"Alabama","Crenshaw County",4,77,96,44,52
050,01,041,"Alabama","Crenshaw County",4,78,85,42,43
050,01,041,"Alabama","Crenshaw County",4,79,81,45,36
050,01,041,"Alabama","Crenshaw County",4,80,55,25,30
050,01,041,"Alabama","Crenshaw County",4,81,52,25,27
050,01,041,"Alabama","Crenshaw County",4,82,53,18,35
050,01,041,"Alabama","Crenshaw County",4,83,54,18,36
050,01,041,"Alabama","Crenshaw County",4,84,53,12,41
050,01,041,"Alabama","Crenshaw County",4,85,259,86,173
050,01,041,"Alabama","Crenshaw County",5,0,154,86,68
050,01,041,"Alabama","Crenshaw County",5,1,171,103,68
050,01,041,"Alabama","Crenshaw County",5,2,155,85,70
050,01,041,"Alabama","Crenshaw County",5,3,145,82,63
050,01,041,"Alabama","Crenshaw County",5,4,134,66,68
050,01,041,"Alabama","Crenshaw County",5,5,147,80,67
050,01,041,"Alabama","Crenshaw County",5,6,154,80,74
050,01,041,"Alabama","Crenshaw County",5,7,162,90,72
050,01,041,"Alabama","Crenshaw County",5,8,186,83,103
050,01,041,"Alabama","Crenshaw County",5,9,170,90,80
050,01,041,"Alabama","Crenshaw County",5,10,168,101,67
050,01,041,"Alabama","Crenshaw County",5,11,178,100,78
050,01,041,"Alabama","Crenshaw County",5,12,188,105,83
050,01,041,"Alabama","Crenshaw County",5,13,198,91,107
050,01,041,"Alabama","Crenshaw County",5,14,178,83,95
050,01,041,"Alabama","Crenshaw County",5,15,173,86,87
050,01,041,"Alabama","Crenshaw County",5,16,181,81,100
050,01,041,"Alabama","Crenshaw County",5,17,193,95,98
050,01,041,"Alabama","Crenshaw County",5,18,147,82,65
050,01,041,"Alabama","Crenshaw County",5,19,122,69,53
050,01,041,"Alabama","Crenshaw County",5,20,125,67,58
050,01,041,"Alabama","Crenshaw County",5,21,142,71,71
050,01,041,"Alabama","Crenshaw County",5,22,143,73,70
050,01,041,"Alabama","Crenshaw County",5,23,131,64,67
050,01,041,"Alabama","Crenshaw County",5,24,153,76,77
050,01,041,"Alabama","Crenshaw County",5,25,147,75,72
050,01,041,"Alabama","Crenshaw County",5,26,139,59,80
050,01,041,"Alabama","Crenshaw County",5,27,161,90,71
050,01,041,"Alabama","Crenshaw County",5,28,145,71,74
050,01,041,"Alabama","Crenshaw County",5,29,158,73,85
050,01,041,"Alabama","Crenshaw County",5,30,161,66,95
050,01,041,"Alabama","Crenshaw County",5,31,163,78,85
050,01,041,"Alabama","Crenshaw County",5,32,203,96,107
050,01,041,"Alabama","Crenshaw County",5,33,180,89,91
050,01,041,"Alabama","Crenshaw County",5,34,167,91,76
050,01,041,"Alabama","Crenshaw County",5,35,160,81,79
050,01,041,"Alabama","Crenshaw County",5,36,153,73,80
050,01,041,"Alabama","Crenshaw County",5,37,152,73,79
050,01,041,"Alabama","Crenshaw County",5,38,131,68,63
050,01,041,"Alabama","Crenshaw County",5,39,128,55,73
050,01,041,"Alabama","Crenshaw County",5,40,135,59,76
050,01,041,"Alabama","Crenshaw County",5,41,161,72,89
050,01,041,"Alabama","Crenshaw County",5,42,163,74,89
050,01,041,"Alabama","Crenshaw County",5,43,154,75,79
050,01,041,"Alabama","Crenshaw County",5,44,144,69,75
050,01,041,"Alabama","Crenshaw County",5,45,145,66,79
050,01,041,"Alabama","Crenshaw County",5,46,131,70,61
050,01,041,"Alabama","Crenshaw County",5,47,167,88,79
050,01,041,"Alabama","Crenshaw County",5,48,140,66,74
050,01,041,"Alabama","Crenshaw County",5,49,151,58,93
050,01,041,"Alabama","Crenshaw County",5,50,163,63,100
050,01,041,"Alabama","Crenshaw County",5,51,179,86,93
050,01,041,"Alabama","Crenshaw County",5,52,191,102,89
050,01,041,"Alabama","Crenshaw County",5,53,160,91,69
050,01,041,"Alabama","Crenshaw County",5,54,142,78,64
050,01,041,"Alabama","Crenshaw County",5,55,147,81,66
050,01,041,"Alabama","Crenshaw County",5,56,173,81,92
050,01,041,"Alabama","Crenshaw County",5,57,183,85,98
050,01,041,"Alabama","Crenshaw County",5,58,176,72,104
050,01,041,"Alabama","Crenshaw County",5,59,186,88,98
050,01,041,"Alabama","Crenshaw County",5,60,186,93,93
050,01,041,"Alabama","Crenshaw County",5,61,198,104,94
050,01,041,"Alabama","Crenshaw County",5,62,193,102,91
050,01,041,"Alabama","Crenshaw County",5,63,186,102,84
050,01,041,"Alabama","Crenshaw County",5,64,168,89,79
050,01,041,"Alabama","Crenshaw County",5,65,184,99,85
050,01,041,"Alabama","Crenshaw County",5,66,182,88,94
050,01,041,"Alabama","Crenshaw County",5,67,171,87,84
050,01,041,"Alabama","Crenshaw County",5,68,176,87,89
050,01,041,"Alabama","Crenshaw County",5,69,157,67,90
050,01,041,"Alabama","Crenshaw County",5,70,139,66,73
050,01,041,"Alabama","Crenshaw County",5,71,142,63,79
050,01,041,"Alabama","Crenshaw County",5,72,141,65,76
050,01,041,"Alabama","Crenshaw County",5,73,128,64,64
050,01,041,"Alabama","Crenshaw County",5,74,121,53,68
050,01,041,"Alabama","Crenshaw County",5,75,127,55,72
050,01,041,"Alabama","Crenshaw County",5,76,151,63,88
050,01,041,"Alabama","Crenshaw County",5,77,102,48,54
050,01,041,"Alabama","Crenshaw County",5,78,89,41,48
050,01,041,"Alabama","Crenshaw County",5,79,84,41,43
050,01,041,"Alabama","Crenshaw County",5,80,77,42,35
050,01,041,"Alabama","Crenshaw County",5,81,52,25,27
050,01,041,"Alabama","Crenshaw County",5,82,47,20,27
050,01,041,"Alabama","Crenshaw County",5,83,51,14,37
050,01,041,"Alabama","Crenshaw County",5,84,50,16,34
050,01,041,"Alabama","Crenshaw County",5,85,262,83,179
050,01,043,"Alabama","Cullman County",1,0,989,506,483
050,01,043,"Alabama","Cullman County",1,1,1012,519,493
050,01,043,"Alabama","Cullman County",1,2,1007,530,477
050,01,043,"Alabama","Cullman County",1,3,1114,582,532
050,01,043,"Alabama","Cullman County",1,4,1107,561,546
050,01,043,"Alabama","Cullman County",1,5,1103,540,563
050,01,043,"Alabama","Cullman County",1,6,1097,561,536
050,01,043,"Alabama","Cullman County",1,7,1053,536,517
050,01,043,"Alabama","Cullman County",1,8,1079,548,531
050,01,043,"Alabama","Cullman County",1,9,1134,570,564
050,01,043,"Alabama","Cullman County",1,10,1136,571,565
050,01,043,"Alabama","Cullman County",1,11,1138,578,560
050,01,043,"Alabama","Cullman County",1,12,1166,605,561
050,01,043,"Alabama","Cullman County",1,13,1134,586,548
050,01,043,"Alabama","Cullman County",1,14,1137,591,546
050,01,043,"Alabama","Cullman County",1,15,1146,603,543
050,01,043,"Alabama","Cullman County",1,16,1170,623,547
050,01,043,"Alabama","Cullman County",1,17,1146,590,556
050,01,043,"Alabama","Cullman County",1,18,966,520,446
050,01,043,"Alabama","Cullman County",1,19,814,425,389
050,01,043,"Alabama","Cullman County",1,20,862,455,407
050,01,043,"Alabama","Cullman County",1,21,889,454,435
050,01,043,"Alabama","Cullman County",1,22,954,482,472
050,01,043,"Alabama","Cullman County",1,23,1008,506,502
050,01,043,"Alabama","Cullman County",1,24,1016,530,486
050,01,043,"Alabama","Cullman County",1,25,1040,538,502
050,01,043,"Alabama","Cullman County",1,26,1044,550,494
050,01,043,"Alabama","Cullman County",1,27,1106,555,551
050,01,043,"Alabama","Cullman County",1,28,1169,574,595
050,01,043,"Alabama","Cullman County",1,29,1280,610,670
050,01,043,"Alabama","Cullman County",1,30,1233,623,610
050,01,043,"Alabama","Cullman County",1,31,1129,567,562
050,01,043,"Alabama","Cullman County",1,32,1082,563,519
050,01,043,"Alabama","Cullman County",1,33,1071,546,525
050,01,043,"Alabama","Cullman County",1,34,1080,566,514
050,01,043,"Alabama","Cullman County",1,35,1041,557,484
050,01,043,"Alabama","Cullman County",1,36,1028,513,515
050,01,043,"Alabama","Cullman County",1,37,1039,522,517
050,01,043,"Alabama","Cullman County",1,38,1015,491,524
050,01,043,"Alabama","Cullman County",1,39,1040,493,547
050,01,043,"Alabama","Cullman County",1,40,1097,556,541
050,01,043,"Alabama","Cullman County",1,41,1052,547,505
050,01,043,"Alabama","Cullman County",1,42,1053,535,518
050,01,043,"Alabama","Cullman County",1,43,1082,560,522
050,01,043,"Alabama","Cullman County",1,44,1107,559,548
050,01,043,"Alabama","Cullman County",1,45,1112,555,557
050,01,043,"Alabama","Cullman County",1,46,1058,538,520
050,01,043,"Alabama","Cullman County",1,47,1036,509,527
050,01,043,"Alabama","Cullman County",1,48,1122,572,550
050,01,043,"Alabama","Cullman County",1,49,1213,607,606
050,01,043,"Alabama","Cullman County",1,50,1112,564,548
050,01,043,"Alabama","Cullman County",1,51,1094,568,526
050,01,043,"Alabama","Cullman County",1,52,1067,554,513
050,01,043,"Alabama","Cullman County",1,53,1139,603,536
050,01,043,"Alabama","Cullman County",1,54,1214,617,597
050,01,043,"Alabama","Cullman County",1,55,1203,598,605
050,01,043,"Alabama","Cullman County",1,56,1206,613,593
050,01,043,"Alabama","Cullman County",1,57,1244,616,628
050,01,043,"Alabama","Cullman County",1,58,1244,642,602
050,01,043,"Alabama","Cullman County",1,59,1237,624,613
050,01,043,"Alabama","Cullman County",1,60,1185,581,604
050,01,043,"Alabama","Cullman County",1,61,1164,580,584
050,01,043,"Alabama","Cullman County",1,62,1190,599,591
050,01,043,"Alabama","Cullman County",1,63,1185,608,577
050,01,043,"Alabama","Cullman County",1,64,1176,577,599
050,01,043,"Alabama","Cullman County",1,65,1170,531,639
050,01,043,"Alabama","Cullman County",1,66,1075,505,570
050,01,043,"Alabama","Cullman County",1,67,1013,486,527
050,01,043,"Alabama","Cullman County",1,68,1000,486,514
050,01,043,"Alabama","Cullman County",1,69,961,453,508
050,01,043,"Alabama","Cullman County",1,70,979,456,523
050,01,043,"Alabama","Cullman County",1,71,955,454,501
050,01,043,"Alabama","Cullman County",1,72,986,450,536
050,01,043,"Alabama","Cullman County",1,73,995,481,514
050,01,043,"Alabama","Cullman County",1,74,684,310,374
050,01,043,"Alabama","Cullman County",1,75,690,308,382
050,01,043,"Alabama","Cullman County",1,76,718,323,395
050,01,043,"Alabama","Cullman County",1,77,686,302,384
050,01,043,"Alabama","Cullman County",1,78,591,274,317
050,01,043,"Alabama","Cullman County",1,79,501,216,285
050,01,043,"Alabama","Cullman County",1,80,468,203,265
050,01,043,"Alabama","Cullman County",1,81,480,198,282
050,01,043,"Alabama","Cullman County",1,82,406,164,242
050,01,043,"Alabama","Cullman County",1,83,320,128,192
050,01,043,"Alabama","Cullman County",1,84,331,142,189
050,01,043,"Alabama","Cullman County",1,85,1482,523,959
050,01,043,"Alabama","Cullman County",2,0,998,523,475
050,01,043,"Alabama","Cullman County",2,1,1004,515,489
050,01,043,"Alabama","Cullman County",2,2,1014,531,483
050,01,043,"Alabama","Cullman County",2,3,1089,570,519
050,01,043,"Alabama","Cullman County",2,4,1115,570,545
050,01,043,"Alabama","Cullman County",2,5,1108,547,561
050,01,043,"Alabama","Cullman County",2,6,1102,560,542
050,01,043,"Alabama","Cullman County",2,7,1064,542,522
050,01,043,"Alabama","Cullman County",2,8,1073,546,527
050,01,043,"Alabama","Cullman County",2,9,1125,570,555
050,01,043,"Alabama","Cullman County",2,10,1143,575,568
050,01,043,"Alabama","Cullman County",2,11,1135,576,559
050,01,043,"Alabama","Cullman County",2,12,1166,601,565
050,01,043,"Alabama","Cullman County",2,13,1144,590,554
050,01,043,"Alabama","Cullman County",2,14,1137,592,545
050,01,043,"Alabama","Cullman County",2,15,1154,607,547
050,01,043,"Alabama","Cullman County",2,16,1163,620,543
050,01,043,"Alabama","Cullman County",2,17,1148,598,550
050,01,043,"Alabama","Cullman County",2,18,969,522,447
050,01,043,"Alabama","Cullman County",2,19,804,422,382
050,01,043,"Alabama","Cullman County",2,20,876,459,417
050,01,043,"Alabama","Cullman County",2,21,894,459,435
050,01,043,"Alabama","Cullman County",2,22,955,483,472
050,01,043,"Alabama","Cullman County",2,23,1015,511,504
050,01,043,"Alabama","Cullman County",2,24,1021,527,494
050,01,043,"Alabama","Cullman County",2,25,1048,545,503
050,01,043,"Alabama","Cullman County",2,26,1057,554,503
050,01,043,"Alabama","Cullman County",2,27,1094,556,538
050,01,043,"Alabama","Cullman County",2,28,1162,574,588
050,01,043,"Alabama","Cullman County",2,29,1254,602,652
050,01,043,"Alabama","Cullman County",2,30,1255,625,630
050,01,043,"Alabama","Cullman County",2,31,1155,581,574
050,01,043,"Alabama","Cullman County",2,32,1091,563,528
050,01,043,"Alabama","Cullman County",2,33,1074,552,522
050,01,043,"Alabama","Cullman County",2,34,1081,563,518
050,01,043,"Alabama","Cullman County",2,35,1060,564,496
050,01,043,"Alabama","Cullman County",2,36,1029,521,508
050,01,043,"Alabama","Cullman County",2,37,1036,518,518
050,01,043,"Alabama","Cullman County",2,38,1029,499,530
050,01,043,"Alabama","Cullman County",2,39,1040,496,544
050,01,043,"Alabama","Cullman County",2,40,1089,546,543
050,01,043,"Alabama","Cullman County",2,41,1061,547,514
050,01,043,"Alabama","Cullman County",2,42,1052,537,515
050,01,043,"Alabama","Cullman County",2,43,1088,562,526
050,01,043,"Alabama","Cullman County",2,44,1099,557,542
050,01,043,"Alabama","Cullman County",2,45,1120,562,558
050,01,043,"Alabama","Cullman County",2,46,1069,541,528
050,01,043,"Alabama","Cullman County",2,47,1041,515,526
050,01,043,"Alabama","Cullman County",2,48,1100,556,544
050,01,043,"Alabama","Cullman County",2,49,1201,604,597
050,01,043,"Alabama","Cullman County",2,50,1145,577,568
050,01,043,"Alabama","Cullman County",2,51,1100,566,534
050,01,043,"Alabama","Cullman County",2,52,1075,556,519
050,01,043,"Alabama","Cullman County",2,53,1124,593,531
050,01,043,"Alabama","Cullman County",2,54,1194,611,583
050,01,043,"Alabama","Cullman County",2,55,1208,604,604
050,01,043,"Alabama","Cullman County",2,56,1211,611,600
050,01,043,"Alabama","Cullman County",2,57,1237,615,622
050,01,043,"Alabama","Cullman County",2,58,1246,637,609
050,01,043,"Alabama","Cullman County",2,59,1251,633,618
050,01,043,"Alabama","Cullman County",2,60,1195,591,604
050,01,043,"Alabama","Cullman County",2,61,1170,584,586
050,01,043,"Alabama","Cullman County",2,62,1186,594,592
050,01,043,"Alabama","Cullman County",2,63,1198,608,590
050,01,043,"Alabama","Cullman County",2,64,1169,579,590
050,01,043,"Alabama","Cullman County",2,65,1174,540,634
050,01,043,"Alabama","Cullman County",2,66,1099,513,586
050,01,043,"Alabama","Cullman County",2,67,1025,487,538
050,01,043,"Alabama","Cullman County",2,68,996,484,512
050,01,043,"Alabama","Cullman County",2,69,975,461,514
050,01,043,"Alabama","Cullman County",2,70,968,450,518
050,01,043,"Alabama","Cullman County",2,71,959,451,508
050,01,043,"Alabama","Cullman County",2,72,962,442,520
050,01,043,"Alabama","Cullman County",2,73,1036,497,539
050,01,043,"Alabama","Cullman County",2,74,713,328,385
050,01,043,"Alabama","Cullman County",2,75,687,310,377
050,01,043,"Alabama","Cullman County",2,76,705,314,391
050,01,043,"Alabama","Cullman County",2,77,697,309,388
050,01,043,"Alabama","Cullman County",2,78,599,276,323
050,01,043,"Alabama","Cullman County",2,79,510,223,287
050,01,043,"Alabama","Cullman County",2,80,473,204,269
050,01,043,"Alabama","Cullman County",2,81,463,194,269
050,01,043,"Alabama","Cullman County",2,82,419,171,248
050,01,043,"Alabama","Cullman County",2,83,329,133,196
050,01,043,"Alabama","Cullman County",2,84,326,139,187
050,01,043,"Alabama","Cullman County",2,85,1511,539,972
050,01,043,"Alabama","Cullman County",3,0,993,513,480
050,01,043,"Alabama","Cullman County",3,1,1042,545,497
050,01,043,"Alabama","Cullman County",3,2,1037,523,514
050,01,043,"Alabama","Cullman County",3,3,1046,555,491
050,01,043,"Alabama","Cullman County",3,4,1105,581,524
050,01,043,"Alabama","Cullman County",3,5,1120,579,541
050,01,043,"Alabama","Cullman County",3,6,1143,567,576
050,01,043,"Alabama","Cullman County",3,7,1116,566,550
050,01,043,"Alabama","Cullman County",3,8,1101,559,542
050,01,043,"Alabama","Cullman County",3,9,1106,568,538
050,01,043,"Alabama","Cullman County",3,10,1144,582,562
050,01,043,"Alabama","Cullman County",3,11,1154,585,569
050,01,043,"Alabama","Cullman County",3,12,1155,586,569
050,01,043,"Alabama","Cullman County",3,13,1210,617,593
050,01,043,"Alabama","Cullman County",3,14,1170,612,558
050,01,043,"Alabama","Cullman County",3,15,1158,599,559
050,01,043,"Alabama","Cullman County",3,16,1173,613,560
050,01,043,"Alabama","Cullman County",3,17,1168,618,550
050,01,043,"Alabama","Cullman County",3,18,998,537,461
050,01,043,"Alabama","Cullman County",3,19,773,407,366
050,01,043,"Alabama","Cullman County",3,20,897,464,433
050,01,043,"Alabama","Cullman County",3,21,921,478,443
050,01,043,"Alabama","Cullman County",3,22,994,508,486
050,01,043,"Alabama","Cullman County",3,23,1065,535,530
050,01,043,"Alabama","Cullman County",3,24,1087,550,537
050,01,043,"Alabama","Cullman County",3,25,1052,535,517
050,01,043,"Alabama","Cullman County",3,26,1077,561,516
050,01,043,"Alabama","Cullman County",3,27,1087,579,508
050,01,043,"Alabama","Cullman County",3,28,1132,581,551
050,01,043,"Alabama","Cullman County",3,29,1181,560,621
050,01,043,"Alabama","Cullman County",3,30,1285,627,658
050,01,043,"Alabama","Cullman County",3,31,1319,655,664
050,01,043,"Alabama","Cullman County",3,32,1179,588,591
050,01,043,"Alabama","Cullman County",3,33,1125,590,535
050,01,043,"Alabama","Cullman County",3,34,1089,558,531
050,01,043,"Alabama","Cullman County",3,35,1125,582,543
050,01,043,"Alabama","Cullman County",3,36,1073,574,499
050,01,043,"Alabama","Cullman County",3,37,1055,534,521
050,01,043,"Alabama","Cullman County",3,38,1044,520,524
050,01,043,"Alabama","Cullman County",3,39,1046,512,534
050,01,043,"Alabama","Cullman County",3,40,1062,504,558
050,01,043,"Alabama","Cullman County",3,41,1112,554,558
050,01,043,"Alabama","Cullman County",3,42,1075,547,528
050,01,043,"Alabama","Cullman County",3,43,1055,539,516
050,01,043,"Alabama","Cullman County",3,44,1109,570,539
050,01,043,"Alabama","Cullman County",3,45,1114,566,548
050,01,043,"Alabama","Cullman County",3,46,1148,565,583
050,01,043,"Alabama","Cullman County",3,47,1088,556,532
050,01,043,"Alabama","Cullman County",3,48,1070,529,541
050,01,043,"Alabama","Cullman County",3,49,1125,572,553
050,01,043,"Alabama","Cullman County",3,50,1219,614,605
050,01,043,"Alabama","Cullman County",3,51,1157,582,575
050,01,043,"Alabama","Cullman County",3,52,1117,571,546
050,01,043,"Alabama","Cullman County",3,53,1080,553,527
050,01,043,"Alabama","Cullman County",3,54,1159,611,548
050,01,043,"Alabama","Cullman County",3,55,1207,612,595
050,01,043,"Alabama","Cullman County",3,56,1259,628,631
050,01,043,"Alabama","Cullman County",3,57,1234,628,606
050,01,043,"Alabama","Cullman County",3,58,1254,630,624
050,01,043,"Alabama","Cullman County",3,59,1275,642,633
050,01,043,"Alabama","Cullman County",3,60,1272,654,618
050,01,043,"Alabama","Cullman County",3,61,1215,595,620
050,01,043,"Alabama","Cullman County",3,62,1177,582,595
050,01,043,"Alabama","Cullman County",3,63,1208,594,614
050,01,043,"Alabama","Cullman County",3,64,1164,585,579
050,01,043,"Alabama","Cullman County",3,65,1170,571,599
050,01,043,"Alabama","Cullman County",3,66,1159,534,625
050,01,043,"Alabama","Cullman County",3,67,1085,504,581
050,01,043,"Alabama","Cullman County",3,68,998,470,528
050,01,043,"Alabama","Cullman County",3,69,992,473,519
050,01,043,"Alabama","Cullman County",3,70,952,454,498
050,01,043,"Alabama","Cullman County",3,71,938,431,507
050,01,043,"Alabama","Cullman County",3,72,948,433,515
050,01,043,"Alabama","Cullman County",3,73,916,432,484
050,01,043,"Alabama","Cullman County",3,74,986,453,533
050,01,043,"Alabama","Cullman County",3,75,689,310,379
050,01,043,"Alabama","Cullman County",3,76,684,305,379
050,01,043,"Alabama","Cullman County",3,77,661,293,368
050,01,043,"Alabama","Cullman County",3,78,664,302,362
050,01,043,"Alabama","Cullman County",3,79,556,253,303
050,01,043,"Alabama","Cullman County",3,80,474,204,270
050,01,043,"Alabama","Cullman County",3,81,443,180,263
050,01,043,"Alabama","Cullman County",3,82,428,182,246
050,01,043,"Alabama","Cullman County",3,83,358,147,211
050,01,043,"Alabama","Cullman County",3,84,305,117,188
050,01,043,"Alabama","Cullman County",3,85,1533,544,989
050,01,043,"Alabama","Cullman County",4,0,999,509,490
050,01,043,"Alabama","Cullman County",4,1,1012,513,499
050,01,043,"Alabama","Cullman County",4,2,1055,545,510
050,01,043,"Alabama","Cullman County",4,3,1051,540,511
050,01,043,"Alabama","Cullman County",4,4,1055,569,486
050,01,043,"Alabama","Cullman County",4,5,1124,586,538
050,01,043,"Alabama","Cullman County",4,6,1132,592,540
050,01,043,"Alabama","Cullman County",4,7,1183,583,600
050,01,043,"Alabama","Cullman County",4,8,1144,581,563
050,01,043,"Alabama","Cullman County",4,9,1109,562,547
050,01,043,"Alabama","Cullman County",4,10,1125,581,544
050,01,043,"Alabama","Cullman County",4,11,1168,588,580
050,01,043,"Alabama","Cullman County",4,12,1163,596,567
050,01,043,"Alabama","Cullman County",4,13,1196,608,588
050,01,043,"Alabama","Cullman County",4,14,1232,637,595
050,01,043,"Alabama","Cullman County",4,15,1226,639,587
050,01,043,"Alabama","Cullman County",4,16,1176,611,565
050,01,043,"Alabama","Cullman County",4,17,1200,637,563
050,01,043,"Alabama","Cullman County",4,18,1016,554,462
050,01,043,"Alabama","Cullman County",4,19,790,415,375
050,01,043,"Alabama","Cullman County",4,20,832,433,399
050,01,043,"Alabama","Cullman County",4,21,930,474,456
050,01,043,"Alabama","Cullman County",4,22,1009,524,485
050,01,043,"Alabama","Cullman County",4,23,1069,547,522
050,01,043,"Alabama","Cullman County",4,24,1092,543,549
050,01,043,"Alabama","Cullman County",4,25,1102,561,541
050,01,043,"Alabama","Cullman County",4,26,1088,567,521
050,01,043,"Alabama","Cullman County",4,27,1113,578,535
050,01,043,"Alabama","Cullman County",4,28,1118,595,523
050,01,043,"Alabama","Cullman County",4,29,1149,595,554
050,01,043,"Alabama","Cullman County",4,30,1200,580,620
050,01,043,"Alabama","Cullman County",4,31,1287,612,675
050,01,043,"Alabama","Cullman County",4,32,1349,675,674
050,01,043,"Alabama","Cullman County",4,33,1213,618,595
050,01,043,"Alabama","Cullman County",4,34,1136,592,544
050,01,043,"Alabama","Cullman County",4,35,1106,560,546
050,01,043,"Alabama","Cullman County",4,36,1135,594,541
050,01,043,"Alabama","Cullman County",4,37,1068,575,493
050,01,043,"Alabama","Cullman County",4,38,1061,533,528
050,01,043,"Alabama","Cullman County",4,39,1064,535,529
050,01,043,"Alabama","Cullman County",4,40,1074,529,545
050,01,043,"Alabama","Cullman County",4,41,1077,521,556
050,01,043,"Alabama","Cullman County",4,42,1126,548,578
050,01,043,"Alabama","Cullman County",4,43,1080,558,522
050,01,043,"Alabama","Cullman County",4,44,1081,545,536
050,01,043,"Alabama","Cullman County",4,45,1134,581,553
050,01,043,"Alabama","Cullman County",4,46,1130,574,556
050,01,043,"Alabama","Cullman County",4,47,1134,556,578
050,01,043,"Alabama","Cullman County",4,48,1097,563,534
050,01,043,"Alabama","Cullman County",4,49,1079,529,550
050,01,043,"Alabama","Cullman County",4,50,1121,577,544
050,01,043,"Alabama","Cullman County",4,51,1224,608,616
050,01,043,"Alabama","Cullman County",4,52,1181,593,588
050,01,043,"Alabama","Cullman County",4,53,1112,578,534
050,01,043,"Alabama","Cullman County",4,54,1095,571,524
050,01,043,"Alabama","Cullman County",4,55,1162,607,555
050,01,043,"Alabama","Cullman County",4,56,1229,630,599
050,01,043,"Alabama","Cullman County",4,57,1290,649,641
050,01,043,"Alabama","Cullman County",4,58,1236,628,608
050,01,043,"Alabama","Cullman County",4,59,1278,629,649
050,01,043,"Alabama","Cullman County",4,60,1274,645,629
050,01,043,"Alabama","Cullman County",4,61,1273,646,627
050,01,043,"Alabama","Cullman County",4,62,1224,603,621
050,01,043,"Alabama","Cullman County",4,63,1199,590,609
050,01,043,"Alabama","Cullman County",4,64,1187,587,600
050,01,043,"Alabama","Cullman County",4,65,1164,588,576
050,01,043,"Alabama","Cullman County",4,66,1145,554,591
050,01,043,"Alabama","Cullman County",4,67,1143,530,613
050,01,043,"Alabama","Cullman County",4,68,1081,498,583
050,01,043,"Alabama","Cullman County",4,69,975,448,527
050,01,043,"Alabama","Cullman County",4,70,962,458,504
050,01,043,"Alabama","Cullman County",4,71,904,428,476
050,01,043,"Alabama","Cullman County",4,72,929,420,509
050,01,043,"Alabama","Cullman County",4,73,917,429,488
050,01,043,"Alabama","Cullman County",4,74,871,394,477
050,01,043,"Alabama","Cullman County",4,75,978,445,533
050,01,043,"Alabama","Cullman County",4,76,699,307,392
050,01,043,"Alabama","Cullman County",4,77,642,283,359
050,01,043,"Alabama","Cullman County",4,78,635,293,342
050,01,043,"Alabama","Cullman County",4,79,611,275,336
050,01,043,"Alabama","Cullman County",4,80,523,236,287
050,01,043,"Alabama","Cullman County",4,81,444,180,264
050,01,043,"Alabama","Cullman County",4,82,411,170,241
050,01,043,"Alabama","Cullman County",4,83,376,161,215
050,01,043,"Alabama","Cullman County",4,84,336,138,198
050,01,043,"Alabama","Cullman County",4,85,1543,535,1008
050,01,043,"Alabama","Cullman County",5,0,1010,516,494
050,01,043,"Alabama","Cullman County",5,1,1052,544,508
050,01,043,"Alabama","Cullman County",5,2,1045,530,515
050,01,043,"Alabama","Cullman County",5,3,1078,559,519
050,01,043,"Alabama","Cullman County",5,4,1069,553,516
050,01,043,"Alabama","Cullman County",5,5,1090,580,510
050,01,043,"Alabama","Cullman County",5,6,1151,592,559
050,01,043,"Alabama","Cullman County",5,7,1161,602,559
050,01,043,"Alabama","Cullman County",5,8,1223,606,617
050,01,043,"Alabama","Cullman County",5,9,1186,594,592
050,01,043,"Alabama","Cullman County",5,10,1149,585,564
050,01,043,"Alabama","Cullman County",5,11,1133,589,544
050,01,043,"Alabama","Cullman County",5,12,1199,601,598
050,01,043,"Alabama","Cullman County",5,13,1171,584,587
050,01,043,"Alabama","Cullman County",5,14,1221,625,596
050,01,043,"Alabama","Cullman County",5,15,1246,647,599
050,01,043,"Alabama","Cullman County",5,16,1226,643,583
050,01,043,"Alabama","Cullman County",5,17,1175,609,566
050,01,043,"Alabama","Cullman County",5,18,1027,565,462
050,01,043,"Alabama","Cullman County",5,19,801,434,367
050,01,043,"Alabama","Cullman County",5,20,870,445,425
050,01,043,"Alabama","Cullman County",5,21,901,472,429
050,01,043,"Alabama","Cullman County",5,22,1005,513,492
050,01,043,"Alabama","Cullman County",5,23,1088,570,518
050,01,043,"Alabama","Cullman County",5,24,1125,587,538
050,01,043,"Alabama","Cullman County",5,25,1118,553,565
050,01,043,"Alabama","Cullman County",5,26,1146,593,553
050,01,043,"Alabama","Cullman County",5,27,1121,593,528
050,01,043,"Alabama","Cullman County",5,28,1119,595,524
050,01,043,"Alabama","Cullman County",5,29,1141,596,545
050,01,043,"Alabama","Cullman County",5,30,1160,596,564
050,01,043,"Alabama","Cullman County",5,31,1257,609,648
050,01,043,"Alabama","Cullman County",5,32,1320,629,691
050,01,043,"Alabama","Cullman County",5,33,1392,702,690
050,01,043,"Alabama","Cullman County",5,34,1222,620,602
050,01,043,"Alabama","Cullman County",5,35,1139,594,545
050,01,043,"Alabama","Cullman County",5,36,1136,577,559
050,01,043,"Alabama","Cullman County",5,37,1127,583,544
050,01,043,"Alabama","Cullman County",5,38,1082,574,508
050,01,043,"Alabama","Cullman County",5,39,1081,541,540
050,01,043,"Alabama","Cullman County",5,40,1091,556,535
050,01,043,"Alabama","Cullman County",5,41,1110,547,563
050,01,043,"Alabama","Cullman County",5,42,1093,523,570
050,01,043,"Alabama","Cullman County",5,43,1125,546,579
050,01,043,"Alabama","Cullman County",5,44,1120,578,542
050,01,043,"Alabama","Cullman County",5,45,1082,544,538
050,01,043,"Alabama","Cullman County",5,46,1149,589,560
050,01,043,"Alabama","Cullman County",5,47,1137,577,560
050,01,043,"Alabama","Cullman County",5,48,1134,564,570
050,01,043,"Alabama","Cullman County",5,49,1104,555,549
050,01,043,"Alabama","Cullman County",5,50,1089,544,545
050,01,043,"Alabama","Cullman County",5,51,1113,564,549
050,01,043,"Alabama","Cullman County",5,52,1237,615,622
050,01,043,"Alabama","Cullman County",5,53,1187,598,589
050,01,043,"Alabama","Cullman County",5,54,1118,591,527
050,01,043,"Alabama","Cullman County",5,55,1111,571,540
050,01,043,"Alabama","Cullman County",5,56,1189,613,576
050,01,043,"Alabama","Cullman County",5,57,1239,632,607
050,01,043,"Alabama","Cullman County",5,58,1285,648,637
050,01,043,"Alabama","Cullman County",5,59,1236,623,613
050,01,043,"Alabama","Cullman County",5,60,1273,629,644
050,01,043,"Alabama","Cullman County",5,61,1282,648,634
050,01,043,"Alabama","Cullman County",5,62,1278,640,638
050,01,043,"Alabama","Cullman County",5,63,1245,617,628
050,01,043,"Alabama","Cullman County",5,64,1164,576,588
050,01,043,"Alabama","Cullman County",5,65,1183,578,605
050,01,043,"Alabama","Cullman County",5,66,1147,577,570
050,01,043,"Alabama","Cullman County",5,67,1147,551,596
050,01,043,"Alabama","Cullman County",5,68,1140,524,616
050,01,043,"Alabama","Cullman County",5,69,1068,484,584
050,01,043,"Alabama","Cullman County",5,70,969,450,519
050,01,043,"Alabama","Cullman County",5,71,941,447,494
050,01,043,"Alabama","Cullman County",5,72,895,421,474
050,01,043,"Alabama","Cullman County",5,73,897,417,480
050,01,043,"Alabama","Cullman County",5,74,888,393,495
050,01,043,"Alabama","Cullman County",5,75,856,384,472
050,01,043,"Alabama","Cullman County",5,76,980,440,540
050,01,043,"Alabama","Cullman County",5,77,660,285,375
050,01,043,"Alabama","Cullman County",5,78,624,282,342
050,01,043,"Alabama","Cullman County",5,79,583,263,320
050,01,043,"Alabama","Cullman County",5,80,590,269,321
050,01,043,"Alabama","Cullman County",5,81,500,215,285
050,01,043,"Alabama","Cullman County",5,82,421,176,245
050,01,043,"Alabama","Cullman County",5,83,362,147,215
050,01,043,"Alabama","Cullman County",5,84,369,157,212
050,01,043,"Alabama","Cullman County",5,85,1642,573,1069
050,01,045,"Alabama","Dale County",1,0,632,322,310
050,01,045,"Alabama","Dale County",1,1,658,313,345
050,01,045,"Alabama","Dale County",1,2,670,346,324
050,01,045,"Alabama","Dale County",1,3,635,318,317
050,01,045,"Alabama","Dale County",1,4,660,341,319
050,01,045,"Alabama","Dale County",1,5,674,336,338
050,01,045,"Alabama","Dale County",1,6,640,325,315
050,01,045,"Alabama","Dale County",1,7,611,329,282
050,01,045,"Alabama","Dale County",1,8,665,351,314
050,01,045,"Alabama","Dale County",1,9,587,310,277
050,01,045,"Alabama","Dale County",1,10,616,334,282
050,01,045,"Alabama","Dale County",1,11,673,364,309
050,01,045,"Alabama","Dale County",1,12,630,326,304
050,01,045,"Alabama","Dale County",1,13,623,324,299
050,01,045,"Alabama","Dale County",1,14,605,303,302
050,01,045,"Alabama","Dale County",1,15,621,314,307
050,01,045,"Alabama","Dale County",1,16,608,319,289
050,01,045,"Alabama","Dale County",1,17,635,326,309
050,01,045,"Alabama","Dale County",1,18,545,281,264
050,01,045,"Alabama","Dale County",1,19,516,277,239
050,01,045,"Alabama","Dale County",1,20,538,289,249
050,01,045,"Alabama","Dale County",1,21,544,278,266
050,01,045,"Alabama","Dale County",1,22,595,298,297
050,01,045,"Alabama","Dale County",1,23,712,390,322
050,01,045,"Alabama","Dale County",1,24,700,374,326
050,01,045,"Alabama","Dale County",1,25,668,341,327
050,01,045,"Alabama","Dale County",1,26,689,364,325
050,01,045,"Alabama","Dale County",1,27,720,375,345
050,01,045,"Alabama","Dale County",1,28,769,392,377
050,01,045,"Alabama","Dale County",1,29,736,352,384
050,01,045,"Alabama","Dale County",1,30,743,355,388
050,01,045,"Alabama","Dale County",1,31,737,365,372
050,01,045,"Alabama","Dale County",1,32,742,395,347
050,01,045,"Alabama","Dale County",1,33,686,357,329
050,01,045,"Alabama","Dale County",1,34,626,299,327
050,01,045,"Alabama","Dale County",1,35,644,306,338
050,01,045,"Alabama","Dale County",1,36,578,277,301
050,01,045,"Alabama","Dale County",1,37,572,275,297
050,01,045,"Alabama","Dale County",1,38,604,290,314
050,01,045,"Alabama","Dale County",1,39,600,306,294
050,01,045,"Alabama","Dale County",1,40,586,283,303
050,01,045,"Alabama","Dale County",1,41,564,255,309
050,01,045,"Alabama","Dale County",1,42,551,259,292
050,01,045,"Alabama","Dale County",1,43,516,258,258
050,01,045,"Alabama","Dale County",1,44,527,251,276
050,01,045,"Alabama","Dale County",1,45,555,268,287
050,01,045,"Alabama","Dale County",1,46,569,277,292
050,01,045,"Alabama","Dale County",1,47,567,269,298
050,01,045,"Alabama","Dale County",1,48,611,286,325
050,01,045,"Alabama","Dale County",1,49,638,314,324
050,01,045,"Alabama","Dale County",1,50,565,261,304
050,01,045,"Alabama","Dale County",1,51,559,272,287
050,01,045,"Alabama","Dale County",1,52,571,293,278
050,01,045,"Alabama","Dale County",1,53,600,286,314
050,01,045,"Alabama","Dale County",1,54,585,289,296
050,01,045,"Alabama","Dale County",1,55,625,310,315
050,01,045,"Alabama","Dale County",1,56,621,295,326
050,01,045,"Alabama","Dale County",1,57,634,310,324
050,01,045,"Alabama","Dale County",1,58,646,322,324
050,01,045,"Alabama","Dale County",1,59,663,320,343
050,01,045,"Alabama","Dale County",1,60,703,345,358
050,01,045,"Alabama","Dale County",1,61,669,333,336
050,01,045,"Alabama","Dale County",1,62,676,340,336
050,01,045,"Alabama","Dale County",1,63,652,308,344
050,01,045,"Alabama","Dale County",1,64,612,292,320
050,01,045,"Alabama","Dale County",1,65,585,282,303
050,01,045,"Alabama","Dale County",1,66,622,299,323
050,01,045,"Alabama","Dale County",1,67,566,280,286
050,01,045,"Alabama","Dale County",1,68,505,248,257
050,01,045,"Alabama","Dale County",1,69,472,237,235
050,01,045,"Alabama","Dale County",1,70,502,246,256
050,01,045,"Alabama","Dale County",1,71,493,233,260
050,01,045,"Alabama","Dale County",1,72,472,211,261
050,01,045,"Alabama","Dale County",1,73,476,216,260
050,01,045,"Alabama","Dale County",1,74,367,159,208
050,01,045,"Alabama","Dale County",1,75,371,167,204
050,01,045,"Alabama","Dale County",1,76,353,153,200
050,01,045,"Alabama","Dale County",1,77,339,154,185
050,01,045,"Alabama","Dale County",1,78,301,132,169
050,01,045,"Alabama","Dale County",1,79,267,115,152
050,01,045,"Alabama","Dale County",1,80,239,102,137
050,01,045,"Alabama","Dale County",1,81,239,90,149
050,01,045,"Alabama","Dale County",1,82,203,77,126
050,01,045,"Alabama","Dale County",1,83,180,71,109
050,01,045,"Alabama","Dale County",1,84,147,56,91
050,01,045,"Alabama","Dale County",1,85,851,320,531
050,01,045,"Alabama","Dale County",2,0,627,306,321
050,01,045,"Alabama","Dale County",2,1,651,314,337
050,01,045,"Alabama","Dale County",2,2,662,337,325
050,01,045,"Alabama","Dale County",2,3,641,327,314
050,01,045,"Alabama","Dale County",2,4,652,335,317
050,01,045,"Alabama","Dale County",2,5,669,336,333
050,01,045,"Alabama","Dale County",2,6,643,326,317
050,01,045,"Alabama","Dale County",2,7,617,326,291
050,01,045,"Alabama","Dale County",2,8,644,341,303
050,01,045,"Alabama","Dale County",2,9,601,319,282
050,01,045,"Alabama","Dale County",2,10,612,330,282
050,01,045,"Alabama","Dale County",2,11,654,354,300
050,01,045,"Alabama","Dale County",2,12,637,335,302
050,01,045,"Alabama","Dale County",2,13,626,324,302
050,01,045,"Alabama","Dale County",2,14,612,306,306
050,01,045,"Alabama","Dale County",2,15,616,312,304
050,01,045,"Alabama","Dale County",2,16,613,318,295
050,01,045,"Alabama","Dale County",2,17,626,322,304
050,01,045,"Alabama","Dale County",2,18,549,286,263
050,01,045,"Alabama","Dale County",2,19,509,271,238
050,01,045,"Alabama","Dale County",2,20,549,294,255
050,01,045,"Alabama","Dale County",2,21,556,285,271
050,01,045,"Alabama","Dale County",2,22,604,309,295
050,01,045,"Alabama","Dale County",2,23,696,375,321
050,01,045,"Alabama","Dale County",2,24,689,366,323
050,01,045,"Alabama","Dale County",2,25,672,346,326
050,01,045,"Alabama","Dale County",2,26,685,359,326
050,01,045,"Alabama","Dale County",2,27,713,374,339
050,01,045,"Alabama","Dale County",2,28,752,382,370
050,01,045,"Alabama","Dale County",2,29,741,357,384
050,01,045,"Alabama","Dale County",2,30,745,357,388
050,01,045,"Alabama","Dale County",2,31,744,370,374
050,01,045,"Alabama","Dale County",2,32,737,385,352
050,01,045,"Alabama","Dale County",2,33,692,361,331
050,01,045,"Alabama","Dale County",2,34,631,309,322
050,01,045,"Alabama","Dale County",2,35,635,300,335
050,01,045,"Alabama","Dale County",2,36,584,278,306
050,01,045,"Alabama","Dale County",2,37,575,275,300
050,01,045,"Alabama","Dale County",2,38,597,288,309
050,01,045,"Alabama","Dale County",2,39,596,299,297
050,01,045,"Alabama","Dale County",2,40,593,287,306
050,01,045,"Alabama","Dale County",2,41,567,261,306
050,01,045,"Alabama","Dale County",2,42,549,256,293
050,01,045,"Alabama","Dale County",2,43,524,257,267
050,01,045,"Alabama","Dale County",2,44,516,251,265
050,01,045,"Alabama","Dale County",2,45,548,264,284
050,01,045,"Alabama","Dale County",2,46,557,270,287
050,01,045,"Alabama","Dale County",2,47,563,267,296
050,01,045,"Alabama","Dale County",2,48,594,280,314
050,01,045,"Alabama","Dale County",2,49,626,303,323
050,01,045,"Alabama","Dale County",2,50,581,273,308
050,01,045,"Alabama","Dale County",2,51,556,266,290
050,01,045,"Alabama","Dale County",2,52,565,286,279
050,01,045,"Alabama","Dale County",2,53,592,286,306
050,01,045,"Alabama","Dale County",2,54,584,285,299
050,01,045,"Alabama","Dale County",2,55,609,302,307
050,01,045,"Alabama","Dale County",2,56,626,300,326
050,01,045,"Alabama","Dale County",2,57,630,305,325
050,01,045,"Alabama","Dale County",2,58,640,316,324
050,01,045,"Alabama","Dale County",2,59,662,323,339
050,01,045,"Alabama","Dale County",2,60,687,336,351
050,01,045,"Alabama","Dale County",2,61,678,335,343
050,01,045,"Alabama","Dale County",2,62,666,334,332
050,01,045,"Alabama","Dale County",2,63,665,319,346
050,01,045,"Alabama","Dale County",2,64,616,295,321
050,01,045,"Alabama","Dale County",2,65,594,288,306
050,01,045,"Alabama","Dale County",2,66,613,296,317
050,01,045,"Alabama","Dale County",2,67,583,286,297
050,01,045,"Alabama","Dale County",2,68,513,251,262
050,01,045,"Alabama","Dale County",2,69,480,239,241
050,01,045,"Alabama","Dale County",2,70,494,245,249
050,01,045,"Alabama","Dale County",2,71,493,234,259
050,01,045,"Alabama","Dale County",2,72,470,211,259
050,01,045,"Alabama","Dale County",2,73,493,223,270
050,01,045,"Alabama","Dale County",2,74,370,162,208
050,01,045,"Alabama","Dale County",2,75,369,163,206
050,01,045,"Alabama","Dale County",2,76,347,151,196
050,01,045,"Alabama","Dale County",2,77,348,155,193
050,01,045,"Alabama","Dale County",2,78,302,131,171
050,01,045,"Alabama","Dale County",2,79,270,119,151
050,01,045,"Alabama","Dale County",2,80,244,103,141
050,01,045,"Alabama","Dale County",2,81,238,92,146
050,01,045,"Alabama","Dale County",2,82,210,77,133
050,01,045,"Alabama","Dale County",2,83,181,71,110
050,01,045,"Alabama","Dale County",2,84,150,57,93
050,01,045,"Alabama","Dale County",2,85,847,315,532
050,01,045,"Alabama","Dale County",3,0,666,330,336
050,01,045,"Alabama","Dale County",3,1,659,301,358
050,01,045,"Alabama","Dale County",3,2,629,295,334
050,01,045,"Alabama","Dale County",3,3,680,341,339
050,01,045,"Alabama","Dale County",3,4,658,343,315
050,01,045,"Alabama","Dale County",3,5,669,341,328
050,01,045,"Alabama","Dale County",3,6,637,314,323
050,01,045,"Alabama","Dale County",3,7,632,317,315
050,01,045,"Alabama","Dale County",3,8,644,335,309
050,01,045,"Alabama","Dale County",3,9,666,341,325
050,01,045,"Alabama","Dale County",3,10,610,332,278
050,01,045,"Alabama","Dale County",3,11,619,332,287
050,01,045,"Alabama","Dale County",3,12,640,323,317
050,01,045,"Alabama","Dale County",3,13,657,345,312
050,01,045,"Alabama","Dale County",3,14,610,318,292
050,01,045,"Alabama","Dale County",3,15,623,307,316
050,01,045,"Alabama","Dale County",3,16,600,305,295
050,01,045,"Alabama","Dale County",3,17,615,316,299
050,01,045,"Alabama","Dale County",3,18,548,304,244
050,01,045,"Alabama","Dale County",3,19,476,241,235
050,01,045,"Alabama","Dale County",3,20,519,282,237
050,01,045,"Alabama","Dale County",3,21,561,295,266
050,01,045,"Alabama","Dale County",3,22,586,301,285
050,01,045,"Alabama","Dale County",3,23,701,363,338
050,01,045,"Alabama","Dale County",3,24,706,367,339
050,01,045,"Alabama","Dale County",3,25,707,378,329
050,01,045,"Alabama","Dale County",3,26,675,325,350
050,01,045,"Alabama","Dale County",3,27,749,395,354
050,01,045,"Alabama","Dale County",3,28,740,399,341
050,01,045,"Alabama","Dale County",3,29,718,374,344
050,01,045,"Alabama","Dale County",3,30,747,351,396
050,01,045,"Alabama","Dale County",3,31,740,364,376
050,01,045,"Alabama","Dale County",3,32,731,377,354
050,01,045,"Alabama","Dale County",3,33,715,371,344
050,01,045,"Alabama","Dale County",3,34,663,344,319
050,01,045,"Alabama","Dale County",3,35,601,274,327
050,01,045,"Alabama","Dale County",3,36,613,292,321
050,01,045,"Alabama","Dale County",3,37,565,275,290
050,01,045,"Alabama","Dale County",3,38,556,269,287
050,01,045,"Alabama","Dale County",3,39,595,286,309
050,01,045,"Alabama","Dale County",3,40,587,294,293
050,01,045,"Alabama","Dale County",3,41,575,274,301
050,01,045,"Alabama","Dale County",3,42,594,277,317
050,01,045,"Alabama","Dale County",3,43,541,254,287
050,01,045,"Alabama","Dale County",3,44,515,245,270
050,01,045,"Alabama","Dale County",3,45,517,247,270
050,01,045,"Alabama","Dale County",3,46,534,248,286
050,01,045,"Alabama","Dale County",3,47,554,263,291
050,01,045,"Alabama","Dale County",3,48,558,266,292
050,01,045,"Alabama","Dale County",3,49,585,289,296
050,01,045,"Alabama","Dale County",3,50,604,297,307
050,01,045,"Alabama","Dale County",3,51,580,280,300
050,01,045,"Alabama","Dale County",3,52,549,256,293
050,01,045,"Alabama","Dale County",3,53,559,281,278
050,01,045,"Alabama","Dale County",3,54,599,288,311
050,01,045,"Alabama","Dale County",3,55,583,286,297
050,01,045,"Alabama","Dale County",3,56,613,299,314
050,01,045,"Alabama","Dale County",3,57,634,308,326
050,01,045,"Alabama","Dale County",3,58,643,310,333
050,01,045,"Alabama","Dale County",3,59,656,312,344
050,01,045,"Alabama","Dale County",3,60,646,313,333
050,01,045,"Alabama","Dale County",3,61,686,332,354
050,01,045,"Alabama","Dale County",3,62,669,335,334
050,01,045,"Alabama","Dale County",3,63,649,330,319
050,01,045,"Alabama","Dale County",3,64,674,318,356
050,01,045,"Alabama","Dale County",3,65,601,293,308
050,01,045,"Alabama","Dale County",3,66,598,288,310
050,01,045,"Alabama","Dale County",3,67,596,278,318
050,01,045,"Alabama","Dale County",3,68,572,280,292
050,01,045,"Alabama","Dale County",3,69,512,247,265
050,01,045,"Alabama","Dale County",3,70,481,237,244
050,01,045,"Alabama","Dale County",3,71,474,231,243
050,01,045,"Alabama","Dale County",3,72,483,226,257
050,01,045,"Alabama","Dale County",3,73,450,202,248
050,01,045,"Alabama","Dale County",3,74,460,208,252
050,01,045,"Alabama","Dale County",3,75,346,149,197
050,01,045,"Alabama","Dale County",3,76,348,148,200
050,01,045,"Alabama","Dale County",3,77,338,147,191
050,01,045,"Alabama","Dale County",3,78,322,144,178
050,01,045,"Alabama","Dale County",3,79,286,124,162
050,01,045,"Alabama","Dale County",3,80,255,112,143
050,01,045,"Alabama","Dale County",3,81,228,98,130
050,01,045,"Alabama","Dale County",3,82,221,86,135
050,01,045,"Alabama","Dale County",3,83,177,63,114
050,01,045,"Alabama","Dale County",3,84,162,65,97
050,01,045,"Alabama","Dale County",3,85,855,313,542
050,01,045,"Alabama","Dale County",4,0,687,347,340
050,01,045,"Alabama","Dale County",4,1,698,345,353
050,01,045,"Alabama","Dale County",4,2,680,325,355
050,01,045,"Alabama","Dale County",4,3,618,292,326
050,01,045,"Alabama","Dale County",4,4,663,331,332
050,01,045,"Alabama","Dale County",4,5,678,346,332
050,01,045,"Alabama","Dale County",4,6,635,320,315
050,01,045,"Alabama","Dale County",4,7,636,321,315
050,01,045,"Alabama","Dale County",4,8,642,330,312
050,01,045,"Alabama","Dale County",4,9,642,330,312
050,01,045,"Alabama","Dale County",4,10,648,326,322
050,01,045,"Alabama","Dale County",4,11,600,313,287
050,01,045,"Alabama","Dale County",4,12,632,333,299
050,01,045,"Alabama","Dale County",4,13,636,314,322
050,01,045,"Alabama","Dale County",4,14,647,335,312
050,01,045,"Alabama","Dale County",4,15,615,312,303
050,01,045,"Alabama","Dale County",4,16,626,304,322
050,01,045,"Alabama","Dale County",4,17,612,322,290
050,01,045,"Alabama","Dale County",4,18,535,296,239
050,01,045,"Alabama","Dale County",4,19,466,261,205
050,01,045,"Alabama","Dale County",4,20,494,260,234
050,01,045,"Alabama","Dale County",4,21,545,290,255
050,01,045,"Alabama","Dale County",4,22,600,293,307
050,01,045,"Alabama","Dale County",4,23,651,356,295
050,01,045,"Alabama","Dale County",4,24,703,375,328
050,01,045,"Alabama","Dale County",4,25,675,341,334
050,01,045,"Alabama","Dale County",4,26,687,378,309
050,01,045,"Alabama","Dale County",4,27,716,368,348
050,01,045,"Alabama","Dale County",4,28,747,392,355
050,01,045,"Alabama","Dale County",4,29,751,405,346
050,01,045,"Alabama","Dale County",4,30,772,398,374
050,01,045,"Alabama","Dale County",4,31,738,347,391
050,01,045,"Alabama","Dale County",4,32,712,350,362
050,01,045,"Alabama","Dale County",4,33,716,369,347
050,01,045,"Alabama","Dale County",4,34,696,360,336
050,01,045,"Alabama","Dale County",4,35,658,330,328
050,01,045,"Alabama","Dale County",4,36,607,284,323
050,01,045,"Alabama","Dale County",4,37,617,292,325
050,01,045,"Alabama","Dale County",4,38,572,271,301
050,01,045,"Alabama","Dale County",4,39,562,263,299
050,01,045,"Alabama","Dale County",4,40,598,292,306
050,01,045,"Alabama","Dale County",4,41,586,290,296
050,01,045,"Alabama","Dale County",4,42,571,286,285
050,01,045,"Alabama","Dale County",4,43,575,258,317
050,01,045,"Alabama","Dale County",4,44,526,232,294
050,01,045,"Alabama","Dale County",4,45,525,262,263
050,01,045,"Alabama","Dale County",4,46,507,241,266
050,01,045,"Alabama","Dale County",4,47,545,258,287
050,01,045,"Alabama","Dale County",4,48,563,261,302
050,01,045,"Alabama","Dale County",4,49,554,266,288
050,01,045,"Alabama","Dale County",4,50,585,281,304
050,01,045,"Alabama","Dale County",4,51,612,304,308
050,01,045,"Alabama","Dale County",4,52,566,285,281
050,01,045,"Alabama","Dale County",4,53,543,253,290
050,01,045,"Alabama","Dale County",4,54,556,277,279
050,01,045,"Alabama","Dale County",4,55,583,280,303
050,01,045,"Alabama","Dale County",4,56,576,281,295
050,01,045,"Alabama","Dale County",4,57,602,292,310
050,01,045,"Alabama","Dale County",4,58,644,318,326
050,01,045,"Alabama","Dale County",4,59,635,308,327
050,01,045,"Alabama","Dale County",4,60,626,292,334
050,01,045,"Alabama","Dale County",4,61,622,299,323
050,01,045,"Alabama","Dale County",4,62,672,325,347
050,01,045,"Alabama","Dale County",4,63,662,318,344
050,01,045,"Alabama","Dale County",4,64,639,327,312
050,01,045,"Alabama","Dale County",4,65,646,308,338
050,01,045,"Alabama","Dale County",4,66,594,292,302
050,01,045,"Alabama","Dale County",4,67,594,284,310
050,01,045,"Alabama","Dale County",4,68,596,276,320
050,01,045,"Alabama","Dale County",4,69,559,268,291
050,01,045,"Alabama","Dale County",4,70,505,243,262
050,01,045,"Alabama","Dale County",4,71,461,226,235
050,01,045,"Alabama","Dale County",4,72,464,222,242
050,01,045,"Alabama","Dale County",4,73,454,214,240
050,01,045,"Alabama","Dale County",4,74,424,190,234
050,01,045,"Alabama","Dale County",4,75,433,194,239
050,01,045,"Alabama","Dale County",4,76,330,143,187
050,01,045,"Alabama","Dale County",4,77,341,143,198
050,01,045,"Alabama","Dale County",4,78,323,138,185
050,01,045,"Alabama","Dale County",4,79,307,142,165
050,01,045,"Alabama","Dale County",4,80,277,121,156
050,01,045,"Alabama","Dale County",4,81,239,108,131
050,01,045,"Alabama","Dale County",4,82,213,88,125
050,01,045,"Alabama","Dale County",4,83,195,76,119
050,01,045,"Alabama","Dale County",4,84,169,61,108
050,01,045,"Alabama","Dale County",4,85,883,328,555
050,01,045,"Alabama","Dale County",5,0,697,350,347
050,01,045,"Alabama","Dale County",5,1,715,398,317
050,01,045,"Alabama","Dale County",5,2,696,355,341
050,01,045,"Alabama","Dale County",5,3,694,345,349
050,01,045,"Alabama","Dale County",5,4,618,303,315
050,01,045,"Alabama","Dale County",5,5,689,335,354
050,01,045,"Alabama","Dale County",5,6,679,340,339
050,01,045,"Alabama","Dale County",5,7,643,316,327
050,01,045,"Alabama","Dale County",5,8,625,303,322
050,01,045,"Alabama","Dale County",5,9,640,331,309
050,01,045,"Alabama","Dale County",5,10,628,327,301
050,01,045,"Alabama","Dale County",5,11,625,306,319
050,01,045,"Alabama","Dale County",5,12,594,312,282
050,01,045,"Alabama","Dale County",5,13,636,334,302
050,01,045,"Alabama","Dale County",5,14,640,330,310
050,01,045,"Alabama","Dale County",5,15,643,318,325
050,01,045,"Alabama","Dale County",5,16,585,301,284
050,01,045,"Alabama","Dale County",5,17,597,300,297
050,01,045,"Alabama","Dale County",5,18,549,299,250
050,01,045,"Alabama","Dale County",5,19,455,254,201
050,01,045,"Alabama","Dale County",5,20,532,295,237
050,01,045,"Alabama","Dale County",5,21,524,264,260
050,01,045,"Alabama","Dale County",5,22,610,322,288
050,01,045,"Alabama","Dale County",5,23,736,368,368
050,01,045,"Alabama","Dale County",5,24,676,359,317
050,01,045,"Alabama","Dale County",5,25,689,368,321
050,01,045,"Alabama","Dale County",5,26,690,354,336
050,01,045,"Alabama","Dale County",5,27,715,391,324
050,01,045,"Alabama","Dale County",5,28,733,368,365
050,01,045,"Alabama","Dale County",5,29,762,387,375
050,01,045,"Alabama","Dale County",5,30,770,392,378
050,01,045,"Alabama","Dale County",5,31,758,386,372
050,01,045,"Alabama","Dale County",5,32,727,351,376
050,01,045,"Alabama","Dale County",5,33,698,331,367
050,01,045,"Alabama","Dale County",5,34,685,350,335
050,01,045,"Alabama","Dale County",5,35,661,346,315
050,01,045,"Alabama","Dale County",5,36,621,305,316
050,01,045,"Alabama","Dale County",5,37,610,294,316
050,01,045,"Alabama","Dale County",5,38,622,288,334
050,01,045,"Alabama","Dale County",5,39,589,287,302
050,01,045,"Alabama","Dale County",5,40,564,265,299
050,01,045,"Alabama","Dale County",5,41,580,278,302
050,01,045,"Alabama","Dale County",5,42,567,274,293
050,01,045,"Alabama","Dale County",5,43,577,282,295
050,01,045,"Alabama","Dale County",5,44,574,263,311
050,01,045,"Alabama","Dale County",5,45,553,247,306
050,01,045,"Alabama","Dale County",5,46,495,249,246
050,01,045,"Alabama","Dale County",5,47,510,244,266
050,01,045,"Alabama","Dale County",5,48,547,257,290
050,01,045,"Alabama","Dale County",5,49,573,264,309
050,01,045,"Alabama","Dale County",5,50,553,264,289
050,01,045,"Alabama","Dale County",5,51,585,285,300
050,01,045,"Alabama","Dale County",5,52,607,304,303
050,01,045,"Alabama","Dale County",5,53,561,275,286
050,01,045,"Alabama","Dale County",5,54,547,254,293
050,01,045,"Alabama","Dale County",5,55,557,272,285
050,01,045,"Alabama","Dale County",5,56,588,282,306
050,01,045,"Alabama","Dale County",5,57,574,275,299
050,01,045,"Alabama","Dale County",5,58,601,295,306
050,01,045,"Alabama","Dale County",5,59,648,314,334
050,01,045,"Alabama","Dale County",5,60,644,317,327
050,01,045,"Alabama","Dale County",5,61,627,287,340
050,01,045,"Alabama","Dale County",5,62,619,303,316
050,01,045,"Alabama","Dale County",5,63,664,315,349
050,01,045,"Alabama","Dale County",5,64,644,312,332
050,01,045,"Alabama","Dale County",5,65,625,322,303
050,01,045,"Alabama","Dale County",5,66,643,306,337
050,01,045,"Alabama","Dale County",5,67,588,284,304
050,01,045,"Alabama","Dale County",5,68,592,278,314
050,01,045,"Alabama","Dale County",5,69,585,267,318
050,01,045,"Alabama","Dale County",5,70,545,267,278
050,01,045,"Alabama","Dale County",5,71,489,233,256
050,01,045,"Alabama","Dale County",5,72,465,222,243
050,01,045,"Alabama","Dale County",5,73,445,214,231
050,01,045,"Alabama","Dale County",5,74,439,207,232
050,01,045,"Alabama","Dale County",5,75,405,184,221
050,01,045,"Alabama","Dale County",5,76,415,187,228
050,01,045,"Alabama","Dale County",5,77,320,141,179
050,01,045,"Alabama","Dale County",5,78,326,136,190
050,01,045,"Alabama","Dale County",5,79,302,131,171
050,01,045,"Alabama","Dale County",5,80,291,135,156
050,01,045,"Alabama","Dale County",5,81,268,119,149
050,01,045,"Alabama","Dale County",5,82,226,101,125
050,01,045,"Alabama","Dale County",5,83,186,78,108
050,01,045,"Alabama","Dale County",5,84,181,70,111
050,01,045,"Alabama","Dale County",5,85,920,342,578
050,01,047,"Alabama","Dallas County",1,0,428,219,209
050,01,047,"Alabama","Dallas County",1,1,432,235,197
050,01,047,"Alabama","Dallas County",1,2,439,243,196
050,01,047,"Alabama","Dallas County",1,3,492,250,242
050,01,047,"Alabama","Dallas County",1,4,466,222,244
050,01,047,"Alabama","Dallas County",1,5,468,224,244
050,01,047,"Alabama","Dallas County",1,6,478,225,253
050,01,047,"Alabama","Dallas County",1,7,478,251,227
050,01,047,"Alabama","Dallas County",1,8,497,251,246
050,01,047,"Alabama","Dallas County",1,9,474,227,247
050,01,047,"Alabama","Dallas County",1,10,523,270,253
050,01,047,"Alabama","Dallas County",1,11,572,302,270
050,01,047,"Alabama","Dallas County",1,12,616,325,291
050,01,047,"Alabama","Dallas County",1,13,586,287,299
050,01,047,"Alabama","Dallas County",1,14,581,295,286
050,01,047,"Alabama","Dallas County",1,15,556,320,236
050,01,047,"Alabama","Dallas County",1,16,571,318,253
050,01,047,"Alabama","Dallas County",1,17,535,287,248
050,01,047,"Alabama","Dallas County",1,18,474,254,220
050,01,047,"Alabama","Dallas County",1,19,451,229,222
050,01,047,"Alabama","Dallas County",1,20,448,212,236
050,01,047,"Alabama","Dallas County",1,21,428,218,210
050,01,047,"Alabama","Dallas County",1,22,457,228,229
050,01,047,"Alabama","Dallas County",1,23,452,215,237
050,01,047,"Alabama","Dallas County",1,24,417,198,219
050,01,047,"Alabama","Dallas County",1,25,397,172,225
050,01,047,"Alabama","Dallas County",1,26,429,186,243
050,01,047,"Alabama","Dallas County",1,27,450,214,236
050,01,047,"Alabama","Dallas County",1,28,473,213,260
050,01,047,"Alabama","Dallas County",1,29,466,198,268
050,01,047,"Alabama","Dallas County",1,30,448,194,254
050,01,047,"Alabama","Dallas County",1,31,422,190,232
050,01,047,"Alabama","Dallas County",1,32,422,195,227
050,01,047,"Alabama","Dallas County",1,33,409,194,215
050,01,047,"Alabama","Dallas County",1,34,431,209,222
050,01,047,"Alabama","Dallas County",1,35,418,186,232
050,01,047,"Alabama","Dallas County",1,36,430,192,238
050,01,047,"Alabama","Dallas County",1,37,440,189,251
050,01,047,"Alabama","Dallas County",1,38,417,178,239
050,01,047,"Alabama","Dallas County",1,39,447,204,243
050,01,047,"Alabama","Dallas County",1,40,425,183,242
050,01,047,"Alabama","Dallas County",1,41,451,213,238
050,01,047,"Alabama","Dallas County",1,42,428,192,236
050,01,047,"Alabama","Dallas County",1,43,396,171,225
050,01,047,"Alabama","Dallas County",1,44,395,164,231
050,01,047,"Alabama","Dallas County",1,45,409,166,243
050,01,047,"Alabama","Dallas County",1,46,428,173,255
050,01,047,"Alabama","Dallas County",1,47,438,176,262
050,01,047,"Alabama","Dallas County",1,48,447,209,238
050,01,047,"Alabama","Dallas County",1,49,435,204,231
050,01,047,"Alabama","Dallas County",1,50,448,210,238
050,01,047,"Alabama","Dallas County",1,51,421,186,235
050,01,047,"Alabama","Dallas County",1,52,446,192,254
050,01,047,"Alabama","Dallas County",1,53,461,218,243
050,01,047,"Alabama","Dallas County",1,54,497,231,266
050,01,047,"Alabama","Dallas County",1,55,549,255,294
050,01,047,"Alabama","Dallas County",1,56,555,268,287
050,01,047,"Alabama","Dallas County",1,57,559,232,327
050,01,047,"Alabama","Dallas County",1,58,583,250,333
050,01,047,"Alabama","Dallas County",1,59,603,274,329
050,01,047,"Alabama","Dallas County",1,60,610,286,324
050,01,047,"Alabama","Dallas County",1,61,586,269,317
050,01,047,"Alabama","Dallas County",1,62,576,262,314
050,01,047,"Alabama","Dallas County",1,63,574,258,316
050,01,047,"Alabama","Dallas County",1,64,581,271,310
050,01,047,"Alabama","Dallas County",1,65,553,262,291
050,01,047,"Alabama","Dallas County",1,66,517,237,280
050,01,047,"Alabama","Dallas County",1,67,504,220,284
050,01,047,"Alabama","Dallas County",1,68,464,207,257
050,01,047,"Alabama","Dallas County",1,69,427,198,229
050,01,047,"Alabama","Dallas County",1,70,440,218,222
050,01,047,"Alabama","Dallas County",1,71,429,209,220
050,01,047,"Alabama","Dallas County",1,72,413,184,229
050,01,047,"Alabama","Dallas County",1,73,429,188,241
050,01,047,"Alabama","Dallas County",1,74,322,140,182
050,01,047,"Alabama","Dallas County",1,75,306,135,171
050,01,047,"Alabama","Dallas County",1,76,292,125,167
050,01,047,"Alabama","Dallas County",1,77,262,117,145
050,01,047,"Alabama","Dallas County",1,78,225,97,128
050,01,047,"Alabama","Dallas County",1,79,199,82,117
050,01,047,"Alabama","Dallas County",1,80,205,84,121
050,01,047,"Alabama","Dallas County",1,81,202,76,126
050,01,047,"Alabama","Dallas County",1,82,161,51,110
050,01,047,"Alabama","Dallas County",1,83,156,59,97
050,01,047,"Alabama","Dallas County",1,84,125,47,78
050,01,047,"Alabama","Dallas County",1,85,708,207,501
050,01,047,"Alabama","Dallas County",2,0,420,223,197
050,01,047,"Alabama","Dallas County",2,1,428,229,199
050,01,047,"Alabama","Dallas County",2,2,438,241,197
050,01,047,"Alabama","Dallas County",2,3,477,246,231
050,01,047,"Alabama","Dallas County",2,4,470,227,243
050,01,047,"Alabama","Dallas County",2,5,466,221,245
050,01,047,"Alabama","Dallas County",2,6,475,225,250
050,01,047,"Alabama","Dallas County",2,7,477,245,232
050,01,047,"Alabama","Dallas County",2,8,489,250,239
050,01,047,"Alabama","Dallas County",2,9,479,234,245
050,01,047,"Alabama","Dallas County",2,10,506,258,248
050,01,047,"Alabama","Dallas County",2,11,552,292,260
050,01,047,"Alabama","Dallas County",2,12,603,320,283
050,01,047,"Alabama","Dallas County",2,13,587,294,293
050,01,047,"Alabama","Dallas County",2,14,583,296,287
050,01,047,"Alabama","Dallas County",2,15,563,315,248
050,01,047,"Alabama","Dallas County",2,16,565,318,247
050,01,047,"Alabama","Dallas County",2,17,535,290,245
050,01,047,"Alabama","Dallas County",2,18,466,250,216
050,01,047,"Alabama","Dallas County",2,19,434,220,214
050,01,047,"Alabama","Dallas County",2,20,452,218,234
050,01,047,"Alabama","Dallas County",2,21,429,215,214
050,01,047,"Alabama","Dallas County",2,22,446,223,223
050,01,047,"Alabama","Dallas County",2,23,449,218,231
050,01,047,"Alabama","Dallas County",2,24,416,197,219
050,01,047,"Alabama","Dallas County",2,25,395,174,221
050,01,047,"Alabama","Dallas County",2,26,418,180,238
050,01,047,"Alabama","Dallas County",2,27,440,203,237
050,01,047,"Alabama","Dallas County",2,28,464,212,252
050,01,047,"Alabama","Dallas County",2,29,464,198,266
050,01,047,"Alabama","Dallas County",2,30,449,192,257
050,01,047,"Alabama","Dallas County",2,31,424,190,234
050,01,047,"Alabama","Dallas County",2,32,417,192,225
050,01,047,"Alabama","Dallas County",2,33,408,193,215
050,01,047,"Alabama","Dallas County",2,34,422,203,219
050,01,047,"Alabama","Dallas County",2,35,422,191,231
050,01,047,"Alabama","Dallas County",2,36,420,186,234
050,01,047,"Alabama","Dallas County",2,37,434,187,247
050,01,047,"Alabama","Dallas County",2,38,420,179,241
050,01,047,"Alabama","Dallas County",2,39,432,195,237
050,01,047,"Alabama","Dallas County",2,40,434,191,243
050,01,047,"Alabama","Dallas County",2,41,440,203,237
050,01,047,"Alabama","Dallas County",2,42,428,196,232
050,01,047,"Alabama","Dallas County",2,43,407,177,230
050,01,047,"Alabama","Dallas County",2,44,387,163,224
050,01,047,"Alabama","Dallas County",2,45,405,167,238
050,01,047,"Alabama","Dallas County",2,46,421,171,250
050,01,047,"Alabama","Dallas County",2,47,430,174,256
050,01,047,"Alabama","Dallas County",2,48,443,201,242
050,01,047,"Alabama","Dallas County",2,49,436,205,231
050,01,047,"Alabama","Dallas County",2,50,440,207,233
050,01,047,"Alabama","Dallas County",2,51,421,190,231
050,01,047,"Alabama","Dallas County",2,52,437,189,248
050,01,047,"Alabama","Dallas County",2,53,454,210,244
050,01,047,"Alabama","Dallas County",2,54,489,229,260
050,01,047,"Alabama","Dallas County",2,55,535,250,285
050,01,047,"Alabama","Dallas County",2,56,552,267,285
050,01,047,"Alabama","Dallas County",2,57,557,239,318
050,01,047,"Alabama","Dallas County",2,58,574,245,329
050,01,047,"Alabama","Dallas County",2,59,592,264,328
050,01,047,"Alabama","Dallas County",2,60,603,279,324
050,01,047,"Alabama","Dallas County",2,61,587,270,317
050,01,047,"Alabama","Dallas County",2,62,568,259,309
050,01,047,"Alabama","Dallas County",2,63,572,258,314
050,01,047,"Alabama","Dallas County",2,64,566,263,303
050,01,047,"Alabama","Dallas County",2,65,556,263,293
050,01,047,"Alabama","Dallas County",2,66,525,241,284
050,01,047,"Alabama","Dallas County",2,67,500,218,282
050,01,047,"Alabama","Dallas County",2,68,464,207,257
050,01,047,"Alabama","Dallas County",2,69,433,198,235
050,01,047,"Alabama","Dallas County",2,70,433,210,223
050,01,047,"Alabama","Dallas County",2,71,428,209,219
050,01,047,"Alabama","Dallas County",2,72,407,187,220
050,01,047,"Alabama","Dallas County",2,73,436,191,245
050,01,047,"Alabama","Dallas County",2,74,326,141,185
050,01,047,"Alabama","Dallas County",2,75,305,132,173
050,01,047,"Alabama","Dallas County",2,76,291,125,166
050,01,047,"Alabama","Dallas County",2,77,269,119,150
050,01,047,"Alabama","Dallas County",2,78,226,99,127
050,01,047,"Alabama","Dallas County",2,79,199,83,116
050,01,047,"Alabama","Dallas County",2,80,207,84,123
050,01,047,"Alabama","Dallas County",2,81,195,74,121
050,01,047,"Alabama","Dallas County",2,82,170,56,114
050,01,047,"Alabama","Dallas County",2,83,158,60,98
050,01,047,"Alabama","Dallas County",2,84,122,44,78
050,01,047,"Alabama","Dallas County",2,85,709,207,502
050,01,047,"Alabama","Dallas County",3,0,440,229,211
050,01,047,"Alabama","Dallas County",3,1,404,211,193
050,01,047,"Alabama","Dallas County",3,2,419,230,189
050,01,047,"Alabama","Dallas County",3,3,443,245,198
050,01,047,"Alabama","Dallas County",3,4,476,246,230
050,01,047,"Alabama","Dallas County",3,5,466,230,236
050,01,047,"Alabama","Dallas County",3,6,458,215,243
050,01,047,"Alabama","Dallas County",3,7,456,216,240
050,01,047,"Alabama","Dallas County",3,8,470,244,226
050,01,047,"Alabama","Dallas County",3,9,491,253,238
050,01,047,"Alabama","Dallas County",3,10,468,229,239
050,01,047,"Alabama","Dallas County",3,11,501,254,247
050,01,047,"Alabama","Dallas County",3,12,555,299,256
050,01,047,"Alabama","Dallas County",3,13,588,312,276
050,01,047,"Alabama","Dallas County",3,14,595,299,296
050,01,047,"Alabama","Dallas County",3,15,571,296,275
050,01,047,"Alabama","Dallas County",3,16,546,297,249
050,01,047,"Alabama","Dallas County",3,17,537,298,239
050,01,047,"Alabama","Dallas County",3,18,459,244,215
050,01,047,"Alabama","Dallas County",3,19,402,209,193
050,01,047,"Alabama","Dallas County",3,20,449,226,223
050,01,047,"Alabama","Dallas County",3,21,465,218,247
050,01,047,"Alabama","Dallas County",3,22,427,211,216
050,01,047,"Alabama","Dallas County",3,23,440,233,207
050,01,047,"Alabama","Dallas County",3,24,428,205,223
050,01,047,"Alabama","Dallas County",3,25,396,179,217
050,01,047,"Alabama","Dallas County",3,26,367,163,204
050,01,047,"Alabama","Dallas County",3,27,436,189,247
050,01,047,"Alabama","Dallas County",3,28,426,200,226
050,01,047,"Alabama","Dallas County",3,29,449,202,247
050,01,047,"Alabama","Dallas County",3,30,432,181,251
050,01,047,"Alabama","Dallas County",3,31,441,186,255
050,01,047,"Alabama","Dallas County",3,32,423,186,237
050,01,047,"Alabama","Dallas County",3,33,423,191,232
050,01,047,"Alabama","Dallas County",3,34,415,198,217
050,01,047,"Alabama","Dallas County",3,35,440,214,226
050,01,047,"Alabama","Dallas County",3,36,418,188,230
050,01,047,"Alabama","Dallas County",3,37,405,183,222
050,01,047,"Alabama","Dallas County",3,38,427,186,241
050,01,047,"Alabama","Dallas County",3,39,406,174,232
050,01,047,"Alabama","Dallas County",3,40,435,203,232
050,01,047,"Alabama","Dallas County",3,41,430,184,246
050,01,047,"Alabama","Dallas County",3,42,434,205,229
050,01,047,"Alabama","Dallas County",3,43,424,193,231
050,01,047,"Alabama","Dallas County",3,44,403,177,226
050,01,047,"Alabama","Dallas County",3,45,370,155,215
050,01,047,"Alabama","Dallas County",3,46,408,168,240
050,01,047,"Alabama","Dallas County",3,47,412,163,249
050,01,047,"Alabama","Dallas County",3,48,429,175,254
050,01,047,"Alabama","Dallas County",3,49,436,196,240
050,01,047,"Alabama","Dallas County",3,50,439,201,238
050,01,047,"Alabama","Dallas County",3,51,438,214,224
050,01,047,"Alabama","Dallas County",3,52,413,182,231
050,01,047,"Alabama","Dallas County",3,53,429,185,244
050,01,047,"Alabama","Dallas County",3,54,450,209,241
050,01,047,"Alabama","Dallas County",3,55,472,222,250
050,01,047,"Alabama","Dallas County",3,56,524,249,275
050,01,047,"Alabama","Dallas County",3,57,543,254,289
050,01,047,"Alabama","Dallas County",3,58,538,234,304
050,01,047,"Alabama","Dallas County",3,59,569,232,337
050,01,047,"Alabama","Dallas County",3,60,598,267,331
050,01,047,"Alabama","Dallas County",3,61,579,262,317
050,01,047,"Alabama","Dallas County",3,62,561,253,308
050,01,047,"Alabama","Dallas County",3,63,557,252,305
050,01,047,"Alabama","Dallas County",3,64,556,245,311
050,01,047,"Alabama","Dallas County",3,65,546,255,291
050,01,047,"Alabama","Dallas County",3,66,536,253,283
050,01,047,"Alabama","Dallas County",3,67,508,228,280
050,01,047,"Alabama","Dallas County",3,68,484,210,274
050,01,047,"Alabama","Dallas County",3,69,454,206,248
050,01,047,"Alabama","Dallas County",3,70,423,192,231
050,01,047,"Alabama","Dallas County",3,71,414,200,214
050,01,047,"Alabama","Dallas County",3,72,406,199,207
050,01,047,"Alabama","Dallas County",3,73,383,176,207
050,01,047,"Alabama","Dallas County",3,74,413,177,236
050,01,047,"Alabama","Dallas County",3,75,294,126,168
050,01,047,"Alabama","Dallas County",3,76,294,125,169
050,01,047,"Alabama","Dallas County",3,77,268,121,147
050,01,047,"Alabama","Dallas County",3,78,250,109,141
050,01,047,"Alabama","Dallas County",3,79,200,86,114
050,01,047,"Alabama","Dallas County",3,80,196,77,119
050,01,047,"Alabama","Dallas County",3,81,192,82,110
050,01,047,"Alabama","Dallas County",3,82,176,65,111
050,01,047,"Alabama","Dallas County",3,83,164,60,104
050,01,047,"Alabama","Dallas County",3,84,115,42,73
050,01,047,"Alabama","Dallas County",3,85,694,214,480
050,01,047,"Alabama","Dallas County",4,0,433,222,211
050,01,047,"Alabama","Dallas County",4,1,469,243,226
050,01,047,"Alabama","Dallas County",4,2,391,196,195
050,01,047,"Alabama","Dallas County",4,3,419,232,187
050,01,047,"Alabama","Dallas County",4,4,442,251,191
050,01,047,"Alabama","Dallas County",4,5,463,243,220
050,01,047,"Alabama","Dallas County",4,6,457,233,224
050,01,047,"Alabama","Dallas County",4,7,436,206,230
050,01,047,"Alabama","Dallas County",4,8,454,223,231
050,01,047,"Alabama","Dallas County",4,9,451,228,223
050,01,047,"Alabama","Dallas County",4,10,472,241,231
050,01,047,"Alabama","Dallas County",4,11,444,218,226
050,01,047,"Alabama","Dallas County",4,12,488,248,240
050,01,047,"Alabama","Dallas County",4,13,533,288,245
050,01,047,"Alabama","Dallas County",4,14,588,314,274
050,01,047,"Alabama","Dallas County",4,15,594,309,285
050,01,047,"Alabama","Dallas County",4,16,556,284,272
050,01,047,"Alabama","Dallas County",4,17,528,281,247
050,01,047,"Alabama","Dallas County",4,18,461,257,204
050,01,047,"Alabama","Dallas County",4,19,377,191,186
050,01,047,"Alabama","Dallas County",4,20,406,206,200
050,01,047,"Alabama","Dallas County",4,21,450,215,235
050,01,047,"Alabama","Dallas County",4,22,462,220,242
050,01,047,"Alabama","Dallas County",4,23,425,220,205
050,01,047,"Alabama","Dallas County",4,24,436,234,202
050,01,047,"Alabama","Dallas County",4,25,398,187,211
050,01,047,"Alabama","Dallas County",4,26,373,165,208
050,01,047,"Alabama","Dallas County",4,27,360,152,208
050,01,047,"Alabama","Dallas County",4,28,412,170,242
050,01,047,"Alabama","Dallas County",4,29,429,205,224
050,01,047,"Alabama","Dallas County",4,30,440,203,237
050,01,047,"Alabama","Dallas County",4,31,425,181,244
050,01,047,"Alabama","Dallas County",4,32,420,171,249
050,01,047,"Alabama","Dallas County",4,33,412,180,232
050,01,047,"Alabama","Dallas County",4,34,411,189,222
050,01,047,"Alabama","Dallas County",4,35,399,189,210
050,01,047,"Alabama","Dallas County",4,36,422,207,215
050,01,047,"Alabama","Dallas County",4,37,399,171,228
050,01,047,"Alabama","Dallas County",4,38,399,180,219
050,01,047,"Alabama","Dallas County",4,39,411,180,231
050,01,047,"Alabama","Dallas County",4,40,395,171,224
050,01,047,"Alabama","Dallas County",4,41,420,200,220
050,01,047,"Alabama","Dallas County",4,42,423,180,243
050,01,047,"Alabama","Dallas County",4,43,432,201,231
050,01,047,"Alabama","Dallas County",4,44,422,195,227
050,01,047,"Alabama","Dallas County",4,45,394,168,226
050,01,047,"Alabama","Dallas County",4,46,365,154,211
050,01,047,"Alabama","Dallas County",4,47,414,167,247
050,01,047,"Alabama","Dallas County",4,48,406,156,250
050,01,047,"Alabama","Dallas County",4,49,420,174,246
050,01,047,"Alabama","Dallas County",4,50,423,181,242
050,01,047,"Alabama","Dallas County",4,51,419,196,223
050,01,047,"Alabama","Dallas County",4,52,428,208,220
050,01,047,"Alabama","Dallas County",4,53,403,177,226
050,01,047,"Alabama","Dallas County",4,54,419,181,238
050,01,047,"Alabama","Dallas County",4,55,434,205,229
050,01,047,"Alabama","Dallas County",4,56,464,216,248
050,01,047,"Alabama","Dallas County",4,57,511,237,274
050,01,047,"Alabama","Dallas County",4,58,525,250,275
050,01,047,"Alabama","Dallas County",4,59,531,226,305
050,01,047,"Alabama","Dallas County",4,60,569,234,335
050,01,047,"Alabama","Dallas County",4,61,580,257,323
050,01,047,"Alabama","Dallas County",4,62,570,256,314
050,01,047,"Alabama","Dallas County",4,63,553,253,300
050,01,047,"Alabama","Dallas County",4,64,544,247,297
050,01,047,"Alabama","Dallas County",4,65,542,239,303
050,01,047,"Alabama","Dallas County",4,66,526,248,278
050,01,047,"Alabama","Dallas County",4,67,516,241,275
050,01,047,"Alabama","Dallas County",4,68,492,222,270
050,01,047,"Alabama","Dallas County",4,69,470,203,267
050,01,047,"Alabama","Dallas County",4,70,443,197,246
050,01,047,"Alabama","Dallas County",4,71,412,190,222
050,01,047,"Alabama","Dallas County",4,72,401,193,208
050,01,047,"Alabama","Dallas County",4,73,384,185,199
050,01,047,"Alabama","Dallas County",4,74,374,171,203
050,01,047,"Alabama","Dallas County",4,75,381,164,217
050,01,047,"Alabama","Dallas County",4,76,280,117,163
050,01,047,"Alabama","Dallas County",4,77,260,116,144
050,01,047,"Alabama","Dallas County",4,78,261,116,145
050,01,047,"Alabama","Dallas County",4,79,231,99,132
050,01,047,"Alabama","Dallas County",4,80,197,79,118
050,01,047,"Alabama","Dallas County",4,81,185,75,110
050,01,047,"Alabama","Dallas County",4,82,175,74,101
050,01,047,"Alabama","Dallas County",4,83,167,69,98
050,01,047,"Alabama","Dallas County",4,84,122,41,81
050,01,047,"Alabama","Dallas County",4,85,701,225,476
050,01,047,"Alabama","Dallas County",5,0,431,224,207
050,01,047,"Alabama","Dallas County",5,1,435,216,219
050,01,047,"Alabama","Dallas County",5,2,453,235,218
050,01,047,"Alabama","Dallas County",5,3,392,202,190
050,01,047,"Alabama","Dallas County",5,4,423,235,188
050,01,047,"Alabama","Dallas County",5,5,419,238,181
050,01,047,"Alabama","Dallas County",5,6,451,246,205
050,01,047,"Alabama","Dallas County",5,7,453,228,225
050,01,047,"Alabama","Dallas County",5,8,429,204,225
050,01,047,"Alabama","Dallas County",5,9,454,221,233
050,01,047,"Alabama","Dallas County",5,10,454,230,224
050,01,047,"Alabama","Dallas County",5,11,475,243,232
050,01,047,"Alabama","Dallas County",5,12,451,221,230
050,01,047,"Alabama","Dallas County",5,13,481,247,234
050,01,047,"Alabama","Dallas County",5,14,535,291,244
050,01,047,"Alabama","Dallas County",5,15,577,314,263
050,01,047,"Alabama","Dallas County",5,16,578,297,281
050,01,047,"Alabama","Dallas County",5,17,538,272,266
050,01,047,"Alabama","Dallas County",5,18,453,250,203
050,01,047,"Alabama","Dallas County",5,19,373,205,168
050,01,047,"Alabama","Dallas County",5,20,391,194,197
050,01,047,"Alabama","Dallas County",5,21,416,206,210
050,01,047,"Alabama","Dallas County",5,22,451,223,228
050,01,047,"Alabama","Dallas County",5,23,457,214,243
050,01,047,"Alabama","Dallas County",5,24,418,214,204
050,01,047,"Alabama","Dallas County",5,25,417,220,197
050,01,047,"Alabama","Dallas County",5,26,390,184,206
050,01,047,"Alabama","Dallas County",5,27,373,163,210
050,01,047,"Alabama","Dallas County",5,28,329,136,193
050,01,047,"Alabama","Dallas County",5,29,406,160,246
050,01,047,"Alabama","Dallas County",5,30,413,193,220
050,01,047,"Alabama","Dallas County",5,31,424,191,233
050,01,047,"Alabama","Dallas County",5,32,422,176,246
050,01,047,"Alabama","Dallas County",5,33,410,172,238
050,01,047,"Alabama","Dallas County",5,34,413,188,225
050,01,047,"Alabama","Dallas County",5,35,406,184,222
050,01,047,"Alabama","Dallas County",5,36,388,183,205
050,01,047,"Alabama","Dallas County",5,37,407,195,212
050,01,047,"Alabama","Dallas County",5,38,398,171,227
050,01,047,"Alabama","Dallas County",5,39,405,192,213
050,01,047,"Alabama","Dallas County",5,40,407,173,234
050,01,047,"Alabama","Dallas County",5,41,390,171,219
050,01,047,"Alabama","Dallas County",5,42,426,199,227
050,01,047,"Alabama","Dallas County",5,43,428,185,243
050,01,047,"Alabama","Dallas County",5,44,420,191,229
050,01,047,"Alabama","Dallas County",5,45,407,188,219
050,01,047,"Alabama","Dallas County",5,46,381,163,218
050,01,047,"Alabama","Dallas County",5,47,361,153,208
050,01,047,"Alabama","Dallas County",5,48,406,168,238
050,01,047,"Alabama","Dallas County",5,49,402,151,251
050,01,047,"Alabama","Dallas County",5,50,417,169,248
050,01,047,"Alabama","Dallas County",5,51,426,189,237
050,01,047,"Alabama","Dallas County",5,52,407,187,220
050,01,047,"Alabama","Dallas County",5,53,419,202,217
050,01,047,"Alabama","Dallas County",5,54,406,177,229
050,01,047,"Alabama","Dallas County",5,55,410,177,233
050,01,047,"Alabama","Dallas County",5,56,437,211,226
050,01,047,"Alabama","Dallas County",5,57,447,201,246
050,01,047,"Alabama","Dallas County",5,58,490,235,255
050,01,047,"Alabama","Dallas County",5,59,515,242,273
050,01,047,"Alabama","Dallas County",5,60,523,224,299
050,01,047,"Alabama","Dallas County",5,61,561,225,336
050,01,047,"Alabama","Dallas County",5,62,561,246,315
050,01,047,"Alabama","Dallas County",5,63,557,251,306
050,01,047,"Alabama","Dallas County",5,64,536,247,289
050,01,047,"Alabama","Dallas County",5,65,537,243,294
050,01,047,"Alabama","Dallas County",5,66,524,233,291
050,01,047,"Alabama","Dallas County",5,67,505,235,270
050,01,047,"Alabama","Dallas County",5,68,496,229,267
050,01,047,"Alabama","Dallas County",5,69,479,218,261
050,01,047,"Alabama","Dallas County",5,70,460,197,263
050,01,047,"Alabama","Dallas County",5,71,434,193,241
050,01,047,"Alabama","Dallas County",5,72,393,180,213
050,01,047,"Alabama","Dallas County",5,73,385,184,201
050,01,047,"Alabama","Dallas County",5,74,372,179,193
050,01,047,"Alabama","Dallas County",5,75,336,151,185
050,01,047,"Alabama","Dallas County",5,76,371,157,214
050,01,047,"Alabama","Dallas County",5,77,256,110,146
050,01,047,"Alabama","Dallas County",5,78,245,109,136
050,01,047,"Alabama","Dallas County",5,79,237,101,136
050,01,047,"Alabama","Dallas County",5,80,227,93,134
050,01,047,"Alabama","Dallas County",5,81,182,76,106
050,01,047,"Alabama","Dallas County",5,82,168,69,99
050,01,047,"Alabama","Dallas County",5,83,177,82,95
050,01,047,"Alabama","Dallas County",5,84,132,54,78
050,01,047,"Alabama","Dallas County",5,85,720,239,481
050,01,049,"Alabama","DeKalb County",1,0,801,412,389
050,01,049,"Alabama","DeKalb County",1,1,814,420,394
050,01,049,"Alabama","DeKalb County",1,2,853,456,397
050,01,049,"Alabama","DeKalb County",1,3,869,464,405
050,01,049,"Alabama","DeKalb County",1,4,932,482,450
050,01,049,"Alabama","DeKalb County",1,5,901,486,415
050,01,049,"Alabama","DeKalb County",1,6,916,497,419
050,01,049,"Alabama","DeKalb County",1,7,914,453,461
050,01,049,"Alabama","DeKalb County",1,8,932,487,445
050,01,049,"Alabama","DeKalb County",1,9,964,482,482
050,01,049,"Alabama","DeKalb County",1,10,1051,518,533
050,01,049,"Alabama","DeKalb County",1,11,1064,539,525
050,01,049,"Alabama","DeKalb County",1,12,1114,554,560
050,01,049,"Alabama","DeKalb County",1,13,1135,588,547
050,01,049,"Alabama","DeKalb County",1,14,1075,561,514
050,01,049,"Alabama","DeKalb County",1,15,1081,552,529
050,01,049,"Alabama","DeKalb County",1,16,1086,571,515
050,01,049,"Alabama","DeKalb County",1,17,1058,549,509
050,01,049,"Alabama","DeKalb County",1,18,896,476,420
050,01,049,"Alabama","DeKalb County",1,19,786,413,373
050,01,049,"Alabama","DeKalb County",1,20,864,465,399
050,01,049,"Alabama","DeKalb County",1,21,841,448,393
050,01,049,"Alabama","DeKalb County",1,22,803,409,394
050,01,049,"Alabama","DeKalb County",1,23,820,419,401
050,01,049,"Alabama","DeKalb County",1,24,850,447,403
050,01,049,"Alabama","DeKalb County",1,25,858,446,412
050,01,049,"Alabama","DeKalb County",1,26,857,448,409
050,01,049,"Alabama","DeKalb County",1,27,880,465,415
050,01,049,"Alabama","DeKalb County",1,28,898,438,460
050,01,049,"Alabama","DeKalb County",1,29,960,482,478
050,01,049,"Alabama","DeKalb County",1,30,880,447,433
050,01,049,"Alabama","DeKalb County",1,31,815,412,403
050,01,049,"Alabama","DeKalb County",1,32,759,393,366
050,01,049,"Alabama","DeKalb County",1,33,757,386,371
050,01,049,"Alabama","DeKalb County",1,34,789,403,386
050,01,049,"Alabama","DeKalb County",1,35,864,458,406
050,01,049,"Alabama","DeKalb County",1,36,824,401,423
050,01,049,"Alabama","DeKalb County",1,37,769,370,399
050,01,049,"Alabama","DeKalb County",1,38,853,425,428
050,01,049,"Alabama","DeKalb County",1,39,853,437,416
050,01,049,"Alabama","DeKalb County",1,40,899,451,448
050,01,049,"Alabama","DeKalb County",1,41,894,439,455
050,01,049,"Alabama","DeKalb County",1,42,927,451,476
050,01,049,"Alabama","DeKalb County",1,43,951,479,472
050,01,049,"Alabama","DeKalb County",1,44,874,451,423
050,01,049,"Alabama","DeKalb County",1,45,905,468,437
050,01,049,"Alabama","DeKalb County",1,46,890,451,439
050,01,049,"Alabama","DeKalb County",1,47,904,455,449
050,01,049,"Alabama","DeKalb County",1,48,992,507,485
050,01,049,"Alabama","DeKalb County",1,49,1026,530,496
050,01,049,"Alabama","DeKalb County",1,50,1004,512,492
050,01,049,"Alabama","DeKalb County",1,51,916,476,440
050,01,049,"Alabama","DeKalb County",1,52,911,458,453
050,01,049,"Alabama","DeKalb County",1,53,918,472,446
050,01,049,"Alabama","DeKalb County",1,54,922,454,468
050,01,049,"Alabama","DeKalb County",1,55,975,478,497
050,01,049,"Alabama","DeKalb County",1,56,937,467,470
050,01,049,"Alabama","DeKalb County",1,57,920,462,458
050,01,049,"Alabama","DeKalb County",1,58,995,513,482
050,01,049,"Alabama","DeKalb County",1,59,951,482,469
050,01,049,"Alabama","DeKalb County",1,60,944,474,470
050,01,049,"Alabama","DeKalb County",1,61,924,470,454
050,01,049,"Alabama","DeKalb County",1,62,917,463,454
050,01,049,"Alabama","DeKalb County",1,63,898,437,461
050,01,049,"Alabama","DeKalb County",1,64,874,414,460
050,01,049,"Alabama","DeKalb County",1,65,870,432,438
050,01,049,"Alabama","DeKalb County",1,66,806,394,412
050,01,049,"Alabama","DeKalb County",1,67,763,373,390
050,01,049,"Alabama","DeKalb County",1,68,771,379,392
050,01,049,"Alabama","DeKalb County",1,69,741,362,379
050,01,049,"Alabama","DeKalb County",1,70,770,352,418
050,01,049,"Alabama","DeKalb County",1,71,763,354,409
050,01,049,"Alabama","DeKalb County",1,72,723,344,379
050,01,049,"Alabama","DeKalb County",1,73,740,364,376
050,01,049,"Alabama","DeKalb County",1,74,535,244,291
050,01,049,"Alabama","DeKalb County",1,75,537,248,289
050,01,049,"Alabama","DeKalb County",1,76,510,243,267
050,01,049,"Alabama","DeKalb County",1,77,506,249,257
050,01,049,"Alabama","DeKalb County",1,78,422,183,239
050,01,049,"Alabama","DeKalb County",1,79,372,165,207
050,01,049,"Alabama","DeKalb County",1,80,329,133,196
050,01,049,"Alabama","DeKalb County",1,81,315,118,197
050,01,049,"Alabama","DeKalb County",1,82,286,108,178
050,01,049,"Alabama","DeKalb County",1,83,239,95,144
050,01,049,"Alabama","DeKalb County",1,84,212,88,124
050,01,049,"Alabama","DeKalb County",1,85,1103,368,735
050,01,049,"Alabama","DeKalb County",2,0,796,412,384
050,01,049,"Alabama","DeKalb County",2,1,814,420,394
050,01,049,"Alabama","DeKalb County",2,2,848,452,396
050,01,049,"Alabama","DeKalb County",2,3,868,465,403
050,01,049,"Alabama","DeKalb County",2,4,919,478,441
050,01,049,"Alabama","DeKalb County",2,5,914,488,426
050,01,049,"Alabama","DeKalb County",2,6,919,497,422
050,01,049,"Alabama","DeKalb County",2,7,912,463,449
050,01,049,"Alabama","DeKalb County",2,8,927,478,449
050,01,049,"Alabama","DeKalb County",2,9,957,481,476
050,01,049,"Alabama","DeKalb County",2,10,1037,512,525
050,01,049,"Alabama","DeKalb County",2,11,1058,533,525
050,01,049,"Alabama","DeKalb County",2,12,1106,553,553
050,01,049,"Alabama","DeKalb County",2,13,1131,581,550
050,01,049,"Alabama","DeKalb County",2,14,1087,568,519
050,01,049,"Alabama","DeKalb County",2,15,1079,553,526
050,01,049,"Alabama","DeKalb County",2,16,1086,565,521
050,01,049,"Alabama","DeKalb County",2,17,1062,554,508
050,01,049,"Alabama","DeKalb County",2,18,901,476,425
050,01,049,"Alabama","DeKalb County",2,19,782,409,373
050,01,049,"Alabama","DeKalb County",2,20,871,465,406
050,01,049,"Alabama","DeKalb County",2,21,853,455,398
050,01,049,"Alabama","DeKalb County",2,22,825,426,399
050,01,049,"Alabama","DeKalb County",2,23,823,423,400
050,01,049,"Alabama","DeKalb County",2,24,843,440,403
050,01,049,"Alabama","DeKalb County",2,25,857,446,411
050,01,049,"Alabama","DeKalb County",2,26,863,451,412
050,01,049,"Alabama","DeKalb County",2,27,870,458,412
050,01,049,"Alabama","DeKalb County",2,28,897,449,448
050,01,049,"Alabama","DeKalb County",2,29,936,467,469
050,01,049,"Alabama","DeKalb County",2,30,902,456,446
050,01,049,"Alabama","DeKalb County",2,31,829,423,406
050,01,049,"Alabama","DeKalb County",2,32,775,397,378
050,01,049,"Alabama","DeKalb County",2,33,755,386,369
050,01,049,"Alabama","DeKalb County",2,34,783,400,383
050,01,049,"Alabama","DeKalb County",2,35,849,447,402
050,01,049,"Alabama","DeKalb County",2,36,821,406,415
050,01,049,"Alabama","DeKalb County",2,37,786,377,409
050,01,049,"Alabama","DeKalb County",2,38,834,410,424
050,01,049,"Alabama","DeKalb County",2,39,852,433,419
050,01,049,"Alabama","DeKalb County",2,40,894,450,444
050,01,049,"Alabama","DeKalb County",2,41,894,441,453
050,01,049,"Alabama","DeKalb County",2,42,919,448,471
050,01,049,"Alabama","DeKalb County",2,43,953,474,479
050,01,049,"Alabama","DeKalb County",2,44,884,453,431
050,01,049,"Alabama","DeKalb County",2,45,902,466,436
050,01,049,"Alabama","DeKalb County",2,46,890,453,437
050,01,049,"Alabama","DeKalb County",2,47,894,449,445
050,01,049,"Alabama","DeKalb County",2,48,972,496,476
050,01,049,"Alabama","DeKalb County",2,49,1024,528,496
050,01,049,"Alabama","DeKalb County",2,50,1007,516,491
050,01,049,"Alabama","DeKalb County",2,51,935,486,449
050,01,049,"Alabama","DeKalb County",2,52,912,464,448
050,01,049,"Alabama","DeKalb County",2,53,916,469,447
050,01,049,"Alabama","DeKalb County",2,54,920,457,463
050,01,049,"Alabama","DeKalb County",2,55,966,475,491
050,01,049,"Alabama","DeKalb County",2,56,945,472,473
050,01,049,"Alabama","DeKalb County",2,57,923,463,460
050,01,049,"Alabama","DeKalb County",2,58,970,496,474
050,01,049,"Alabama","DeKalb County",2,59,964,492,472
050,01,049,"Alabama","DeKalb County",2,60,947,477,470
050,01,049,"Alabama","DeKalb County",2,61,927,469,458
050,01,049,"Alabama","DeKalb County",2,62,918,464,454
050,01,049,"Alabama","DeKalb County",2,63,908,446,462
050,01,049,"Alabama","DeKalb County",2,64,874,416,458
050,01,049,"Alabama","DeKalb County",2,65,867,426,441
050,01,049,"Alabama","DeKalb County",2,66,820,403,417
050,01,049,"Alabama","DeKalb County",2,67,772,379,393
050,01,049,"Alabama","DeKalb County",2,68,763,375,388
050,01,049,"Alabama","DeKalb County",2,69,751,369,382
050,01,049,"Alabama","DeKalb County",2,70,758,351,407
050,01,049,"Alabama","DeKalb County",2,71,757,346,411
050,01,049,"Alabama","DeKalb County",2,72,717,338,379
050,01,049,"Alabama","DeKalb County",2,73,770,374,396
050,01,049,"Alabama","DeKalb County",2,74,548,256,292
050,01,049,"Alabama","DeKalb County",2,75,530,242,288
050,01,049,"Alabama","DeKalb County",2,76,505,238,267
050,01,049,"Alabama","DeKalb County",2,77,515,252,263
050,01,049,"Alabama","DeKalb County",2,78,432,193,239
050,01,049,"Alabama","DeKalb County",2,79,369,163,206
050,01,049,"Alabama","DeKalb County",2,80,336,137,199
050,01,049,"Alabama","DeKalb County",2,81,312,121,191
050,01,049,"Alabama","DeKalb County",2,82,290,109,181
050,01,049,"Alabama","DeKalb County",2,83,242,95,147
050,01,049,"Alabama","DeKalb County",2,84,215,89,126
050,01,049,"Alabama","DeKalb County",2,85,1105,369,736
050,01,049,"Alabama","DeKalb County",3,0,820,445,375
050,01,049,"Alabama","DeKalb County",3,1,784,400,384
050,01,049,"Alabama","DeKalb County",3,2,834,421,413
050,01,049,"Alabama","DeKalb County",3,3,878,461,417
050,01,049,"Alabama","DeKalb County",3,4,900,481,419
050,01,049,"Alabama","DeKalb County",3,5,923,469,454
050,01,049,"Alabama","DeKalb County",3,6,942,512,430
050,01,049,"Alabama","DeKalb County",3,7,947,514,433
050,01,049,"Alabama","DeKalb County",3,8,918,471,447
050,01,049,"Alabama","DeKalb County",3,9,959,501,458
050,01,049,"Alabama","DeKalb County",3,10,988,491,497
050,01,049,"Alabama","DeKalb County",3,11,1032,515,517
050,01,049,"Alabama","DeKalb County",3,12,1063,541,522
050,01,049,"Alabama","DeKalb County",3,13,1111,549,562
050,01,049,"Alabama","DeKalb County",3,14,1134,583,551
050,01,049,"Alabama","DeKalb County",3,15,1088,570,518
050,01,049,"Alabama","DeKalb County",3,16,1089,539,550
050,01,049,"Alabama","DeKalb County",3,17,1086,562,524
050,01,049,"Alabama","DeKalb County",3,18,933,497,436
050,01,049,"Alabama","DeKalb County",3,19,773,397,376
050,01,049,"Alabama","DeKalb County",3,20,841,444,397
050,01,049,"Alabama","DeKalb County",3,21,891,461,430
050,01,049,"Alabama","DeKalb County",3,22,901,462,439
050,01,049,"Alabama","DeKalb County",3,23,873,438,435
050,01,049,"Alabama","DeKalb County",3,24,830,424,406
050,01,049,"Alabama","DeKalb County",3,25,871,448,423
050,01,049,"Alabama","DeKalb County",3,26,858,445,413
050,01,049,"Alabama","DeKalb County",3,27,861,444,417
050,01,049,"Alabama","DeKalb County",3,28,854,442,412
050,01,049,"Alabama","DeKalb County",3,29,899,457,442
050,01,049,"Alabama","DeKalb County",3,30,962,475,487
050,01,049,"Alabama","DeKalb County",3,31,909,473,436
050,01,049,"Alabama","DeKalb County",3,32,844,434,410
050,01,049,"Alabama","DeKalb County",3,33,764,379,385
050,01,049,"Alabama","DeKalb County",3,34,735,375,360
050,01,049,"Alabama","DeKalb County",3,35,780,392,388
050,01,049,"Alabama","DeKalb County",3,36,848,443,405
050,01,049,"Alabama","DeKalb County",3,37,811,412,399
050,01,049,"Alabama","DeKalb County",3,38,781,374,407
050,01,049,"Alabama","DeKalb County",3,39,826,398,428
050,01,049,"Alabama","DeKalb County",3,40,873,448,425
050,01,049,"Alabama","DeKalb County",3,41,898,450,448
050,01,049,"Alabama","DeKalb County",3,42,898,442,456
050,01,049,"Alabama","DeKalb County",3,43,922,447,475
050,01,049,"Alabama","DeKalb County",3,44,938,462,476
050,01,049,"Alabama","DeKalb County",3,45,885,456,429
050,01,049,"Alabama","DeKalb County",3,46,896,457,439
050,01,049,"Alabama","DeKalb County",3,47,889,452,437
050,01,049,"Alabama","DeKalb County",3,48,910,458,452
050,01,049,"Alabama","DeKalb County",3,49,965,482,483
050,01,049,"Alabama","DeKalb County",3,50,1030,529,501
050,01,049,"Alabama","DeKalb County",3,51,1018,517,501
050,01,049,"Alabama","DeKalb County",3,52,934,483,451
050,01,049,"Alabama","DeKalb County",3,53,918,469,449
050,01,049,"Alabama","DeKalb County",3,54,919,462,457
050,01,049,"Alabama","DeKalb County",3,55,918,450,468
050,01,049,"Alabama","DeKalb County",3,56,960,477,483
050,01,049,"Alabama","DeKalb County",3,57,937,464,473
050,01,049,"Alabama","DeKalb County",3,58,909,453,456
050,01,049,"Alabama","DeKalb County",3,59,961,486,475
050,01,049,"Alabama","DeKalb County",3,60,959,487,472
050,01,049,"Alabama","DeKalb County",3,61,945,472,473
050,01,049,"Alabama","DeKalb County",3,62,920,466,454
050,01,049,"Alabama","DeKalb County",3,63,916,460,456
050,01,049,"Alabama","DeKalb County",3,64,915,455,460
050,01,049,"Alabama","DeKalb County",3,65,873,414,459
050,01,049,"Alabama","DeKalb County",3,66,861,423,438
050,01,049,"Alabama","DeKalb County",3,67,800,396,404
050,01,049,"Alabama","DeKalb County",3,68,742,366,376
050,01,049,"Alabama","DeKalb County",3,69,766,378,388
050,01,049,"Alabama","DeKalb County",3,70,739,360,379
050,01,049,"Alabama","DeKalb County",3,71,733,340,393
050,01,049,"Alabama","DeKalb County",3,72,750,339,411
050,01,049,"Alabama","DeKalb County",3,73,676,311,365
050,01,049,"Alabama","DeKalb County",3,74,744,356,388
050,01,049,"Alabama","DeKalb County",3,75,516,241,275
050,01,049,"Alabama","DeKalb County",3,76,510,231,279
050,01,049,"Alabama","DeKalb County",3,77,479,226,253
050,01,049,"Alabama","DeKalb County",3,78,480,231,249
050,01,049,"Alabama","DeKalb County",3,79,390,172,218
050,01,049,"Alabama","DeKalb County",3,80,348,152,196
050,01,049,"Alabama","DeKalb County",3,81,308,122,186
050,01,049,"Alabama","DeKalb County",3,82,269,100,169
050,01,049,"Alabama","DeKalb County",3,83,253,91,162
050,01,049,"Alabama","DeKalb County",3,84,214,82,132
050,01,049,"Alabama","DeKalb County",3,85,1087,361,726
050,01,049,"Alabama","DeKalb County",4,0,834,420,414
050,01,049,"Alabama","DeKalb County",4,1,801,426,375
050,01,049,"Alabama","DeKalb County",4,2,815,414,401
050,01,049,"Alabama","DeKalb County",4,3,852,433,419
050,01,049,"Alabama","DeKalb County",4,4,890,469,421
050,01,049,"Alabama","DeKalb County",4,5,889,488,401
050,01,049,"Alabama","DeKalb County",4,6,940,483,457
050,01,049,"Alabama","DeKalb County",4,7,978,529,449
050,01,049,"Alabama","DeKalb County",4,8,920,498,422
050,01,049,"Alabama","DeKalb County",4,9,938,480,458
050,01,049,"Alabama","DeKalb County",4,10,972,503,469
050,01,049,"Alabama","DeKalb County",4,11,981,490,491
050,01,049,"Alabama","DeKalb County",4,12,1051,517,534
050,01,049,"Alabama","DeKalb County",4,13,1081,546,535
050,01,049,"Alabama","DeKalb County",4,14,1131,559,572
050,01,049,"Alabama","DeKalb County",4,15,1137,589,548
050,01,049,"Alabama","DeKalb County",4,16,1080,572,508
050,01,049,"Alabama","DeKalb County",4,17,1091,548,543
050,01,049,"Alabama","DeKalb County",4,18,947,504,443
050,01,049,"Alabama","DeKalb County",4,19,753,407,346
050,01,049,"Alabama","DeKalb County",4,20,821,419,402
050,01,049,"Alabama","DeKalb County",4,21,856,444,412
050,01,049,"Alabama","DeKalb County",4,22,954,488,466
050,01,049,"Alabama","DeKalb County",4,23,926,482,444
050,01,049,"Alabama","DeKalb County",4,24,873,440,433
050,01,049,"Alabama","DeKalb County",4,25,812,409,403
050,01,049,"Alabama","DeKalb County",4,26,856,442,414
050,01,049,"Alabama","DeKalb County",4,27,865,457,408
050,01,049,"Alabama","DeKalb County",4,28,876,465,411
050,01,049,"Alabama","DeKalb County",4,29,871,449,422
050,01,049,"Alabama","DeKalb County",4,30,904,463,441
050,01,049,"Alabama","DeKalb County",4,31,968,473,495
050,01,049,"Alabama","DeKalb County",4,32,916,466,450
050,01,049,"Alabama","DeKalb County",4,33,851,440,411
050,01,049,"Alabama","DeKalb County",4,34,777,383,394
050,01,049,"Alabama","DeKalb County",4,35,738,381,357
050,01,049,"Alabama","DeKalb County",4,36,775,375,400
050,01,049,"Alabama","DeKalb County",4,37,845,447,398
050,01,049,"Alabama","DeKalb County",4,38,802,407,395
050,01,049,"Alabama","DeKalb County",4,39,768,368,400
050,01,049,"Alabama","DeKalb County",4,40,833,408,425
050,01,049,"Alabama","DeKalb County",4,41,871,443,428
050,01,049,"Alabama","DeKalb County",4,42,897,446,451
050,01,049,"Alabama","DeKalb County",4,43,900,449,451
050,01,049,"Alabama","DeKalb County",4,44,902,444,458
050,01,049,"Alabama","DeKalb County",4,45,926,454,472
050,01,049,"Alabama","DeKalb County",4,46,877,450,427
050,01,049,"Alabama","DeKalb County",4,47,891,452,439
050,01,049,"Alabama","DeKalb County",4,48,887,436,451
050,01,049,"Alabama","DeKalb County",4,49,905,458,447
050,01,049,"Alabama","DeKalb County",4,50,951,480,471
050,01,049,"Alabama","DeKalb County",4,51,1056,546,510
050,01,049,"Alabama","DeKalb County",4,52,1021,521,500
050,01,049,"Alabama","DeKalb County",4,53,916,479,437
050,01,049,"Alabama","DeKalb County",4,54,934,476,458
050,01,049,"Alabama","DeKalb County",4,55,913,457,456
050,01,049,"Alabama","DeKalb County",4,56,931,458,473
050,01,049,"Alabama","DeKalb County",4,57,960,483,477
050,01,049,"Alabama","DeKalb County",4,58,922,452,470
050,01,049,"Alabama","DeKalb County",4,59,907,439,468
050,01,049,"Alabama","DeKalb County",4,60,964,474,490
050,01,049,"Alabama","DeKalb County",4,61,981,503,478
050,01,049,"Alabama","DeKalb County",4,62,931,470,461
050,01,049,"Alabama","DeKalb County",4,63,915,462,453
050,01,049,"Alabama","DeKalb County",4,64,905,454,451
050,01,049,"Alabama","DeKalb County",4,65,891,436,455
050,01,049,"Alabama","DeKalb County",4,66,871,414,457
050,01,049,"Alabama","DeKalb County",4,67,849,414,435
050,01,049,"Alabama","DeKalb County",4,68,801,401,400
050,01,049,"Alabama","DeKalb County",4,69,740,367,373
050,01,049,"Alabama","DeKalb County",4,70,739,361,378
050,01,049,"Alabama","DeKalb County",4,71,713,347,366
050,01,049,"Alabama","DeKalb County",4,72,736,340,396
050,01,049,"Alabama","DeKalb County",4,73,714,321,393
050,01,049,"Alabama","DeKalb County",4,74,660,298,362
050,01,049,"Alabama","DeKalb County",4,75,702,325,377
050,01,049,"Alabama","DeKalb County",4,76,508,231,277
050,01,049,"Alabama","DeKalb County",4,77,481,219,262
050,01,049,"Alabama","DeKalb County",4,78,461,214,247
050,01,049,"Alabama","DeKalb County",4,79,454,221,233
050,01,049,"Alabama","DeKalb County",4,80,366,164,202
050,01,049,"Alabama","DeKalb County",4,81,323,143,180
050,01,049,"Alabama","DeKalb County",4,82,270,99,171
050,01,049,"Alabama","DeKalb County",4,83,233,88,145
050,01,049,"Alabama","DeKalb County",4,84,221,74,147
050,01,049,"Alabama","DeKalb County",4,85,1118,373,745
050,01,049,"Alabama","DeKalb County",5,0,838,422,416
050,01,049,"Alabama","DeKalb County",5,1,858,430,428
050,01,049,"Alabama","DeKalb County",5,2,817,432,385
050,01,049,"Alabama","DeKalb County",5,3,849,431,418
050,01,049,"Alabama","DeKalb County",5,4,867,452,415
050,01,049,"Alabama","DeKalb County",5,5,913,479,434
050,01,049,"Alabama","DeKalb County",5,6,896,498,398
050,01,049,"Alabama","DeKalb County",5,7,925,483,442
050,01,049,"Alabama","DeKalb County",5,8,985,525,460
050,01,049,"Alabama","DeKalb County",5,9,952,527,425
050,01,049,"Alabama","DeKalb County",5,10,927,470,457
050,01,049,"Alabama","DeKalb County",5,11,977,507,470
050,01,049,"Alabama","DeKalb County",5,12,983,495,488
050,01,049,"Alabama","DeKalb County",5,13,1068,530,538
050,01,049,"Alabama","DeKalb County",5,14,1084,547,537
050,01,049,"Alabama","DeKalb County",5,15,1116,547,569
050,01,049,"Alabama","DeKalb County",5,16,1142,591,551
050,01,049,"Alabama","DeKalb County",5,17,1075,564,511
050,01,049,"Alabama","DeKalb County",5,18,922,480,442
050,01,049,"Alabama","DeKalb County",5,19,798,416,382
050,01,049,"Alabama","DeKalb County",5,20,823,451,372
050,01,049,"Alabama","DeKalb County",5,21,864,429,435
050,01,049,"Alabama","DeKalb County",5,22,908,473,435
050,01,049,"Alabama","DeKalb County",5,23,966,495,471
050,01,049,"Alabama","DeKalb County",5,24,942,491,451
050,01,049,"Alabama","DeKalb County",5,25,880,438,442
050,01,049,"Alabama","DeKalb County",5,26,824,411,413
050,01,049,"Alabama","DeKalb County",5,27,857,435,422
050,01,049,"Alabama","DeKalb County",5,28,877,453,424
050,01,049,"Alabama","DeKalb County",5,29,912,498,414
050,01,049,"Alabama","DeKalb County",5,30,876,458,418
050,01,049,"Alabama","DeKalb County",5,31,919,482,437
050,01,049,"Alabama","DeKalb County",5,32,973,475,498
050,01,049,"Alabama","DeKalb County",5,33,919,461,458
050,01,049,"Alabama","DeKalb County",5,34,857,430,427
050,01,049,"Alabama","DeKalb County",5,35,810,412,398
050,01,049,"Alabama","DeKalb County",5,36,742,372,370
050,01,049,"Alabama","DeKalb County",5,37,786,390,396
050,01,049,"Alabama","DeKalb County",5,38,876,463,413
050,01,049,"Alabama","DeKalb County",5,39,824,419,405
050,01,049,"Alabama","DeKalb County",5,40,784,388,396
050,01,049,"Alabama","DeKalb County",5,41,840,402,438
050,01,049,"Alabama","DeKalb County",5,42,868,442,426
050,01,049,"Alabama","DeKalb County",5,43,900,452,448
050,01,049,"Alabama","DeKalb County",5,44,895,445,450
050,01,049,"Alabama","DeKalb County",5,45,906,448,458
050,01,049,"Alabama","DeKalb County",5,46,935,455,480
050,01,049,"Alabama","DeKalb County",5,47,875,451,424
050,01,049,"Alabama","DeKalb County",5,48,906,458,448
050,01,049,"Alabama","DeKalb County",5,49,894,441,453
050,01,049,"Alabama","DeKalb County",5,50,908,457,451
050,01,049,"Alabama","DeKalb County",5,51,956,476,480
050,01,049,"Alabama","DeKalb County",5,52,1044,539,505
050,01,049,"Alabama","DeKalb County",5,53,1021,518,503
050,01,049,"Alabama","DeKalb County",5,54,938,488,450
050,01,049,"Alabama","DeKalb County",5,55,953,484,469
050,01,049,"Alabama","DeKalb County",5,56,916,456,460
050,01,049,"Alabama","DeKalb County",5,57,922,454,468
050,01,049,"Alabama","DeKalb County",5,58,957,482,475
050,01,049,"Alabama","DeKalb County",5,59,920,444,476
050,01,049,"Alabama","DeKalb County",5,60,906,430,476
050,01,049,"Alabama","DeKalb County",5,61,952,476,476
050,01,049,"Alabama","DeKalb County",5,62,979,498,481
050,01,049,"Alabama","DeKalb County",5,63,937,474,463
050,01,049,"Alabama","DeKalb County",5,64,898,455,443
050,01,049,"Alabama","DeKalb County",5,65,890,442,448
050,01,049,"Alabama","DeKalb County",5,66,879,426,453
050,01,049,"Alabama","DeKalb County",5,67,856,408,448
050,01,049,"Alabama","DeKalb County",5,68,833,399,434
050,01,049,"Alabama","DeKalb County",5,69,803,404,399
050,01,049,"Alabama","DeKalb County",5,70,716,349,367
050,01,049,"Alabama","DeKalb County",5,71,715,348,367
050,01,049,"Alabama","DeKalb County",5,72,707,345,362
050,01,049,"Alabama","DeKalb County",5,73,695,320,375
050,01,049,"Alabama","DeKalb County",5,74,700,308,392
050,01,049,"Alabama","DeKalb County",5,75,636,284,352
050,01,049,"Alabama","DeKalb County",5,76,675,311,364
050,01,049,"Alabama","DeKalb County",5,77,485,223,262
050,01,049,"Alabama","DeKalb County",5,78,453,203,250
050,01,049,"Alabama","DeKalb County",5,79,424,199,225
050,01,049,"Alabama","DeKalb County",5,80,434,213,221
050,01,049,"Alabama","DeKalb County",5,81,346,153,193
050,01,049,"Alabama","DeKalb County",5,82,287,123,164
050,01,049,"Alabama","DeKalb County",5,83,232,86,146
050,01,049,"Alabama","DeKalb County",5,84,203,74,129
050,01,049,"Alabama","DeKalb County",5,85,1163,385,778
050,01,051,"Alabama","Elmore County",1,0,932,474,458
050,01,051,"Alabama","Elmore County",1,1,954,480,474
050,01,051,"Alabama","Elmore County",1,2,972,502,470
050,01,051,"Alabama","Elmore County",1,3,1009,503,506
050,01,051,"Alabama","Elmore County",1,4,1008,521,487
050,01,051,"Alabama","Elmore County",1,5,1054,525,529
050,01,051,"Alabama","Elmore County",1,6,1058,561,497
050,01,051,"Alabama","Elmore County",1,7,1048,567,481
050,01,051,"Alabama","Elmore County",1,8,1023,533,490
050,01,051,"Alabama","Elmore County",1,9,1071,584,487
050,01,051,"Alabama","Elmore County",1,10,1123,597,526
050,01,051,"Alabama","Elmore County",1,11,1125,567,558
050,01,051,"Alabama","Elmore County",1,12,1164,574,590
050,01,051,"Alabama","Elmore County",1,13,1149,590,559
050,01,051,"Alabama","Elmore County",1,14,1193,596,597
050,01,051,"Alabama","Elmore County",1,15,1174,576,598
050,01,051,"Alabama","Elmore County",1,16,1137,569,568
050,01,051,"Alabama","Elmore County",1,17,1162,588,574
050,01,051,"Alabama","Elmore County",1,18,1052,561,491
050,01,051,"Alabama","Elmore County",1,19,956,533,423
050,01,051,"Alabama","Elmore County",1,20,1019,569,450
050,01,051,"Alabama","Elmore County",1,21,1025,588,437
050,01,051,"Alabama","Elmore County",1,22,1064,558,506
050,01,051,"Alabama","Elmore County",1,23,1047,554,493
050,01,051,"Alabama","Elmore County",1,24,1095,539,556
050,01,051,"Alabama","Elmore County",1,25,1114,562,552
050,01,051,"Alabama","Elmore County",1,26,1162,565,597
050,01,051,"Alabama","Elmore County",1,27,1219,587,632
050,01,051,"Alabama","Elmore County",1,28,1250,604,646
050,01,051,"Alabama","Elmore County",1,29,1395,649,746
050,01,051,"Alabama","Elmore County",1,30,1328,644,684
050,01,051,"Alabama","Elmore County",1,31,1266,616,650
050,01,051,"Alabama","Elmore County",1,32,1220,611,609
050,01,051,"Alabama","Elmore County",1,33,1296,613,683
050,01,051,"Alabama","Elmore County",1,34,1168,555,613
050,01,051,"Alabama","Elmore County",1,35,1171,570,601
050,01,051,"Alabama","Elmore County",1,36,1149,550,599
050,01,051,"Alabama","Elmore County",1,37,1152,532,620
050,01,051,"Alabama","Elmore County",1,38,1245,544,701
050,01,051,"Alabama","Elmore County",1,39,1172,556,616
050,01,051,"Alabama","Elmore County",1,40,1173,610,563
050,01,051,"Alabama","Elmore County",1,41,1126,554,572
050,01,051,"Alabama","Elmore County",1,42,1132,547,585
050,01,051,"Alabama","Elmore County",1,43,1124,502,622
050,01,051,"Alabama","Elmore County",1,44,1173,552,621
050,01,051,"Alabama","Elmore County",1,45,1127,550,577
050,01,051,"Alabama","Elmore County",1,46,1055,499,556
050,01,051,"Alabama","Elmore County",1,47,1188,545,643
050,01,051,"Alabama","Elmore County",1,48,1260,592,668
050,01,051,"Alabama","Elmore County",1,49,1320,605,715
050,01,051,"Alabama","Elmore County",1,50,1200,585,615
050,01,051,"Alabama","Elmore County",1,51,1099,537,562
050,01,051,"Alabama","Elmore County",1,52,1120,534,586
050,01,051,"Alabama","Elmore County",1,53,1106,557,549
050,01,051,"Alabama","Elmore County",1,54,1178,574,604
050,01,051,"Alabama","Elmore County",1,55,1213,579,634
050,01,051,"Alabama","Elmore County",1,56,1280,623,657
050,01,051,"Alabama","Elmore County",1,57,1230,590,640
050,01,051,"Alabama","Elmore County",1,58,1246,585,661
050,01,051,"Alabama","Elmore County",1,59,1193,570,623
050,01,051,"Alabama","Elmore County",1,60,1157,566,591
050,01,051,"Alabama","Elmore County",1,61,1191,560,631
050,01,051,"Alabama","Elmore County",1,62,1149,559,590
050,01,051,"Alabama","Elmore County",1,63,1114,556,558
050,01,051,"Alabama","Elmore County",1,64,1101,551,550
050,01,051,"Alabama","Elmore County",1,65,1004,463,541
050,01,051,"Alabama","Elmore County",1,66,990,459,531
050,01,051,"Alabama","Elmore County",1,67,948,433,515
050,01,051,"Alabama","Elmore County",1,68,871,399,472
050,01,051,"Alabama","Elmore County",1,69,784,363,421
050,01,051,"Alabama","Elmore County",1,70,815,378,437
050,01,051,"Alabama","Elmore County",1,71,810,388,422
050,01,051,"Alabama","Elmore County",1,72,798,387,411
050,01,051,"Alabama","Elmore County",1,73,820,382,438
050,01,051,"Alabama","Elmore County",1,74,624,278,346
050,01,051,"Alabama","Elmore County",1,75,584,276,308
050,01,051,"Alabama","Elmore County",1,76,563,259,304
050,01,051,"Alabama","Elmore County",1,77,573,269,304
050,01,051,"Alabama","Elmore County",1,78,478,219,259
050,01,051,"Alabama","Elmore County",1,79,390,168,222
050,01,051,"Alabama","Elmore County",1,80,374,161,213
050,01,051,"Alabama","Elmore County",1,81,353,156,197
050,01,051,"Alabama","Elmore County",1,82,319,139,180
050,01,051,"Alabama","Elmore County",1,83,268,120,148
050,01,051,"Alabama","Elmore County",1,84,258,102,156
050,01,051,"Alabama","Elmore County",1,85,1180,367,813
050,01,051,"Alabama","Elmore County",2,0,919,466,453
050,01,051,"Alabama","Elmore County",2,1,943,475,468
050,01,051,"Alabama","Elmore County",2,2,975,499,476
050,01,051,"Alabama","Elmore County",2,3,992,503,489
050,01,051,"Alabama","Elmore County",2,4,1009,518,491
050,01,051,"Alabama","Elmore County",2,5,1047,528,519
050,01,051,"Alabama","Elmore County",2,6,1065,557,508
050,01,051,"Alabama","Elmore County",2,7,1053,566,487
050,01,051,"Alabama","Elmore County",2,8,1027,541,486
050,01,051,"Alabama","Elmore County",2,9,1061,573,488
050,01,051,"Alabama","Elmore County",2,10,1108,595,513
050,01,051,"Alabama","Elmore County",2,11,1125,574,551
050,01,051,"Alabama","Elmore County",2,12,1163,575,588
050,01,051,"Alabama","Elmore County",2,13,1152,587,565
050,01,051,"Alabama","Elmore County",2,14,1178,592,586
050,01,051,"Alabama","Elmore County",2,15,1177,578,599
050,01,051,"Alabama","Elmore County",2,16,1156,578,578
050,01,051,"Alabama","Elmore County",2,17,1151,583,568
050,01,051,"Alabama","Elmore County",2,18,1042,553,489
050,01,051,"Alabama","Elmore County",2,19,944,526,418
050,01,051,"Alabama","Elmore County",2,20,1042,577,465
050,01,051,"Alabama","Elmore County",2,21,1017,580,437
050,01,051,"Alabama","Elmore County",2,22,1058,563,495
050,01,051,"Alabama","Elmore County",2,23,1052,543,509
050,01,051,"Alabama","Elmore County",2,24,1081,536,545
050,01,051,"Alabama","Elmore County",2,25,1101,554,547
050,01,051,"Alabama","Elmore County",2,26,1149,560,589
050,01,051,"Alabama","Elmore County",2,27,1203,574,629
050,01,051,"Alabama","Elmore County",2,28,1244,600,644
050,01,051,"Alabama","Elmore County",2,29,1371,638,733
050,01,051,"Alabama","Elmore County",2,30,1345,654,691
050,01,051,"Alabama","Elmore County",2,31,1273,619,654
050,01,051,"Alabama","Elmore County",2,32,1235,614,621
050,01,051,"Alabama","Elmore County",2,33,1285,603,682
050,01,051,"Alabama","Elmore County",2,34,1176,564,612
050,01,051,"Alabama","Elmore County",2,35,1168,570,598
050,01,051,"Alabama","Elmore County",2,36,1147,545,602
050,01,051,"Alabama","Elmore County",2,37,1137,526,611
050,01,051,"Alabama","Elmore County",2,38,1243,546,697
050,01,051,"Alabama","Elmore County",2,39,1151,547,604
050,01,051,"Alabama","Elmore County",2,40,1170,599,571
050,01,051,"Alabama","Elmore County",2,41,1144,564,580
050,01,051,"Alabama","Elmore County",2,42,1123,546,577
050,01,051,"Alabama","Elmore County",2,43,1118,504,614
050,01,051,"Alabama","Elmore County",2,44,1148,537,611
050,01,051,"Alabama","Elmore County",2,45,1116,543,573
050,01,051,"Alabama","Elmore County",2,46,1055,501,554
050,01,051,"Alabama","Elmore County",2,47,1167,534,633
050,01,051,"Alabama","Elmore County",2,48,1237,579,658
050,01,051,"Alabama","Elmore County",2,49,1307,601,706
050,01,051,"Alabama","Elmore County",2,50,1216,587,629
050,01,051,"Alabama","Elmore County",2,51,1114,546,568
050,01,051,"Alabama","Elmore County",2,52,1119,533,586
050,01,051,"Alabama","Elmore County",2,53,1101,549,552
050,01,051,"Alabama","Elmore County",2,54,1161,568,593
050,01,051,"Alabama","Elmore County",2,55,1187,570,617
050,01,051,"Alabama","Elmore County",2,56,1272,618,654
050,01,051,"Alabama","Elmore County",2,57,1243,599,644
050,01,051,"Alabama","Elmore County",2,58,1240,581,659
050,01,051,"Alabama","Elmore County",2,59,1211,573,638
050,01,051,"Alabama","Elmore County",2,60,1166,568,598
050,01,051,"Alabama","Elmore County",2,61,1185,558,627
050,01,051,"Alabama","Elmore County",2,62,1148,556,592
050,01,051,"Alabama","Elmore County",2,63,1133,563,570
050,01,051,"Alabama","Elmore County",2,64,1094,546,548
050,01,051,"Alabama","Elmore County",2,65,1026,482,544
050,01,051,"Alabama","Elmore County",2,66,1000,462,538
050,01,051,"Alabama","Elmore County",2,67,956,437,519
050,01,051,"Alabama","Elmore County",2,68,878,405,473
050,01,051,"Alabama","Elmore County",2,69,808,371,437
050,01,051,"Alabama","Elmore County",2,70,805,373,432
050,01,051,"Alabama","Elmore County",2,71,808,383,425
050,01,051,"Alabama","Elmore County",2,72,787,379,408
050,01,051,"Alabama","Elmore County",2,73,848,396,452
050,01,051,"Alabama","Elmore County",2,74,624,282,342
050,01,051,"Alabama","Elmore County",2,75,593,276,317
050,01,051,"Alabama","Elmore County",2,76,561,258,303
050,01,051,"Alabama","Elmore County",2,77,578,270,308
050,01,051,"Alabama","Elmore County",2,78,483,225,258
050,01,051,"Alabama","Elmore County",2,79,401,175,226
050,01,051,"Alabama","Elmore County",2,80,373,161,212
050,01,051,"Alabama","Elmore County",2,81,350,154,196
050,01,051,"Alabama","Elmore County",2,82,321,138,183
050,01,051,"Alabama","Elmore County",2,83,271,120,151
050,01,051,"Alabama","Elmore County",2,84,258,106,152
050,01,051,"Alabama","Elmore County",2,85,1192,370,822
050,01,051,"Alabama","Elmore County",3,0,906,447,459
050,01,051,"Alabama","Elmore County",3,1,959,482,477
050,01,051,"Alabama","Elmore County",3,2,982,479,503
050,01,051,"Alabama","Elmore County",3,3,990,503,487
050,01,051,"Alabama","Elmore County",3,4,1022,499,523
050,01,051,"Alabama","Elmore County",3,5,1025,539,486
050,01,051,"Alabama","Elmore County",3,6,1061,548,513
050,01,051,"Alabama","Elmore County",3,7,1093,574,519
050,01,051,"Alabama","Elmore County",3,8,1065,573,492
050,01,051,"Alabama","Elmore County",3,9,1042,559,483
050,01,051,"Alabama","Elmore County",3,10,1082,589,493
050,01,051,"Alabama","Elmore County",3,11,1132,618,514
050,01,051,"Alabama","Elmore County",3,12,1136,592,544
050,01,051,"Alabama","Elmore County",3,13,1183,597,586
050,01,051,"Alabama","Elmore County",3,14,1177,606,571
050,01,051,"Alabama","Elmore County",3,15,1194,602,592
050,01,051,"Alabama","Elmore County",3,16,1179,598,581
050,01,051,"Alabama","Elmore County",3,17,1167,581,586
050,01,051,"Alabama","Elmore County",3,18,1043,548,495
050,01,051,"Alabama","Elmore County",3,19,892,491,401
050,01,051,"Alabama","Elmore County",3,20,1100,613,487
050,01,051,"Alabama","Elmore County",3,21,1070,601,469
050,01,051,"Alabama","Elmore County",3,22,1106,608,498
050,01,051,"Alabama","Elmore County",3,23,1119,569,550
050,01,051,"Alabama","Elmore County",3,24,1142,565,577
050,01,051,"Alabama","Elmore County",3,25,1065,543,522
050,01,051,"Alabama","Elmore County",3,26,1108,559,549
050,01,051,"Alabama","Elmore County",3,27,1177,557,620
050,01,051,"Alabama","Elmore County",3,28,1239,613,626
050,01,051,"Alabama","Elmore County",3,29,1338,618,720
050,01,051,"Alabama","Elmore County",3,30,1322,639,683
050,01,051,"Alabama","Elmore County",3,31,1360,667,693
050,01,051,"Alabama","Elmore County",3,32,1325,649,676
050,01,051,"Alabama","Elmore County",3,33,1288,607,681
050,01,051,"Alabama","Elmore County",3,34,1207,599,608
050,01,051,"Alabama","Elmore County",3,35,1180,579,601
050,01,051,"Alabama","Elmore County",3,36,1192,553,639
050,01,051,"Alabama","Elmore County",3,37,1143,535,608
050,01,051,"Alabama","Elmore County",3,38,1262,575,687
050,01,051,"Alabama","Elmore County",3,39,1133,550,583
050,01,051,"Alabama","Elmore County",3,40,1146,559,587
050,01,051,"Alabama","Elmore County",3,41,1201,575,626
050,01,051,"Alabama","Elmore County",3,42,1161,574,587
050,01,051,"Alabama","Elmore County",3,43,1084,515,569
050,01,051,"Alabama","Elmore County",3,44,1147,518,629
050,01,051,"Alabama","Elmore County",3,45,1084,530,554
050,01,051,"Alabama","Elmore County",3,46,1136,567,569
050,01,051,"Alabama","Elmore County",3,47,1139,522,617
050,01,051,"Alabama","Elmore County",3,48,1187,536,651
050,01,051,"Alabama","Elmore County",3,49,1239,585,654
050,01,051,"Alabama","Elmore County",3,50,1247,604,643
050,01,051,"Alabama","Elmore County",3,51,1177,578,599
050,01,051,"Alabama","Elmore County",3,52,1148,545,603
050,01,051,"Alabama","Elmore County",3,53,1103,523,580
050,01,051,"Alabama","Elmore County",3,54,1138,563,575
050,01,051,"Alabama","Elmore County",3,55,1098,529,569
050,01,051,"Alabama","Elmore County",3,56,1223,593,630
050,01,051,"Alabama","Elmore County",3,57,1271,621,650
050,01,051,"Alabama","Elmore County",3,58,1239,595,644
050,01,051,"Alabama","Elmore County",3,59,1225,580,645
050,01,051,"Alabama","Elmore County",3,60,1229,587,642
050,01,051,"Alabama","Elmore County",3,61,1170,558,612
050,01,051,"Alabama","Elmore County",3,62,1169,557,612
050,01,051,"Alabama","Elmore County",3,63,1154,559,595
050,01,051,"Alabama","Elmore County",3,64,1142,545,597
050,01,051,"Alabama","Elmore County",3,65,1091,540,551
050,01,051,"Alabama","Elmore County",3,66,1019,479,540
050,01,051,"Alabama","Elmore County",3,67,991,455,536
050,01,051,"Alabama","Elmore County",3,68,910,414,496
050,01,051,"Alabama","Elmore County",3,69,876,400,476
050,01,051,"Alabama","Elmore County",3,70,792,369,423
050,01,051,"Alabama","Elmore County",3,71,780,360,420
050,01,051,"Alabama","Elmore County",3,72,792,368,424
050,01,051,"Alabama","Elmore County",3,73,748,357,391
050,01,051,"Alabama","Elmore County",3,74,818,382,436
050,01,051,"Alabama","Elmore County",3,75,594,268,326
050,01,051,"Alabama","Elmore County",3,76,568,258,310
050,01,051,"Alabama","Elmore County",3,77,549,246,303
050,01,051,"Alabama","Elmore County",3,78,547,256,291
050,01,051,"Alabama","Elmore County",3,79,440,193,247
050,01,051,"Alabama","Elmore County",3,80,376,159,217
050,01,051,"Alabama","Elmore County",3,81,358,152,206
050,01,051,"Alabama","Elmore County",3,82,326,138,188
050,01,051,"Alabama","Elmore County",3,83,291,119,172
050,01,051,"Alabama","Elmore County",3,84,227,101,126
050,01,051,"Alabama","Elmore County",3,85,1233,397,836
050,01,051,"Alabama","Elmore County",4,0,926,472,454
050,01,051,"Alabama","Elmore County",4,1,932,460,472
050,01,051,"Alabama","Elmore County",4,2,958,486,472
050,01,051,"Alabama","Elmore County",4,3,990,487,503
050,01,051,"Alabama","Elmore County",4,4,1020,525,495
050,01,051,"Alabama","Elmore County",4,5,997,472,525
050,01,051,"Alabama","Elmore County",4,6,1029,539,490
050,01,051,"Alabama","Elmore County",4,7,1092,559,533
050,01,051,"Alabama","Elmore County",4,8,1104,574,530
050,01,051,"Alabama","Elmore County",4,9,1067,579,488
050,01,051,"Alabama","Elmore County",4,10,1079,576,503
050,01,051,"Alabama","Elmore County",4,11,1126,607,519
050,01,051,"Alabama","Elmore County",4,12,1136,626,510
050,01,051,"Alabama","Elmore County",4,13,1159,608,551
050,01,051,"Alabama","Elmore County",4,14,1204,602,602
050,01,051,"Alabama","Elmore County",4,15,1185,615,570
050,01,051,"Alabama","Elmore County",4,16,1217,610,607
050,01,051,"Alabama","Elmore County",4,17,1177,604,573
050,01,051,"Alabama","Elmore County",4,18,1031,539,492
050,01,051,"Alabama","Elmore County",4,19,874,476,398
050,01,051,"Alabama","Elmore County",4,20,1020,564,456
050,01,051,"Alabama","Elmore County",4,21,1098,637,461
050,01,051,"Alabama","Elmore County",4,22,1149,633,516
050,01,051,"Alabama","Elmore County",4,23,1135,591,544
050,01,051,"Alabama","Elmore County",4,24,1128,546,582
050,01,051,"Alabama","Elmore County",4,25,1065,555,510
050,01,051,"Alabama","Elmore County",4,26,1103,574,529
050,01,051,"Alabama","Elmore County",4,27,1108,541,567
050,01,051,"Alabama","Elmore County",4,28,1176,575,601
050,01,051,"Alabama","Elmore County",4,29,1279,596,683
050,01,051,"Alabama","Elmore County",4,30,1316,625,691
050,01,051,"Alabama","Elmore County",4,31,1318,634,684
050,01,051,"Alabama","Elmore County",4,32,1416,681,735
050,01,051,"Alabama","Elmore County",4,33,1400,635,765
050,01,051,"Alabama","Elmore County",4,34,1229,605,624
050,01,051,"Alabama","Elmore County",4,35,1228,620,608
050,01,051,"Alabama","Elmore County",4,36,1183,570,613
050,01,051,"Alabama","Elmore County",4,37,1201,546,655
050,01,051,"Alabama","Elmore County",4,38,1273,565,708
050,01,051,"Alabama","Elmore County",4,39,1164,584,580
050,01,051,"Alabama","Elmore County",4,40,1126,546,580
050,01,051,"Alabama","Elmore County",4,41,1208,560,648
050,01,051,"Alabama","Elmore County",4,42,1239,603,636
050,01,051,"Alabama","Elmore County",4,43,1143,553,590
050,01,051,"Alabama","Elmore County",4,44,1120,533,587
050,01,051,"Alabama","Elmore County",4,45,1100,502,598
050,01,051,"Alabama","Elmore County",4,46,1072,526,546
050,01,051,"Alabama","Elmore County",4,47,1225,570,655
050,01,051,"Alabama","Elmore County",4,48,1151,531,620
050,01,051,"Alabama","Elmore County",4,49,1202,537,665
050,01,051,"Alabama","Elmore County",4,50,1197,583,614
050,01,051,"Alabama","Elmore County",4,51,1222,601,621
050,01,051,"Alabama","Elmore County",4,52,1198,578,620
050,01,051,"Alabama","Elmore County",4,53,1142,545,597
050,01,051,"Alabama","Elmore County",4,54,1140,545,595
050,01,051,"Alabama","Elmore County",4,55,1088,533,555
050,01,051,"Alabama","Elmore County",4,56,1114,546,568
050,01,051,"Alabama","Elmore County",4,57,1205,587,618
050,01,051,"Alabama","Elmore County",4,58,1299,629,670
050,01,051,"Alabama","Elmore County",4,59,1237,593,644
050,01,051,"Alabama","Elmore County",4,60,1242,586,656
050,01,051,"Alabama","Elmore County",4,61,1274,589,685
050,01,051,"Alabama","Elmore County",4,62,1155,569,586
050,01,051,"Alabama","Elmore County",4,63,1157,555,602
050,01,051,"Alabama","Elmore County",4,64,1153,540,613
050,01,051,"Alabama","Elmore County",4,65,1141,541,600
050,01,051,"Alabama","Elmore County",4,66,1098,553,545
050,01,051,"Alabama","Elmore County",4,67,1019,469,550
050,01,051,"Alabama","Elmore County",4,68,962,449,513
050,01,051,"Alabama","Elmore County",4,69,902,397,505
050,01,051,"Alabama","Elmore County",4,70,883,410,473
050,01,051,"Alabama","Elmore County",4,71,772,362,410
050,01,051,"Alabama","Elmore County",4,72,769,343,426
050,01,051,"Alabama","Elmore County",4,73,772,357,415
050,01,051,"Alabama","Elmore County",4,74,723,347,376
050,01,051,"Alabama","Elmore County",4,75,805,380,425
050,01,051,"Alabama","Elmore County",4,76,570,252,318
050,01,051,"Alabama","Elmore County",4,77,537,241,296
050,01,051,"Alabama","Elmore County",4,78,516,231,285
050,01,051,"Alabama","Elmore County",4,79,520,246,274
050,01,051,"Alabama","Elmore County",4,80,420,180,240
050,01,051,"Alabama","Elmore County",4,81,351,150,201
050,01,051,"Alabama","Elmore County",4,82,324,135,189
050,01,051,"Alabama","Elmore County",4,83,297,118,179
050,01,051,"Alabama","Elmore County",4,84,263,104,159
050,01,051,"Alabama","Elmore County",4,85,1255,422,833
050,01,051,"Alabama","Elmore County",5,0,931,472,459
050,01,051,"Alabama","Elmore County",5,1,956,476,480
050,01,051,"Alabama","Elmore County",5,2,940,453,487
050,01,051,"Alabama","Elmore County",5,3,953,483,470
050,01,051,"Alabama","Elmore County",5,4,960,474,486
050,01,051,"Alabama","Elmore County",5,5,1054,549,505
050,01,051,"Alabama","Elmore County",5,6,1039,507,532
050,01,051,"Alabama","Elmore County",5,7,1052,553,499
050,01,051,"Alabama","Elmore County",5,8,1087,559,528
050,01,051,"Alabama","Elmore County",5,9,1122,586,536
050,01,051,"Alabama","Elmore County",5,10,1093,583,510
050,01,051,"Alabama","Elmore County",5,11,1113,576,537
050,01,051,"Alabama","Elmore County",5,12,1130,616,514
050,01,051,"Alabama","Elmore County",5,13,1171,648,523
050,01,051,"Alabama","Elmore County",5,14,1178,605,573
050,01,051,"Alabama","Elmore County",5,15,1236,615,621
050,01,051,"Alabama","Elmore County",5,16,1215,642,573
050,01,051,"Alabama","Elmore County",5,17,1201,607,594
050,01,051,"Alabama","Elmore County",5,18,1077,579,498
050,01,051,"Alabama","Elmore County",5,19,900,489,411
050,01,051,"Alabama","Elmore County",5,20,1018,560,458
050,01,051,"Alabama","Elmore County",5,21,1022,584,438
050,01,051,"Alabama","Elmore County",5,22,1184,665,519
050,01,051,"Alabama","Elmore County",5,23,1199,633,566
050,01,051,"Alabama","Elmore County",5,24,1149,584,565
050,01,051,"Alabama","Elmore County",5,25,1104,550,554
050,01,051,"Alabama","Elmore County",5,26,1077,544,533
050,01,051,"Alabama","Elmore County",5,27,1099,531,568
050,01,051,"Alabama","Elmore County",5,28,1099,556,543
050,01,051,"Alabama","Elmore County",5,29,1260,577,683
050,01,051,"Alabama","Elmore County",5,30,1236,605,631
050,01,051,"Alabama","Elmore County",5,31,1285,628,657
050,01,051,"Alabama","Elmore County",5,32,1361,648,713
050,01,051,"Alabama","Elmore County",5,33,1504,667,837
050,01,051,"Alabama","Elmore County",5,34,1348,653,695
050,01,051,"Alabama","Elmore County",5,35,1226,622,604
050,01,051,"Alabama","Elmore County",5,36,1246,603,643
050,01,051,"Alabama","Elmore County",5,37,1183,549,634
050,01,051,"Alabama","Elmore County",5,38,1335,592,743
050,01,051,"Alabama","Elmore County",5,39,1134,545,589
050,01,051,"Alabama","Elmore County",5,40,1149,575,574
050,01,051,"Alabama","Elmore County",5,41,1176,551,625
050,01,051,"Alabama","Elmore County",5,42,1215,565,650
050,01,051,"Alabama","Elmore County",5,43,1204,570,634
050,01,051,"Alabama","Elmore County",5,44,1185,585,600
050,01,051,"Alabama","Elmore County",5,45,1085,540,545
050,01,051,"Alabama","Elmore County",5,46,1102,508,594
050,01,051,"Alabama","Elmore County",5,47,1137,526,611
050,01,051,"Alabama","Elmore County",5,48,1200,561,639
050,01,051,"Alabama","Elmore County",5,49,1159,530,629
050,01,051,"Alabama","Elmore County",5,50,1155,540,615
050,01,051,"Alabama","Elmore County",5,51,1176,581,595
050,01,051,"Alabama","Elmore County",5,52,1250,603,647
050,01,051,"Alabama","Elmore County",5,53,1184,578,606
050,01,051,"Alabama","Elmore County",5,54,1184,559,625
050,01,051,"Alabama","Elmore County",5,55,1094,515,579
050,01,051,"Alabama","Elmore County",5,56,1111,533,578
050,01,051,"Alabama","Elmore County",5,57,1123,543,580
050,01,051,"Alabama","Elmore County",5,58,1209,580,629
050,01,051,"Alabama","Elmore County",5,59,1307,640,667
050,01,051,"Alabama","Elmore County",5,60,1256,603,653
050,01,051,"Alabama","Elmore County",5,61,1289,590,699
050,01,051,"Alabama","Elmore County",5,62,1237,583,654
050,01,051,"Alabama","Elmore County",5,63,1168,572,596
050,01,051,"Alabama","Elmore County",5,64,1164,559,605
050,01,051,"Alabama","Elmore County",5,65,1163,545,618
050,01,051,"Alabama","Elmore County",5,66,1145,550,595
050,01,051,"Alabama","Elmore County",5,67,1089,539,550
050,01,051,"Alabama","Elmore County",5,68,1001,460,541
050,01,051,"Alabama","Elmore County",5,69,941,431,510
050,01,051,"Alabama","Elmore County",5,70,894,394,500
050,01,051,"Alabama","Elmore County",5,71,856,392,464
050,01,051,"Alabama","Elmore County",5,72,761,349,412
050,01,051,"Alabama","Elmore County",5,73,749,326,423
050,01,051,"Alabama","Elmore County",5,74,749,350,399
050,01,051,"Alabama","Elmore County",5,75,697,337,360
050,01,051,"Alabama","Elmore County",5,76,765,358,407
050,01,051,"Alabama","Elmore County",5,77,541,234,307
050,01,051,"Alabama","Elmore County",5,78,510,229,281
050,01,051,"Alabama","Elmore County",5,79,475,214,261
050,01,051,"Alabama","Elmore County",5,80,497,234,263
050,01,051,"Alabama","Elmore County",5,81,391,175,216
050,01,051,"Alabama","Elmore County",5,82,333,139,194
050,01,051,"Alabama","Elmore County",5,83,291,115,176
050,01,051,"Alabama","Elmore County",5,84,271,107,164
050,01,051,"Alabama","Elmore County",5,85,1326,458,868
050,01,053,"Alabama","Escambia County",1,0,428,217,211
050,01,053,"Alabama","Escambia County",1,1,440,212,228
050,01,053,"Alabama","Escambia County",1,2,445,207,238
050,01,053,"Alabama","Escambia County",1,3,470,224,246
050,01,053,"Alabama","Escambia County",1,4,461,235,226
050,01,053,"Alabama","Escambia County",1,5,428,211,217
050,01,053,"Alabama","Escambia County",1,6,435,229,206
050,01,053,"Alabama","Escambia County",1,7,456,235,221
050,01,053,"Alabama","Escambia County",1,8,459,224,235
050,01,053,"Alabama","Escambia County",1,9,470,229,241
050,01,053,"Alabama","Escambia County",1,10,520,268,252
050,01,053,"Alabama","Escambia County",1,11,494,262,232
050,01,053,"Alabama","Escambia County",1,12,465,237,228
050,01,053,"Alabama","Escambia County",1,13,502,246,256
050,01,053,"Alabama","Escambia County",1,14,487,240,247
050,01,053,"Alabama","Escambia County",1,15,470,233,237
050,01,053,"Alabama","Escambia County",1,16,472,227,245
050,01,053,"Alabama","Escambia County",1,17,489,242,247
050,01,053,"Alabama","Escambia County",1,18,424,227,197
050,01,053,"Alabama","Escambia County",1,19,345,170,175
050,01,053,"Alabama","Escambia County",1,20,365,178,187
050,01,053,"Alabama","Escambia County",1,21,365,181,184
050,01,053,"Alabama","Escambia County",1,22,413,208,205
050,01,053,"Alabama","Escambia County",1,23,444,232,212
050,01,053,"Alabama","Escambia County",1,24,440,244,196
050,01,053,"Alabama","Escambia County",1,25,442,256,186
050,01,053,"Alabama","Escambia County",1,26,489,268,221
050,01,053,"Alabama","Escambia County",1,27,515,264,251
050,01,053,"Alabama","Escambia County",1,28,543,287,256
050,01,053,"Alabama","Escambia County",1,29,533,278,255
050,01,053,"Alabama","Escambia County",1,30,505,277,228
050,01,053,"Alabama","Escambia County",1,31,472,275,197
050,01,053,"Alabama","Escambia County",1,32,440,247,193
050,01,053,"Alabama","Escambia County",1,33,447,249,198
050,01,053,"Alabama","Escambia County",1,34,450,235,215
050,01,053,"Alabama","Escambia County",1,35,412,209,203
050,01,053,"Alabama","Escambia County",1,36,447,228,219
050,01,053,"Alabama","Escambia County",1,37,426,215,211
050,01,053,"Alabama","Escambia County",1,38,439,239,200
050,01,053,"Alabama","Escambia County",1,39,466,264,202
050,01,053,"Alabama","Escambia County",1,40,477,255,222
050,01,053,"Alabama","Escambia County",1,41,432,243,189
050,01,053,"Alabama","Escambia County",1,42,440,243,197
050,01,053,"Alabama","Escambia County",1,43,417,205,212
050,01,053,"Alabama","Escambia County",1,44,449,240,209
050,01,053,"Alabama","Escambia County",1,45,454,248,206
050,01,053,"Alabama","Escambia County",1,46,447,256,191
050,01,053,"Alabama","Escambia County",1,47,494,270,224
050,01,053,"Alabama","Escambia County",1,48,492,253,239
050,01,053,"Alabama","Escambia County",1,49,523,271,252
050,01,053,"Alabama","Escambia County",1,50,477,245,232
050,01,053,"Alabama","Escambia County",1,51,421,212,209
050,01,053,"Alabama","Escambia County",1,52,439,231,208
050,01,053,"Alabama","Escambia County",1,53,462,240,222
050,01,053,"Alabama","Escambia County",1,54,455,238,217
050,01,053,"Alabama","Escambia County",1,55,471,235,236
050,01,053,"Alabama","Escambia County",1,56,499,255,244
050,01,053,"Alabama","Escambia County",1,57,492,243,249
050,01,053,"Alabama","Escambia County",1,58,500,242,258
050,01,053,"Alabama","Escambia County",1,59,524,262,262
050,01,053,"Alabama","Escambia County",1,60,513,248,265
050,01,053,"Alabama","Escambia County",1,61,472,234,238
050,01,053,"Alabama","Escambia County",1,62,446,221,225
050,01,053,"Alabama","Escambia County",1,63,464,223,241
050,01,053,"Alabama","Escambia County",1,64,455,193,262
050,01,053,"Alabama","Escambia County",1,65,451,201,250
050,01,053,"Alabama","Escambia County",1,66,435,204,231
050,01,053,"Alabama","Escambia County",1,67,424,185,239
050,01,053,"Alabama","Escambia County",1,68,417,189,228
050,01,053,"Alabama","Escambia County",1,69,400,193,207
050,01,053,"Alabama","Escambia County",1,70,392,177,215
050,01,053,"Alabama","Escambia County",1,71,360,155,205
050,01,053,"Alabama","Escambia County",1,72,370,163,207
050,01,053,"Alabama","Escambia County",1,73,363,173,190
050,01,053,"Alabama","Escambia County",1,74,296,122,174
050,01,053,"Alabama","Escambia County",1,75,280,116,164
050,01,053,"Alabama","Escambia County",1,76,296,130,166
050,01,053,"Alabama","Escambia County",1,77,288,119,169
050,01,053,"Alabama","Escambia County",1,78,243,102,141
050,01,053,"Alabama","Escambia County",1,79,230,79,151
050,01,053,"Alabama","Escambia County",1,80,207,83,124
050,01,053,"Alabama","Escambia County",1,81,207,87,120
050,01,053,"Alabama","Escambia County",1,82,176,74,102
050,01,053,"Alabama","Escambia County",1,83,166,67,99
050,01,053,"Alabama","Escambia County",1,84,134,48,86
050,01,053,"Alabama","Escambia County",1,85,705,225,480
050,01,053,"Alabama","Escambia County",2,0,417,219,198
050,01,053,"Alabama","Escambia County",2,1,436,211,225
050,01,053,"Alabama","Escambia County",2,2,440,208,232
050,01,053,"Alabama","Escambia County",2,3,464,223,241
050,01,053,"Alabama","Escambia County",2,4,464,233,231
050,01,053,"Alabama","Escambia County",2,5,437,218,219
050,01,053,"Alabama","Escambia County",2,6,431,224,207
050,01,053,"Alabama","Escambia County",2,7,447,230,217
050,01,053,"Alabama","Escambia County",2,8,456,225,231
050,01,053,"Alabama","Escambia County",2,9,466,228,238
050,01,053,"Alabama","Escambia County",2,10,505,258,247
050,01,053,"Alabama","Escambia County",2,11,495,261,234
050,01,053,"Alabama","Escambia County",2,12,473,243,230
050,01,053,"Alabama","Escambia County",2,13,489,241,248
050,01,053,"Alabama","Escambia County",2,14,489,241,248
050,01,053,"Alabama","Escambia County",2,15,472,233,239
050,01,053,"Alabama","Escambia County",2,16,473,230,243
050,01,053,"Alabama","Escambia County",2,17,482,239,243
050,01,053,"Alabama","Escambia County",2,18,417,219,198
050,01,053,"Alabama","Escambia County",2,19,350,177,173
050,01,053,"Alabama","Escambia County",2,20,368,180,188
050,01,053,"Alabama","Escambia County",2,21,367,180,187
050,01,053,"Alabama","Escambia County",2,22,409,207,202
050,01,053,"Alabama","Escambia County",2,23,445,231,214
050,01,053,"Alabama","Escambia County",2,24,443,243,200
050,01,053,"Alabama","Escambia County",2,25,443,254,189
050,01,053,"Alabama","Escambia County",2,26,481,270,211
050,01,053,"Alabama","Escambia County",2,27,505,262,243
050,01,053,"Alabama","Escambia County",2,28,536,283,253
050,01,053,"Alabama","Escambia County",2,29,534,282,252
050,01,053,"Alabama","Escambia County",2,30,516,281,235
050,01,053,"Alabama","Escambia County",2,31,481,279,202
050,01,053,"Alabama","Escambia County",2,32,444,250,194
050,01,053,"Alabama","Escambia County",2,33,447,246,201
050,01,053,"Alabama","Escambia County",2,34,445,236,209
050,01,053,"Alabama","Escambia County",2,35,423,215,208
050,01,053,"Alabama","Escambia County",2,36,433,221,212
050,01,053,"Alabama","Escambia County",2,37,430,217,213
050,01,053,"Alabama","Escambia County",2,38,441,237,204
050,01,053,"Alabama","Escambia County",2,39,458,256,202
050,01,053,"Alabama","Escambia County",2,40,473,254,219
050,01,053,"Alabama","Escambia County",2,41,444,247,197
050,01,053,"Alabama","Escambia County",2,42,435,241,194
050,01,053,"Alabama","Escambia County",2,43,419,211,208
050,01,053,"Alabama","Escambia County",2,44,440,235,205
050,01,053,"Alabama","Escambia County",2,45,452,243,209
050,01,053,"Alabama","Escambia County",2,46,448,253,195
050,01,053,"Alabama","Escambia County",2,47,478,264,214
050,01,053,"Alabama","Escambia County",2,48,492,257,235
050,01,053,"Alabama","Escambia County",2,49,519,269,250
050,01,053,"Alabama","Escambia County",2,50,489,252,237
050,01,053,"Alabama","Escambia County",2,51,426,214,212
050,01,053,"Alabama","Escambia County",2,52,438,228,210
050,01,053,"Alabama","Escambia County",2,53,453,236,217
050,01,053,"Alabama","Escambia County",2,54,453,236,217
050,01,053,"Alabama","Escambia County",2,55,464,233,231
050,01,053,"Alabama","Escambia County",2,56,497,253,244
050,01,053,"Alabama","Escambia County",2,57,490,245,245
050,01,053,"Alabama","Escambia County",2,58,493,241,252
050,01,053,"Alabama","Escambia County",2,59,523,260,263
050,01,053,"Alabama","Escambia County",2,60,512,248,264
050,01,053,"Alabama","Escambia County",2,61,480,237,243
050,01,053,"Alabama","Escambia County",2,62,449,222,227
050,01,053,"Alabama","Escambia County",2,63,461,223,238
050,01,053,"Alabama","Escambia County",2,64,452,196,256
050,01,053,"Alabama","Escambia County",2,65,449,197,252
050,01,053,"Alabama","Escambia County",2,66,437,200,237
050,01,053,"Alabama","Escambia County",2,67,420,186,234
050,01,053,"Alabama","Escambia County",2,68,413,186,227
050,01,053,"Alabama","Escambia County",2,69,405,193,212
050,01,053,"Alabama","Escambia County",2,70,394,181,213
050,01,053,"Alabama","Escambia County",2,71,366,161,205
050,01,053,"Alabama","Escambia County",2,72,358,156,202
050,01,053,"Alabama","Escambia County",2,73,381,179,202
050,01,053,"Alabama","Escambia County",2,74,292,124,168
050,01,053,"Alabama","Escambia County",2,75,282,118,164
050,01,053,"Alabama","Escambia County",2,76,286,123,163
050,01,053,"Alabama","Escambia County",2,77,297,123,174
050,01,053,"Alabama","Escambia County",2,78,245,102,143
050,01,053,"Alabama","Escambia County",2,79,230,82,148
050,01,053,"Alabama","Escambia County",2,80,210,81,129
050,01,053,"Alabama","Escambia County",2,81,204,86,118
050,01,053,"Alabama","Escambia County",2,82,179,78,101
050,01,053,"Alabama","Escambia County",2,83,162,64,98
050,01,053,"Alabama","Escambia County",2,84,139,53,86
050,01,053,"Alabama","Escambia County",2,85,704,220,484
050,01,053,"Alabama","Escambia County",3,0,435,229,206
050,01,053,"Alabama","Escambia County",3,1,415,228,187
050,01,053,"Alabama","Escambia County",3,2,442,220,222
050,01,053,"Alabama","Escambia County",3,3,434,208,226
050,01,053,"Alabama","Escambia County",3,4,471,218,253
050,01,053,"Alabama","Escambia County",3,5,466,226,240
050,01,053,"Alabama","Escambia County",3,6,422,205,217
050,01,053,"Alabama","Escambia County",3,7,447,235,212
050,01,053,"Alabama","Escambia County",3,8,461,242,219
050,01,053,"Alabama","Escambia County",3,9,474,227,247
050,01,053,"Alabama","Escambia County",3,10,485,242,243
050,01,053,"Alabama","Escambia County",3,11,488,252,236
050,01,053,"Alabama","Escambia County",3,12,497,261,236
050,01,053,"Alabama","Escambia County",3,13,489,254,235
050,01,053,"Alabama","Escambia County",3,14,505,247,258
050,01,053,"Alabama","Escambia County",3,15,490,238,252
050,01,053,"Alabama","Escambia County",3,16,471,230,241
050,01,053,"Alabama","Escambia County",3,17,471,231,240
050,01,053,"Alabama","Escambia County",3,18,418,216,202
050,01,053,"Alabama","Escambia County",3,19,360,190,170
050,01,053,"Alabama","Escambia County",3,20,369,179,190
050,01,053,"Alabama","Escambia County",3,21,384,186,198
050,01,053,"Alabama","Escambia County",3,22,396,195,201
050,01,053,"Alabama","Escambia County",3,23,418,217,201
050,01,053,"Alabama","Escambia County",3,24,461,241,220
050,01,053,"Alabama","Escambia County",3,25,444,248,196
050,01,053,"Alabama","Escambia County",3,26,441,252,189
050,01,053,"Alabama","Escambia County",3,27,473,257,216
050,01,053,"Alabama","Escambia County",3,28,488,262,226
050,01,053,"Alabama","Escambia County",3,29,535,287,248
050,01,053,"Alabama","Escambia County",3,30,533,284,249
050,01,053,"Alabama","Escambia County",3,31,541,303,238
050,01,053,"Alabama","Escambia County",3,32,494,287,207
050,01,053,"Alabama","Escambia County",3,33,457,246,211
050,01,053,"Alabama","Escambia County",3,34,419,220,199
050,01,053,"Alabama","Escambia County",3,35,438,235,203
050,01,053,"Alabama","Escambia County",3,36,450,222,228
050,01,053,"Alabama","Escambia County",3,37,429,218,211
050,01,053,"Alabama","Escambia County",3,38,431,219,212
050,01,053,"Alabama","Escambia County",3,39,464,257,207
050,01,053,"Alabama","Escambia County",3,40,439,236,203
050,01,053,"Alabama","Escambia County",3,41,479,264,215
050,01,053,"Alabama","Escambia County",3,42,444,245,199
050,01,053,"Alabama","Escambia County",3,43,430,230,200
050,01,053,"Alabama","Escambia County",3,44,440,233,207
050,01,053,"Alabama","Escambia County",3,45,413,209,204
050,01,053,"Alabama","Escambia County",3,46,449,237,212
050,01,053,"Alabama","Escambia County",3,47,455,260,195
050,01,053,"Alabama","Escambia County",3,48,487,266,221
050,01,053,"Alabama","Escambia County",3,49,495,262,233
050,01,053,"Alabama","Escambia County",3,50,522,275,247
050,01,053,"Alabama","Escambia County",3,51,481,233,248
050,01,053,"Alabama","Escambia County",3,52,439,224,215
050,01,053,"Alabama","Escambia County",3,53,431,223,208
050,01,053,"Alabama","Escambia County",3,54,441,229,212
050,01,053,"Alabama","Escambia County",3,55,450,231,219
050,01,053,"Alabama","Escambia County",3,56,469,237,232
050,01,053,"Alabama","Escambia County",3,57,484,241,243
050,01,053,"Alabama","Escambia County",3,58,481,243,238
050,01,053,"Alabama","Escambia County",3,59,497,243,254
050,01,053,"Alabama","Escambia County",3,60,503,245,258
050,01,053,"Alabama","Escambia County",3,61,515,245,270
050,01,053,"Alabama","Escambia County",3,62,470,238,232
050,01,053,"Alabama","Escambia County",3,63,439,218,221
050,01,053,"Alabama","Escambia County",3,64,449,216,233
050,01,053,"Alabama","Escambia County",3,65,442,195,247
050,01,053,"Alabama","Escambia County",3,66,432,188,244
050,01,053,"Alabama","Escambia County",3,67,421,197,224
050,01,053,"Alabama","Escambia County",3,68,414,184,230
050,01,053,"Alabama","Escambia County",3,69,399,176,223
050,01,053,"Alabama","Escambia County",3,70,390,187,203
050,01,053,"Alabama","Escambia County",3,71,381,175,206
050,01,053,"Alabama","Escambia County",3,72,353,154,199
050,01,053,"Alabama","Escambia County",3,73,344,149,195
050,01,053,"Alabama","Escambia County",3,74,371,165,206
050,01,053,"Alabama","Escambia County",3,75,275,119,156
050,01,053,"Alabama","Escambia County",3,76,268,107,161
050,01,053,"Alabama","Escambia County",3,77,271,109,162
050,01,053,"Alabama","Escambia County",3,78,285,118,167
050,01,053,"Alabama","Escambia County",3,79,218,90,128
050,01,053,"Alabama","Escambia County",3,80,204,70,134
050,01,053,"Alabama","Escambia County",3,81,193,69,124
050,01,053,"Alabama","Escambia County",3,82,186,84,102
050,01,053,"Alabama","Escambia County",3,83,158,65,93
050,01,053,"Alabama","Escambia County",3,84,143,60,83
050,01,053,"Alabama","Escambia County",3,85,704,217,487
050,01,053,"Alabama","Escambia County",4,0,412,226,186
050,01,053,"Alabama","Escambia County",4,1,470,259,211
050,01,053,"Alabama","Escambia County",4,2,420,238,182
050,01,053,"Alabama","Escambia County",4,3,440,225,215
050,01,053,"Alabama","Escambia County",4,4,455,229,226
050,01,053,"Alabama","Escambia County",4,5,446,204,242
050,01,053,"Alabama","Escambia County",4,6,474,243,231
050,01,053,"Alabama","Escambia County",4,7,425,204,221
050,01,053,"Alabama","Escambia County",4,8,448,233,215
050,01,053,"Alabama","Escambia County",4,9,458,238,220
050,01,053,"Alabama","Escambia County",4,10,472,223,249
050,01,053,"Alabama","Escambia County",4,11,469,232,237
050,01,053,"Alabama","Escambia County",4,12,482,250,232
050,01,053,"Alabama","Escambia County",4,13,501,268,233
050,01,053,"Alabama","Escambia County",4,14,492,256,236
050,01,053,"Alabama","Escambia County",4,15,504,250,254
050,01,053,"Alabama","Escambia County",4,16,497,242,255
050,01,053,"Alabama","Escambia County",4,17,470,228,242
050,01,053,"Alabama","Escambia County",4,18,395,198,197
050,01,053,"Alabama","Escambia County",4,19,350,183,167
050,01,053,"Alabama","Escambia County",4,20,386,197,189
050,01,053,"Alabama","Escambia County",4,21,389,185,204
050,01,053,"Alabama","Escambia County",4,22,416,205,211
050,01,053,"Alabama","Escambia County",4,23,420,218,202
050,01,053,"Alabama","Escambia County",4,24,431,228,203
050,01,053,"Alabama","Escambia County",4,25,466,240,226
050,01,053,"Alabama","Escambia County",4,26,442,242,200
050,01,053,"Alabama","Escambia County",4,27,445,247,198
050,01,053,"Alabama","Escambia County",4,28,482,262,220
050,01,053,"Alabama","Escambia County",4,29,494,265,229
050,01,053,"Alabama","Escambia County",4,30,547,293,254
050,01,053,"Alabama","Escambia County",4,31,542,302,240
050,01,053,"Alabama","Escambia County",4,32,532,286,246
050,01,053,"Alabama","Escambia County",4,33,503,286,217
050,01,053,"Alabama","Escambia County",4,34,446,235,211
050,01,053,"Alabama","Escambia County",4,35,422,215,207
050,01,053,"Alabama","Escambia County",4,36,440,244,196
050,01,053,"Alabama","Escambia County",4,37,449,229,220
050,01,053,"Alabama","Escambia County",4,38,446,236,210
050,01,053,"Alabama","Escambia County",4,39,440,227,213
050,01,053,"Alabama","Escambia County",4,40,428,226,202
050,01,053,"Alabama","Escambia County",4,41,440,228,212
050,01,053,"Alabama","Escambia County",4,42,482,257,225
050,01,053,"Alabama","Escambia County",4,43,440,232,208
050,01,053,"Alabama","Escambia County",4,44,458,256,202
050,01,053,"Alabama","Escambia County",4,45,434,222,212
050,01,053,"Alabama","Escambia County",4,46,403,207,196
050,01,053,"Alabama","Escambia County",4,47,432,228,204
050,01,053,"Alabama","Escambia County",4,48,452,258,194
050,01,053,"Alabama","Escambia County",4,49,488,262,226
050,01,053,"Alabama","Escambia County",4,50,496,262,234
050,01,053,"Alabama","Escambia County",4,51,516,266,250
050,01,053,"Alabama","Escambia County",4,52,494,247,247
050,01,053,"Alabama","Escambia County",4,53,445,221,224
050,01,053,"Alabama","Escambia County",4,54,422,219,203
050,01,053,"Alabama","Escambia County",4,55,430,213,217
050,01,053,"Alabama","Escambia County",4,56,462,239,223
050,01,053,"Alabama","Escambia County",4,57,450,224,226
050,01,053,"Alabama","Escambia County",4,58,470,227,243
050,01,053,"Alabama","Escambia County",4,59,490,252,238
050,01,053,"Alabama","Escambia County",4,60,496,236,260
050,01,053,"Alabama","Escambia County",4,61,492,236,256
050,01,053,"Alabama","Escambia County",4,62,515,245,270
050,01,053,"Alabama","Escambia County",4,63,468,235,233
050,01,053,"Alabama","Escambia County",4,64,424,211,213
050,01,053,"Alabama","Escambia County",4,65,439,208,231
050,01,053,"Alabama","Escambia County",4,66,448,196,252
050,01,053,"Alabama","Escambia County",4,67,422,181,241
050,01,053,"Alabama","Escambia County",4,68,407,191,216
050,01,053,"Alabama","Escambia County",4,69,403,175,228
050,01,053,"Alabama","Escambia County",4,70,384,177,207
050,01,053,"Alabama","Escambia County",4,71,381,183,198
050,01,053,"Alabama","Escambia County",4,72,362,163,199
050,01,053,"Alabama","Escambia County",4,73,340,144,196
050,01,053,"Alabama","Escambia County",4,74,328,139,189
050,01,053,"Alabama","Escambia County",4,75,350,163,187
050,01,053,"Alabama","Escambia County",4,76,261,112,149
050,01,053,"Alabama","Escambia County",4,77,253,95,158
050,01,053,"Alabama","Escambia County",4,78,259,103,156
050,01,053,"Alabama","Escambia County",4,79,264,106,158
050,01,053,"Alabama","Escambia County",4,80,203,85,118
050,01,053,"Alabama","Escambia County",4,81,191,64,127
050,01,053,"Alabama","Escambia County",4,82,173,65,108
050,01,053,"Alabama","Escambia County",4,83,168,72,96
050,01,053,"Alabama","Escambia County",4,84,146,63,83
050,01,053,"Alabama","Escambia County",4,85,709,221,488
050,01,053,"Alabama","Escambia County",5,0,424,231,193
050,01,053,"Alabama","Escambia County",5,1,394,210,184
050,01,053,"Alabama","Escambia County",5,2,478,263,215
050,01,053,"Alabama","Escambia County",5,3,420,240,180
050,01,053,"Alabama","Escambia County",5,4,437,224,213
050,01,053,"Alabama","Escambia County",5,5,439,227,212
050,01,053,"Alabama","Escambia County",5,6,444,209,235
050,01,053,"Alabama","Escambia County",5,7,473,243,230
050,01,053,"Alabama","Escambia County",5,8,425,203,222
050,01,053,"Alabama","Escambia County",5,9,460,239,221
050,01,053,"Alabama","Escambia County",5,10,466,242,224
050,01,053,"Alabama","Escambia County",5,11,465,223,242
050,01,053,"Alabama","Escambia County",5,12,480,239,241
050,01,053,"Alabama","Escambia County",5,13,480,252,228
050,01,053,"Alabama","Escambia County",5,14,509,275,234
050,01,053,"Alabama","Escambia County",5,15,485,252,233
050,01,053,"Alabama","Escambia County",5,16,509,253,256
050,01,053,"Alabama","Escambia County",5,17,488,235,253
050,01,053,"Alabama","Escambia County",5,18,397,200,197
050,01,053,"Alabama","Escambia County",5,19,328,163,165
050,01,053,"Alabama","Escambia County",5,20,371,189,182
050,01,053,"Alabama","Escambia County",5,21,387,199,188
050,01,053,"Alabama","Escambia County",5,22,422,208,214
050,01,053,"Alabama","Escambia County",5,23,437,221,216
050,01,053,"Alabama","Escambia County",5,24,432,227,205
050,01,053,"Alabama","Escambia County",5,25,440,237,203
050,01,053,"Alabama","Escambia County",5,26,459,239,220
050,01,053,"Alabama","Escambia County",5,27,422,226,196
050,01,053,"Alabama","Escambia County",5,28,454,259,195
050,01,053,"Alabama","Escambia County",5,29,486,262,224
050,01,053,"Alabama","Escambia County",5,30,492,265,227
050,01,053,"Alabama","Escambia County",5,31,561,313,248
050,01,053,"Alabama","Escambia County",5,32,546,299,247
050,01,053,"Alabama","Escambia County",5,33,536,287,249
050,01,053,"Alabama","Escambia County",5,34,470,259,211
050,01,053,"Alabama","Escambia County",5,35,437,231,206
050,01,053,"Alabama","Escambia County",5,36,419,207,212
050,01,053,"Alabama","Escambia County",5,37,437,242,195
050,01,053,"Alabama","Escambia County",5,38,459,236,223
050,01,053,"Alabama","Escambia County",5,39,454,239,215
050,01,053,"Alabama","Escambia County",5,40,427,210,217
050,01,053,"Alabama","Escambia County",5,41,444,239,205
050,01,053,"Alabama","Escambia County",5,42,445,233,212
050,01,053,"Alabama","Escambia County",5,43,473,242,231
050,01,053,"Alabama","Escambia County",5,44,469,261,208
050,01,053,"Alabama","Escambia County",5,45,429,231,198
050,01,053,"Alabama","Escambia County",5,46,425,219,206
050,01,053,"Alabama","Escambia County",5,47,391,199,192
050,01,053,"Alabama","Escambia County",5,48,430,223,207
050,01,053,"Alabama","Escambia County",5,49,449,257,192
050,01,053,"Alabama","Escambia County",5,50,492,269,223
050,01,053,"Alabama","Escambia County",5,51,486,248,238
050,01,053,"Alabama","Escambia County",5,52,531,287,244
050,01,053,"Alabama","Escambia County",5,53,506,247,259
050,01,053,"Alabama","Escambia County",5,54,426,209,217
050,01,053,"Alabama","Escambia County",5,55,405,204,201
050,01,053,"Alabama","Escambia County",5,56,436,223,213
050,01,053,"Alabama","Escambia County",5,57,454,231,223
050,01,053,"Alabama","Escambia County",5,58,440,212,228
050,01,053,"Alabama","Escambia County",5,59,482,234,248
050,01,053,"Alabama","Escambia County",5,60,481,243,238
050,01,053,"Alabama","Escambia County",5,61,494,234,260
050,01,053,"Alabama","Escambia County",5,62,495,238,257
050,01,053,"Alabama","Escambia County",5,63,513,235,278
050,01,053,"Alabama","Escambia County",5,64,463,236,227
050,01,053,"Alabama","Escambia County",5,65,417,206,211
050,01,053,"Alabama","Escambia County",5,66,440,205,235
050,01,053,"Alabama","Escambia County",5,67,444,194,250
050,01,053,"Alabama","Escambia County",5,68,417,181,236
050,01,053,"Alabama","Escambia County",5,69,394,187,207
050,01,053,"Alabama","Escambia County",5,70,397,173,224
050,01,053,"Alabama","Escambia County",5,71,370,172,198
050,01,053,"Alabama","Escambia County",5,72,362,172,190
050,01,053,"Alabama","Escambia County",5,73,356,158,198
050,01,053,"Alabama","Escambia County",5,74,325,133,192
050,01,053,"Alabama","Escambia County",5,75,306,134,172
050,01,053,"Alabama","Escambia County",5,76,335,150,185
050,01,053,"Alabama","Escambia County",5,77,253,104,149
050,01,053,"Alabama","Escambia County",5,78,241,89,152
050,01,053,"Alabama","Escambia County",5,79,235,94,141
050,01,053,"Alabama","Escambia County",5,80,245,98,147
050,01,053,"Alabama","Escambia County",5,81,188,77,111
050,01,053,"Alabama","Escambia County",5,82,176,63,113
050,01,053,"Alabama","Escambia County",5,83,155,55,100
050,01,053,"Alabama","Escambia County",5,84,153,69,84
050,01,053,"Alabama","Escambia County",5,85,741,233,508
050,01,055,"Alabama","Etowah County",1,0,1174,608,566
050,01,055,"Alabama","Etowah County",1,1,1168,619,549
050,01,055,"Alabama","Etowah County",1,2,1215,590,625
050,01,055,"Alabama","Etowah County",1,3,1246,640,606
050,01,055,"Alabama","Etowah County",1,4,1232,652,580
050,01,055,"Alabama","Etowah County",1,5,1217,650,567
050,01,055,"Alabama","Etowah County",1,6,1208,623,585
050,01,055,"Alabama","Etowah County",1,7,1174,617,557
050,01,055,"Alabama","Etowah County",1,8,1183,630,553
050,01,055,"Alabama","Etowah County",1,9,1234,658,576
050,01,055,"Alabama","Etowah County",1,10,1324,689,635
050,01,055,"Alabama","Etowah County",1,11,1306,689,617
050,01,055,"Alabama","Etowah County",1,12,1298,664,634
050,01,055,"Alabama","Etowah County",1,13,1354,673,681
050,01,055,"Alabama","Etowah County",1,14,1293,649,644
050,01,055,"Alabama","Etowah County",1,15,1288,667,621
050,01,055,"Alabama","Etowah County",1,16,1296,668,628
050,01,055,"Alabama","Etowah County",1,17,1324,680,644
050,01,055,"Alabama","Etowah County",1,18,1186,596,590
050,01,055,"Alabama","Etowah County",1,19,1038,542,496
050,01,055,"Alabama","Etowah County",1,20,1082,558,524
050,01,055,"Alabama","Etowah County",1,21,1169,589,580
050,01,055,"Alabama","Etowah County",1,22,1196,615,581
050,01,055,"Alabama","Etowah County",1,23,1220,597,623
050,01,055,"Alabama","Etowah County",1,24,1258,647,611
050,01,055,"Alabama","Etowah County",1,25,1267,637,630
050,01,055,"Alabama","Etowah County",1,26,1262,611,651
050,01,055,"Alabama","Etowah County",1,27,1299,642,657
050,01,055,"Alabama","Etowah County",1,28,1301,637,664
050,01,055,"Alabama","Etowah County",1,29,1354,662,692
050,01,055,"Alabama","Etowah County",1,30,1318,641,677
050,01,055,"Alabama","Etowah County",1,31,1228,591,637
050,01,055,"Alabama","Etowah County",1,32,1152,543,609
050,01,055,"Alabama","Etowah County",1,33,1131,541,590
050,01,055,"Alabama","Etowah County",1,34,1168,529,639
050,01,055,"Alabama","Etowah County",1,35,1203,599,604
050,01,055,"Alabama","Etowah County",1,36,1206,604,602
050,01,055,"Alabama","Etowah County",1,37,1239,605,634
050,01,055,"Alabama","Etowah County",1,38,1254,597,657
050,01,055,"Alabama","Etowah County",1,39,1267,603,664
050,01,055,"Alabama","Etowah County",1,40,1255,595,660
050,01,055,"Alabama","Etowah County",1,41,1219,570,649
050,01,055,"Alabama","Etowah County",1,42,1227,584,643
050,01,055,"Alabama","Etowah County",1,43,1212,583,629
050,01,055,"Alabama","Etowah County",1,44,1206,615,591
050,01,055,"Alabama","Etowah County",1,45,1284,629,655
050,01,055,"Alabama","Etowah County",1,46,1337,640,697
050,01,055,"Alabama","Etowah County",1,47,1384,669,715
050,01,055,"Alabama","Etowah County",1,48,1427,722,705
050,01,055,"Alabama","Etowah County",1,49,1509,735,774
050,01,055,"Alabama","Etowah County",1,50,1497,747,750
050,01,055,"Alabama","Etowah County",1,51,1437,728,709
050,01,055,"Alabama","Etowah County",1,52,1351,675,676
050,01,055,"Alabama","Etowah County",1,53,1327,665,662
050,01,055,"Alabama","Etowah County",1,54,1339,656,683
050,01,055,"Alabama","Etowah County",1,55,1452,697,755
050,01,055,"Alabama","Etowah County",1,56,1359,668,691
050,01,055,"Alabama","Etowah County",1,57,1371,668,703
050,01,055,"Alabama","Etowah County",1,58,1419,680,739
050,01,055,"Alabama","Etowah County",1,59,1473,706,767
050,01,055,"Alabama","Etowah County",1,60,1450,720,730
050,01,055,"Alabama","Etowah County",1,61,1422,677,745
050,01,055,"Alabama","Etowah County",1,62,1487,725,762
050,01,055,"Alabama","Etowah County",1,63,1445,715,730
050,01,055,"Alabama","Etowah County",1,64,1374,656,718
050,01,055,"Alabama","Etowah County",1,65,1342,617,725
050,01,055,"Alabama","Etowah County",1,66,1327,608,719
050,01,055,"Alabama","Etowah County",1,67,1287,609,678
050,01,055,"Alabama","Etowah County",1,68,1323,632,691
050,01,055,"Alabama","Etowah County",1,69,1228,580,648
050,01,055,"Alabama","Etowah County",1,70,1208,538,670
050,01,055,"Alabama","Etowah County",1,71,1192,533,659
050,01,055,"Alabama","Etowah County",1,72,1233,566,667
050,01,055,"Alabama","Etowah County",1,73,1231,591,640
050,01,055,"Alabama","Etowah County",1,74,814,369,445
050,01,055,"Alabama","Etowah County",1,75,815,354,461
050,01,055,"Alabama","Etowah County",1,76,759,338,421
050,01,055,"Alabama","Etowah County",1,77,751,329,422
050,01,055,"Alabama","Etowah County",1,78,675,291,384
050,01,055,"Alabama","Etowah County",1,79,575,241,334
050,01,055,"Alabama","Etowah County",1,80,562,223,339
050,01,055,"Alabama","Etowah County",1,81,526,205,321
050,01,055,"Alabama","Etowah County",1,82,450,193,257
050,01,055,"Alabama","Etowah County",1,83,378,159,219
050,01,055,"Alabama","Etowah County",1,84,376,147,229
050,01,055,"Alabama","Etowah County",1,85,1787,582,1205
050,01,055,"Alabama","Etowah County",2,0,1169,614,555
050,01,055,"Alabama","Etowah County",2,1,1168,614,554
050,01,055,"Alabama","Etowah County",2,2,1210,601,609
050,01,055,"Alabama","Etowah County",2,3,1236,628,608
050,01,055,"Alabama","Etowah County",2,4,1239,652,587
050,01,055,"Alabama","Etowah County",2,5,1223,653,570
050,01,055,"Alabama","Etowah County",2,6,1214,632,582
050,01,055,"Alabama","Etowah County",2,7,1185,621,564
050,01,055,"Alabama","Etowah County",2,8,1177,625,552
050,01,055,"Alabama","Etowah County",2,9,1225,653,572
050,01,055,"Alabama","Etowah County",2,10,1308,685,623
050,01,055,"Alabama","Etowah County",2,11,1310,688,622
050,01,055,"Alabama","Etowah County",2,12,1311,675,636
050,01,055,"Alabama","Etowah County",2,13,1346,677,669
050,01,055,"Alabama","Etowah County",2,14,1312,658,654
050,01,055,"Alabama","Etowah County",2,15,1297,668,629
050,01,055,"Alabama","Etowah County",2,16,1297,671,626
050,01,055,"Alabama","Etowah County",2,17,1320,680,640
050,01,055,"Alabama","Etowah County",2,18,1165,594,571
050,01,055,"Alabama","Etowah County",2,19,1018,524,494
050,01,055,"Alabama","Etowah County",2,20,1103,566,537
050,01,055,"Alabama","Etowah County",2,21,1157,587,570
050,01,055,"Alabama","Etowah County",2,22,1199,609,590
050,01,055,"Alabama","Etowah County",2,23,1220,604,616
050,01,055,"Alabama","Etowah County",2,24,1244,632,612
050,01,055,"Alabama","Etowah County",2,25,1263,637,626
050,01,055,"Alabama","Etowah County",2,26,1267,619,648
050,01,055,"Alabama","Etowah County",2,27,1286,629,657
050,01,055,"Alabama","Etowah County",2,28,1302,639,663
050,01,055,"Alabama","Etowah County",2,29,1335,652,683
050,01,055,"Alabama","Etowah County",2,30,1337,648,689
050,01,055,"Alabama","Etowah County",2,31,1245,600,645
050,01,055,"Alabama","Etowah County",2,32,1174,553,621
050,01,055,"Alabama","Etowah County",2,33,1144,543,601
050,01,055,"Alabama","Etowah County",2,34,1163,534,629
050,01,055,"Alabama","Etowah County",2,35,1204,588,616
050,01,055,"Alabama","Etowah County",2,36,1199,598,601
050,01,055,"Alabama","Etowah County",2,37,1234,605,629
050,01,055,"Alabama","Etowah County",2,38,1254,600,654
050,01,055,"Alabama","Etowah County",2,39,1259,601,658
050,01,055,"Alabama","Etowah County",2,40,1265,601,664
050,01,055,"Alabama","Etowah County",2,41,1229,576,653
050,01,055,"Alabama","Etowah County",2,42,1221,580,641
050,01,055,"Alabama","Etowah County",2,43,1224,592,632
050,01,055,"Alabama","Etowah County",2,44,1193,601,592
050,01,055,"Alabama","Etowah County",2,45,1273,628,645
050,01,055,"Alabama","Etowah County",2,46,1317,636,681
050,01,055,"Alabama","Etowah County",2,47,1368,660,708
050,01,055,"Alabama","Etowah County",2,48,1413,706,707
050,01,055,"Alabama","Etowah County",2,49,1499,735,764
050,01,055,"Alabama","Etowah County",2,50,1500,747,753
050,01,055,"Alabama","Etowah County",2,51,1442,729,713
050,01,055,"Alabama","Etowah County",2,52,1371,689,682
050,01,055,"Alabama","Etowah County",2,53,1329,662,667
050,01,055,"Alabama","Etowah County",2,54,1334,657,677
050,01,055,"Alabama","Etowah County",2,55,1423,687,736
050,01,055,"Alabama","Etowah County",2,56,1383,673,710
050,01,055,"Alabama","Etowah County",2,57,1364,666,698
050,01,055,"Alabama","Etowah County",2,58,1403,675,728
050,01,055,"Alabama","Etowah County",2,59,1466,701,765
050,01,055,"Alabama","Etowah County",2,60,1455,715,740
050,01,055,"Alabama","Etowah County",2,61,1422,683,739
050,01,055,"Alabama","Etowah County",2,62,1466,710,756
050,01,055,"Alabama","Etowah County",2,63,1470,723,747
050,01,055,"Alabama","Etowah County",2,64,1375,660,715
050,01,055,"Alabama","Etowah County",2,65,1343,621,722
050,01,055,"Alabama","Etowah County",2,66,1326,610,716
050,01,055,"Alabama","Etowah County",2,67,1287,603,684
050,01,055,"Alabama","Etowah County",2,68,1293,616,677
050,01,055,"Alabama","Etowah County",2,69,1257,596,661
050,01,055,"Alabama","Etowah County",2,70,1206,545,661
050,01,055,"Alabama","Etowah County",2,71,1197,535,662
050,01,055,"Alabama","Etowah County",2,72,1191,541,650
050,01,055,"Alabama","Etowah County",2,73,1277,605,672
050,01,055,"Alabama","Etowah County",2,74,852,392,460
050,01,055,"Alabama","Etowah County",2,75,818,361,457
050,01,055,"Alabama","Etowah County",2,76,760,337,423
050,01,055,"Alabama","Etowah County",2,77,766,335,431
050,01,055,"Alabama","Etowah County",2,78,674,290,384
050,01,055,"Alabama","Etowah County",2,79,585,248,337
050,01,055,"Alabama","Etowah County",2,80,552,219,333
050,01,055,"Alabama","Etowah County",2,81,529,210,319
050,01,055,"Alabama","Etowah County",2,82,464,192,272
050,01,055,"Alabama","Etowah County",2,83,382,161,221
050,01,055,"Alabama","Etowah County",2,84,365,145,220
050,01,055,"Alabama","Etowah County",2,85,1805,590,1215
050,01,055,"Alabama","Etowah County",3,0,1086,575,511
050,01,055,"Alabama","Etowah County",3,1,1181,621,560
050,01,055,"Alabama","Etowah County",3,2,1194,629,565
050,01,055,"Alabama","Etowah County",3,3,1191,590,601
050,01,055,"Alabama","Etowah County",3,4,1258,636,622
050,01,055,"Alabama","Etowah County",3,5,1252,650,602
050,01,055,"Alabama","Etowah County",3,6,1246,663,583
050,01,055,"Alabama","Etowah County",3,7,1226,640,586
050,01,055,"Alabama","Etowah County",3,8,1206,630,576
050,01,055,"Alabama","Etowah County",3,9,1193,631,562
050,01,055,"Alabama","Etowah County",3,10,1209,649,560
050,01,055,"Alabama","Etowah County",3,11,1337,706,631
050,01,055,"Alabama","Etowah County",3,12,1302,685,617
050,01,055,"Alabama","Etowah County",3,13,1308,671,637
050,01,055,"Alabama","Etowah County",3,14,1343,680,663
050,01,055,"Alabama","Etowah County",3,15,1330,672,658
050,01,055,"Alabama","Etowah County",3,16,1263,657,606
050,01,055,"Alabama","Etowah County",3,17,1302,677,625
050,01,055,"Alabama","Etowah County",3,18,1163,613,550
050,01,055,"Alabama","Etowah County",3,19,952,489,463
050,01,055,"Alabama","Etowah County",3,20,1099,554,545
050,01,055,"Alabama","Etowah County",3,21,1148,588,560
050,01,055,"Alabama","Etowah County",3,22,1202,604,598
050,01,055,"Alabama","Etowah County",3,23,1250,627,623
050,01,055,"Alabama","Etowah County",3,24,1244,618,626
050,01,055,"Alabama","Etowah County",3,25,1238,636,602
050,01,055,"Alabama","Etowah County",3,26,1256,620,636
050,01,055,"Alabama","Etowah County",3,27,1290,628,662
050,01,055,"Alabama","Etowah County",3,28,1280,621,659
050,01,055,"Alabama","Etowah County",3,29,1298,635,663
050,01,055,"Alabama","Etowah County",3,30,1320,628,692
050,01,055,"Alabama","Etowah County",3,31,1337,651,686
050,01,055,"Alabama","Etowah County",3,32,1280,603,677
050,01,055,"Alabama","Etowah County",3,33,1154,537,617
050,01,055,"Alabama","Etowah County",3,34,1152,551,601
050,01,055,"Alabama","Etowah County",3,35,1184,555,629
050,01,055,"Alabama","Etowah County",3,36,1192,570,622
050,01,055,"Alabama","Etowah County",3,37,1211,604,607
050,01,055,"Alabama","Etowah County",3,38,1219,589,630
050,01,055,"Alabama","Etowah County",3,39,1276,613,663
050,01,055,"Alabama","Etowah County",3,40,1235,587,648
050,01,055,"Alabama","Etowah County",3,41,1268,605,663
050,01,055,"Alabama","Etowah County",3,42,1215,566,649
050,01,055,"Alabama","Etowah County",3,43,1237,580,657
050,01,055,"Alabama","Etowah County",3,44,1221,593,628
050,01,055,"Alabama","Etowah County",3,45,1199,594,605
050,01,055,"Alabama","Etowah County",3,46,1289,647,642
050,01,055,"Alabama","Etowah County",3,47,1331,637,694
050,01,055,"Alabama","Etowah County",3,48,1350,659,691
050,01,055,"Alabama","Etowah County",3,49,1404,695,709
050,01,055,"Alabama","Etowah County",3,50,1509,753,756
050,01,055,"Alabama","Etowah County",3,51,1505,750,755
050,01,055,"Alabama","Etowah County",3,52,1457,726,731
050,01,055,"Alabama","Etowah County",3,53,1339,663,676
050,01,055,"Alabama","Etowah County",3,54,1300,652,648
050,01,055,"Alabama","Etowah County",3,55,1317,652,665
050,01,055,"Alabama","Etowah County",3,56,1401,677,724
050,01,055,"Alabama","Etowah County",3,57,1338,640,698
050,01,055,"Alabama","Etowah County",3,58,1336,664,672
050,01,055,"Alabama","Etowah County",3,59,1397,667,730
050,01,055,"Alabama","Etowah County",3,60,1445,694,751
050,01,055,"Alabama","Etowah County",3,61,1455,704,751
050,01,055,"Alabama","Etowah County",3,62,1399,671,728
050,01,055,"Alabama","Etowah County",3,63,1427,688,739
050,01,055,"Alabama","Etowah County",3,64,1449,705,744
050,01,055,"Alabama","Etowah County",3,65,1342,628,714
050,01,055,"Alabama","Etowah County",3,66,1326,608,718
050,01,055,"Alabama","Etowah County",3,67,1294,600,694
050,01,055,"Alabama","Etowah County",3,68,1257,593,664
050,01,055,"Alabama","Etowah County",3,69,1249,586,663
050,01,055,"Alabama","Etowah County",3,70,1213,567,646
050,01,055,"Alabama","Etowah County",3,71,1162,531,631
050,01,055,"Alabama","Etowah County",3,72,1168,518,650
050,01,055,"Alabama","Etowah County",3,73,1144,519,625
050,01,055,"Alabama","Etowah County",3,74,1225,570,655
050,01,055,"Alabama","Etowah County",3,75,822,372,450
050,01,055,"Alabama","Etowah County",3,76,763,332,431
050,01,055,"Alabama","Etowah County",3,77,699,312,387
050,01,055,"Alabama","Etowah County",3,78,736,312,424
050,01,055,"Alabama","Etowah County",3,79,606,257,349
050,01,055,"Alabama","Etowah County",3,80,540,230,310
050,01,055,"Alabama","Etowah County",3,81,502,201,301
050,01,055,"Alabama","Etowah County",3,82,480,183,297
050,01,055,"Alabama","Etowah County",3,83,408,164,244
050,01,055,"Alabama","Etowah County",3,84,332,138,194
050,01,055,"Alabama","Etowah County",3,85,1747,580,1167
050,01,055,"Alabama","Etowah County",4,0,1146,580,566
050,01,055,"Alabama","Etowah County",4,1,1093,576,517
050,01,055,"Alabama","Etowah County",4,2,1191,624,567
050,01,055,"Alabama","Etowah County",4,3,1207,625,582
050,01,055,"Alabama","Etowah County",4,4,1220,605,615
050,01,055,"Alabama","Etowah County",4,5,1245,632,613
050,01,055,"Alabama","Etowah County",4,6,1255,646,609
050,01,055,"Alabama","Etowah County",4,7,1274,675,599
050,01,055,"Alabama","Etowah County",4,8,1238,651,587
050,01,055,"Alabama","Etowah County",4,9,1226,630,596
050,01,055,"Alabama","Etowah County",4,10,1190,637,553
050,01,055,"Alabama","Etowah County",4,11,1239,663,576
050,01,055,"Alabama","Etowah County",4,12,1331,706,625
050,01,055,"Alabama","Etowah County",4,13,1308,680,628
050,01,055,"Alabama","Etowah County",4,14,1331,692,639
050,01,055,"Alabama","Etowah County",4,15,1346,683,663
050,01,055,"Alabama","Etowah County",4,16,1321,675,646
050,01,055,"Alabama","Etowah County",4,17,1271,671,600
050,01,055,"Alabama","Etowah County",4,18,1120,599,521
050,01,055,"Alabama","Etowah County",4,19,937,501,436
050,01,055,"Alabama","Etowah County",4,20,1028,522,506
050,01,055,"Alabama","Etowah County",4,21,1155,575,580
050,01,055,"Alabama","Etowah County",4,22,1212,588,624
050,01,055,"Alabama","Etowah County",4,23,1231,609,622
050,01,055,"Alabama","Etowah County",4,24,1272,650,622
050,01,055,"Alabama","Etowah County",4,25,1243,632,611
050,01,055,"Alabama","Etowah County",4,26,1245,624,621
050,01,055,"Alabama","Etowah County",4,27,1285,637,648
050,01,055,"Alabama","Etowah County",4,28,1263,609,654
050,01,055,"Alabama","Etowah County",4,29,1270,621,649
050,01,055,"Alabama","Etowah County",4,30,1301,651,650
050,01,055,"Alabama","Etowah County",4,31,1319,629,690
050,01,055,"Alabama","Etowah County",4,32,1343,648,695
050,01,055,"Alabama","Etowah County",4,33,1260,588,672
050,01,055,"Alabama","Etowah County",4,34,1185,551,634
050,01,055,"Alabama","Etowah County",4,35,1147,564,583
050,01,055,"Alabama","Etowah County",4,36,1180,565,615
050,01,055,"Alabama","Etowah County",4,37,1205,596,609
050,01,055,"Alabama","Etowah County",4,38,1228,604,624
050,01,055,"Alabama","Etowah County",4,39,1243,594,649
050,01,055,"Alabama","Etowah County",4,40,1259,588,671
050,01,055,"Alabama","Etowah County",4,41,1237,576,661
050,01,055,"Alabama","Etowah County",4,42,1292,612,680
050,01,055,"Alabama","Etowah County",4,43,1227,575,652
050,01,055,"Alabama","Etowah County",4,44,1229,584,645
050,01,055,"Alabama","Etowah County",4,45,1210,579,631
050,01,055,"Alabama","Etowah County",4,46,1214,613,601
050,01,055,"Alabama","Etowah County",4,47,1300,648,652
050,01,055,"Alabama","Etowah County",4,48,1341,653,688
050,01,055,"Alabama","Etowah County",4,49,1345,641,704
050,01,055,"Alabama","Etowah County",4,50,1386,677,709
050,01,055,"Alabama","Etowah County",4,51,1514,753,761
050,01,055,"Alabama","Etowah County",4,52,1505,758,747
050,01,055,"Alabama","Etowah County",4,53,1447,712,735
050,01,055,"Alabama","Etowah County",4,54,1323,662,661
050,01,055,"Alabama","Etowah County",4,55,1289,649,640
050,01,055,"Alabama","Etowah County",4,56,1306,630,676
050,01,055,"Alabama","Etowah County",4,57,1392,672,720
050,01,055,"Alabama","Etowah County",4,58,1328,642,686
050,01,055,"Alabama","Etowah County",4,59,1316,644,672
050,01,055,"Alabama","Etowah County",4,60,1394,661,733
050,01,055,"Alabama","Etowah County",4,61,1428,670,758
050,01,055,"Alabama","Etowah County",4,62,1436,690,746
050,01,055,"Alabama","Etowah County",4,63,1381,663,718
050,01,055,"Alabama","Etowah County",4,64,1408,676,732
050,01,055,"Alabama","Etowah County",4,65,1414,694,720
050,01,055,"Alabama","Etowah County",4,66,1330,619,711
050,01,055,"Alabama","Etowah County",4,67,1287,586,701
050,01,055,"Alabama","Etowah County",4,68,1283,593,690
050,01,055,"Alabama","Etowah County",4,69,1233,571,662
050,01,055,"Alabama","Etowah County",4,70,1202,551,651
050,01,055,"Alabama","Etowah County",4,71,1164,546,618
050,01,055,"Alabama","Etowah County",4,72,1140,506,634
050,01,055,"Alabama","Etowah County",4,73,1115,499,616
050,01,055,"Alabama","Etowah County",4,74,1091,482,609
050,01,055,"Alabama","Etowah County",4,75,1187,549,638
050,01,055,"Alabama","Etowah County",4,76,779,345,434
050,01,055,"Alabama","Etowah County",4,77,723,324,399
050,01,055,"Alabama","Etowah County",4,78,663,289,374
050,01,055,"Alabama","Etowah County",4,79,685,288,397
050,01,055,"Alabama","Etowah County",4,80,548,235,313
050,01,055,"Alabama","Etowah County",4,81,505,216,289
050,01,055,"Alabama","Etowah County",4,82,461,187,274
050,01,055,"Alabama","Etowah County",4,83,429,160,269
050,01,055,"Alabama","Etowah County",4,84,361,141,220
050,01,055,"Alabama","Etowah County",4,85,1692,573,1119
050,01,055,"Alabama","Etowah County",5,0,1157,584,573
050,01,055,"Alabama","Etowah County",5,1,1144,585,559
050,01,055,"Alabama","Etowah County",5,2,1118,590,528
050,01,055,"Alabama","Etowah County",5,3,1196,612,584
050,01,055,"Alabama","Etowah County",5,4,1197,625,572
050,01,055,"Alabama","Etowah County",5,5,1252,630,622
050,01,055,"Alabama","Etowah County",5,6,1243,634,609
050,01,055,"Alabama","Etowah County",5,7,1291,658,633
050,01,055,"Alabama","Etowah County",5,8,1286,684,602
050,01,055,"Alabama","Etowah County",5,9,1267,666,601
050,01,055,"Alabama","Etowah County",5,10,1243,635,608
050,01,055,"Alabama","Etowah County",5,11,1216,644,572
050,01,055,"Alabama","Etowah County",5,12,1265,669,596
050,01,055,"Alabama","Etowah County",5,13,1350,721,629
050,01,055,"Alabama","Etowah County",5,14,1338,695,643
050,01,055,"Alabama","Etowah County",5,15,1344,693,651
050,01,055,"Alabama","Etowah County",5,16,1345,688,657
050,01,055,"Alabama","Etowah County",5,17,1337,668,669
050,01,055,"Alabama","Etowah County",5,18,1115,602,513
050,01,055,"Alabama","Etowah County",5,19,928,499,429
050,01,055,"Alabama","Etowah County",5,20,1019,520,499
050,01,055,"Alabama","Etowah County",5,21,1094,550,544
050,01,055,"Alabama","Etowah County",5,22,1198,590,608
050,01,055,"Alabama","Etowah County",5,23,1288,628,660
050,01,055,"Alabama","Etowah County",5,24,1266,613,653
050,01,055,"Alabama","Etowah County",5,25,1261,650,611
050,01,055,"Alabama","Etowah County",5,26,1251,637,614
050,01,055,"Alabama","Etowah County",5,27,1225,609,616
050,01,055,"Alabama","Etowah County",5,28,1299,633,666
050,01,055,"Alabama","Etowah County",5,29,1270,603,667
050,01,055,"Alabama","Etowah County",5,30,1283,632,651
050,01,055,"Alabama","Etowah County",5,31,1297,654,643
050,01,055,"Alabama","Etowah County",5,32,1309,627,682
050,01,055,"Alabama","Etowah County",5,33,1336,644,692
050,01,055,"Alabama","Etowah County",5,34,1258,589,669
050,01,055,"Alabama","Etowah County",5,35,1173,544,629
050,01,055,"Alabama","Etowah County",5,36,1138,555,583
050,01,055,"Alabama","Etowah County",5,37,1227,593,634
050,01,055,"Alabama","Etowah County",5,38,1236,610,626
050,01,055,"Alabama","Etowah County",5,39,1219,597,622
050,01,055,"Alabama","Etowah County",5,40,1262,611,651
050,01,055,"Alabama","Etowah County",5,41,1270,601,669
050,01,055,"Alabama","Etowah County",5,42,1266,590,676
050,01,055,"Alabama","Etowah County",5,43,1299,615,684
050,01,055,"Alabama","Etowah County",5,44,1237,576,661
050,01,055,"Alabama","Etowah County",5,45,1271,602,669
050,01,055,"Alabama","Etowah County",5,46,1212,586,626
050,01,055,"Alabama","Etowah County",5,47,1196,597,599
050,01,055,"Alabama","Etowah County",5,48,1286,643,643
050,01,055,"Alabama","Etowah County",5,49,1347,648,699
050,01,055,"Alabama","Etowah County",5,50,1345,649,696
050,01,055,"Alabama","Etowah County",5,51,1407,691,716
050,01,055,"Alabama","Etowah County",5,52,1527,777,750
050,01,055,"Alabama","Etowah County",5,53,1457,727,730
050,01,055,"Alabama","Etowah County",5,54,1432,715,717
050,01,055,"Alabama","Etowah County",5,55,1292,647,645
050,01,055,"Alabama","Etowah County",5,56,1273,632,641
050,01,055,"Alabama","Etowah County",5,57,1285,608,677
050,01,055,"Alabama","Etowah County",5,58,1402,687,715
050,01,055,"Alabama","Etowah County",5,59,1335,630,705
050,01,055,"Alabama","Etowah County",5,60,1321,659,662
050,01,055,"Alabama","Etowah County",5,61,1370,642,728
050,01,055,"Alabama","Etowah County",5,62,1396,655,741
050,01,055,"Alabama","Etowah County",5,63,1422,681,741
050,01,055,"Alabama","Etowah County",5,64,1357,655,702
050,01,055,"Alabama","Etowah County",5,65,1385,673,712
050,01,055,"Alabama","Etowah County",5,66,1397,684,713
050,01,055,"Alabama","Etowah County",5,67,1312,602,710
050,01,055,"Alabama","Etowah County",5,68,1259,574,685
050,01,055,"Alabama","Etowah County",5,69,1244,568,676
050,01,055,"Alabama","Etowah County",5,70,1206,548,658
050,01,055,"Alabama","Etowah County",5,71,1172,540,632
050,01,055,"Alabama","Etowah County",5,72,1150,523,627
050,01,055,"Alabama","Etowah County",5,73,1102,490,612
050,01,055,"Alabama","Etowah County",5,74,1074,476,598
050,01,055,"Alabama","Etowah County",5,75,1059,468,591
050,01,055,"Alabama","Etowah County",5,76,1137,510,627
050,01,055,"Alabama","Etowah County",5,77,742,333,409
050,01,055,"Alabama","Etowah County",5,78,691,302,389
050,01,055,"Alabama","Etowah County",5,79,626,271,355
050,01,055,"Alabama","Etowah County",5,80,627,260,367
050,01,055,"Alabama","Etowah County",5,81,518,222,296
050,01,055,"Alabama","Etowah County",5,82,459,195,264
050,01,055,"Alabama","Etowah County",5,83,428,172,256
050,01,055,"Alabama","Etowah County",5,84,384,140,244
050,01,055,"Alabama","Etowah County",5,85,1723,582,1141
050,01,057,"Alabama","Fayette County",1,0,157,80,77
050,01,057,"Alabama","Fayette County",1,1,186,95,91
050,01,057,"Alabama","Fayette County",1,2,192,92,100
050,01,057,"Alabama","Fayette County",1,3,177,86,91
050,01,057,"Alabama","Fayette County",1,4,193,100,93
050,01,057,"Alabama","Fayette County",1,5,205,103,102
050,01,057,"Alabama","Fayette County",1,6,200,91,109
050,01,057,"Alabama","Fayette County",1,7,197,94,103
050,01,057,"Alabama","Fayette County",1,8,176,88,88
050,01,057,"Alabama","Fayette County",1,9,170,94,76
050,01,057,"Alabama","Fayette County",1,10,191,106,85
050,01,057,"Alabama","Fayette County",1,11,219,114,105
050,01,057,"Alabama","Fayette County",1,12,211,113,98
050,01,057,"Alabama","Fayette County",1,13,201,105,96
050,01,057,"Alabama","Fayette County",1,14,209,107,102
050,01,057,"Alabama","Fayette County",1,15,214,110,104
050,01,057,"Alabama","Fayette County",1,16,203,100,103
050,01,057,"Alabama","Fayette County",1,17,200,109,91
050,01,057,"Alabama","Fayette County",1,18,171,88,83
050,01,057,"Alabama","Fayette County",1,19,168,88,80
050,01,057,"Alabama","Fayette County",1,20,158,90,68
050,01,057,"Alabama","Fayette County",1,21,181,101,80
050,01,057,"Alabama","Fayette County",1,22,170,95,75
050,01,057,"Alabama","Fayette County",1,23,178,86,92
050,01,057,"Alabama","Fayette County",1,24,199,105,94
050,01,057,"Alabama","Fayette County",1,25,173,81,92
050,01,057,"Alabama","Fayette County",1,26,183,84,99
050,01,057,"Alabama","Fayette County",1,27,192,103,89
050,01,057,"Alabama","Fayette County",1,28,197,98,99
050,01,057,"Alabama","Fayette County",1,29,211,107,104
050,01,057,"Alabama","Fayette County",1,30,185,98,87
050,01,057,"Alabama","Fayette County",1,31,178,94,84
050,01,057,"Alabama","Fayette County",1,32,159,77,82
050,01,057,"Alabama","Fayette County",1,33,181,87,94
050,01,057,"Alabama","Fayette County",1,34,186,79,107
050,01,057,"Alabama","Fayette County",1,35,194,88,106
050,01,057,"Alabama","Fayette County",1,36,202,98,104
050,01,057,"Alabama","Fayette County",1,37,191,99,92
050,01,057,"Alabama","Fayette County",1,38,195,99,96
050,01,057,"Alabama","Fayette County",1,39,165,89,76
050,01,057,"Alabama","Fayette County",1,40,180,93,87
050,01,057,"Alabama","Fayette County",1,41,200,102,98
050,01,057,"Alabama","Fayette County",1,42,171,83,88
050,01,057,"Alabama","Fayette County",1,43,185,94,91
050,01,057,"Alabama","Fayette County",1,44,173,87,86
050,01,057,"Alabama","Fayette County",1,45,179,89,90
050,01,057,"Alabama","Fayette County",1,46,187,90,97
050,01,057,"Alabama","Fayette County",1,47,201,95,106
050,01,057,"Alabama","Fayette County",1,48,212,110,102
050,01,057,"Alabama","Fayette County",1,49,251,121,130
050,01,057,"Alabama","Fayette County",1,50,232,117,115
050,01,057,"Alabama","Fayette County",1,51,197,100,97
050,01,057,"Alabama","Fayette County",1,52,189,98,91
050,01,057,"Alabama","Fayette County",1,53,199,97,102
050,01,057,"Alabama","Fayette County",1,54,215,104,111
050,01,057,"Alabama","Fayette County",1,55,230,112,118
050,01,057,"Alabama","Fayette County",1,56,239,128,111
050,01,057,"Alabama","Fayette County",1,57,246,130,116
050,01,057,"Alabama","Fayette County",1,58,256,136,120
050,01,057,"Alabama","Fayette County",1,59,232,119,113
050,01,057,"Alabama","Fayette County",1,60,226,106,120
050,01,057,"Alabama","Fayette County",1,61,230,103,127
050,01,057,"Alabama","Fayette County",1,62,235,98,137
050,01,057,"Alabama","Fayette County",1,63,223,103,120
050,01,057,"Alabama","Fayette County",1,64,226,112,114
050,01,057,"Alabama","Fayette County",1,65,240,130,110
050,01,057,"Alabama","Fayette County",1,66,226,113,113
050,01,057,"Alabama","Fayette County",1,67,197,95,102
050,01,057,"Alabama","Fayette County",1,68,224,98,126
050,01,057,"Alabama","Fayette County",1,69,201,97,104
050,01,057,"Alabama","Fayette County",1,70,220,101,119
050,01,057,"Alabama","Fayette County",1,71,190,88,102
050,01,057,"Alabama","Fayette County",1,72,194,86,108
050,01,057,"Alabama","Fayette County",1,73,185,84,101
050,01,057,"Alabama","Fayette County",1,74,134,54,80
050,01,057,"Alabama","Fayette County",1,75,140,64,76
050,01,057,"Alabama","Fayette County",1,76,160,79,81
050,01,057,"Alabama","Fayette County",1,77,160,69,91
050,01,057,"Alabama","Fayette County",1,78,117,47,70
050,01,057,"Alabama","Fayette County",1,79,110,42,68
050,01,057,"Alabama","Fayette County",1,80,121,53,68
050,01,057,"Alabama","Fayette County",1,81,111,55,56
050,01,057,"Alabama","Fayette County",1,82,109,48,61
050,01,057,"Alabama","Fayette County",1,83,80,32,48
050,01,057,"Alabama","Fayette County",1,84,64,27,37
050,01,057,"Alabama","Fayette County",1,85,311,113,198
050,01,057,"Alabama","Fayette County",2,0,163,90,73
050,01,057,"Alabama","Fayette County",2,1,183,93,90
050,01,057,"Alabama","Fayette County",2,2,192,94,98
050,01,057,"Alabama","Fayette County",2,3,177,87,90
050,01,057,"Alabama","Fayette County",2,4,191,99,92
050,01,057,"Alabama","Fayette County",2,5,201,102,99
050,01,057,"Alabama","Fayette County",2,6,201,95,106
050,01,057,"Alabama","Fayette County",2,7,196,92,104
050,01,057,"Alabama","Fayette County",2,8,178,89,89
050,01,057,"Alabama","Fayette County",2,9,170,92,78
050,01,057,"Alabama","Fayette County",2,10,188,105,83
050,01,057,"Alabama","Fayette County",2,11,212,113,99
050,01,057,"Alabama","Fayette County",2,12,213,113,100
050,01,057,"Alabama","Fayette County",2,13,203,106,97
050,01,057,"Alabama","Fayette County",2,14,208,107,101
050,01,057,"Alabama","Fayette County",2,15,213,109,104
050,01,057,"Alabama","Fayette County",2,16,209,104,105
050,01,057,"Alabama","Fayette County",2,17,199,105,94
050,01,057,"Alabama","Fayette County",2,18,174,90,84
050,01,057,"Alabama","Fayette County",2,19,162,86,76
050,01,057,"Alabama","Fayette County",2,20,164,91,73
050,01,057,"Alabama","Fayette County",2,21,177,100,77
050,01,057,"Alabama","Fayette County",2,22,171,94,77
050,01,057,"Alabama","Fayette County",2,23,178,89,89
050,01,057,"Alabama","Fayette County",2,24,193,98,95
050,01,057,"Alabama","Fayette County",2,25,177,85,92
050,01,057,"Alabama","Fayette County",2,26,181,85,96
050,01,057,"Alabama","Fayette County",2,27,190,98,92
050,01,057,"Alabama","Fayette County",2,28,195,98,97
050,01,057,"Alabama","Fayette County",2,29,204,102,102
050,01,057,"Alabama","Fayette County",2,30,193,100,93
050,01,057,"Alabama","Fayette County",2,31,182,95,87
050,01,057,"Alabama","Fayette County",2,32,163,80,83
050,01,057,"Alabama","Fayette County",2,33,177,85,92
050,01,057,"Alabama","Fayette County",2,34,182,80,102
050,01,057,"Alabama","Fayette County",2,35,195,88,107
050,01,057,"Alabama","Fayette County",2,36,200,95,105
050,01,057,"Alabama","Fayette County",2,37,196,99,97
050,01,057,"Alabama","Fayette County",2,38,197,100,97
050,01,057,"Alabama","Fayette County",2,39,170,90,80
050,01,057,"Alabama","Fayette County",2,40,179,93,86
050,01,057,"Alabama","Fayette County",2,41,195,100,95
050,01,057,"Alabama","Fayette County",2,42,176,86,90
050,01,057,"Alabama","Fayette County",2,43,181,92,89
050,01,057,"Alabama","Fayette County",2,44,174,87,87
050,01,057,"Alabama","Fayette County",2,45,180,89,91
050,01,057,"Alabama","Fayette County",2,46,185,90,95
050,01,057,"Alabama","Fayette County",2,47,198,95,103
050,01,057,"Alabama","Fayette County",2,48,213,109,104
050,01,057,"Alabama","Fayette County",2,49,244,119,125
050,01,057,"Alabama","Fayette County",2,50,236,117,119
050,01,057,"Alabama","Fayette County",2,51,203,103,100
050,01,057,"Alabama","Fayette County",2,52,189,97,92
050,01,057,"Alabama","Fayette County",2,53,197,97,100
050,01,057,"Alabama","Fayette County",2,54,208,101,107
050,01,057,"Alabama","Fayette County",2,55,228,111,117
050,01,057,"Alabama","Fayette County",2,56,237,125,112
050,01,057,"Alabama","Fayette County",2,57,247,131,116
050,01,057,"Alabama","Fayette County",2,58,252,133,119
050,01,057,"Alabama","Fayette County",2,59,237,121,116
050,01,057,"Alabama","Fayette County",2,60,226,109,117
050,01,057,"Alabama","Fayette County",2,61,231,104,127
050,01,057,"Alabama","Fayette County",2,62,234,99,135
050,01,057,"Alabama","Fayette County",2,63,230,104,126
050,01,057,"Alabama","Fayette County",2,64,223,109,114
050,01,057,"Alabama","Fayette County",2,65,235,126,109
050,01,057,"Alabama","Fayette County",2,66,227,117,110
050,01,057,"Alabama","Fayette County",2,67,205,99,106
050,01,057,"Alabama","Fayette County",2,68,216,96,120
050,01,057,"Alabama","Fayette County",2,69,208,97,111
050,01,057,"Alabama","Fayette County",2,70,215,100,115
050,01,057,"Alabama","Fayette County",2,71,195,90,105
050,01,057,"Alabama","Fayette County",2,72,192,86,106
050,01,057,"Alabama","Fayette County",2,73,193,87,106
050,01,057,"Alabama","Fayette County",2,74,137,56,81
050,01,057,"Alabama","Fayette County",2,75,140,64,76
050,01,057,"Alabama","Fayette County",2,76,152,74,78
050,01,057,"Alabama","Fayette County",2,77,164,73,91
050,01,057,"Alabama","Fayette County",2,78,121,49,72
050,01,057,"Alabama","Fayette County",2,79,108,41,67
050,01,057,"Alabama","Fayette County",2,80,117,49,68
050,01,057,"Alabama","Fayette County",2,81,110,53,57
050,01,057,"Alabama","Fayette County",2,82,111,51,60
050,01,057,"Alabama","Fayette County",2,83,86,36,50
050,01,057,"Alabama","Fayette County",2,84,64,26,38
050,01,057,"Alabama","Fayette County",2,85,314,113,201
050,01,057,"Alabama","Fayette County",3,0,180,87,93
050,01,057,"Alabama","Fayette County",3,1,160,86,74
050,01,057,"Alabama","Fayette County",3,2,176,90,86
050,01,057,"Alabama","Fayette County",3,3,185,93,92
050,01,057,"Alabama","Fayette County",3,4,178,88,90
050,01,057,"Alabama","Fayette County",3,5,189,100,89
050,01,057,"Alabama","Fayette County",3,6,202,100,102
050,01,057,"Alabama","Fayette County",3,7,209,102,107
050,01,057,"Alabama","Fayette County",3,8,187,90,97
050,01,057,"Alabama","Fayette County",3,9,176,86,90
050,01,057,"Alabama","Fayette County",3,10,173,98,75
050,01,057,"Alabama","Fayette County",3,11,189,105,84
050,01,057,"Alabama","Fayette County",3,12,207,111,96
050,01,057,"Alabama","Fayette County",3,13,215,111,104
050,01,057,"Alabama","Fayette County",3,14,202,109,93
050,01,057,"Alabama","Fayette County",3,15,215,108,107
050,01,057,"Alabama","Fayette County",3,16,211,106,105
050,01,057,"Alabama","Fayette County",3,17,206,101,105
050,01,057,"Alabama","Fayette County",3,18,182,96,86
050,01,057,"Alabama","Fayette County",3,19,147,82,65
050,01,057,"Alabama","Fayette County",3,20,165,89,76
050,01,057,"Alabama","Fayette County",3,21,178,93,85
050,01,057,"Alabama","Fayette County",3,22,180,96,84
050,01,057,"Alabama","Fayette County",3,23,168,87,81
050,01,057,"Alabama","Fayette County",3,24,180,90,90
050,01,057,"Alabama","Fayette County",3,25,177,95,82
050,01,057,"Alabama","Fayette County",3,26,185,93,92
050,01,057,"Alabama","Fayette County",3,27,182,84,98
050,01,057,"Alabama","Fayette County",3,28,190,97,93
050,01,057,"Alabama","Fayette County",3,29,197,97,100
050,01,057,"Alabama","Fayette County",3,30,200,98,102
050,01,057,"Alabama","Fayette County",3,31,194,101,93
050,01,057,"Alabama","Fayette County",3,32,180,95,85
050,01,057,"Alabama","Fayette County",3,33,161,80,81
050,01,057,"Alabama","Fayette County",3,34,168,79,89
050,01,057,"Alabama","Fayette County",3,35,192,82,110
050,01,057,"Alabama","Fayette County",3,36,186,85,101
050,01,057,"Alabama","Fayette County",3,37,198,91,107
050,01,057,"Alabama","Fayette County",3,38,199,99,100
050,01,057,"Alabama","Fayette County",3,39,188,93,95
050,01,057,"Alabama","Fayette County",3,40,166,91,75
050,01,057,"Alabama","Fayette County",3,41,174,89,85
050,01,057,"Alabama","Fayette County",3,42,201,101,100
050,01,057,"Alabama","Fayette County",3,43,177,87,90
050,01,057,"Alabama","Fayette County",3,44,179,93,86
050,01,057,"Alabama","Fayette County",3,45,174,84,90
050,01,057,"Alabama","Fayette County",3,46,178,89,89
050,01,057,"Alabama","Fayette County",3,47,188,95,93
050,01,057,"Alabama","Fayette County",3,48,190,94,96
050,01,057,"Alabama","Fayette County",3,49,202,106,96
050,01,057,"Alabama","Fayette County",3,50,242,117,125
050,01,057,"Alabama","Fayette County",3,51,225,112,113
050,01,057,"Alabama","Fayette County",3,52,208,106,102
050,01,057,"Alabama","Fayette County",3,53,188,95,93
050,01,057,"Alabama","Fayette County",3,54,195,96,99
050,01,057,"Alabama","Fayette County",3,55,210,104,106
050,01,057,"Alabama","Fayette County",3,56,220,106,114
050,01,057,"Alabama","Fayette County",3,57,241,128,113
050,01,057,"Alabama","Fayette County",3,58,248,127,121
050,01,057,"Alabama","Fayette County",3,59,247,125,122
050,01,057,"Alabama","Fayette County",3,60,228,117,111
050,01,057,"Alabama","Fayette County",3,61,224,110,114
050,01,057,"Alabama","Fayette County",3,62,226,102,124
050,01,057,"Alabama","Fayette County",3,63,232,97,135
050,01,057,"Alabama","Fayette County",3,64,221,103,118
050,01,057,"Alabama","Fayette County",3,65,216,103,113
050,01,057,"Alabama","Fayette County",3,66,219,119,100
050,01,057,"Alabama","Fayette County",3,67,221,114,107
050,01,057,"Alabama","Fayette County",3,68,204,97,107
050,01,057,"Alabama","Fayette County",3,69,202,86,116
050,01,057,"Alabama","Fayette County",3,70,201,91,110
050,01,057,"Alabama","Fayette County",3,71,206,95,111
050,01,057,"Alabama","Fayette County",3,72,190,87,103
050,01,057,"Alabama","Fayette County",3,73,183,78,105
050,01,057,"Alabama","Fayette County",3,74,189,83,106
050,01,057,"Alabama","Fayette County",3,75,130,56,74
050,01,057,"Alabama","Fayette County",3,76,134,59,75
050,01,057,"Alabama","Fayette County",3,77,150,73,77
050,01,057,"Alabama","Fayette County",3,78,147,65,82
050,01,057,"Alabama","Fayette County",3,79,109,44,65
050,01,057,"Alabama","Fayette County",3,80,103,38,65
050,01,057,"Alabama","Fayette County",3,81,104,44,60
050,01,057,"Alabama","Fayette County",3,82,103,47,56
050,01,057,"Alabama","Fayette County",3,83,99,47,52
050,01,057,"Alabama","Fayette County",3,84,68,30,38
050,01,057,"Alabama","Fayette County",3,85,308,110,198
050,01,057,"Alabama","Fayette County",4,0,176,98,78
050,01,057,"Alabama","Fayette County",4,1,185,89,96
050,01,057,"Alabama","Fayette County",4,2,164,88,76
050,01,057,"Alabama","Fayette County",4,3,190,95,95
050,01,057,"Alabama","Fayette County",4,4,190,94,96
050,01,057,"Alabama","Fayette County",4,5,172,87,85
050,01,057,"Alabama","Fayette County",4,6,190,108,82
050,01,057,"Alabama","Fayette County",4,7,210,104,106
050,01,057,"Alabama","Fayette County",4,8,210,100,110
050,01,057,"Alabama","Fayette County",4,9,197,98,99
050,01,057,"Alabama","Fayette County",4,10,184,91,93
050,01,057,"Alabama","Fayette County",4,11,172,93,79
050,01,057,"Alabama","Fayette County",4,12,188,105,83
050,01,057,"Alabama","Fayette County",4,13,201,108,93
050,01,057,"Alabama","Fayette County",4,14,221,115,106
050,01,057,"Alabama","Fayette County",4,15,193,106,87
050,01,057,"Alabama","Fayette County",4,16,211,107,104
050,01,057,"Alabama","Fayette County",4,17,209,107,102
050,01,057,"Alabama","Fayette County",4,18,184,88,96
050,01,057,"Alabama","Fayette County",4,19,151,86,65
050,01,057,"Alabama","Fayette County",4,20,136,76,60
050,01,057,"Alabama","Fayette County",4,21,178,93,85
050,01,057,"Alabama","Fayette County",4,22,177,89,88
050,01,057,"Alabama","Fayette County",4,23,175,90,85
050,01,057,"Alabama","Fayette County",4,24,186,95,91
050,01,057,"Alabama","Fayette County",4,25,188,91,97
050,01,057,"Alabama","Fayette County",4,26,188,102,86
050,01,057,"Alabama","Fayette County",4,27,189,93,96
050,01,057,"Alabama","Fayette County",4,28,187,84,103
050,01,057,"Alabama","Fayette County",4,29,191,95,96
050,01,057,"Alabama","Fayette County",4,30,207,102,105
050,01,057,"Alabama","Fayette County",4,31,198,99,99
050,01,057,"Alabama","Fayette County",4,32,200,105,95
050,01,057,"Alabama","Fayette County",4,33,195,102,93
050,01,057,"Alabama","Fayette County",4,34,156,77,79
050,01,057,"Alabama","Fayette County",4,35,180,86,94
050,01,057,"Alabama","Fayette County",4,36,183,74,109
050,01,057,"Alabama","Fayette County",4,37,181,82,99
050,01,057,"Alabama","Fayette County",4,38,197,91,106
050,01,057,"Alabama","Fayette County",4,39,203,103,100
050,01,057,"Alabama","Fayette County",4,40,187,97,90
050,01,057,"Alabama","Fayette County",4,41,164,93,71
050,01,057,"Alabama","Fayette County",4,42,165,82,83
050,01,057,"Alabama","Fayette County",4,43,204,106,98
050,01,057,"Alabama","Fayette County",4,44,170,81,89
050,01,057,"Alabama","Fayette County",4,45,172,86,86
050,01,057,"Alabama","Fayette County",4,46,175,85,90
050,01,057,"Alabama","Fayette County",4,47,176,90,86
050,01,057,"Alabama","Fayette County",4,48,187,97,90
050,01,057,"Alabama","Fayette County",4,49,191,92,99
050,01,057,"Alabama","Fayette County",4,50,201,106,95
050,01,057,"Alabama","Fayette County",4,51,237,115,122
050,01,057,"Alabama","Fayette County",4,52,230,118,112
050,01,057,"Alabama","Fayette County",4,53,197,96,101
050,01,057,"Alabama","Fayette County",4,54,184,88,96
050,01,057,"Alabama","Fayette County",4,55,194,99,95
050,01,057,"Alabama","Fayette County",4,56,204,101,103
050,01,057,"Alabama","Fayette County",4,57,224,107,117
050,01,057,"Alabama","Fayette County",4,58,239,126,113
050,01,057,"Alabama","Fayette County",4,59,242,120,122
050,01,057,"Alabama","Fayette County",4,60,238,122,116
050,01,057,"Alabama","Fayette County",4,61,220,119,101
050,01,057,"Alabama","Fayette County",4,62,222,112,110
050,01,057,"Alabama","Fayette County",4,63,230,102,128
050,01,057,"Alabama","Fayette County",4,64,231,96,135
050,01,057,"Alabama","Fayette County",4,65,222,108,114
050,01,057,"Alabama","Fayette County",4,66,206,96,110
050,01,057,"Alabama","Fayette County",4,67,208,110,98
050,01,057,"Alabama","Fayette County",4,68,216,114,102
050,01,057,"Alabama","Fayette County",4,69,201,93,108
050,01,057,"Alabama","Fayette County",4,70,196,85,111
050,01,057,"Alabama","Fayette County",4,71,195,88,107
050,01,057,"Alabama","Fayette County",4,72,205,92,113
050,01,057,"Alabama","Fayette County",4,73,182,83,99
050,01,057,"Alabama","Fayette County",4,74,180,76,104
050,01,057,"Alabama","Fayette County",4,75,181,82,99
050,01,057,"Alabama","Fayette County",4,76,122,53,69
050,01,057,"Alabama","Fayette County",4,77,134,57,77
050,01,057,"Alabama","Fayette County",4,78,136,64,72
050,01,057,"Alabama","Fayette County",4,79,139,66,73
050,01,057,"Alabama","Fayette County",4,80,107,43,64
050,01,057,"Alabama","Fayette County",4,81,92,35,57
050,01,057,"Alabama","Fayette County",4,82,96,36,60
050,01,057,"Alabama","Fayette County",4,83,88,41,47
050,01,057,"Alabama","Fayette County",4,84,83,39,44
050,01,057,"Alabama","Fayette County",4,85,316,118,198
050,01,057,"Alabama","Fayette County",5,0,179,97,82
050,01,057,"Alabama","Fayette County",5,1,183,99,84
050,01,057,"Alabama","Fayette County",5,2,180,92,88
050,01,057,"Alabama","Fayette County",5,3,172,94,78
050,01,057,"Alabama","Fayette County",5,4,182,95,87
050,01,057,"Alabama","Fayette County",5,5,189,97,92
050,01,057,"Alabama","Fayette County",5,6,177,93,84
050,01,057,"Alabama","Fayette County",5,7,178,94,84
050,01,057,"Alabama","Fayette County",5,8,207,100,107
050,01,057,"Alabama","Fayette County",5,9,211,103,108
050,01,057,"Alabama","Fayette County",5,10,192,90,102
050,01,057,"Alabama","Fayette County",5,11,181,97,84
050,01,057,"Alabama","Fayette County",5,12,176,98,78
050,01,057,"Alabama","Fayette County",5,13,183,101,82
050,01,057,"Alabama","Fayette County",5,14,205,107,98
050,01,057,"Alabama","Fayette County",5,15,223,119,104
050,01,057,"Alabama","Fayette County",5,16,207,112,95
050,01,057,"Alabama","Fayette County",5,17,210,109,101
050,01,057,"Alabama","Fayette County",5,18,183,98,85
050,01,057,"Alabama","Fayette County",5,19,152,81,71
050,01,057,"Alabama","Fayette County",5,20,151,85,66
050,01,057,"Alabama","Fayette County",5,21,142,79,63
050,01,057,"Alabama","Fayette County",5,22,177,88,89
050,01,057,"Alabama","Fayette County",5,23,172,83,89
050,01,057,"Alabama","Fayette County",5,24,185,94,91
050,01,057,"Alabama","Fayette County",5,25,180,88,92
050,01,057,"Alabama","Fayette County",5,26,186,87,99
050,01,057,"Alabama","Fayette County",5,27,188,100,88
050,01,057,"Alabama","Fayette County",5,28,188,95,93
050,01,057,"Alabama","Fayette County",5,29,179,74,105
050,01,057,"Alabama","Fayette County",5,30,189,97,92
050,01,057,"Alabama","Fayette County",5,31,222,109,113
050,01,057,"Alabama","Fayette County",5,32,190,95,95
050,01,057,"Alabama","Fayette County",5,33,194,98,96
050,01,057,"Alabama","Fayette County",5,34,197,95,102
050,01,057,"Alabama","Fayette County",5,35,165,83,82
050,01,057,"Alabama","Fayette County",5,36,182,84,98
050,01,057,"Alabama","Fayette County",5,37,187,77,110
050,01,057,"Alabama","Fayette County",5,38,187,89,98
050,01,057,"Alabama","Fayette County",5,39,201,94,107
050,01,057,"Alabama","Fayette County",5,40,203,109,94
050,01,057,"Alabama","Fayette County",5,41,185,95,90
050,01,057,"Alabama","Fayette County",5,42,163,88,75
050,01,057,"Alabama","Fayette County",5,43,161,82,79
050,01,057,"Alabama","Fayette County",5,44,194,98,96
050,01,057,"Alabama","Fayette County",5,45,165,79,86
050,01,057,"Alabama","Fayette County",5,46,176,87,89
050,01,057,"Alabama","Fayette County",5,47,178,90,88
050,01,057,"Alabama","Fayette County",5,48,175,96,79
050,01,057,"Alabama","Fayette County",5,49,184,93,91
050,01,057,"Alabama","Fayette County",5,50,191,94,97
050,01,057,"Alabama","Fayette County",5,51,198,106,92
050,01,057,"Alabama","Fayette County",5,52,233,115,118
050,01,057,"Alabama","Fayette County",5,53,226,116,110
050,01,057,"Alabama","Fayette County",5,54,188,92,96
050,01,057,"Alabama","Fayette County",5,55,187,87,100
050,01,057,"Alabama","Fayette County",5,56,192,99,93
050,01,057,"Alabama","Fayette County",5,57,214,106,108
050,01,057,"Alabama","Fayette County",5,58,221,102,119
050,01,057,"Alabama","Fayette County",5,59,231,120,111
050,01,057,"Alabama","Fayette County",5,60,225,109,116
050,01,057,"Alabama","Fayette County",5,61,228,115,113
050,01,057,"Alabama","Fayette County",5,62,216,122,94
050,01,057,"Alabama","Fayette County",5,63,218,109,109
050,01,057,"Alabama","Fayette County",5,64,229,101,128
050,01,057,"Alabama","Fayette County",5,65,227,96,131
050,01,057,"Alabama","Fayette County",5,66,212,105,107
050,01,057,"Alabama","Fayette County",5,67,201,91,110
050,01,057,"Alabama","Fayette County",5,68,210,113,97
050,01,057,"Alabama","Fayette County",5,69,208,108,100
050,01,057,"Alabama","Fayette County",5,70,193,90,103
050,01,057,"Alabama","Fayette County",5,71,188,79,109
050,01,057,"Alabama","Fayette County",5,72,196,86,110
050,01,057,"Alabama","Fayette County",5,73,193,87,106
050,01,057,"Alabama","Fayette County",5,74,181,84,97
050,01,057,"Alabama","Fayette County",5,75,172,72,100
050,01,057,"Alabama","Fayette County",5,76,172,77,95
050,01,057,"Alabama","Fayette County",5,77,125,53,72
050,01,057,"Alabama","Fayette County",5,78,122,49,73
050,01,057,"Alabama","Fayette County",5,79,128,64,64
050,01,057,"Alabama","Fayette County",5,80,137,66,71
050,01,057,"Alabama","Fayette County",5,81,96,40,56
050,01,057,"Alabama","Fayette County",5,82,87,30,57
050,01,057,"Alabama","Fayette County",5,83,84,32,52
050,01,057,"Alabama","Fayette County",5,84,79,38,41
050,01,057,"Alabama","Fayette County",5,85,343,138,205
050,01,059,"Alabama","Franklin County",1,0,444,225,219
050,01,059,"Alabama","Franklin County",1,1,454,231,223
050,01,059,"Alabama","Franklin County",1,2,458,229,229
050,01,059,"Alabama","Franklin County",1,3,465,239,226
050,01,059,"Alabama","Franklin County",1,4,416,211,205
050,01,059,"Alabama","Franklin County",1,5,423,223,200
050,01,059,"Alabama","Franklin County",1,6,443,232,211
050,01,059,"Alabama","Franklin County",1,7,453,225,228
050,01,059,"Alabama","Franklin County",1,8,444,227,217
050,01,059,"Alabama","Franklin County",1,9,419,221,198
050,01,059,"Alabama","Franklin County",1,10,442,227,215
050,01,059,"Alabama","Franklin County",1,11,446,219,227
050,01,059,"Alabama","Franklin County",1,12,481,250,231
050,01,059,"Alabama","Franklin County",1,13,452,236,216
050,01,059,"Alabama","Franklin County",1,14,473,237,236
050,01,059,"Alabama","Franklin County",1,15,452,234,218
050,01,059,"Alabama","Franklin County",1,16,456,234,222
050,01,059,"Alabama","Franklin County",1,17,445,233,212
050,01,059,"Alabama","Franklin County",1,18,398,205,193
050,01,059,"Alabama","Franklin County",1,19,346,184,162
050,01,059,"Alabama","Franklin County",1,20,344,181,163
050,01,059,"Alabama","Franklin County",1,21,383,211,172
050,01,059,"Alabama","Franklin County",1,22,396,205,191
050,01,059,"Alabama","Franklin County",1,23,377,197,180
050,01,059,"Alabama","Franklin County",1,24,353,181,172
050,01,059,"Alabama","Franklin County",1,25,374,199,175
050,01,059,"Alabama","Franklin County",1,26,375,197,178
050,01,059,"Alabama","Franklin County",1,27,394,202,192
050,01,059,"Alabama","Franklin County",1,28,434,203,231
050,01,059,"Alabama","Franklin County",1,29,427,205,222
050,01,059,"Alabama","Franklin County",1,30,445,237,208
050,01,059,"Alabama","Franklin County",1,31,402,215,187
050,01,059,"Alabama","Franklin County",1,32,358,183,175
050,01,059,"Alabama","Franklin County",1,33,377,199,178
050,01,059,"Alabama","Franklin County",1,34,382,197,185
050,01,059,"Alabama","Franklin County",1,35,404,221,183
050,01,059,"Alabama","Franklin County",1,36,372,198,174
050,01,059,"Alabama","Franklin County",1,37,369,197,172
050,01,059,"Alabama","Franklin County",1,38,370,190,180
050,01,059,"Alabama","Franklin County",1,39,399,196,203
050,01,059,"Alabama","Franklin County",1,40,388,214,174
050,01,059,"Alabama","Franklin County",1,41,384,203,181
050,01,059,"Alabama","Franklin County",1,42,370,199,171
050,01,059,"Alabama","Franklin County",1,43,405,212,193
050,01,059,"Alabama","Franklin County",1,44,396,192,204
050,01,059,"Alabama","Franklin County",1,45,380,182,198
050,01,059,"Alabama","Franklin County",1,46,417,213,204
050,01,059,"Alabama","Franklin County",1,47,420,234,186
050,01,059,"Alabama","Franklin County",1,48,459,258,201
050,01,059,"Alabama","Franklin County",1,49,492,249,243
050,01,059,"Alabama","Franklin County",1,50,408,201,207
050,01,059,"Alabama","Franklin County",1,51,379,194,185
050,01,059,"Alabama","Franklin County",1,52,391,201,190
050,01,059,"Alabama","Franklin County",1,53,410,225,185
050,01,059,"Alabama","Franklin County",1,54,415,221,194
050,01,059,"Alabama","Franklin County",1,55,411,201,210
050,01,059,"Alabama","Franklin County",1,56,411,196,215
050,01,059,"Alabama","Franklin County",1,57,423,213,210
050,01,059,"Alabama","Franklin County",1,58,408,205,203
050,01,059,"Alabama","Franklin County",1,59,383,191,192
050,01,059,"Alabama","Franklin County",1,60,400,200,200
050,01,059,"Alabama","Franklin County",1,61,400,195,205
050,01,059,"Alabama","Franklin County",1,62,389,187,202
050,01,059,"Alabama","Franklin County",1,63,384,195,189
050,01,059,"Alabama","Franklin County",1,64,383,206,177
050,01,059,"Alabama","Franklin County",1,65,382,182,200
050,01,059,"Alabama","Franklin County",1,66,363,163,200
050,01,059,"Alabama","Franklin County",1,67,339,159,180
050,01,059,"Alabama","Franklin County",1,68,328,150,178
050,01,059,"Alabama","Franklin County",1,69,327,158,169
050,01,059,"Alabama","Franklin County",1,70,323,149,174
050,01,059,"Alabama","Franklin County",1,71,296,152,144
050,01,059,"Alabama","Franklin County",1,72,311,162,149
050,01,059,"Alabama","Franklin County",1,73,305,147,158
050,01,059,"Alabama","Franklin County",1,74,221,94,127
050,01,059,"Alabama","Franklin County",1,75,205,92,113
050,01,059,"Alabama","Franklin County",1,76,223,98,125
050,01,059,"Alabama","Franklin County",1,77,211,95,116
050,01,059,"Alabama","Franklin County",1,78,179,70,109
050,01,059,"Alabama","Franklin County",1,79,158,61,97
050,01,059,"Alabama","Franklin County",1,80,168,77,91
050,01,059,"Alabama","Franklin County",1,81,167,65,102
050,01,059,"Alabama","Franklin County",1,82,133,53,80
050,01,059,"Alabama","Franklin County",1,83,132,52,80
050,01,059,"Alabama","Franklin County",1,84,102,39,63
050,01,059,"Alabama","Franklin County",1,85,588,216,372
050,01,059,"Alabama","Franklin County",2,0,435,221,214
050,01,059,"Alabama","Franklin County",2,1,447,228,219
050,01,059,"Alabama","Franklin County",2,2,455,226,229
050,01,059,"Alabama","Franklin County",2,3,459,235,224
050,01,059,"Alabama","Franklin County",2,4,426,216,210
050,01,059,"Alabama","Franklin County",2,5,421,221,200
050,01,059,"Alabama","Franklin County",2,6,438,230,208
050,01,059,"Alabama","Franklin County",2,7,450,227,223
050,01,059,"Alabama","Franklin County",2,8,438,221,217
050,01,059,"Alabama","Franklin County",2,9,423,221,202
050,01,059,"Alabama","Franklin County",2,10,437,227,210
050,01,059,"Alabama","Franklin County",2,11,446,223,223
050,01,059,"Alabama","Franklin County",2,12,476,245,231
050,01,059,"Alabama","Franklin County",2,13,461,241,220
050,01,059,"Alabama","Franklin County",2,14,465,235,230
050,01,059,"Alabama","Franklin County",2,15,456,234,222
050,01,059,"Alabama","Franklin County",2,16,454,233,221
050,01,059,"Alabama","Franklin County",2,17,450,233,217
050,01,059,"Alabama","Franklin County",2,18,393,205,188
050,01,059,"Alabama","Franklin County",2,19,342,181,161
050,01,059,"Alabama","Franklin County",2,20,350,185,165
050,01,059,"Alabama","Franklin County",2,21,379,207,172
050,01,059,"Alabama","Franklin County",2,22,398,210,188
050,01,059,"Alabama","Franklin County",2,23,382,199,183
050,01,059,"Alabama","Franklin County",2,24,360,183,177
050,01,059,"Alabama","Franklin County",2,25,369,194,175
050,01,059,"Alabama","Franklin County",2,26,372,197,175
050,01,059,"Alabama","Franklin County",2,27,393,201,192
050,01,059,"Alabama","Franklin County",2,28,424,204,220
050,01,059,"Alabama","Franklin County",2,29,426,203,223
050,01,059,"Alabama","Franklin County",2,30,439,229,210
050,01,059,"Alabama","Franklin County",2,31,407,218,189
050,01,059,"Alabama","Franklin County",2,32,368,191,177
050,01,059,"Alabama","Franklin County",2,33,368,193,175
050,01,059,"Alabama","Franklin County",2,34,381,198,183
050,01,059,"Alabama","Franklin County",2,35,400,216,184
050,01,059,"Alabama","Franklin County",2,36,377,204,173
050,01,059,"Alabama","Franklin County",2,37,372,199,173
050,01,059,"Alabama","Franklin County",2,38,372,192,180
050,01,059,"Alabama","Franklin County",2,39,389,193,196
050,01,059,"Alabama","Franklin County",2,40,398,213,185
050,01,059,"Alabama","Franklin County",2,41,381,202,179
050,01,059,"Alabama","Franklin County",2,42,372,199,173
050,01,059,"Alabama","Franklin County",2,43,402,211,191
050,01,059,"Alabama","Franklin County",2,44,393,193,200
050,01,059,"Alabama","Franklin County",2,45,385,186,199
050,01,059,"Alabama","Franklin County",2,46,407,205,202
050,01,059,"Alabama","Franklin County",2,47,417,227,190
050,01,059,"Alabama","Franklin County",2,48,450,255,195
050,01,059,"Alabama","Franklin County",2,49,485,251,234
050,01,059,"Alabama","Franklin County",2,50,430,213,217
050,01,059,"Alabama","Franklin County",2,51,385,195,190
050,01,059,"Alabama","Franklin County",2,52,388,199,189
050,01,059,"Alabama","Franklin County",2,53,403,218,185
050,01,059,"Alabama","Franklin County",2,54,409,222,187
050,01,059,"Alabama","Franklin County",2,55,410,205,205
050,01,059,"Alabama","Franklin County",2,56,411,196,215
050,01,059,"Alabama","Franklin County",2,57,421,211,210
050,01,059,"Alabama","Franklin County",2,58,413,206,207
050,01,059,"Alabama","Franklin County",2,59,393,195,198
050,01,059,"Alabama","Franklin County",2,60,394,196,198
050,01,059,"Alabama","Franklin County",2,61,399,197,202
050,01,059,"Alabama","Franklin County",2,62,390,188,202
050,01,059,"Alabama","Franklin County",2,63,388,194,194
050,01,059,"Alabama","Franklin County",2,64,381,203,178
050,01,059,"Alabama","Franklin County",2,65,384,187,197
050,01,059,"Alabama","Franklin County",2,66,365,167,198
050,01,059,"Alabama","Franklin County",2,67,340,157,183
050,01,059,"Alabama","Franklin County",2,68,330,151,179
050,01,059,"Alabama","Franklin County",2,69,327,156,171
050,01,059,"Alabama","Franklin County",2,70,323,151,172
050,01,059,"Alabama","Franklin County",2,71,301,151,150
050,01,059,"Alabama","Franklin County",2,72,300,155,145
050,01,059,"Alabama","Franklin County",2,73,316,157,159
050,01,059,"Alabama","Franklin County",2,74,227,99,128
050,01,059,"Alabama","Franklin County",2,75,206,91,115
050,01,059,"Alabama","Franklin County",2,76,216,94,122
050,01,059,"Alabama","Franklin County",2,77,212,97,115
050,01,059,"Alabama","Franklin County",2,78,180,72,108
050,01,059,"Alabama","Franklin County",2,79,157,62,95
050,01,059,"Alabama","Franklin County",2,80,164,74,90
050,01,059,"Alabama","Franklin County",2,81,168,67,101
050,01,059,"Alabama","Franklin County",2,82,138,56,82
050,01,059,"Alabama","Franklin County",2,83,131,51,80
050,01,059,"Alabama","Franklin County",2,84,106,41,65
050,01,059,"Alabama","Franklin County",2,85,584,214,370
050,01,059,"Alabama","Franklin County",3,0,396,212,184
050,01,059,"Alabama","Franklin County",3,1,431,212,219
050,01,059,"Alabama","Franklin County",3,2,449,230,219
050,01,059,"Alabama","Franklin County",3,3,455,233,222
050,01,059,"Alabama","Franklin County",3,4,452,223,229
050,01,059,"Alabama","Franklin County",3,5,423,208,215
050,01,059,"Alabama","Franklin County",3,6,429,220,209
050,01,059,"Alabama","Franklin County",3,7,440,225,215
050,01,059,"Alabama","Franklin County",3,8,459,234,225
050,01,059,"Alabama","Franklin County",3,9,450,224,226
050,01,059,"Alabama","Franklin County",3,10,430,227,203
050,01,059,"Alabama","Franklin County",3,11,440,228,212
050,01,059,"Alabama","Franklin County",3,12,441,225,216
050,01,059,"Alabama","Franklin County",3,13,475,238,237
050,01,059,"Alabama","Franklin County",3,14,449,221,228
050,01,059,"Alabama","Franklin County",3,15,474,247,227
050,01,059,"Alabama","Franklin County",3,16,441,229,212
050,01,059,"Alabama","Franklin County",3,17,448,229,219
050,01,059,"Alabama","Franklin County",3,18,402,215,187
050,01,059,"Alabama","Franklin County",3,19,327,170,157
050,01,059,"Alabama","Franklin County",3,20,370,189,181
050,01,059,"Alabama","Franklin County",3,21,382,200,182
050,01,059,"Alabama","Franklin County",3,22,398,207,191
050,01,059,"Alabama","Franklin County",3,23,385,199,186
050,01,059,"Alabama","Franklin County",3,24,380,197,183
050,01,059,"Alabama","Franklin County",3,25,352,178,174
050,01,059,"Alabama","Franklin County",3,26,365,192,173
050,01,059,"Alabama","Franklin County",3,27,365,196,169
050,01,059,"Alabama","Franklin County",3,28,407,208,199
050,01,059,"Alabama","Franklin County",3,29,409,193,216
050,01,059,"Alabama","Franklin County",3,30,417,194,223
050,01,059,"Alabama","Franklin County",3,31,419,215,204
050,01,059,"Alabama","Franklin County",3,32,403,208,195
050,01,059,"Alabama","Franklin County",3,33,362,188,174
050,01,059,"Alabama","Franklin County",3,34,361,196,165
050,01,059,"Alabama","Franklin County",3,35,381,192,189
050,01,059,"Alabama","Franklin County",3,36,406,217,189
050,01,059,"Alabama","Franklin County",3,37,365,191,174
050,01,059,"Alabama","Franklin County",3,38,371,190,181
050,01,059,"Alabama","Franklin County",3,39,369,186,183
050,01,059,"Alabama","Franklin County",3,40,388,197,191
050,01,059,"Alabama","Franklin County",3,41,401,205,196
050,01,059,"Alabama","Franklin County",3,42,383,208,175
050,01,059,"Alabama","Franklin County",3,43,373,192,181
050,01,059,"Alabama","Franklin County",3,44,402,212,190
050,01,059,"Alabama","Franklin County",3,45,384,189,195
050,01,059,"Alabama","Franklin County",3,46,380,190,190
050,01,059,"Alabama","Franklin County",3,47,411,205,206
050,01,059,"Alabama","Franklin County",3,48,404,220,184
050,01,059,"Alabama","Franklin County",3,49,448,253,195
050,01,059,"Alabama","Franklin County",3,50,485,245,240
050,01,059,"Alabama","Franklin County",3,51,433,208,225
050,01,059,"Alabama","Franklin County",3,52,386,197,189
050,01,059,"Alabama","Franklin County",3,53,398,203,195
050,01,059,"Alabama","Franklin County",3,54,403,219,184
050,01,059,"Alabama","Franklin County",3,55,415,225,190
050,01,059,"Alabama","Franklin County",3,56,415,199,216
050,01,059,"Alabama","Franklin County",3,57,409,195,214
050,01,059,"Alabama","Franklin County",3,58,435,216,219
050,01,059,"Alabama","Franklin County",3,59,420,208,212
050,01,059,"Alabama","Franklin County",3,60,390,189,201
050,01,059,"Alabama","Franklin County",3,61,389,194,195
050,01,059,"Alabama","Franklin County",3,62,391,191,200
050,01,059,"Alabama","Franklin County",3,63,389,187,202
050,01,059,"Alabama","Franklin County",3,64,383,194,189
050,01,059,"Alabama","Franklin County",3,65,390,203,187
050,01,059,"Alabama","Franklin County",3,66,353,169,184
050,01,059,"Alabama","Franklin County",3,67,353,164,189
050,01,059,"Alabama","Franklin County",3,68,340,154,186
050,01,059,"Alabama","Franklin County",3,69,312,138,174
050,01,059,"Alabama","Franklin County",3,70,312,145,167
050,01,059,"Alabama","Franklin County",3,71,304,144,160
050,01,059,"Alabama","Franklin County",3,72,294,144,150
050,01,059,"Alabama","Franklin County",3,73,273,139,134
050,01,059,"Alabama","Franklin County",3,74,302,144,158
050,01,059,"Alabama","Franklin County",3,75,208,96,112
050,01,059,"Alabama","Franklin County",3,76,211,87,124
050,01,059,"Alabama","Franklin County",3,77,195,89,106
050,01,059,"Alabama","Franklin County",3,78,201,83,118
050,01,059,"Alabama","Franklin County",3,79,167,69,98
050,01,059,"Alabama","Franklin County",3,80,144,61,83
050,01,059,"Alabama","Franklin County",3,81,176,68,108
050,01,059,"Alabama","Franklin County",3,82,136,62,74
050,01,059,"Alabama","Franklin County",3,83,137,51,86
050,01,059,"Alabama","Franklin County",3,84,114,42,72
050,01,059,"Alabama","Franklin County",3,85,583,222,361
050,01,059,"Alabama","Franklin County",4,0,440,237,203
050,01,059,"Alabama","Franklin County",4,1,394,206,188
050,01,059,"Alabama","Franklin County",4,2,428,216,212
050,01,059,"Alabama","Franklin County",4,3,449,232,217
050,01,059,"Alabama","Franklin County",4,4,447,223,224
050,01,059,"Alabama","Franklin County",4,5,452,224,228
050,01,059,"Alabama","Franklin County",4,6,422,208,214
050,01,059,"Alabama","Franklin County",4,7,418,215,203
050,01,059,"Alabama","Franklin County",4,8,429,218,211
050,01,059,"Alabama","Franklin County",4,9,463,233,230
050,01,059,"Alabama","Franklin County",4,10,451,225,226
050,01,059,"Alabama","Franklin County",4,11,427,229,198
050,01,059,"Alabama","Franklin County",4,12,452,235,217
050,01,059,"Alabama","Franklin County",4,13,449,231,218
050,01,059,"Alabama","Franklin County",4,14,475,239,236
050,01,059,"Alabama","Franklin County",4,15,449,228,221
050,01,059,"Alabama","Franklin County",4,16,475,243,232
050,01,059,"Alabama","Franklin County",4,17,450,231,219
050,01,059,"Alabama","Franklin County",4,18,407,209,198
050,01,059,"Alabama","Franklin County",4,19,327,178,149
050,01,059,"Alabama","Franklin County",4,20,339,168,171
050,01,059,"Alabama","Franklin County",4,21,395,202,193
050,01,059,"Alabama","Franklin County",4,22,404,217,187
050,01,059,"Alabama","Franklin County",4,23,399,208,191
050,01,059,"Alabama","Franklin County",4,24,379,192,187
050,01,059,"Alabama","Franklin County",4,25,378,193,185
050,01,059,"Alabama","Franklin County",4,26,356,181,175
050,01,059,"Alabama","Franklin County",4,27,368,193,175
050,01,059,"Alabama","Franklin County",4,28,368,197,171
050,01,059,"Alabama","Franklin County",4,29,392,201,191
050,01,059,"Alabama","Franklin County",4,30,399,192,207
050,01,059,"Alabama","Franklin County",4,31,385,182,203
050,01,059,"Alabama","Franklin County",4,32,405,205,200
050,01,059,"Alabama","Franklin County",4,33,408,215,193
050,01,059,"Alabama","Franklin County",4,34,363,187,176
050,01,059,"Alabama","Franklin County",4,35,373,205,168
050,01,059,"Alabama","Franklin County",4,36,379,188,191
050,01,059,"Alabama","Franklin County",4,37,396,213,183
050,01,059,"Alabama","Franklin County",4,38,366,190,176
050,01,059,"Alabama","Franklin County",4,39,376,192,184
050,01,059,"Alabama","Franklin County",4,40,375,191,184
050,01,059,"Alabama","Franklin County",4,41,378,184,194
050,01,059,"Alabama","Franklin County",4,42,403,213,190
050,01,059,"Alabama","Franklin County",4,43,378,207,171
050,01,059,"Alabama","Franklin County",4,44,356,187,169
050,01,059,"Alabama","Franklin County",4,45,396,212,184
050,01,059,"Alabama","Franklin County",4,46,393,199,194
050,01,059,"Alabama","Franklin County",4,47,386,190,196
050,01,059,"Alabama","Franklin County",4,48,397,195,202
050,01,059,"Alabama","Franklin County",4,49,398,211,187
050,01,059,"Alabama","Franklin County",4,50,433,237,196
050,01,059,"Alabama","Franklin County",4,51,483,241,242
050,01,059,"Alabama","Franklin County",4,52,430,206,224
050,01,059,"Alabama","Franklin County",4,53,381,194,187
050,01,059,"Alabama","Franklin County",4,54,399,204,195
050,01,059,"Alabama","Franklin County",4,55,394,213,181
050,01,059,"Alabama","Franklin County",4,56,401,212,189
050,01,059,"Alabama","Franklin County",4,57,425,207,218
050,01,059,"Alabama","Franklin County",4,58,412,194,218
050,01,059,"Alabama","Franklin County",4,59,435,217,218
050,01,059,"Alabama","Franklin County",4,60,421,213,208
050,01,059,"Alabama","Franklin County",4,61,394,189,205
050,01,059,"Alabama","Franklin County",4,62,385,191,194
050,01,059,"Alabama","Franklin County",4,63,389,191,198
050,01,059,"Alabama","Franklin County",4,64,379,184,195
050,01,059,"Alabama","Franklin County",4,65,387,188,199
050,01,059,"Alabama","Franklin County",4,66,373,193,180
050,01,059,"Alabama","Franklin County",4,67,346,169,177
050,01,059,"Alabama","Franklin County",4,68,347,159,188
050,01,059,"Alabama","Franklin County",4,69,334,148,186
050,01,059,"Alabama","Franklin County",4,70,305,135,170
050,01,059,"Alabama","Franklin County",4,71,300,145,155
050,01,059,"Alabama","Franklin County",4,72,291,133,158
050,01,059,"Alabama","Franklin County",4,73,277,135,142
050,01,059,"Alabama","Franklin County",4,74,262,126,136
050,01,059,"Alabama","Franklin County",4,75,274,130,144
050,01,059,"Alabama","Franklin County",4,76,209,93,116
050,01,059,"Alabama","Franklin County",4,77,196,85,111
050,01,059,"Alabama","Franklin County",4,78,184,76,108
050,01,059,"Alabama","Franklin County",4,79,188,80,108
050,01,059,"Alabama","Franklin County",4,80,150,62,88
050,01,059,"Alabama","Franklin County",4,81,154,56,98
050,01,059,"Alabama","Franklin County",4,82,143,60,83
050,01,059,"Alabama","Franklin County",4,83,132,56,76
050,01,059,"Alabama","Franklin County",4,84,118,41,77
050,01,059,"Alabama","Franklin County",4,85,587,232,355
050,01,059,"Alabama","Franklin County",5,0,441,240,201
050,01,059,"Alabama","Franklin County",5,1,449,251,198
050,01,059,"Alabama","Franklin County",5,2,394,206,188
050,01,059,"Alabama","Franklin County",5,3,425,211,214
050,01,059,"Alabama","Franklin County",5,4,452,240,212
050,01,059,"Alabama","Franklin County",5,5,441,216,225
050,01,059,"Alabama","Franklin County",5,6,464,231,233
050,01,059,"Alabama","Franklin County",5,7,431,217,214
050,01,059,"Alabama","Franklin County",5,8,423,223,200
050,01,059,"Alabama","Franklin County",5,9,422,215,207
050,01,059,"Alabama","Franklin County",5,10,461,227,234
050,01,059,"Alabama","Franklin County",5,11,448,225,223
050,01,059,"Alabama","Franklin County",5,12,437,236,201
050,01,059,"Alabama","Franklin County",5,13,462,239,223
050,01,059,"Alabama","Franklin County",5,14,446,230,216
050,01,059,"Alabama","Franklin County",5,15,476,238,238
050,01,059,"Alabama","Franklin County",5,16,457,227,230
050,01,059,"Alabama","Franklin County",5,17,474,245,229
050,01,059,"Alabama","Franklin County",5,18,391,210,181
050,01,059,"Alabama","Franklin County",5,19,340,169,171
050,01,059,"Alabama","Franklin County",5,20,358,194,164
050,01,059,"Alabama","Franklin County",5,21,353,177,176
050,01,059,"Alabama","Franklin County",5,22,414,212,202
050,01,059,"Alabama","Franklin County",5,23,390,219,171
050,01,059,"Alabama","Franklin County",5,24,380,187,193
050,01,059,"Alabama","Franklin County",5,25,370,193,177
050,01,059,"Alabama","Franklin County",5,26,372,180,192
050,01,059,"Alabama","Franklin County",5,27,333,170,163
050,01,059,"Alabama","Franklin County",5,28,359,190,169
050,01,059,"Alabama","Franklin County",5,29,343,187,156
050,01,059,"Alabama","Franklin County",5,30,400,210,190
050,01,059,"Alabama","Franklin County",5,31,407,192,215
050,01,059,"Alabama","Franklin County",5,32,388,176,212
050,01,059,"Alabama","Franklin County",5,33,406,200,206
050,01,059,"Alabama","Franklin County",5,34,400,207,193
050,01,059,"Alabama","Franklin County",5,35,362,186,176
050,01,059,"Alabama","Franklin County",5,36,380,208,172
050,01,059,"Alabama","Franklin County",5,37,367,192,175
050,01,059,"Alabama","Franklin County",5,38,370,189,181
050,01,059,"Alabama","Franklin County",5,39,380,196,184
050,01,059,"Alabama","Franklin County",5,40,382,199,183
050,01,059,"Alabama","Franklin County",5,41,358,178,180
050,01,059,"Alabama","Franklin County",5,42,381,188,193
050,01,059,"Alabama","Franklin County",5,43,398,207,191
050,01,059,"Alabama","Franklin County",5,44,368,204,164
050,01,059,"Alabama","Franklin County",5,45,353,184,169
050,01,059,"Alabama","Franklin County",5,46,401,214,187
050,01,059,"Alabama","Franklin County",5,47,388,201,187
050,01,059,"Alabama","Franklin County",5,48,388,189,199
050,01,059,"Alabama","Franklin County",5,49,389,193,196
050,01,059,"Alabama","Franklin County",5,50,384,207,177
050,01,059,"Alabama","Franklin County",5,51,440,242,198
050,01,059,"Alabama","Franklin County",5,52,477,238,239
050,01,059,"Alabama","Franklin County",5,53,421,199,222
050,01,059,"Alabama","Franklin County",5,54,382,201,181
050,01,059,"Alabama","Franklin County",5,55,392,196,196
050,01,059,"Alabama","Franklin County",5,56,384,205,179
050,01,059,"Alabama","Franklin County",5,57,404,214,190
050,01,059,"Alabama","Franklin County",5,58,413,197,216
050,01,059,"Alabama","Franklin County",5,59,402,190,212
050,01,059,"Alabama","Franklin County",5,60,440,216,224
050,01,059,"Alabama","Franklin County",5,61,417,212,205
050,01,059,"Alabama","Franklin County",5,62,384,183,201
050,01,059,"Alabama","Franklin County",5,63,379,189,190
050,01,059,"Alabama","Franklin County",5,64,383,187,196
050,01,059,"Alabama","Franklin County",5,65,372,176,196
050,01,059,"Alabama","Franklin County",5,66,368,176,192
050,01,059,"Alabama","Franklin County",5,67,360,185,175
050,01,059,"Alabama","Franklin County",5,68,345,170,175
050,01,059,"Alabama","Franklin County",5,69,341,153,188
050,01,059,"Alabama","Franklin County",5,70,328,144,184
050,01,059,"Alabama","Franklin County",5,71,296,135,161
050,01,059,"Alabama","Franklin County",5,72,294,134,160
050,01,059,"Alabama","Franklin County",5,73,275,122,153
050,01,059,"Alabama","Franklin County",5,74,271,124,147
050,01,059,"Alabama","Franklin County",5,75,238,116,122
050,01,059,"Alabama","Franklin County",5,76,271,123,148
050,01,059,"Alabama","Franklin County",5,77,188,87,101
050,01,059,"Alabama","Franklin County",5,78,184,72,112
050,01,059,"Alabama","Franklin County",5,79,172,74,98
050,01,059,"Alabama","Franklin County",5,80,173,74,99
050,01,059,"Alabama","Franklin County",5,81,162,59,103
050,01,059,"Alabama","Franklin County",5,82,133,56,77
050,01,059,"Alabama","Franklin County",5,83,142,55,87
050,01,059,"Alabama","Franklin County",5,84,112,47,65
050,01,059,"Alabama","Franklin County",5,85,603,242,361
050,01,061,"Alabama","Geneva County",1,0,268,138,130
050,01,061,"Alabama","Geneva County",1,1,294,152,142
050,01,061,"Alabama","Geneva County",1,2,282,143,139
050,01,061,"Alabama","Geneva County",1,3,317,167,150
050,01,061,"Alabama","Geneva County",1,4,294,142,152
050,01,061,"Alabama","Geneva County",1,5,289,141,148
050,01,061,"Alabama","Geneva County",1,6,311,150,161
050,01,061,"Alabama","Geneva County",1,7,316,156,160
050,01,061,"Alabama","Geneva County",1,8,321,162,159
050,01,061,"Alabama","Geneva County",1,9,329,171,158
050,01,061,"Alabama","Geneva County",1,10,324,168,156
050,01,061,"Alabama","Geneva County",1,11,344,186,158
050,01,061,"Alabama","Geneva County",1,12,373,192,181
050,01,061,"Alabama","Geneva County",1,13,378,182,196
050,01,061,"Alabama","Geneva County",1,14,361,185,176
050,01,061,"Alabama","Geneva County",1,15,370,184,186
050,01,061,"Alabama","Geneva County",1,16,353,179,174
050,01,061,"Alabama","Geneva County",1,17,380,207,173
050,01,061,"Alabama","Geneva County",1,18,317,176,141
050,01,061,"Alabama","Geneva County",1,19,246,126,120
050,01,061,"Alabama","Geneva County",1,20,255,129,126
050,01,061,"Alabama","Geneva County",1,21,251,124,127
050,01,061,"Alabama","Geneva County",1,22,241,116,125
050,01,061,"Alabama","Geneva County",1,23,256,128,128
050,01,061,"Alabama","Geneva County",1,24,274,147,127
050,01,061,"Alabama","Geneva County",1,25,256,137,119
050,01,061,"Alabama","Geneva County",1,26,302,157,145
050,01,061,"Alabama","Geneva County",1,27,297,145,152
050,01,061,"Alabama","Geneva County",1,28,310,147,163
050,01,061,"Alabama","Geneva County",1,29,313,164,149
050,01,061,"Alabama","Geneva County",1,30,296,142,154
050,01,061,"Alabama","Geneva County",1,31,311,159,152
050,01,061,"Alabama","Geneva County",1,32,291,139,152
050,01,061,"Alabama","Geneva County",1,33,308,145,163
050,01,061,"Alabama","Geneva County",1,34,336,169,167
050,01,061,"Alabama","Geneva County",1,35,303,142,161
050,01,061,"Alabama","Geneva County",1,36,289,132,157
050,01,061,"Alabama","Geneva County",1,37,307,150,157
050,01,061,"Alabama","Geneva County",1,38,298,141,157
050,01,061,"Alabama","Geneva County",1,39,309,159,150
050,01,061,"Alabama","Geneva County",1,40,327,163,164
050,01,061,"Alabama","Geneva County",1,41,333,174,159
050,01,061,"Alabama","Geneva County",1,42,287,138,149
050,01,061,"Alabama","Geneva County",1,43,302,156,146
050,01,061,"Alabama","Geneva County",1,44,324,163,161
050,01,061,"Alabama","Geneva County",1,45,314,144,170
050,01,061,"Alabama","Geneva County",1,46,301,147,154
050,01,061,"Alabama","Geneva County",1,47,329,169,160
050,01,061,"Alabama","Geneva County",1,48,372,180,192
050,01,061,"Alabama","Geneva County",1,49,367,181,186
050,01,061,"Alabama","Geneva County",1,50,373,174,199
050,01,061,"Alabama","Geneva County",1,51,367,178,189
050,01,061,"Alabama","Geneva County",1,52,356,185,171
050,01,061,"Alabama","Geneva County",1,53,376,196,180
050,01,061,"Alabama","Geneva County",1,54,381,203,178
050,01,061,"Alabama","Geneva County",1,55,399,217,182
050,01,061,"Alabama","Geneva County",1,56,380,201,179
050,01,061,"Alabama","Geneva County",1,57,371,181,190
050,01,061,"Alabama","Geneva County",1,58,380,181,199
050,01,061,"Alabama","Geneva County",1,59,362,175,187
050,01,061,"Alabama","Geneva County",1,60,369,172,197
050,01,061,"Alabama","Geneva County",1,61,363,169,194
050,01,061,"Alabama","Geneva County",1,62,408,181,227
050,01,061,"Alabama","Geneva County",1,63,387,189,198
050,01,061,"Alabama","Geneva County",1,64,402,215,187
050,01,061,"Alabama","Geneva County",1,65,387,208,179
050,01,061,"Alabama","Geneva County",1,66,363,186,177
050,01,061,"Alabama","Geneva County",1,67,340,154,186
050,01,061,"Alabama","Geneva County",1,68,322,150,172
050,01,061,"Alabama","Geneva County",1,69,288,138,150
050,01,061,"Alabama","Geneva County",1,70,320,160,160
050,01,061,"Alabama","Geneva County",1,71,326,166,160
050,01,061,"Alabama","Geneva County",1,72,313,148,165
050,01,061,"Alabama","Geneva County",1,73,315,150,165
050,01,061,"Alabama","Geneva County",1,74,239,113,126
050,01,061,"Alabama","Geneva County",1,75,236,115,121
050,01,061,"Alabama","Geneva County",1,76,235,115,120
050,01,061,"Alabama","Geneva County",1,77,220,99,121
050,01,061,"Alabama","Geneva County",1,78,183,77,106
050,01,061,"Alabama","Geneva County",1,79,161,64,97
050,01,061,"Alabama","Geneva County",1,80,157,60,97
050,01,061,"Alabama","Geneva County",1,81,135,51,84
050,01,061,"Alabama","Geneva County",1,82,139,49,90
050,01,061,"Alabama","Geneva County",1,83,115,39,76
050,01,061,"Alabama","Geneva County",1,84,121,44,77
050,01,061,"Alabama","Geneva County",1,85,543,203,340
050,01,061,"Alabama","Geneva County",2,0,274,144,130
050,01,061,"Alabama","Geneva County",2,1,289,149,140
050,01,061,"Alabama","Geneva County",2,2,288,148,140
050,01,061,"Alabama","Geneva County",2,3,311,161,150
050,01,061,"Alabama","Geneva County",2,4,300,148,152
050,01,061,"Alabama","Geneva County",2,5,295,142,153
050,01,061,"Alabama","Geneva County",2,6,306,148,158
050,01,061,"Alabama","Geneva County",2,7,312,155,157
050,01,061,"Alabama","Geneva County",2,8,320,161,159
050,01,061,"Alabama","Geneva County",2,9,324,167,157
050,01,061,"Alabama","Geneva County",2,10,323,168,155
050,01,061,"Alabama","Geneva County",2,11,340,182,158
050,01,061,"Alabama","Geneva County",2,12,364,189,175
050,01,061,"Alabama","Geneva County",2,13,379,185,194
050,01,061,"Alabama","Geneva County",2,14,364,183,181
050,01,061,"Alabama","Geneva County",2,15,370,184,186
050,01,061,"Alabama","Geneva County",2,16,360,182,178
050,01,061,"Alabama","Geneva County",2,17,372,201,171
050,01,061,"Alabama","Geneva County",2,18,314,175,139
050,01,061,"Alabama","Geneva County",2,19,249,131,118
050,01,061,"Alabama","Geneva County",2,20,259,130,129
050,01,061,"Alabama","Geneva County",2,21,252,124,128
050,01,061,"Alabama","Geneva County",2,22,244,117,127
050,01,061,"Alabama","Geneva County",2,23,256,127,129
050,01,061,"Alabama","Geneva County",2,24,272,144,128
050,01,061,"Alabama","Geneva County",2,25,265,140,125
050,01,061,"Alabama","Geneva County",2,26,291,153,138
050,01,061,"Alabama","Geneva County",2,27,297,147,150
050,01,061,"Alabama","Geneva County",2,28,309,148,161
050,01,061,"Alabama","Geneva County",2,29,317,162,155
050,01,061,"Alabama","Geneva County",2,30,304,149,155
050,01,061,"Alabama","Geneva County",2,31,307,155,152
050,01,061,"Alabama","Geneva County",2,32,292,142,150
050,01,061,"Alabama","Geneva County",2,33,304,144,160
050,01,061,"Alabama","Geneva County",2,34,333,165,168
050,01,061,"Alabama","Geneva County",2,35,312,149,163
050,01,061,"Alabama","Geneva County",2,36,294,135,159
050,01,061,"Alabama","Geneva County",2,37,303,146,157
050,01,061,"Alabama","Geneva County",2,38,302,144,158
050,01,061,"Alabama","Geneva County",2,39,307,153,154
050,01,061,"Alabama","Geneva County",2,40,329,166,163
050,01,061,"Alabama","Geneva County",2,41,330,170,160
050,01,061,"Alabama","Geneva County",2,42,294,147,147
050,01,061,"Alabama","Geneva County",2,43,300,151,149
050,01,061,"Alabama","Geneva County",2,44,316,158,158
050,01,061,"Alabama","Geneva County",2,45,319,149,170
050,01,061,"Alabama","Geneva County",2,46,304,147,157
050,01,061,"Alabama","Geneva County",2,47,325,165,160
050,01,061,"Alabama","Geneva County",2,48,362,178,184
050,01,061,"Alabama","Geneva County",2,49,370,181,189
050,01,061,"Alabama","Geneva County",2,50,372,173,199
050,01,061,"Alabama","Geneva County",2,51,367,176,191
050,01,061,"Alabama","Geneva County",2,52,359,183,176
050,01,061,"Alabama","Geneva County",2,53,372,192,180
050,01,061,"Alabama","Geneva County",2,54,380,202,178
050,01,061,"Alabama","Geneva County",2,55,395,216,179
050,01,061,"Alabama","Geneva County",2,56,387,204,183
050,01,061,"Alabama","Geneva County",2,57,375,186,189
050,01,061,"Alabama","Geneva County",2,58,380,181,199
050,01,061,"Alabama","Geneva County",2,59,371,178,193
050,01,061,"Alabama","Geneva County",2,60,368,173,195
050,01,061,"Alabama","Geneva County",2,61,361,168,193
050,01,061,"Alabama","Geneva County",2,62,397,179,218
050,01,061,"Alabama","Geneva County",2,63,395,187,208
050,01,061,"Alabama","Geneva County",2,64,396,209,187
050,01,061,"Alabama","Geneva County",2,65,392,210,182
050,01,061,"Alabama","Geneva County",2,66,370,192,178
050,01,061,"Alabama","Geneva County",2,67,343,160,183
050,01,061,"Alabama","Geneva County",2,68,325,151,174
050,01,061,"Alabama","Geneva County",2,69,298,142,156
050,01,061,"Alabama","Geneva County",2,70,309,155,154
050,01,061,"Alabama","Geneva County",2,71,323,165,158
050,01,061,"Alabama","Geneva County",2,72,310,151,159
050,01,061,"Alabama","Geneva County",2,73,327,158,169
050,01,061,"Alabama","Geneva County",2,74,239,112,127
050,01,061,"Alabama","Geneva County",2,75,236,113,123
050,01,061,"Alabama","Geneva County",2,76,233,113,120
050,01,061,"Alabama","Geneva County",2,77,229,106,123
050,01,061,"Alabama","Geneva County",2,78,188,80,108
050,01,061,"Alabama","Geneva County",2,79,163,65,98
050,01,061,"Alabama","Geneva County",2,80,155,59,96
050,01,061,"Alabama","Geneva County",2,81,137,52,85
050,01,061,"Alabama","Geneva County",2,82,138,47,91
050,01,061,"Alabama","Geneva County",2,83,115,40,75
050,01,061,"Alabama","Geneva County",2,84,116,44,72
050,01,061,"Alabama","Geneva County",2,85,554,208,346
050,01,061,"Alabama","Geneva County",3,0,269,131,138
050,01,061,"Alabama","Geneva County",3,1,274,141,133
050,01,061,"Alabama","Geneva County",3,2,295,156,139
050,01,061,"Alabama","Geneva County",3,3,289,155,134
050,01,061,"Alabama","Geneva County",3,4,321,161,160
050,01,061,"Alabama","Geneva County",3,5,309,161,148
050,01,061,"Alabama","Geneva County",3,6,308,152,156
050,01,061,"Alabama","Geneva County",3,7,303,144,159
050,01,061,"Alabama","Geneva County",3,8,317,160,157
050,01,061,"Alabama","Geneva County",3,9,337,170,167
050,01,061,"Alabama","Geneva County",3,10,325,167,158
050,01,061,"Alabama","Geneva County",3,11,342,184,158
050,01,061,"Alabama","Geneva County",3,12,334,180,154
050,01,061,"Alabama","Geneva County",3,13,366,197,169
050,01,061,"Alabama","Geneva County",3,14,390,183,207
050,01,061,"Alabama","Geneva County",3,15,369,187,182
050,01,061,"Alabama","Geneva County",3,16,365,184,181
050,01,061,"Alabama","Geneva County",3,17,357,185,172
050,01,061,"Alabama","Geneva County",3,18,316,172,144
050,01,061,"Alabama","Geneva County",3,19,251,139,112
050,01,061,"Alabama","Geneva County",3,20,271,141,130
050,01,061,"Alabama","Geneva County",3,21,266,138,128
050,01,061,"Alabama","Geneva County",3,22,265,127,138
050,01,061,"Alabama","Geneva County",3,23,254,122,132
050,01,061,"Alabama","Geneva County",3,24,276,141,135
050,01,061,"Alabama","Geneva County",3,25,260,133,127
050,01,061,"Alabama","Geneva County",3,26,276,152,124
050,01,061,"Alabama","Geneva County",3,27,286,145,141
050,01,061,"Alabama","Geneva County",3,28,303,150,153
050,01,061,"Alabama","Geneva County",3,29,323,158,165
050,01,061,"Alabama","Geneva County",3,30,328,163,165
050,01,061,"Alabama","Geneva County",3,31,318,150,168
050,01,061,"Alabama","Geneva County",3,32,303,150,153
050,01,061,"Alabama","Geneva County",3,33,292,142,150
050,01,061,"Alabama","Geneva County",3,34,313,148,165
050,01,061,"Alabama","Geneva County",3,35,325,158,167
050,01,061,"Alabama","Geneva County",3,36,309,150,159
050,01,061,"Alabama","Geneva County",3,37,295,132,163
050,01,061,"Alabama","Geneva County",3,38,316,150,166
050,01,061,"Alabama","Geneva County",3,39,308,147,161
050,01,061,"Alabama","Geneva County",3,40,304,153,151
050,01,061,"Alabama","Geneva County",3,41,334,163,171
050,01,061,"Alabama","Geneva County",3,42,323,172,151
050,01,061,"Alabama","Geneva County",3,43,287,142,145
050,01,061,"Alabama","Geneva County",3,44,298,150,148
050,01,061,"Alabama","Geneva County",3,45,318,155,163
050,01,061,"Alabama","Geneva County",3,46,322,153,169
050,01,061,"Alabama","Geneva County",3,47,299,144,155
050,01,061,"Alabama","Geneva County",3,48,320,167,153
050,01,061,"Alabama","Geneva County",3,49,361,173,188
050,01,061,"Alabama","Geneva County",3,50,371,182,189
050,01,061,"Alabama","Geneva County",3,51,376,176,200
050,01,061,"Alabama","Geneva County",3,52,356,171,185
050,01,061,"Alabama","Geneva County",3,53,344,174,170
050,01,061,"Alabama","Geneva County",3,54,384,199,185
050,01,061,"Alabama","Geneva County",3,55,384,202,182
050,01,061,"Alabama","Geneva County",3,56,392,210,182
050,01,061,"Alabama","Geneva County",3,57,383,206,177
050,01,061,"Alabama","Geneva County",3,58,370,180,190
050,01,061,"Alabama","Geneva County",3,59,367,172,195
050,01,061,"Alabama","Geneva County",3,60,377,180,197
050,01,061,"Alabama","Geneva County",3,61,365,169,196
050,01,061,"Alabama","Geneva County",3,62,366,172,194
050,01,061,"Alabama","Geneva County",3,63,389,165,224
050,01,061,"Alabama","Geneva County",3,64,394,191,203
050,01,061,"Alabama","Geneva County",3,65,372,200,172
050,01,061,"Alabama","Geneva County",3,66,385,206,179
050,01,061,"Alabama","Geneva County",3,67,369,193,176
050,01,061,"Alabama","Geneva County",3,68,337,155,182
050,01,061,"Alabama","Geneva County",3,69,313,141,172
050,01,061,"Alabama","Geneva County",3,70,289,138,151
050,01,061,"Alabama","Geneva County",3,71,302,151,151
050,01,061,"Alabama","Geneva County",3,72,311,155,156
050,01,061,"Alabama","Geneva County",3,73,293,139,154
050,01,061,"Alabama","Geneva County",3,74,316,152,164
050,01,061,"Alabama","Geneva County",3,75,217,99,118
050,01,061,"Alabama","Geneva County",3,76,234,113,121
050,01,061,"Alabama","Geneva County",3,77,218,105,113
050,01,061,"Alabama","Geneva County",3,78,217,96,121
050,01,061,"Alabama","Geneva County",3,79,166,74,92
050,01,061,"Alabama","Geneva County",3,80,144,55,89
050,01,061,"Alabama","Geneva County",3,81,139,54,85
050,01,061,"Alabama","Geneva County",3,82,121,42,79
050,01,061,"Alabama","Geneva County",3,83,127,43,84
050,01,061,"Alabama","Geneva County",3,84,93,31,62
050,01,061,"Alabama","Geneva County",3,85,549,207,342
050,01,061,"Alabama","Geneva County",4,0,290,147,143
050,01,061,"Alabama","Geneva County",4,1,270,131,139
050,01,061,"Alabama","Geneva County",4,2,279,141,138
050,01,061,"Alabama","Geneva County",4,3,292,148,144
050,01,061,"Alabama","Geneva County",4,4,290,158,132
050,01,061,"Alabama","Geneva County",4,5,341,176,165
050,01,061,"Alabama","Geneva County",4,6,314,168,146
050,01,061,"Alabama","Geneva County",4,7,315,153,162
050,01,061,"Alabama","Geneva County",4,8,314,147,167
050,01,061,"Alabama","Geneva County",4,9,331,172,159
050,01,061,"Alabama","Geneva County",4,10,342,166,176
050,01,061,"Alabama","Geneva County",4,11,338,171,167
050,01,061,"Alabama","Geneva County",4,12,340,178,162
050,01,061,"Alabama","Geneva County",4,13,350,178,172
050,01,061,"Alabama","Geneva County",4,14,384,205,179
050,01,061,"Alabama","Geneva County",4,15,380,180,200
050,01,061,"Alabama","Geneva County",4,16,388,199,189
050,01,061,"Alabama","Geneva County",4,17,371,187,184
050,01,061,"Alabama","Geneva County",4,18,301,159,142
050,01,061,"Alabama","Geneva County",4,19,249,139,110
050,01,061,"Alabama","Geneva County",4,20,266,147,119
050,01,061,"Alabama","Geneva County",4,21,278,140,138
050,01,061,"Alabama","Geneva County",4,22,290,149,141
050,01,061,"Alabama","Geneva County",4,23,283,137,146
050,01,061,"Alabama","Geneva County",4,24,268,128,140
050,01,061,"Alabama","Geneva County",4,25,288,147,141
050,01,061,"Alabama","Geneva County",4,26,283,144,139
050,01,061,"Alabama","Geneva County",4,27,274,141,133
050,01,061,"Alabama","Geneva County",4,28,287,151,136
050,01,061,"Alabama","Geneva County",4,29,312,160,152
050,01,061,"Alabama","Geneva County",4,30,318,155,163
050,01,061,"Alabama","Geneva County",4,31,340,173,167
050,01,061,"Alabama","Geneva County",4,32,325,146,179
050,01,061,"Alabama","Geneva County",4,33,311,155,156
050,01,061,"Alabama","Geneva County",4,34,301,149,152
050,01,061,"Alabama","Geneva County",4,35,311,148,163
050,01,061,"Alabama","Geneva County",4,36,332,159,173
050,01,061,"Alabama","Geneva County",4,37,310,154,156
050,01,061,"Alabama","Geneva County",4,38,287,126,161
050,01,061,"Alabama","Geneva County",4,39,326,155,171
050,01,061,"Alabama","Geneva County",4,40,316,148,168
050,01,061,"Alabama","Geneva County",4,41,300,154,146
050,01,061,"Alabama","Geneva County",4,42,329,159,170
050,01,061,"Alabama","Geneva County",4,43,322,166,156
050,01,061,"Alabama","Geneva County",4,44,300,150,150
050,01,061,"Alabama","Geneva County",4,45,301,150,151
050,01,061,"Alabama","Geneva County",4,46,300,144,156
050,01,061,"Alabama","Geneva County",4,47,326,154,172
050,01,061,"Alabama","Geneva County",4,48,308,152,156
050,01,061,"Alabama","Geneva County",4,49,317,162,155
050,01,061,"Alabama","Geneva County",4,50,356,171,185
050,01,061,"Alabama","Geneva County",4,51,369,179,190
050,01,061,"Alabama","Geneva County",4,52,366,169,197
050,01,061,"Alabama","Geneva County",4,53,362,177,185
050,01,061,"Alabama","Geneva County",4,54,344,171,173
050,01,061,"Alabama","Geneva County",4,55,394,206,188
050,01,061,"Alabama","Geneva County",4,56,387,202,185
050,01,061,"Alabama","Geneva County",4,57,382,201,181
050,01,061,"Alabama","Geneva County",4,58,377,198,179
050,01,061,"Alabama","Geneva County",4,59,356,173,183
050,01,061,"Alabama","Geneva County",4,60,364,165,199
050,01,061,"Alabama","Geneva County",4,61,376,180,196
050,01,061,"Alabama","Geneva County",4,62,372,179,193
050,01,061,"Alabama","Geneva County",4,63,372,173,199
050,01,061,"Alabama","Geneva County",4,64,386,163,223
050,01,061,"Alabama","Geneva County",4,65,393,191,202
050,01,061,"Alabama","Geneva County",4,66,369,207,162
050,01,061,"Alabama","Geneva County",4,67,379,202,177
050,01,061,"Alabama","Geneva County",4,68,360,182,178
050,01,061,"Alabama","Geneva County",4,69,320,148,172
050,01,061,"Alabama","Geneva County",4,70,301,134,167
050,01,061,"Alabama","Geneva County",4,71,283,132,151
050,01,061,"Alabama","Geneva County",4,72,293,145,148
050,01,061,"Alabama","Geneva County",4,73,303,148,155
050,01,061,"Alabama","Geneva County",4,74,296,139,157
050,01,061,"Alabama","Geneva County",4,75,289,139,150
050,01,061,"Alabama","Geneva County",4,76,208,96,112
050,01,061,"Alabama","Geneva County",4,77,224,106,118
050,01,061,"Alabama","Geneva County",4,78,199,90,109
050,01,061,"Alabama","Geneva County",4,79,203,89,114
050,01,061,"Alabama","Geneva County",4,80,155,65,90
050,01,061,"Alabama","Geneva County",4,81,133,50,83
050,01,061,"Alabama","Geneva County",4,82,130,44,86
050,01,061,"Alabama","Geneva County",4,83,107,34,73
050,01,061,"Alabama","Geneva County",4,84,106,34,72
050,01,061,"Alabama","Geneva County",4,85,558,206,352
050,01,061,"Alabama","Geneva County",5,0,296,150,146
050,01,061,"Alabama","Geneva County",5,1,275,141,134
050,01,061,"Alabama","Geneva County",5,2,268,130,138
050,01,061,"Alabama","Geneva County",5,3,272,133,139
050,01,061,"Alabama","Geneva County",5,4,306,162,144
050,01,061,"Alabama","Geneva County",5,5,302,166,136
050,01,061,"Alabama","Geneva County",5,6,341,170,171
050,01,061,"Alabama","Geneva County",5,7,325,176,149
050,01,061,"Alabama","Geneva County",5,8,328,172,156
050,01,061,"Alabama","Geneva County",5,9,321,152,169
050,01,061,"Alabama","Geneva County",5,10,334,169,165
050,01,061,"Alabama","Geneva County",5,11,353,172,181
050,01,061,"Alabama","Geneva County",5,12,351,178,173
050,01,061,"Alabama","Geneva County",5,13,353,188,165
050,01,061,"Alabama","Geneva County",5,14,352,186,166
050,01,061,"Alabama","Geneva County",5,15,381,200,181
050,01,061,"Alabama","Geneva County",5,16,392,182,210
050,01,061,"Alabama","Geneva County",5,17,377,191,186
050,01,061,"Alabama","Geneva County",5,18,318,167,151
050,01,061,"Alabama","Geneva County",5,19,245,125,120
050,01,061,"Alabama","Geneva County",5,20,255,141,114
050,01,061,"Alabama","Geneva County",5,21,291,148,143
050,01,061,"Alabama","Geneva County",5,22,292,148,144
050,01,061,"Alabama","Geneva County",5,23,298,155,143
050,01,061,"Alabama","Geneva County",5,24,292,136,156
050,01,061,"Alabama","Geneva County",5,25,271,130,141
050,01,061,"Alabama","Geneva County",5,26,295,152,143
050,01,061,"Alabama","Geneva County",5,27,298,156,142
050,01,061,"Alabama","Geneva County",5,28,265,144,121
050,01,061,"Alabama","Geneva County",5,29,283,156,127
050,01,061,"Alabama","Geneva County",5,30,320,166,154
050,01,061,"Alabama","Geneva County",5,31,340,170,170
050,01,061,"Alabama","Geneva County",5,32,331,174,157
050,01,061,"Alabama","Geneva County",5,33,333,158,175
050,01,061,"Alabama","Geneva County",5,34,327,165,162
050,01,061,"Alabama","Geneva County",5,35,301,142,159
050,01,061,"Alabama","Geneva County",5,36,309,148,161
050,01,061,"Alabama","Geneva County",5,37,340,159,181
050,01,061,"Alabama","Geneva County",5,38,319,159,160
050,01,061,"Alabama","Geneva County",5,39,294,129,165
050,01,061,"Alabama","Geneva County",5,40,328,150,178
050,01,061,"Alabama","Geneva County",5,41,325,150,175
050,01,061,"Alabama","Geneva County",5,42,302,161,141
050,01,061,"Alabama","Geneva County",5,43,326,163,163
050,01,061,"Alabama","Geneva County",5,44,328,168,160
050,01,061,"Alabama","Geneva County",5,45,306,153,153
050,01,061,"Alabama","Geneva County",5,46,309,148,161
050,01,061,"Alabama","Geneva County",5,47,303,141,162
050,01,061,"Alabama","Geneva County",5,48,327,154,173
050,01,061,"Alabama","Geneva County",5,49,326,160,166
050,01,061,"Alabama","Geneva County",5,50,326,166,160
050,01,061,"Alabama","Geneva County",5,51,359,174,185
050,01,061,"Alabama","Geneva County",5,52,375,189,186
050,01,061,"Alabama","Geneva County",5,53,367,169,198
050,01,061,"Alabama","Geneva County",5,54,365,176,189
050,01,061,"Alabama","Geneva County",5,55,351,175,176
050,01,061,"Alabama","Geneva County",5,56,395,207,188
050,01,061,"Alabama","Geneva County",5,57,388,205,183
050,01,061,"Alabama","Geneva County",5,58,398,204,194
050,01,061,"Alabama","Geneva County",5,59,383,201,182
050,01,061,"Alabama","Geneva County",5,60,356,172,184
050,01,061,"Alabama","Geneva County",5,61,373,172,201
050,01,061,"Alabama","Geneva County",5,62,368,176,192
050,01,061,"Alabama","Geneva County",5,63,375,174,201
050,01,061,"Alabama","Geneva County",5,64,378,182,196
050,01,061,"Alabama","Geneva County",5,65,378,159,219
050,01,061,"Alabama","Geneva County",5,66,390,193,197
050,01,061,"Alabama","Geneva County",5,67,364,198,166
050,01,061,"Alabama","Geneva County",5,68,367,195,172
050,01,061,"Alabama","Geneva County",5,69,349,175,174
050,01,061,"Alabama","Geneva County",5,70,317,148,169
050,01,061,"Alabama","Geneva County",5,71,299,129,170
050,01,061,"Alabama","Geneva County",5,72,269,128,141
050,01,061,"Alabama","Geneva County",5,73,284,142,142
050,01,061,"Alabama","Geneva County",5,74,296,145,151
050,01,061,"Alabama","Geneva County",5,75,272,128,144
050,01,061,"Alabama","Geneva County",5,76,276,133,143
050,01,061,"Alabama","Geneva County",5,77,198,88,110
050,01,061,"Alabama","Geneva County",5,78,210,95,115
050,01,061,"Alabama","Geneva County",5,79,187,87,100
050,01,061,"Alabama","Geneva County",5,80,186,79,107
050,01,061,"Alabama","Geneva County",5,81,144,63,81
050,01,061,"Alabama","Geneva County",5,82,127,43,84
050,01,061,"Alabama","Geneva County",5,83,122,38,84
050,01,061,"Alabama","Geneva County",5,84,91,26,65
050,01,061,"Alabama","Geneva County",5,85,581,208,373
050,01,063,"Alabama","Greene County",1,0,78,39,39
050,01,063,"Alabama","Greene County",1,1,86,43,43
050,01,063,"Alabama","Greene County",1,2,95,43,52
050,01,063,"Alabama","Greene County",1,3,78,39,39
050,01,063,"Alabama","Greene County",1,4,81,44,37
050,01,063,"Alabama","Greene County",1,5,93,38,55
050,01,063,"Alabama","Greene County",1,6,89,42,47
050,01,063,"Alabama","Greene County",1,7,99,51,48
050,01,063,"Alabama","Greene County",1,8,85,44,41
050,01,063,"Alabama","Greene County",1,9,96,55,41
050,01,063,"Alabama","Greene County",1,10,99,52,47
050,01,063,"Alabama","Greene County",1,11,105,49,56
050,01,063,"Alabama","Greene County",1,12,96,39,57
050,01,063,"Alabama","Greene County",1,13,101,49,52
050,01,063,"Alabama","Greene County",1,14,103,55,48
050,01,063,"Alabama","Greene County",1,15,89,44,45
050,01,063,"Alabama","Greene County",1,16,99,51,48
050,01,063,"Alabama","Greene County",1,17,92,39,53
050,01,063,"Alabama","Greene County",1,18,93,47,46
050,01,063,"Alabama","Greene County",1,19,75,36,39
050,01,063,"Alabama","Greene County",1,20,79,37,42
050,01,063,"Alabama","Greene County",1,21,82,43,39
050,01,063,"Alabama","Greene County",1,22,90,46,44
050,01,063,"Alabama","Greene County",1,23,81,44,37
050,01,063,"Alabama","Greene County",1,24,84,46,38
050,01,063,"Alabama","Greene County",1,25,88,40,48
050,01,063,"Alabama","Greene County",1,26,94,49,45
050,01,063,"Alabama","Greene County",1,27,79,41,38
050,01,063,"Alabama","Greene County",1,28,95,50,45
050,01,063,"Alabama","Greene County",1,29,113,60,53
050,01,063,"Alabama","Greene County",1,30,101,50,51
050,01,063,"Alabama","Greene County",1,31,90,42,48
050,01,063,"Alabama","Greene County",1,32,84,41,43
050,01,063,"Alabama","Greene County",1,33,70,39,31
050,01,063,"Alabama","Greene County",1,34,67,37,30
050,01,063,"Alabama","Greene County",1,35,78,33,45
050,01,063,"Alabama","Greene County",1,36,73,32,41
050,01,063,"Alabama","Greene County",1,37,80,37,43
050,01,063,"Alabama","Greene County",1,38,86,38,48
050,01,063,"Alabama","Greene County",1,39,81,39,42
050,01,063,"Alabama","Greene County",1,40,95,40,55
050,01,063,"Alabama","Greene County",1,41,75,36,39
050,01,063,"Alabama","Greene County",1,42,68,34,34
050,01,063,"Alabama","Greene County",1,43,69,31,38
050,01,063,"Alabama","Greene County",1,44,82,41,41
050,01,063,"Alabama","Greene County",1,45,82,41,41
050,01,063,"Alabama","Greene County",1,46,73,41,32
050,01,063,"Alabama","Greene County",1,47,77,45,32
050,01,063,"Alabama","Greene County",1,48,86,35,51
050,01,063,"Alabama","Greene County",1,49,87,40,47
050,01,063,"Alabama","Greene County",1,50,77,34,43
050,01,063,"Alabama","Greene County",1,51,80,35,45
050,01,063,"Alabama","Greene County",1,52,86,40,46
050,01,063,"Alabama","Greene County",1,53,102,44,58
050,01,063,"Alabama","Greene County",1,54,97,42,55
050,01,063,"Alabama","Greene County",1,55,96,42,54
050,01,063,"Alabama","Greene County",1,56,98,46,52
050,01,063,"Alabama","Greene County",1,57,116,43,73
050,01,063,"Alabama","Greene County",1,58,106,51,55
050,01,063,"Alabama","Greene County",1,59,105,49,56
050,01,063,"Alabama","Greene County",1,60,123,61,62
050,01,063,"Alabama","Greene County",1,61,116,51,65
050,01,063,"Alabama","Greene County",1,62,109,52,57
050,01,063,"Alabama","Greene County",1,63,128,62,66
050,01,063,"Alabama","Greene County",1,64,130,60,70
050,01,063,"Alabama","Greene County",1,65,132,61,71
050,01,063,"Alabama","Greene County",1,66,132,60,72
050,01,063,"Alabama","Greene County",1,67,129,56,73
050,01,063,"Alabama","Greene County",1,68,118,62,56
050,01,063,"Alabama","Greene County",1,69,125,58,67
050,01,063,"Alabama","Greene County",1,70,117,52,65
050,01,063,"Alabama","Greene County",1,71,106,45,61
050,01,063,"Alabama","Greene County",1,72,101,48,53
050,01,063,"Alabama","Greene County",1,73,95,41,54
050,01,063,"Alabama","Greene County",1,74,55,19,36
050,01,063,"Alabama","Greene County",1,75,64,24,40
050,01,063,"Alabama","Greene County",1,76,69,26,43
050,01,063,"Alabama","Greene County",1,77,62,27,35
050,01,063,"Alabama","Greene County",1,78,51,24,27
050,01,063,"Alabama","Greene County",1,79,52,26,26
050,01,063,"Alabama","Greene County",1,80,54,27,27
050,01,063,"Alabama","Greene County",1,81,48,23,25
050,01,063,"Alabama","Greene County",1,82,40,20,20
050,01,063,"Alabama","Greene County",1,83,39,17,22
050,01,063,"Alabama","Greene County",1,84,32,12,20
050,01,063,"Alabama","Greene County",1,85,220,64,156
050,01,063,"Alabama","Greene County",2,0,88,46,42
050,01,063,"Alabama","Greene County",2,1,84,41,43
050,01,063,"Alabama","Greene County",2,2,93,43,50
050,01,063,"Alabama","Greene County",2,3,81,39,42
050,01,063,"Alabama","Greene County",2,4,83,44,39
050,01,063,"Alabama","Greene County",2,5,91,40,51
050,01,063,"Alabama","Greene County",2,6,93,43,50
050,01,063,"Alabama","Greene County",2,7,96,49,47
050,01,063,"Alabama","Greene County",2,8,87,46,41
050,01,063,"Alabama","Greene County",2,9,92,51,41
050,01,063,"Alabama","Greene County",2,10,95,50,45
050,01,063,"Alabama","Greene County",2,11,103,49,54
050,01,063,"Alabama","Greene County",2,12,98,41,57
050,01,063,"Alabama","Greene County",2,13,102,48,54
050,01,063,"Alabama","Greene County",2,14,100,52,48
050,01,063,"Alabama","Greene County",2,15,92,46,46
050,01,063,"Alabama","Greene County",2,16,95,48,47
050,01,063,"Alabama","Greene County",2,17,92,41,51
050,01,063,"Alabama","Greene County",2,18,90,43,47
050,01,063,"Alabama","Greene County",2,19,78,38,40
050,01,063,"Alabama","Greene County",2,20,79,37,42
050,01,063,"Alabama","Greene County",2,21,82,41,41
050,01,063,"Alabama","Greene County",2,22,88,46,42
050,01,063,"Alabama","Greene County",2,23,84,45,39
050,01,063,"Alabama","Greene County",2,24,82,45,37
050,01,063,"Alabama","Greene County",2,25,87,42,45
050,01,063,"Alabama","Greene County",2,26,91,45,46
050,01,063,"Alabama","Greene County",2,27,82,42,40
050,01,063,"Alabama","Greene County",2,28,92,49,43
050,01,063,"Alabama","Greene County",2,29,109,58,51
050,01,063,"Alabama","Greene County",2,30,104,53,51
050,01,063,"Alabama","Greene County",2,31,93,44,49
050,01,063,"Alabama","Greene County",2,32,83,40,43
050,01,063,"Alabama","Greene County",2,33,73,39,34
050,01,063,"Alabama","Greene County",2,34,67,37,30
050,01,063,"Alabama","Greene County",2,35,76,34,42
050,01,063,"Alabama","Greene County",2,36,71,31,40
050,01,063,"Alabama","Greene County",2,37,79,36,43
050,01,063,"Alabama","Greene County",2,38,84,38,46
050,01,063,"Alabama","Greene County",2,39,82,38,44
050,01,063,"Alabama","Greene County",2,40,93,40,53
050,01,063,"Alabama","Greene County",2,41,79,37,42
050,01,063,"Alabama","Greene County",2,42,69,34,35
050,01,063,"Alabama","Greene County",2,43,69,32,37
050,01,063,"Alabama","Greene County",2,44,77,37,40
050,01,063,"Alabama","Greene County",2,45,82,40,42
050,01,063,"Alabama","Greene County",2,46,73,40,33
050,01,063,"Alabama","Greene County",2,47,76,44,32
050,01,063,"Alabama","Greene County",2,48,83,37,46
050,01,063,"Alabama","Greene County",2,49,87,39,48
050,01,063,"Alabama","Greene County",2,50,80,35,45
050,01,063,"Alabama","Greene County",2,51,79,35,44
050,01,063,"Alabama","Greene County",2,52,85,39,46
050,01,063,"Alabama","Greene County",2,53,97,42,55
050,01,063,"Alabama","Greene County",2,54,98,42,56
050,01,063,"Alabama","Greene County",2,55,95,42,53
050,01,063,"Alabama","Greene County",2,56,97,45,52
050,01,063,"Alabama","Greene County",2,57,111,43,68
050,01,063,"Alabama","Greene County",2,58,108,49,59
050,01,063,"Alabama","Greene County",2,59,104,47,57
050,01,063,"Alabama","Greene County",2,60,117,57,60
050,01,063,"Alabama","Greene County",2,61,116,54,62
050,01,063,"Alabama","Greene County",2,62,108,50,58
050,01,063,"Alabama","Greene County",2,63,126,61,65
050,01,063,"Alabama","Greene County",2,64,129,60,69
050,01,063,"Alabama","Greene County",2,65,131,61,70
050,01,063,"Alabama","Greene County",2,66,131,59,72
050,01,063,"Alabama","Greene County",2,67,129,57,72
050,01,063,"Alabama","Greene County",2,68,120,59,61
050,01,063,"Alabama","Greene County",2,69,125,60,65
050,01,063,"Alabama","Greene County",2,70,116,53,63
050,01,063,"Alabama","Greene County",2,71,106,46,60
050,01,063,"Alabama","Greene County",2,72,99,45,54
050,01,063,"Alabama","Greene County",2,73,99,43,56
050,01,063,"Alabama","Greene County",2,74,61,24,37
050,01,063,"Alabama","Greene County",2,75,61,22,39
050,01,063,"Alabama","Greene County",2,76,66,25,41
050,01,063,"Alabama","Greene County",2,77,64,27,37
050,01,063,"Alabama","Greene County",2,78,52,24,28
050,01,063,"Alabama","Greene County",2,79,51,25,26
050,01,063,"Alabama","Greene County",2,80,52,27,25
050,01,063,"Alabama","Greene County",2,81,48,23,25
050,01,063,"Alabama","Greene County",2,82,39,20,19
050,01,063,"Alabama","Greene County",2,83,40,18,22
050,01,063,"Alabama","Greene County",2,84,29,12,17
050,01,063,"Alabama","Greene County",2,85,222,66,156
050,01,063,"Alabama","Greene County",3,0,107,54,53
050,01,063,"Alabama","Greene County",3,1,95,49,46
050,01,063,"Alabama","Greene County",3,2,79,32,47
050,01,063,"Alabama","Greene County",3,3,91,43,48
050,01,063,"Alabama","Greene County",3,4,88,42,46
050,01,063,"Alabama","Greene County",3,5,84,43,41
050,01,063,"Alabama","Greene County",3,6,82,36,46
050,01,063,"Alabama","Greene County",3,7,89,41,48
050,01,063,"Alabama","Greene County",3,8,91,44,47
050,01,063,"Alabama","Greene County",3,9,82,41,41
050,01,063,"Alabama","Greene County",3,10,89,47,42
050,01,063,"Alabama","Greene County",3,11,98,53,45
050,01,063,"Alabama","Greene County",3,12,106,48,58
050,01,063,"Alabama","Greene County",3,13,92,38,54
050,01,063,"Alabama","Greene County",3,14,106,47,59
050,01,063,"Alabama","Greene County",3,15,91,47,44
050,01,063,"Alabama","Greene County",3,16,91,47,44
050,01,063,"Alabama","Greene County",3,17,96,46,50
050,01,063,"Alabama","Greene County",3,18,84,42,42
050,01,063,"Alabama","Greene County",3,19,83,39,44
050,01,063,"Alabama","Greene County",3,20,79,40,39
050,01,063,"Alabama","Greene County",3,21,83,38,45
050,01,063,"Alabama","Greene County",3,22,79,39,40
050,01,063,"Alabama","Greene County",3,23,90,45,45
050,01,063,"Alabama","Greene County",3,24,86,46,40
050,01,063,"Alabama","Greene County",3,25,79,43,36
050,01,063,"Alabama","Greene County",3,26,84,42,42
050,01,063,"Alabama","Greene County",3,27,87,44,43
050,01,063,"Alabama","Greene County",3,28,80,38,42
050,01,063,"Alabama","Greene County",3,29,90,50,40
050,01,063,"Alabama","Greene County",3,30,99,56,43
050,01,063,"Alabama","Greene County",3,31,99,49,50
050,01,063,"Alabama","Greene County",3,32,87,38,49
050,01,063,"Alabama","Greene County",3,33,83,40,43
050,01,063,"Alabama","Greene County",3,34,76,43,33
050,01,063,"Alabama","Greene County",3,35,66,36,30
050,01,063,"Alabama","Greene County",3,36,70,32,38
050,01,063,"Alabama","Greene County",3,37,71,30,41
050,01,063,"Alabama","Greene County",3,38,80,35,45
050,01,063,"Alabama","Greene County",3,39,88,41,47
050,01,063,"Alabama","Greene County",3,40,81,34,47
050,01,063,"Alabama","Greene County",3,41,91,39,52
050,01,063,"Alabama","Greene County",3,42,78,36,42
050,01,063,"Alabama","Greene County",3,43,66,33,33
050,01,063,"Alabama","Greene County",3,44,69,32,37
050,01,063,"Alabama","Greene County",3,45,81,39,42
050,01,063,"Alabama","Greene County",3,46,80,33,47
050,01,063,"Alabama","Greene County",3,47,71,40,31
050,01,063,"Alabama","Greene County",3,48,70,38,32
050,01,063,"Alabama","Greene County",3,49,86,40,46
050,01,063,"Alabama","Greene County",3,50,84,39,45
050,01,063,"Alabama","Greene County",3,51,81,37,44
050,01,063,"Alabama","Greene County",3,52,80,37,43
050,01,063,"Alabama","Greene County",3,53,86,39,47
050,01,063,"Alabama","Greene County",3,54,98,44,54
050,01,063,"Alabama","Greene County",3,55,102,46,56
050,01,063,"Alabama","Greene County",3,56,93,39,54
050,01,063,"Alabama","Greene County",3,57,89,42,47
050,01,063,"Alabama","Greene County",3,58,105,41,64
050,01,063,"Alabama","Greene County",3,59,112,51,61
050,01,063,"Alabama","Greene County",3,60,96,44,52
050,01,063,"Alabama","Greene County",3,61,121,59,62
050,01,063,"Alabama","Greene County",3,62,118,54,64
050,01,063,"Alabama","Greene County",3,63,101,45,56
050,01,063,"Alabama","Greene County",3,64,124,57,67
050,01,063,"Alabama","Greene County",3,65,116,53,63
050,01,063,"Alabama","Greene County",3,66,135,64,71
050,01,063,"Alabama","Greene County",3,67,133,61,72
050,01,063,"Alabama","Greene County",3,68,125,55,70
050,01,063,"Alabama","Greene County",3,69,117,57,60
050,01,063,"Alabama","Greene County",3,70,118,57,61
050,01,063,"Alabama","Greene County",3,71,116,55,61
050,01,063,"Alabama","Greene County",3,72,102,44,58
050,01,063,"Alabama","Greene County",3,73,96,46,50
050,01,063,"Alabama","Greene County",3,74,94,39,55
050,01,063,"Alabama","Greene County",3,75,57,20,37
050,01,063,"Alabama","Greene County",3,76,57,21,36
050,01,063,"Alabama","Greene County",3,77,64,22,42
050,01,063,"Alabama","Greene County",3,78,62,26,36
050,01,063,"Alabama","Greene County",3,79,45,22,23
050,01,063,"Alabama","Greene County",3,80,48,24,24
050,01,063,"Alabama","Greene County",3,81,48,22,26
050,01,063,"Alabama","Greene County",3,82,42,20,22
050,01,063,"Alabama","Greene County",3,83,40,21,19
050,01,063,"Alabama","Greene County",3,84,36,16,20
050,01,063,"Alabama","Greene County",3,85,220,68,152
050,01,063,"Alabama","Greene County",4,0,82,36,46
050,01,063,"Alabama","Greene County",4,1,103,46,57
050,01,063,"Alabama","Greene County",4,2,97,48,49
050,01,063,"Alabama","Greene County",4,3,78,33,45
050,01,063,"Alabama","Greene County",4,4,86,40,46
050,01,063,"Alabama","Greene County",4,5,86,41,45
050,01,063,"Alabama","Greene County",4,6,88,48,40
050,01,063,"Alabama","Greene County",4,7,78,34,44
050,01,063,"Alabama","Greene County",4,8,92,44,48
050,01,063,"Alabama","Greene County",4,9,92,45,47
050,01,063,"Alabama","Greene County",4,10,87,43,44
050,01,063,"Alabama","Greene County",4,11,82,45,37
050,01,063,"Alabama","Greene County",4,12,93,49,44
050,01,063,"Alabama","Greene County",4,13,100,45,55
050,01,063,"Alabama","Greene County",4,14,88,36,52
050,01,063,"Alabama","Greene County",4,15,105,44,61
050,01,063,"Alabama","Greene County",4,16,86,46,40
050,01,063,"Alabama","Greene County",4,17,90,46,44
050,01,063,"Alabama","Greene County",4,18,77,38,39
050,01,063,"Alabama","Greene County",4,19,75,36,39
050,01,063,"Alabama","Greene County",4,20,79,36,43
050,01,063,"Alabama","Greene County",4,21,77,44,33
050,01,063,"Alabama","Greene County",4,22,90,41,49
050,01,063,"Alabama","Greene County",4,23,83,43,40
050,01,063,"Alabama","Greene County",4,24,80,39,41
050,01,063,"Alabama","Greene County",4,25,87,48,39
050,01,063,"Alabama","Greene County",4,26,74,39,35
050,01,063,"Alabama","Greene County",4,27,77,36,41
050,01,063,"Alabama","Greene County",4,28,86,43,43
050,01,063,"Alabama","Greene County",4,29,81,34,47
050,01,063,"Alabama","Greene County",4,30,83,46,37
050,01,063,"Alabama","Greene County",4,31,92,53,39
050,01,063,"Alabama","Greene County",4,32,92,46,46
050,01,063,"Alabama","Greene County",4,33,88,41,47
050,01,063,"Alabama","Greene County",4,34,86,45,41
050,01,063,"Alabama","Greene County",4,35,73,38,35
050,01,063,"Alabama","Greene County",4,36,63,31,32
050,01,063,"Alabama","Greene County",4,37,71,34,37
050,01,063,"Alabama","Greene County",4,38,66,29,37
050,01,063,"Alabama","Greene County",4,39,76,31,45
050,01,063,"Alabama","Greene County",4,40,89,41,48
050,01,063,"Alabama","Greene County",4,41,72,34,38
050,01,063,"Alabama","Greene County",4,42,86,39,47
050,01,063,"Alabama","Greene County",4,43,84,39,45
050,01,063,"Alabama","Greene County",4,44,61,29,32
050,01,063,"Alabama","Greene County",4,45,66,29,37
050,01,063,"Alabama","Greene County",4,46,83,39,44
050,01,063,"Alabama","Greene County",4,47,76,31,45
050,01,063,"Alabama","Greene County",4,48,70,40,30
050,01,063,"Alabama","Greene County",4,49,71,38,33
050,01,063,"Alabama","Greene County",4,50,83,39,44
050,01,063,"Alabama","Greene County",4,51,82,38,44
050,01,063,"Alabama","Greene County",4,52,83,36,47
050,01,063,"Alabama","Greene County",4,53,77,34,43
050,01,063,"Alabama","Greene County",4,54,82,36,46
050,01,063,"Alabama","Greene County",4,55,97,44,53
050,01,063,"Alabama","Greene County",4,56,107,49,58
050,01,063,"Alabama","Greene County",4,57,94,39,55
050,01,063,"Alabama","Greene County",4,58,89,43,46
050,01,063,"Alabama","Greene County",4,59,102,35,67
050,01,063,"Alabama","Greene County",4,60,105,48,57
050,01,063,"Alabama","Greene County",4,61,89,39,50
050,01,063,"Alabama","Greene County",4,62,118,58,60
050,01,063,"Alabama","Greene County",4,63,120,59,61
050,01,063,"Alabama","Greene County",4,64,94,41,53
050,01,063,"Alabama","Greene County",4,65,112,48,64
050,01,063,"Alabama","Greene County",4,66,119,54,65
050,01,063,"Alabama","Greene County",4,67,136,64,72
050,01,063,"Alabama","Greene County",4,68,133,61,72
050,01,063,"Alabama","Greene County",4,69,127,57,70
050,01,063,"Alabama","Greene County",4,70,111,55,56
050,01,063,"Alabama","Greene County",4,71,115,54,61
050,01,063,"Alabama","Greene County",4,72,111,51,60
050,01,063,"Alabama","Greene County",4,73,102,45,57
050,01,063,"Alabama","Greene County",4,74,91,44,47
050,01,063,"Alabama","Greene County",4,75,89,37,52
050,01,063,"Alabama","Greene County",4,76,49,20,29
050,01,063,"Alabama","Greene County",4,77,55,19,36
050,01,063,"Alabama","Greene County",4,78,59,19,40
050,01,063,"Alabama","Greene County",4,79,61,25,36
050,01,063,"Alabama","Greene County",4,80,42,21,21
050,01,063,"Alabama","Greene County",4,81,44,19,25
050,01,063,"Alabama","Greene County",4,82,42,19,23
050,01,063,"Alabama","Greene County",4,83,43,19,24
050,01,063,"Alabama","Greene County",4,84,34,19,15
050,01,063,"Alabama","Greene County",4,85,228,78,150
050,01,063,"Alabama","Greene County",5,0,82,37,45
050,01,063,"Alabama","Greene County",5,1,97,34,63
050,01,063,"Alabama","Greene County",5,2,96,45,51
050,01,063,"Alabama","Greene County",5,3,99,45,54
050,01,063,"Alabama","Greene County",5,4,75,33,42
050,01,063,"Alabama","Greene County",5,5,94,45,49
050,01,063,"Alabama","Greene County",5,6,83,39,44
050,01,063,"Alabama","Greene County",5,7,83,46,37
050,01,063,"Alabama","Greene County",5,8,80,38,42
050,01,063,"Alabama","Greene County",5,9,86,44,42
050,01,063,"Alabama","Greene County",5,10,88,43,45
050,01,063,"Alabama","Greene County",5,11,84,40,44
050,01,063,"Alabama","Greene County",5,12,88,48,40
050,01,063,"Alabama","Greene County",5,13,84,43,41
050,01,063,"Alabama","Greene County",5,14,98,43,55
050,01,063,"Alabama","Greene County",5,15,85,34,51
050,01,063,"Alabama","Greene County",5,16,99,46,53
050,01,063,"Alabama","Greene County",5,17,85,48,37
050,01,063,"Alabama","Greene County",5,18,74,39,35
050,01,063,"Alabama","Greene County",5,19,66,30,36
050,01,063,"Alabama","Greene County",5,20,83,39,44
050,01,063,"Alabama","Greene County",5,21,82,38,44
050,01,063,"Alabama","Greene County",5,22,81,44,37
050,01,063,"Alabama","Greene County",5,23,92,44,48
050,01,063,"Alabama","Greene County",5,24,87,46,41
050,01,063,"Alabama","Greene County",5,25,77,36,41
050,01,063,"Alabama","Greene County",5,26,91,52,39
050,01,063,"Alabama","Greene County",5,27,77,41,36
050,01,063,"Alabama","Greene County",5,28,81,39,42
050,01,063,"Alabama","Greene County",5,29,75,38,37
050,01,063,"Alabama","Greene County",5,30,76,32,44
050,01,063,"Alabama","Greene County",5,31,81,46,35
050,01,063,"Alabama","Greene County",5,32,94,57,37
050,01,063,"Alabama","Greene County",5,33,89,44,45
050,01,063,"Alabama","Greene County",5,34,84,41,43
050,01,063,"Alabama","Greene County",5,35,80,40,40
050,01,063,"Alabama","Greene County",5,36,64,36,28
050,01,063,"Alabama","Greene County",5,37,65,31,34
050,01,063,"Alabama","Greene County",5,38,66,32,34
050,01,063,"Alabama","Greene County",5,39,65,27,38
050,01,063,"Alabama","Greene County",5,40,77,31,46
050,01,063,"Alabama","Greene County",5,41,82,38,44
050,01,063,"Alabama","Greene County",5,42,72,36,36
050,01,063,"Alabama","Greene County",5,43,92,41,51
050,01,063,"Alabama","Greene County",5,44,85,42,43
050,01,063,"Alabama","Greene County",5,45,66,31,35
050,01,063,"Alabama","Greene County",5,46,69,33,36
050,01,063,"Alabama","Greene County",5,47,79,37,42
050,01,063,"Alabama","Greene County",5,48,74,31,43
050,01,063,"Alabama","Greene County",5,49,71,40,31
050,01,063,"Alabama","Greene County",5,50,66,39,27
050,01,063,"Alabama","Greene County",5,51,82,37,45
050,01,063,"Alabama","Greene County",5,52,80,36,44
050,01,063,"Alabama","Greene County",5,53,77,32,45
050,01,063,"Alabama","Greene County",5,54,77,34,43
050,01,063,"Alabama","Greene County",5,55,79,36,43
050,01,063,"Alabama","Greene County",5,56,93,44,49
050,01,063,"Alabama","Greene County",5,57,106,50,56
050,01,063,"Alabama","Greene County",5,58,92,39,53
050,01,063,"Alabama","Greene County",5,59,87,39,48
050,01,063,"Alabama","Greene County",5,60,96,33,63
050,01,063,"Alabama","Greene County",5,61,104,46,58
050,01,063,"Alabama","Greene County",5,62,92,41,51
050,01,063,"Alabama","Greene County",5,63,116,55,61
050,01,063,"Alabama","Greene County",5,64,114,53,61
050,01,063,"Alabama","Greene County",5,65,90,36,54
050,01,063,"Alabama","Greene County",5,66,112,48,64
050,01,063,"Alabama","Greene County",5,67,118,54,64
050,01,063,"Alabama","Greene County",5,68,135,63,72
050,01,063,"Alabama","Greene County",5,69,132,60,72
050,01,063,"Alabama","Greene County",5,70,120,54,66
050,01,063,"Alabama","Greene County",5,71,104,52,52
050,01,063,"Alabama","Greene County",5,72,109,51,58
050,01,063,"Alabama","Greene County",5,73,111,51,60
050,01,063,"Alabama","Greene County",5,74,94,40,54
050,01,063,"Alabama","Greene County",5,75,89,43,46
050,01,063,"Alabama","Greene County",5,76,82,35,47
050,01,063,"Alabama","Greene County",5,77,44,17,27
050,01,063,"Alabama","Greene County",5,78,50,15,35
050,01,063,"Alabama","Greene County",5,79,58,18,40
050,01,063,"Alabama","Greene County",5,80,62,27,35
050,01,063,"Alabama","Greene County",5,81,39,17,22
050,01,063,"Alabama","Greene County",5,82,38,16,22
050,01,063,"Alabama","Greene County",5,83,42,19,23
050,01,063,"Alabama","Greene County",5,84,37,17,20
050,01,063,"Alabama","Greene County",5,85,231,86,145
050,01,065,"Alabama","Hale County",1,0,174,89,85
050,01,065,"Alabama","Hale County",1,1,180,94,86
050,01,065,"Alabama","Hale County",1,2,201,110,91
050,01,065,"Alabama","Hale County",1,3,191,99,92
050,01,065,"Alabama","Hale County",1,4,215,124,91
050,01,065,"Alabama","Hale County",1,5,204,108,96
050,01,065,"Alabama","Hale County",1,6,198,107,91
050,01,065,"Alabama","Hale County",1,7,190,95,95
050,01,065,"Alabama","Hale County",1,8,183,91,92
050,01,065,"Alabama","Hale County",1,9,185,92,93
050,01,065,"Alabama","Hale County",1,10,186,96,90
050,01,065,"Alabama","Hale County",1,11,203,108,95
050,01,065,"Alabama","Hale County",1,12,209,113,96
050,01,065,"Alabama","Hale County",1,13,194,97,97
050,01,065,"Alabama","Hale County",1,14,198,96,102
050,01,065,"Alabama","Hale County",1,15,190,100,90
050,01,065,"Alabama","Hale County",1,16,189,89,100
050,01,065,"Alabama","Hale County",1,17,185,98,87
050,01,065,"Alabama","Hale County",1,18,157,84,73
050,01,065,"Alabama","Hale County",1,19,147,70,77
050,01,065,"Alabama","Hale County",1,20,177,90,87
050,01,065,"Alabama","Hale County",1,21,164,78,86
050,01,065,"Alabama","Hale County",1,22,178,85,93
050,01,065,"Alabama","Hale County",1,23,170,76,94
050,01,065,"Alabama","Hale County",1,24,183,76,107
050,01,065,"Alabama","Hale County",1,25,200,96,104
050,01,065,"Alabama","Hale County",1,26,196,98,98
050,01,065,"Alabama","Hale County",1,27,194,94,100
050,01,065,"Alabama","Hale County",1,28,183,96,87
050,01,065,"Alabama","Hale County",1,29,188,80,108
050,01,065,"Alabama","Hale County",1,30,177,83,94
050,01,065,"Alabama","Hale County",1,31,164,73,91
050,01,065,"Alabama","Hale County",1,32,152,66,86
050,01,065,"Alabama","Hale County",1,33,143,64,79
050,01,065,"Alabama","Hale County",1,34,167,85,82
050,01,065,"Alabama","Hale County",1,35,164,82,82
050,01,065,"Alabama","Hale County",1,36,174,73,101
050,01,065,"Alabama","Hale County",1,37,173,78,95
050,01,065,"Alabama","Hale County",1,38,167,78,89
050,01,065,"Alabama","Hale County",1,39,167,76,91
050,01,065,"Alabama","Hale County",1,40,173,75,98
050,01,065,"Alabama","Hale County",1,41,155,65,90
050,01,065,"Alabama","Hale County",1,42,176,80,96
050,01,065,"Alabama","Hale County",1,43,169,73,96
050,01,065,"Alabama","Hale County",1,44,131,61,70
050,01,065,"Alabama","Hale County",1,45,147,62,85
050,01,065,"Alabama","Hale County",1,46,156,70,86
050,01,065,"Alabama","Hale County",1,47,166,75,91
050,01,065,"Alabama","Hale County",1,48,171,83,88
050,01,065,"Alabama","Hale County",1,49,154,82,72
050,01,065,"Alabama","Hale County",1,50,166,79,87
050,01,065,"Alabama","Hale County",1,51,160,81,79
050,01,065,"Alabama","Hale County",1,52,155,65,90
050,01,065,"Alabama","Hale County",1,53,167,69,98
050,01,065,"Alabama","Hale County",1,54,192,81,111
050,01,065,"Alabama","Hale County",1,55,233,106,127
050,01,065,"Alabama","Hale County",1,56,209,96,113
050,01,065,"Alabama","Hale County",1,57,229,103,126
050,01,065,"Alabama","Hale County",1,58,218,111,107
050,01,065,"Alabama","Hale County",1,59,220,108,112
050,01,065,"Alabama","Hale County",1,60,228,104,124
050,01,065,"Alabama","Hale County",1,61,210,99,111
050,01,065,"Alabama","Hale County",1,62,204,104,100
050,01,065,"Alabama","Hale County",1,63,218,109,109
050,01,065,"Alabama","Hale County",1,64,220,105,115
050,01,065,"Alabama","Hale County",1,65,205,92,113
050,01,065,"Alabama","Hale County",1,66,186,88,98
050,01,065,"Alabama","Hale County",1,67,188,91,97
050,01,065,"Alabama","Hale County",1,68,202,92,110
050,01,065,"Alabama","Hale County",1,69,181,86,95
050,01,065,"Alabama","Hale County",1,70,163,92,71
050,01,065,"Alabama","Hale County",1,71,163,86,77
050,01,065,"Alabama","Hale County",1,72,154,70,84
050,01,065,"Alabama","Hale County",1,73,157,75,82
050,01,065,"Alabama","Hale County",1,74,119,56,63
050,01,065,"Alabama","Hale County",1,75,115,58,57
050,01,065,"Alabama","Hale County",1,76,111,53,58
050,01,065,"Alabama","Hale County",1,77,109,52,57
050,01,065,"Alabama","Hale County",1,78,98,42,56
050,01,065,"Alabama","Hale County",1,79,94,42,52
050,01,065,"Alabama","Hale County",1,80,75,30,45
050,01,065,"Alabama","Hale County",1,81,58,21,37
050,01,065,"Alabama","Hale County",1,82,61,29,32
050,01,065,"Alabama","Hale County",1,83,69,29,40
050,01,065,"Alabama","Hale County",1,84,74,20,54
050,01,065,"Alabama","Hale County",1,85,319,78,241
050,01,065,"Alabama","Hale County",2,0,179,90,89
050,01,065,"Alabama","Hale County",2,1,180,94,86
050,01,065,"Alabama","Hale County",2,2,195,106,89
050,01,065,"Alabama","Hale County",2,3,192,102,90
050,01,065,"Alabama","Hale County",2,4,207,116,91
050,01,065,"Alabama","Hale County",2,5,208,112,96
050,01,065,"Alabama","Hale County",2,6,202,110,92
050,01,065,"Alabama","Hale County",2,7,194,98,96
050,01,065,"Alabama","Hale County",2,8,188,92,96
050,01,065,"Alabama","Hale County",2,9,183,91,92
050,01,065,"Alabama","Hale County",2,10,186,95,91
050,01,065,"Alabama","Hale County",2,11,199,104,95
050,01,065,"Alabama","Hale County",2,12,207,112,95
050,01,065,"Alabama","Hale County",2,13,197,101,96
050,01,065,"Alabama","Hale County",2,14,198,97,101
050,01,065,"Alabama","Hale County",2,15,192,98,94
050,01,065,"Alabama","Hale County",2,16,192,93,99
050,01,065,"Alabama","Hale County",2,17,187,96,91
050,01,065,"Alabama","Hale County",2,18,155,83,72
050,01,065,"Alabama","Hale County",2,19,144,70,74
050,01,065,"Alabama","Hale County",2,20,174,86,88
050,01,065,"Alabama","Hale County",2,21,171,83,88
050,01,065,"Alabama","Hale County",2,22,175,83,92
050,01,065,"Alabama","Hale County",2,23,172,78,94
050,01,065,"Alabama","Hale County",2,24,179,76,103
050,01,065,"Alabama","Hale County",2,25,195,92,103
050,01,065,"Alabama","Hale County",2,26,201,99,102
050,01,065,"Alabama","Hale County",2,27,193,95,98
050,01,065,"Alabama","Hale County",2,28,187,95,92
050,01,065,"Alabama","Hale County",2,29,187,84,103
050,01,065,"Alabama","Hale County",2,30,176,80,96
050,01,065,"Alabama","Hale County",2,31,166,74,92
050,01,065,"Alabama","Hale County",2,32,156,68,88
050,01,065,"Alabama","Hale County",2,33,144,64,80
050,01,065,"Alabama","Hale County",2,34,160,79,81
050,01,065,"Alabama","Hale County",2,35,168,85,83
050,01,065,"Alabama","Hale County",2,36,171,74,97
050,01,065,"Alabama","Hale County",2,37,172,76,96
050,01,065,"Alabama","Hale County",2,38,167,78,89
050,01,065,"Alabama","Hale County",2,39,165,75,90
050,01,065,"Alabama","Hale County",2,40,170,72,98
050,01,065,"Alabama","Hale County",2,41,157,67,90
050,01,065,"Alabama","Hale County",2,42,171,76,95
050,01,065,"Alabama","Hale County",2,43,174,76,98
050,01,065,"Alabama","Hale County",2,44,140,64,76
050,01,065,"Alabama","Hale County",2,45,142,61,81
050,01,065,"Alabama","Hale County",2,46,154,68,86
050,01,065,"Alabama","Hale County",2,47,164,73,91
050,01,065,"Alabama","Hale County",2,48,172,82,90
050,01,065,"Alabama","Hale County",2,49,159,83,76
050,01,065,"Alabama","Hale County",2,50,161,78,83
050,01,065,"Alabama","Hale County",2,51,159,79,80
050,01,065,"Alabama","Hale County",2,52,157,69,88
050,01,065,"Alabama","Hale County",2,53,165,68,97
050,01,065,"Alabama","Hale County",2,54,183,78,105
050,01,065,"Alabama","Hale County",2,55,222,99,123
050,01,065,"Alabama","Hale County",2,56,215,99,116
050,01,065,"Alabama","Hale County",2,57,223,100,123
050,01,065,"Alabama","Hale County",2,58,222,110,112
050,01,065,"Alabama","Hale County",2,59,219,107,112
050,01,065,"Alabama","Hale County",2,60,223,104,119
050,01,065,"Alabama","Hale County",2,61,215,100,115
050,01,065,"Alabama","Hale County",2,62,206,104,102
050,01,065,"Alabama","Hale County",2,63,217,109,108
050,01,065,"Alabama","Hale County",2,64,218,103,115
050,01,065,"Alabama","Hale County",2,65,209,96,113
050,01,065,"Alabama","Hale County",2,66,188,86,102
050,01,065,"Alabama","Hale County",2,67,188,91,97
050,01,065,"Alabama","Hale County",2,68,195,90,105
050,01,065,"Alabama","Hale County",2,69,188,88,100
050,01,065,"Alabama","Hale County",2,70,164,87,77
050,01,065,"Alabama","Hale County",2,71,161,87,74
050,01,065,"Alabama","Hale County",2,72,152,70,82
050,01,065,"Alabama","Hale County",2,73,160,76,84
050,01,065,"Alabama","Hale County",2,74,119,57,62
050,01,065,"Alabama","Hale County",2,75,115,56,59
050,01,065,"Alabama","Hale County",2,76,107,53,54
050,01,065,"Alabama","Hale County",2,77,108,51,57
050,01,065,"Alabama","Hale County",2,78,98,43,55
050,01,065,"Alabama","Hale County",2,79,92,41,51
050,01,065,"Alabama","Hale County",2,80,80,32,48
050,01,065,"Alabama","Hale County",2,81,64,24,40
050,01,065,"Alabama","Hale County",2,82,57,25,32
050,01,065,"Alabama","Hale County",2,83,64,28,36
050,01,065,"Alabama","Hale County",2,84,72,22,50
050,01,065,"Alabama","Hale County",2,85,319,78,241
050,01,065,"Alabama","Hale County",3,0,182,85,97
050,01,065,"Alabama","Hale County",3,1,193,96,97
050,01,065,"Alabama","Hale County",3,2,179,95,84
050,01,065,"Alabama","Hale County",3,3,210,111,99
050,01,065,"Alabama","Hale County",3,4,197,100,97
050,01,065,"Alabama","Hale County",3,5,211,117,94
050,01,065,"Alabama","Hale County",3,6,210,112,98
050,01,065,"Alabama","Hale County",3,7,194,104,90
050,01,065,"Alabama","Hale County",3,8,204,101,103
050,01,065,"Alabama","Hale County",3,9,188,94,94
050,01,065,"Alabama","Hale County",3,10,184,98,86
050,01,065,"Alabama","Hale County",3,11,187,103,84
050,01,065,"Alabama","Hale County",3,12,202,104,98
050,01,065,"Alabama","Hale County",3,13,194,103,91
050,01,065,"Alabama","Hale County",3,14,199,106,93
050,01,065,"Alabama","Hale County",3,15,201,96,105
050,01,065,"Alabama","Hale County",3,16,193,97,96
050,01,065,"Alabama","Hale County",3,17,191,95,96
050,01,065,"Alabama","Hale County",3,18,159,82,77
050,01,065,"Alabama","Hale County",3,19,119,65,54
050,01,065,"Alabama","Hale County",3,20,146,73,73
050,01,065,"Alabama","Hale County",3,21,174,84,90
050,01,065,"Alabama","Hale County",3,22,170,86,84
050,01,065,"Alabama","Hale County",3,23,180,86,94
050,01,065,"Alabama","Hale County",3,24,163,68,95
050,01,065,"Alabama","Hale County",3,25,174,70,104
050,01,065,"Alabama","Hale County",3,26,197,92,105
050,01,065,"Alabama","Hale County",3,27,197,92,105
050,01,065,"Alabama","Hale County",3,28,183,91,92
050,01,065,"Alabama","Hale County",3,29,194,92,102
050,01,065,"Alabama","Hale County",3,30,201,91,110
050,01,065,"Alabama","Hale County",3,31,171,74,97
050,01,065,"Alabama","Hale County",3,32,176,77,99
050,01,065,"Alabama","Hale County",3,33,154,70,84
050,01,065,"Alabama","Hale County",3,34,143,66,77
050,01,065,"Alabama","Hale County",3,35,172,85,87
050,01,065,"Alabama","Hale County",3,36,173,88,85
050,01,065,"Alabama","Hale County",3,37,168,69,99
050,01,065,"Alabama","Hale County",3,38,180,86,94
050,01,065,"Alabama","Hale County",3,39,171,86,85
050,01,065,"Alabama","Hale County",3,40,164,68,96
050,01,065,"Alabama","Hale County",3,41,159,66,93
050,01,065,"Alabama","Hale County",3,42,170,75,95
050,01,065,"Alabama","Hale County",3,43,160,68,92
050,01,065,"Alabama","Hale County",3,44,167,75,92
050,01,065,"Alabama","Hale County",3,45,149,68,81
050,01,065,"Alabama","Hale County",3,46,150,62,88
050,01,065,"Alabama","Hale County",3,47,155,64,91
050,01,065,"Alabama","Hale County",3,48,156,69,87
050,01,065,"Alabama","Hale County",3,49,165,81,84
050,01,065,"Alabama","Hale County",3,50,165,83,82
050,01,065,"Alabama","Hale County",3,51,160,78,82
050,01,065,"Alabama","Hale County",3,52,159,78,81
050,01,065,"Alabama","Hale County",3,53,152,68,84
050,01,065,"Alabama","Hale County",3,54,172,72,100
050,01,065,"Alabama","Hale County",3,55,178,76,102
050,01,065,"Alabama","Hale County",3,56,220,101,119
050,01,065,"Alabama","Hale County",3,57,208,92,116
050,01,065,"Alabama","Hale County",3,58,224,101,123
050,01,065,"Alabama","Hale County",3,59,219,109,110
050,01,065,"Alabama","Hale County",3,60,216,104,112
050,01,065,"Alabama","Hale County",3,61,214,98,116
050,01,065,"Alabama","Hale County",3,62,207,98,109
050,01,065,"Alabama","Hale County",3,63,201,103,98
050,01,065,"Alabama","Hale County",3,64,216,108,108
050,01,065,"Alabama","Hale County",3,65,221,101,120
050,01,065,"Alabama","Hale County",3,66,202,90,112
050,01,065,"Alabama","Hale County",3,67,182,85,97
050,01,065,"Alabama","Hale County",3,68,187,91,96
050,01,065,"Alabama","Hale County",3,69,190,89,101
050,01,065,"Alabama","Hale County",3,70,182,89,93
050,01,065,"Alabama","Hale County",3,71,165,86,79
050,01,065,"Alabama","Hale County",3,72,152,82,70
050,01,065,"Alabama","Hale County",3,73,140,67,73
050,01,065,"Alabama","Hale County",3,74,158,75,83
050,01,065,"Alabama","Hale County",3,75,113,51,62
050,01,065,"Alabama","Hale County",3,76,107,52,55
050,01,065,"Alabama","Hale County",3,77,98,45,53
050,01,065,"Alabama","Hale County",3,78,98,45,53
050,01,065,"Alabama","Hale County",3,79,86,38,48
050,01,065,"Alabama","Hale County",3,80,82,37,45
050,01,065,"Alabama","Hale County",3,81,85,32,53
050,01,065,"Alabama","Hale County",3,82,53,20,33
050,01,065,"Alabama","Hale County",3,83,51,23,28
050,01,065,"Alabama","Hale County",3,84,62,28,34
050,01,065,"Alabama","Hale County",3,85,322,80,242
050,01,065,"Alabama","Hale County",4,0,206,110,96
050,01,065,"Alabama","Hale County",4,1,180,84,96
050,01,065,"Alabama","Hale County",4,2,190,97,93
050,01,065,"Alabama","Hale County",4,3,185,95,90
050,01,065,"Alabama","Hale County",4,4,212,112,100
050,01,065,"Alabama","Hale County",4,5,187,95,92
050,01,065,"Alabama","Hale County",4,6,216,116,100
050,01,065,"Alabama","Hale County",4,7,205,106,99
050,01,065,"Alabama","Hale County",4,8,196,104,92
050,01,065,"Alabama","Hale County",4,9,209,106,103
050,01,065,"Alabama","Hale County",4,10,195,97,98
050,01,065,"Alabama","Hale County",4,11,184,97,87
050,01,065,"Alabama","Hale County",4,12,184,100,84
050,01,065,"Alabama","Hale County",4,13,194,102,92
050,01,065,"Alabama","Hale County",4,14,193,108,85
050,01,065,"Alabama","Hale County",4,15,195,100,95
050,01,065,"Alabama","Hale County",4,16,191,91,100
050,01,065,"Alabama","Hale County",4,17,186,95,91
050,01,065,"Alabama","Hale County",4,18,160,83,77
050,01,065,"Alabama","Hale County",4,19,130,63,67
050,01,065,"Alabama","Hale County",4,20,122,64,58
050,01,065,"Alabama","Hale County",4,21,142,67,75
050,01,065,"Alabama","Hale County",4,22,186,86,100
050,01,065,"Alabama","Hale County",4,23,180,91,89
050,01,065,"Alabama","Hale County",4,24,173,86,87
050,01,065,"Alabama","Hale County",4,25,157,66,91
050,01,065,"Alabama","Hale County",4,26,173,71,102
050,01,065,"Alabama","Hale County",4,27,191,93,98
050,01,065,"Alabama","Hale County",4,28,205,96,109
050,01,065,"Alabama","Hale County",4,29,190,88,102
050,01,065,"Alabama","Hale County",4,30,197,93,104
050,01,065,"Alabama","Hale County",4,31,191,91,100
050,01,065,"Alabama","Hale County",4,32,169,69,100
050,01,065,"Alabama","Hale County",4,33,177,77,100
050,01,065,"Alabama","Hale County",4,34,152,68,84
050,01,065,"Alabama","Hale County",4,35,153,70,83
050,01,065,"Alabama","Hale County",4,36,175,92,83
050,01,065,"Alabama","Hale County",4,37,177,90,87
050,01,065,"Alabama","Hale County",4,38,158,64,94
050,01,065,"Alabama","Hale County",4,39,189,87,102
050,01,065,"Alabama","Hale County",4,40,172,88,84
050,01,065,"Alabama","Hale County",4,41,162,72,90
050,01,065,"Alabama","Hale County",4,42,158,66,92
050,01,065,"Alabama","Hale County",4,43,164,73,91
050,01,065,"Alabama","Hale County",4,44,162,70,92
050,01,065,"Alabama","Hale County",4,45,166,73,93
050,01,065,"Alabama","Hale County",4,46,148,68,80
050,01,065,"Alabama","Hale County",4,47,148,62,86
050,01,065,"Alabama","Hale County",4,48,159,64,95
050,01,065,"Alabama","Hale County",4,49,158,71,87
050,01,065,"Alabama","Hale County",4,50,161,77,84
050,01,065,"Alabama","Hale County",4,51,162,85,77
050,01,065,"Alabama","Hale County",4,52,153,75,78
050,01,065,"Alabama","Hale County",4,53,148,73,75
050,01,065,"Alabama","Hale County",4,54,162,75,87
050,01,065,"Alabama","Hale County",4,55,167,72,95
050,01,065,"Alabama","Hale County",4,56,180,75,105
050,01,065,"Alabama","Hale County",4,57,202,92,110
050,01,065,"Alabama","Hale County",4,58,205,88,117
050,01,065,"Alabama","Hale County",4,59,217,93,124
050,01,065,"Alabama","Hale County",4,60,211,105,106
050,01,065,"Alabama","Hale County",4,61,206,99,107
050,01,065,"Alabama","Hale County",4,62,208,96,112
050,01,065,"Alabama","Hale County",4,63,196,92,104
050,01,065,"Alabama","Hale County",4,64,197,101,96
050,01,065,"Alabama","Hale County",4,65,216,103,113
050,01,065,"Alabama","Hale County",4,66,214,95,119
050,01,065,"Alabama","Hale County",4,67,198,88,110
050,01,065,"Alabama","Hale County",4,68,179,81,98
050,01,065,"Alabama","Hale County",4,69,179,87,92
050,01,065,"Alabama","Hale County",4,70,185,87,98
050,01,065,"Alabama","Hale County",4,71,180,87,93
050,01,065,"Alabama","Hale County",4,72,157,84,73
050,01,065,"Alabama","Hale County",4,73,142,75,67
050,01,065,"Alabama","Hale County",4,74,135,67,68
050,01,065,"Alabama","Hale County",4,75,142,64,78
050,01,065,"Alabama","Hale County",4,76,106,46,60
050,01,065,"Alabama","Hale County",4,77,97,45,52
050,01,065,"Alabama","Hale County",4,78,97,43,54
050,01,065,"Alabama","Hale County",4,79,88,42,46
050,01,065,"Alabama","Hale County",4,80,83,36,47
050,01,065,"Alabama","Hale County",4,81,87,38,49
050,01,065,"Alabama","Hale County",4,82,71,27,44
050,01,065,"Alabama","Hale County",4,83,50,19,31
050,01,065,"Alabama","Hale County",4,84,45,22,23
050,01,065,"Alabama","Hale County",4,85,321,86,235
050,01,065,"Alabama","Hale County",5,0,211,113,98
050,01,065,"Alabama","Hale County",5,1,214,119,95
050,01,065,"Alabama","Hale County",5,2,188,93,95
050,01,065,"Alabama","Hale County",5,3,202,104,98
050,01,065,"Alabama","Hale County",5,4,175,83,92
050,01,065,"Alabama","Hale County",5,5,219,114,105
050,01,065,"Alabama","Hale County",5,6,190,95,95
050,01,065,"Alabama","Hale County",5,7,223,122,101
050,01,065,"Alabama","Hale County",5,8,206,106,100
050,01,065,"Alabama","Hale County",5,9,207,105,102
050,01,065,"Alabama","Hale County",5,10,216,107,109
050,01,065,"Alabama","Hale County",5,11,202,96,106
050,01,065,"Alabama","Hale County",5,12,192,99,93
050,01,065,"Alabama","Hale County",5,13,194,104,90
050,01,065,"Alabama","Hale County",5,14,201,104,97
050,01,065,"Alabama","Hale County",5,15,209,114,95
050,01,065,"Alabama","Hale County",5,16,190,100,90
050,01,065,"Alabama","Hale County",5,17,203,97,106
050,01,065,"Alabama","Hale County",5,18,165,88,77
050,01,065,"Alabama","Hale County",5,19,137,76,61
050,01,065,"Alabama","Hale County",5,20,146,66,80
050,01,065,"Alabama","Hale County",5,21,135,79,56
050,01,065,"Alabama","Hale County",5,22,159,75,84
050,01,065,"Alabama","Hale County",5,23,201,91,110
050,01,065,"Alabama","Hale County",5,24,185,93,92
050,01,065,"Alabama","Hale County",5,25,183,85,98
050,01,065,"Alabama","Hale County",5,26,169,78,91
050,01,065,"Alabama","Hale County",5,27,193,81,112
050,01,065,"Alabama","Hale County",5,28,199,100,99
050,01,065,"Alabama","Hale County",5,29,207,101,106
050,01,065,"Alabama","Hale County",5,30,184,86,98
050,01,065,"Alabama","Hale County",5,31,206,95,111
050,01,065,"Alabama","Hale County",5,32,189,84,105
050,01,065,"Alabama","Hale County",5,33,184,71,113
050,01,065,"Alabama","Hale County",5,34,188,82,106
050,01,065,"Alabama","Hale County",5,35,158,70,88
050,01,065,"Alabama","Hale County",5,36,162,72,90
050,01,065,"Alabama","Hale County",5,37,184,96,88
050,01,065,"Alabama","Hale County",5,38,183,89,94
050,01,065,"Alabama","Hale County",5,39,168,73,95
050,01,065,"Alabama","Hale County",5,40,194,85,109
050,01,065,"Alabama","Hale County",5,41,172,86,86
050,01,065,"Alabama","Hale County",5,42,164,73,91
050,01,065,"Alabama","Hale County",5,43,169,77,92
050,01,065,"Alabama","Hale County",5,44,165,72,93
050,01,065,"Alabama","Hale County",5,45,166,71,95
050,01,065,"Alabama","Hale County",5,46,176,80,96
050,01,065,"Alabama","Hale County",5,47,147,70,77
050,01,065,"Alabama","Hale County",5,48,151,60,91
050,01,065,"Alabama","Hale County",5,49,154,64,90
050,01,065,"Alabama","Hale County",5,50,167,72,95
050,01,065,"Alabama","Hale County",5,51,164,79,85
050,01,065,"Alabama","Hale County",5,52,164,82,82
050,01,065,"Alabama","Hale County",5,53,154,73,81
050,01,065,"Alabama","Hale County",5,54,141,71,70
050,01,065,"Alabama","Hale County",5,55,165,78,87
050,01,065,"Alabama","Hale County",5,56,162,64,98
050,01,065,"Alabama","Hale County",5,57,171,67,104
050,01,065,"Alabama","Hale County",5,58,195,87,108
050,01,065,"Alabama","Hale County",5,59,194,83,111
050,01,065,"Alabama","Hale County",5,60,214,89,125
050,01,065,"Alabama","Hale County",5,61,201,99,102
050,01,065,"Alabama","Hale County",5,62,199,95,104
050,01,065,"Alabama","Hale County",5,63,209,96,113
050,01,065,"Alabama","Hale County",5,64,200,93,107
050,01,065,"Alabama","Hale County",5,65,200,102,98
050,01,065,"Alabama","Hale County",5,66,204,97,107
050,01,065,"Alabama","Hale County",5,67,212,101,111
050,01,065,"Alabama","Hale County",5,68,195,86,109
050,01,065,"Alabama","Hale County",5,69,176,81,95
050,01,065,"Alabama","Hale County",5,70,172,86,86
050,01,065,"Alabama","Hale County",5,71,181,84,97
050,01,065,"Alabama","Hale County",5,72,170,85,85
050,01,065,"Alabama","Hale County",5,73,150,80,70
050,01,065,"Alabama","Hale County",5,74,141,77,64
050,01,065,"Alabama","Hale County",5,75,120,57,63
050,01,065,"Alabama","Hale County",5,76,131,59,72
050,01,065,"Alabama","Hale County",5,77,97,41,56
050,01,065,"Alabama","Hale County",5,78,96,44,52
050,01,065,"Alabama","Hale County",5,79,89,41,48
050,01,065,"Alabama","Hale County",5,80,83,38,45
050,01,065,"Alabama","Hale County",5,81,89,39,50
050,01,065,"Alabama","Hale County",5,82,78,33,45
050,01,065,"Alabama","Hale County",5,83,64,26,38
050,01,065,"Alabama","Hale County",5,84,44,17,27
050,01,065,"Alabama","Hale County",5,85,311,89,222
050,01,067,"Alabama","Henry County",1,0,149,76,73
050,01,067,"Alabama","Henry County",1,1,153,78,75
050,01,067,"Alabama","Henry County",1,2,179,94,85
050,01,067,"Alabama","Henry County",1,3,190,95,95
050,01,067,"Alabama","Henry County",1,4,182,101,81
050,01,067,"Alabama","Henry County",1,5,187,101,86
050,01,067,"Alabama","Henry County",1,6,206,109,97
050,01,067,"Alabama","Henry County",1,7,190,94,96
050,01,067,"Alabama","Henry County",1,8,184,98,86
050,01,067,"Alabama","Henry County",1,9,186,95,91
050,01,067,"Alabama","Henry County",1,10,188,90,98
050,01,067,"Alabama","Henry County",1,11,199,100,99
050,01,067,"Alabama","Henry County",1,12,220,120,100
050,01,067,"Alabama","Henry County",1,13,223,114,109
050,01,067,"Alabama","Henry County",1,14,208,111,97
050,01,067,"Alabama","Henry County",1,15,223,126,97
050,01,067,"Alabama","Henry County",1,16,231,131,100
050,01,067,"Alabama","Henry County",1,17,225,115,110
050,01,067,"Alabama","Henry County",1,18,190,97,93
050,01,067,"Alabama","Henry County",1,19,151,75,76
050,01,067,"Alabama","Henry County",1,20,158,80,78
050,01,067,"Alabama","Henry County",1,21,173,89,84
050,01,067,"Alabama","Henry County",1,22,172,88,84
050,01,067,"Alabama","Henry County",1,23,165,85,80
050,01,067,"Alabama","Henry County",1,24,170,86,84
050,01,067,"Alabama","Henry County",1,25,158,80,78
050,01,067,"Alabama","Henry County",1,26,173,82,91
050,01,067,"Alabama","Henry County",1,27,178,80,98
050,01,067,"Alabama","Henry County",1,28,170,89,81
050,01,067,"Alabama","Henry County",1,29,191,96,95
050,01,067,"Alabama","Henry County",1,30,177,86,91
050,01,067,"Alabama","Henry County",1,31,187,75,112
050,01,067,"Alabama","Henry County",1,32,185,80,105
050,01,067,"Alabama","Henry County",1,33,175,83,92
050,01,067,"Alabama","Henry County",1,34,172,77,95
050,01,067,"Alabama","Henry County",1,35,189,96,93
050,01,067,"Alabama","Henry County",1,36,182,90,92
050,01,067,"Alabama","Henry County",1,37,189,87,102
050,01,067,"Alabama","Henry County",1,38,208,100,108
050,01,067,"Alabama","Henry County",1,39,226,113,113
050,01,067,"Alabama","Henry County",1,40,228,113,115
050,01,067,"Alabama","Henry County",1,41,212,114,98
050,01,067,"Alabama","Henry County",1,42,212,109,103
050,01,067,"Alabama","Henry County",1,43,220,96,124
050,01,067,"Alabama","Henry County",1,44,214,97,117
050,01,067,"Alabama","Henry County",1,45,207,108,99
050,01,067,"Alabama","Henry County",1,46,226,111,115
050,01,067,"Alabama","Henry County",1,47,236,115,121
050,01,067,"Alabama","Henry County",1,48,236,128,108
050,01,067,"Alabama","Henry County",1,49,243,120,123
050,01,067,"Alabama","Henry County",1,50,211,102,109
050,01,067,"Alabama","Henry County",1,51,212,103,109
050,01,067,"Alabama","Henry County",1,52,200,106,94
050,01,067,"Alabama","Henry County",1,53,214,102,112
050,01,067,"Alabama","Henry County",1,54,225,104,121
050,01,067,"Alabama","Henry County",1,55,265,127,138
050,01,067,"Alabama","Henry County",1,56,232,108,124
050,01,067,"Alabama","Henry County",1,57,216,98,118
050,01,067,"Alabama","Henry County",1,58,235,112,123
050,01,067,"Alabama","Henry County",1,59,245,120,125
050,01,067,"Alabama","Henry County",1,60,221,105,116
050,01,067,"Alabama","Henry County",1,61,224,106,118
050,01,067,"Alabama","Henry County",1,62,238,117,121
050,01,067,"Alabama","Henry County",1,63,292,142,150
050,01,067,"Alabama","Henry County",1,64,256,129,127
050,01,067,"Alabama","Henry County",1,65,254,119,135
050,01,067,"Alabama","Henry County",1,66,251,111,140
050,01,067,"Alabama","Henry County",1,67,249,112,137
050,01,067,"Alabama","Henry County",1,68,266,117,149
050,01,067,"Alabama","Henry County",1,69,249,114,135
050,01,067,"Alabama","Henry County",1,70,244,115,129
050,01,067,"Alabama","Henry County",1,71,249,116,133
050,01,067,"Alabama","Henry County",1,72,241,120,121
050,01,067,"Alabama","Henry County",1,73,240,116,124
050,01,067,"Alabama","Henry County",1,74,166,85,81
050,01,067,"Alabama","Henry County",1,75,166,80,86
050,01,067,"Alabama","Henry County",1,76,160,69,91
050,01,067,"Alabama","Henry County",1,77,159,74,85
050,01,067,"Alabama","Henry County",1,78,141,67,74
050,01,067,"Alabama","Henry County",1,79,104,52,52
050,01,067,"Alabama","Henry County",1,80,83,31,52
050,01,067,"Alabama","Henry County",1,81,88,37,51
050,01,067,"Alabama","Henry County",1,82,87,38,49
050,01,067,"Alabama","Henry County",1,83,91,45,46
050,01,067,"Alabama","Henry County",1,84,83,36,47
050,01,067,"Alabama","Henry County",1,85,388,101,287
050,01,067,"Alabama","Henry County",2,0,152,78,74
050,01,067,"Alabama","Henry County",2,1,153,78,75
050,01,067,"Alabama","Henry County",2,2,173,90,83
050,01,067,"Alabama","Henry County",2,3,186,95,91
050,01,067,"Alabama","Henry County",2,4,186,100,86
050,01,067,"Alabama","Henry County",2,5,190,101,89
050,01,067,"Alabama","Henry County",2,6,206,110,96
050,01,067,"Alabama","Henry County",2,7,194,97,97
050,01,067,"Alabama","Henry County",2,8,186,97,89
050,01,067,"Alabama","Henry County",2,9,188,97,91
050,01,067,"Alabama","Henry County",2,10,189,93,96
050,01,067,"Alabama","Henry County",2,11,197,98,99
050,01,067,"Alabama","Henry County",2,12,219,117,102
050,01,067,"Alabama","Henry County",2,13,222,115,107
050,01,067,"Alabama","Henry County",2,14,210,112,98
050,01,067,"Alabama","Henry County",2,15,222,124,98
050,01,067,"Alabama","Henry County",2,16,230,130,100
050,01,067,"Alabama","Henry County",2,17,229,120,109
050,01,067,"Alabama","Henry County",2,18,190,97,93
050,01,067,"Alabama","Henry County",2,19,154,77,77
050,01,067,"Alabama","Henry County",2,20,161,81,80
050,01,067,"Alabama","Henry County",2,21,171,87,84
050,01,067,"Alabama","Henry County",2,22,174,90,84
050,01,067,"Alabama","Henry County",2,23,171,88,83
050,01,067,"Alabama","Henry County",2,24,167,83,84
050,01,067,"Alabama","Henry County",2,25,160,81,79
050,01,067,"Alabama","Henry County",2,26,171,82,89
050,01,067,"Alabama","Henry County",2,27,174,79,95
050,01,067,"Alabama","Henry County",2,28,172,87,85
050,01,067,"Alabama","Henry County",2,29,188,96,92
050,01,067,"Alabama","Henry County",2,30,183,88,95
050,01,067,"Alabama","Henry County",2,31,186,77,109
050,01,067,"Alabama","Henry County",2,32,187,79,108
050,01,067,"Alabama","Henry County",2,33,176,81,95
050,01,067,"Alabama","Henry County",2,34,174,80,94
050,01,067,"Alabama","Henry County",2,35,185,91,94
050,01,067,"Alabama","Henry County",2,36,184,91,93
050,01,067,"Alabama","Henry County",2,37,189,90,99
050,01,067,"Alabama","Henry County",2,38,205,98,107
050,01,067,"Alabama","Henry County",2,39,222,110,112
050,01,067,"Alabama","Henry County",2,40,229,114,115
050,01,067,"Alabama","Henry County",2,41,217,114,103
050,01,067,"Alabama","Henry County",2,42,211,109,102
050,01,067,"Alabama","Henry County",2,43,224,102,122
050,01,067,"Alabama","Henry County",2,44,212,95,117
050,01,067,"Alabama","Henry County",2,45,211,106,105
050,01,067,"Alabama","Henry County",2,46,222,112,110
050,01,067,"Alabama","Henry County",2,47,233,114,119
050,01,067,"Alabama","Henry County",2,48,239,126,113
050,01,067,"Alabama","Henry County",2,49,242,121,121
050,01,067,"Alabama","Henry County",2,50,217,106,111
050,01,067,"Alabama","Henry County",2,51,209,101,108
050,01,067,"Alabama","Henry County",2,52,200,102,98
050,01,067,"Alabama","Henry County",2,53,211,103,108
050,01,067,"Alabama","Henry County",2,54,221,104,117
050,01,067,"Alabama","Henry County",2,55,257,122,135
050,01,067,"Alabama","Henry County",2,56,242,114,128
050,01,067,"Alabama","Henry County",2,57,220,101,119
050,01,067,"Alabama","Henry County",2,58,230,108,122
050,01,067,"Alabama","Henry County",2,59,244,118,126
050,01,067,"Alabama","Henry County",2,60,227,108,119
050,01,067,"Alabama","Henry County",2,61,223,106,117
050,01,067,"Alabama","Henry County",2,62,234,113,121
050,01,067,"Alabama","Henry County",2,63,281,137,144
050,01,067,"Alabama","Henry County",2,64,264,132,132
050,01,067,"Alabama","Henry County",2,65,252,119,133
050,01,067,"Alabama","Henry County",2,66,252,113,139
050,01,067,"Alabama","Henry County",2,67,248,111,137
050,01,067,"Alabama","Henry County",2,68,255,113,142
050,01,067,"Alabama","Henry County",2,69,253,116,137
050,01,067,"Alabama","Henry County",2,70,245,115,130
050,01,067,"Alabama","Henry County",2,71,247,115,132
050,01,067,"Alabama","Henry County",2,72,238,117,121
050,01,067,"Alabama","Henry County",2,73,249,122,127
050,01,067,"Alabama","Henry County",2,74,174,88,86
050,01,067,"Alabama","Henry County",2,75,165,81,84
050,01,067,"Alabama","Henry County",2,76,160,70,90
050,01,067,"Alabama","Henry County",2,77,162,73,89
050,01,067,"Alabama","Henry County",2,78,142,66,76
050,01,067,"Alabama","Henry County",2,79,108,54,54
050,01,067,"Alabama","Henry County",2,80,88,35,53
050,01,067,"Alabama","Henry County",2,81,85,34,51
050,01,067,"Alabama","Henry County",2,82,85,36,49
050,01,067,"Alabama","Henry County",2,83,89,44,45
050,01,067,"Alabama","Henry County",2,84,83,37,46
050,01,067,"Alabama","Henry County",2,85,393,103,290
050,01,067,"Alabama","Henry County",3,0,158,82,76
050,01,067,"Alabama","Henry County",3,1,171,93,78
050,01,067,"Alabama","Henry County",3,2,156,70,86
050,01,067,"Alabama","Henry County",3,3,189,93,96
050,01,067,"Alabama","Henry County",3,4,198,104,94
050,01,067,"Alabama","Henry County",3,5,179,94,85
050,01,067,"Alabama","Henry County",3,6,190,92,98
050,01,067,"Alabama","Henry County",3,7,191,101,90
050,01,067,"Alabama","Henry County",3,8,200,99,101
050,01,067,"Alabama","Henry County",3,9,193,95,98
050,01,067,"Alabama","Henry County",3,10,194,97,97
050,01,067,"Alabama","Henry County",3,11,196,99,97
050,01,067,"Alabama","Henry County",3,12,206,112,94
050,01,067,"Alabama","Henry County",3,13,239,130,109
050,01,067,"Alabama","Henry County",3,14,235,122,113
050,01,067,"Alabama","Henry County",3,15,212,111,101
050,01,067,"Alabama","Henry County",3,16,225,124,101
050,01,067,"Alabama","Henry County",3,17,229,123,106
050,01,067,"Alabama","Henry County",3,18,198,106,92
050,01,067,"Alabama","Henry County",3,19,162,84,78
050,01,067,"Alabama","Henry County",3,20,164,85,79
050,01,067,"Alabama","Henry County",3,21,162,79,83
050,01,067,"Alabama","Henry County",3,22,171,81,90
050,01,067,"Alabama","Henry County",3,23,182,96,86
050,01,067,"Alabama","Henry County",3,24,163,79,84
050,01,067,"Alabama","Henry County",3,25,171,86,85
050,01,067,"Alabama","Henry County",3,26,174,92,82
050,01,067,"Alabama","Henry County",3,27,170,84,86
050,01,067,"Alabama","Henry County",3,28,181,88,93
050,01,067,"Alabama","Henry County",3,29,194,97,97
050,01,067,"Alabama","Henry County",3,30,185,97,88
050,01,067,"Alabama","Henry County",3,31,192,92,100
050,01,067,"Alabama","Henry County",3,32,193,81,112
050,01,067,"Alabama","Henry County",3,33,188,75,113
050,01,067,"Alabama","Henry County",3,34,190,95,95
050,01,067,"Alabama","Henry County",3,35,181,82,99
050,01,067,"Alabama","Henry County",3,36,193,93,100
050,01,067,"Alabama","Henry County",3,37,198,100,98
050,01,067,"Alabama","Henry County",3,38,197,90,107
050,01,067,"Alabama","Henry County",3,39,210,104,106
050,01,067,"Alabama","Henry County",3,40,234,109,125
050,01,067,"Alabama","Henry County",3,41,248,130,118
050,01,067,"Alabama","Henry County",3,42,218,113,105
050,01,067,"Alabama","Henry County",3,43,222,113,109
050,01,067,"Alabama","Henry County",3,44,228,103,125
050,01,067,"Alabama","Henry County",3,45,216,94,122
050,01,067,"Alabama","Henry County",3,46,223,113,110
050,01,067,"Alabama","Henry County",3,47,233,122,111
050,01,067,"Alabama","Henry County",3,48,224,109,115
050,01,067,"Alabama","Henry County",3,49,248,126,122
050,01,067,"Alabama","Henry County",3,50,231,119,112
050,01,067,"Alabama","Henry County",3,51,221,106,115
050,01,067,"Alabama","Henry County",3,52,219,102,117
050,01,067,"Alabama","Henry County",3,53,200,98,102
050,01,067,"Alabama","Henry County",3,54,216,108,108
050,01,067,"Alabama","Henry County",3,55,224,104,120
050,01,067,"Alabama","Henry County",3,56,262,123,139
050,01,067,"Alabama","Henry County",3,57,246,114,132
050,01,067,"Alabama","Henry County",3,58,207,89,118
050,01,067,"Alabama","Henry County",3,59,240,110,130
050,01,067,"Alabama","Henry County",3,60,246,122,124
050,01,067,"Alabama","Henry County",3,61,237,113,124
050,01,067,"Alabama","Henry County",3,62,234,110,124
050,01,067,"Alabama","Henry County",3,63,251,122,129
050,01,067,"Alabama","Henry County",3,64,274,139,135
050,01,067,"Alabama","Henry County",3,65,270,138,132
050,01,067,"Alabama","Henry County",3,66,261,122,139
050,01,067,"Alabama","Henry County",3,67,255,118,137
050,01,067,"Alabama","Henry County",3,68,242,105,137
050,01,067,"Alabama","Henry County",3,69,246,107,139
050,01,067,"Alabama","Henry County",3,70,245,107,138
050,01,067,"Alabama","Henry County",3,71,238,111,127
050,01,067,"Alabama","Henry County",3,72,246,118,128
050,01,067,"Alabama","Henry County",3,73,222,106,116
050,01,067,"Alabama","Henry County",3,74,248,122,126
050,01,067,"Alabama","Henry County",3,75,166,83,83
050,01,067,"Alabama","Henry County",3,76,156,76,80
050,01,067,"Alabama","Henry County",3,77,150,65,85
050,01,067,"Alabama","Henry County",3,78,166,72,94
050,01,067,"Alabama","Henry County",3,79,124,64,60
050,01,067,"Alabama","Henry County",3,80,99,50,49
050,01,067,"Alabama","Henry County",3,81,79,28,51
050,01,067,"Alabama","Henry County",3,82,80,36,44
050,01,067,"Alabama","Henry County",3,83,87,41,46
050,01,067,"Alabama","Henry County",3,84,74,34,40
050,01,067,"Alabama","Henry County",3,85,397,115,282
050,01,067,"Alabama","Henry County",4,0,172,75,97
050,01,067,"Alabama","Henry County",4,1,182,100,82
050,01,067,"Alabama","Henry County",4,2,167,91,76
050,01,067,"Alabama","Henry County",4,3,161,71,90
050,01,067,"Alabama","Henry County",4,4,191,94,97
050,01,067,"Alabama","Henry County",4,5,200,101,99
050,01,067,"Alabama","Henry County",4,6,200,104,96
050,01,067,"Alabama","Henry County",4,7,204,97,107
050,01,067,"Alabama","Henry County",4,8,197,105,92
050,01,067,"Alabama","Henry County",4,9,201,105,96
050,01,067,"Alabama","Henry County",4,10,192,98,94
050,01,067,"Alabama","Henry County",4,11,202,105,97
050,01,067,"Alabama","Henry County",4,12,197,95,102
050,01,067,"Alabama","Henry County",4,13,220,127,93
050,01,067,"Alabama","Henry County",4,14,248,134,114
050,01,067,"Alabama","Henry County",4,15,230,122,108
050,01,067,"Alabama","Henry County",4,16,223,120,103
050,01,067,"Alabama","Henry County",4,17,222,121,101
050,01,067,"Alabama","Henry County",4,18,205,117,88
050,01,067,"Alabama","Henry County",4,19,149,82,67
050,01,067,"Alabama","Henry County",4,20,161,82,79
050,01,067,"Alabama","Henry County",4,21,160,81,79
050,01,067,"Alabama","Henry County",4,22,179,81,98
050,01,067,"Alabama","Henry County",4,23,173,86,87
050,01,067,"Alabama","Henry County",4,24,172,91,81
050,01,067,"Alabama","Henry County",4,25,167,79,88
050,01,067,"Alabama","Henry County",4,26,169,80,89
050,01,067,"Alabama","Henry County",4,27,184,96,88
050,01,067,"Alabama","Henry County",4,28,197,93,104
050,01,067,"Alabama","Henry County",4,29,188,84,104
050,01,067,"Alabama","Henry County",4,30,185,93,92
050,01,067,"Alabama","Henry County",4,31,201,103,98
050,01,067,"Alabama","Henry County",4,32,204,94,110
050,01,067,"Alabama","Henry County",4,33,198,86,112
050,01,067,"Alabama","Henry County",4,34,199,88,111
050,01,067,"Alabama","Henry County",4,35,198,94,104
050,01,067,"Alabama","Henry County",4,36,169,80,89
050,01,067,"Alabama","Henry County",4,37,201,100,101
050,01,067,"Alabama","Henry County",4,38,197,101,96
050,01,067,"Alabama","Henry County",4,39,201,91,110
050,01,067,"Alabama","Henry County",4,40,222,110,112
050,01,067,"Alabama","Henry County",4,41,236,106,130
050,01,067,"Alabama","Henry County",4,42,246,129,117
050,01,067,"Alabama","Henry County",4,43,215,113,102
050,01,067,"Alabama","Henry County",4,44,224,113,111
050,01,067,"Alabama","Henry County",4,45,226,100,126
050,01,067,"Alabama","Henry County",4,46,219,97,122
050,01,067,"Alabama","Henry County",4,47,228,116,112
050,01,067,"Alabama","Henry County",4,48,233,117,116
050,01,067,"Alabama","Henry County",4,49,227,107,120
050,01,067,"Alabama","Henry County",4,50,252,127,125
050,01,067,"Alabama","Henry County",4,51,233,119,114
050,01,067,"Alabama","Henry County",4,52,223,106,117
050,01,067,"Alabama","Henry County",4,53,226,105,121
050,01,067,"Alabama","Henry County",4,54,209,103,106
050,01,067,"Alabama","Henry County",4,55,221,112,109
050,01,067,"Alabama","Henry County",4,56,215,101,114
050,01,067,"Alabama","Henry County",4,57,253,122,131
050,01,067,"Alabama","Henry County",4,58,241,107,134
050,01,067,"Alabama","Henry County",4,59,221,97,124
050,01,067,"Alabama","Henry County",4,60,237,112,125
050,01,067,"Alabama","Henry County",4,61,243,119,124
050,01,067,"Alabama","Henry County",4,62,246,112,134
050,01,067,"Alabama","Henry County",4,63,230,107,123
050,01,067,"Alabama","Henry County",4,64,251,126,125
050,01,067,"Alabama","Henry County",4,65,285,145,140
050,01,067,"Alabama","Henry County",4,66,262,138,124
050,01,067,"Alabama","Henry County",4,67,270,126,144
050,01,067,"Alabama","Henry County",4,68,250,112,138
050,01,067,"Alabama","Henry County",4,69,246,107,139
050,01,067,"Alabama","Henry County",4,70,249,107,142
050,01,067,"Alabama","Henry County",4,71,248,110,138
050,01,067,"Alabama","Henry County",4,72,242,115,127
050,01,067,"Alabama","Henry County",4,73,232,108,124
050,01,067,"Alabama","Henry County",4,74,223,104,119
050,01,067,"Alabama","Henry County",4,75,241,115,126
050,01,067,"Alabama","Henry County",4,76,166,78,88
050,01,067,"Alabama","Henry County",4,77,147,73,74
050,01,067,"Alabama","Henry County",4,78,151,62,89
050,01,067,"Alabama","Henry County",4,79,155,70,85
050,01,067,"Alabama","Henry County",4,80,127,64,63
050,01,067,"Alabama","Henry County",4,81,95,42,53
050,01,067,"Alabama","Henry County",4,82,72,28,44
050,01,067,"Alabama","Henry County",4,83,86,42,44
050,01,067,"Alabama","Henry County",4,84,74,33,41
050,01,067,"Alabama","Henry County",4,85,406,128,278
050,01,067,"Alabama","Henry County",5,0,173,77,96
050,01,067,"Alabama","Henry County",5,1,184,78,106
050,01,067,"Alabama","Henry County",5,2,186,97,89
050,01,067,"Alabama","Henry County",5,3,178,93,85
050,01,067,"Alabama","Henry County",5,4,161,68,93
050,01,067,"Alabama","Henry County",5,5,202,96,106
050,01,067,"Alabama","Henry County",5,6,204,102,102
050,01,067,"Alabama","Henry County",5,7,214,111,103
050,01,067,"Alabama","Henry County",5,8,200,94,106
050,01,067,"Alabama","Henry County",5,9,202,104,98
050,01,067,"Alabama","Henry County",5,10,205,108,97
050,01,067,"Alabama","Henry County",5,11,193,94,99
050,01,067,"Alabama","Henry County",5,12,212,106,106
050,01,067,"Alabama","Henry County",5,13,210,95,115
050,01,067,"Alabama","Henry County",5,14,223,124,99
050,01,067,"Alabama","Henry County",5,15,248,136,112
050,01,067,"Alabama","Henry County",5,16,239,128,111
050,01,067,"Alabama","Henry County",5,17,229,125,104
050,01,067,"Alabama","Henry County",5,18,196,106,90
050,01,067,"Alabama","Henry County",5,19,161,90,71
050,01,067,"Alabama","Henry County",5,20,152,81,71
050,01,067,"Alabama","Henry County",5,21,174,87,87
050,01,067,"Alabama","Henry County",5,22,164,86,78
050,01,067,"Alabama","Henry County",5,23,188,88,100
050,01,067,"Alabama","Henry County",5,24,171,80,91
050,01,067,"Alabama","Henry County",5,25,174,85,89
050,01,067,"Alabama","Henry County",5,26,175,78,97
050,01,067,"Alabama","Henry County",5,27,191,92,99
050,01,067,"Alabama","Henry County",5,28,179,95,84
050,01,067,"Alabama","Henry County",5,29,188,88,100
050,01,067,"Alabama","Henry County",5,30,183,87,96
050,01,067,"Alabama","Henry County",5,31,193,100,93
050,01,067,"Alabama","Henry County",5,32,209,105,104
050,01,067,"Alabama","Henry County",5,33,214,92,122
050,01,067,"Alabama","Henry County",5,34,203,93,110
050,01,067,"Alabama","Henry County",5,35,197,90,107
050,01,067,"Alabama","Henry County",5,36,209,98,111
050,01,067,"Alabama","Henry County",5,37,173,82,91
050,01,067,"Alabama","Henry County",5,38,204,106,98
050,01,067,"Alabama","Henry County",5,39,211,105,106
050,01,067,"Alabama","Henry County",5,40,208,94,114
050,01,067,"Alabama","Henry County",5,41,222,111,111
050,01,067,"Alabama","Henry County",5,42,230,102,128
050,01,067,"Alabama","Henry County",5,43,258,136,122
050,01,067,"Alabama","Henry County",5,44,220,113,107
050,01,067,"Alabama","Henry County",5,45,217,102,115
050,01,067,"Alabama","Henry County",5,46,225,99,126
050,01,067,"Alabama","Henry County",5,47,225,99,126
050,01,067,"Alabama","Henry County",5,48,230,118,112
050,01,067,"Alabama","Henry County",5,49,235,117,118
050,01,067,"Alabama","Henry County",5,50,226,106,120
050,01,067,"Alabama","Henry County",5,51,258,134,124
050,01,067,"Alabama","Henry County",5,52,237,119,118
050,01,067,"Alabama","Henry County",5,53,224,105,119
050,01,067,"Alabama","Henry County",5,54,236,105,131
050,01,067,"Alabama","Henry County",5,55,214,108,106
050,01,067,"Alabama","Henry County",5,56,227,114,113
050,01,067,"Alabama","Henry County",5,57,215,105,110
050,01,067,"Alabama","Henry County",5,58,252,120,132
050,01,067,"Alabama","Henry County",5,59,251,110,141
050,01,067,"Alabama","Henry County",5,60,227,101,126
050,01,067,"Alabama","Henry County",5,61,239,109,130
050,01,067,"Alabama","Henry County",5,62,247,121,126
050,01,067,"Alabama","Henry County",5,63,251,118,133
050,01,067,"Alabama","Henry County",5,64,224,108,116
050,01,067,"Alabama","Henry County",5,65,249,127,122
050,01,067,"Alabama","Henry County",5,66,296,157,139
050,01,067,"Alabama","Henry County",5,67,265,143,122
050,01,067,"Alabama","Henry County",5,68,263,118,145
050,01,067,"Alabama","Henry County",5,69,247,113,134
050,01,067,"Alabama","Henry County",5,70,241,103,138
050,01,067,"Alabama","Henry County",5,71,249,107,142
050,01,067,"Alabama","Henry County",5,72,246,108,138
050,01,067,"Alabama","Henry County",5,73,228,107,121
050,01,067,"Alabama","Henry County",5,74,227,104,123
050,01,067,"Alabama","Henry County",5,75,221,99,122
050,01,067,"Alabama","Henry County",5,76,232,110,122
050,01,067,"Alabama","Henry County",5,77,160,78,82
050,01,067,"Alabama","Henry County",5,78,148,68,80
050,01,067,"Alabama","Henry County",5,79,139,59,80
050,01,067,"Alabama","Henry County",5,80,152,68,84
050,01,067,"Alabama","Henry County",5,81,115,56,59
050,01,067,"Alabama","Henry County",5,82,91,43,48
050,01,067,"Alabama","Henry County",5,83,70,32,38
050,01,067,"Alabama","Henry County",5,84,77,35,42
050,01,067,"Alabama","Henry County",5,85,413,141,272
050,01,069,"Alabama","Houston County",1,0,1363,697,666
050,01,069,"Alabama","Houston County",1,1,1333,683,650
050,01,069,"Alabama","Houston County",1,2,1353,671,682
050,01,069,"Alabama","Houston County",1,3,1330,691,639
050,01,069,"Alabama","Houston County",1,4,1390,741,649
050,01,069,"Alabama","Houston County",1,5,1288,671,617
050,01,069,"Alabama","Houston County",1,6,1298,711,587
050,01,069,"Alabama","Houston County",1,7,1327,703,624
050,01,069,"Alabama","Houston County",1,8,1359,700,659
050,01,069,"Alabama","Houston County",1,9,1348,690,658
050,01,069,"Alabama","Houston County",1,10,1449,726,723
050,01,069,"Alabama","Houston County",1,11,1423,711,712
050,01,069,"Alabama","Houston County",1,12,1489,772,717
050,01,069,"Alabama","Houston County",1,13,1470,782,688
050,01,069,"Alabama","Houston County",1,14,1446,767,679
050,01,069,"Alabama","Houston County",1,15,1378,729,649
050,01,069,"Alabama","Houston County",1,16,1488,785,703
050,01,069,"Alabama","Houston County",1,17,1450,733,717
050,01,069,"Alabama","Houston County",1,18,1270,640,630
050,01,069,"Alabama","Houston County",1,19,1064,562,502
050,01,069,"Alabama","Houston County",1,20,1110,552,558
050,01,069,"Alabama","Houston County",1,21,1109,546,563
050,01,069,"Alabama","Houston County",1,22,1137,556,581
050,01,069,"Alabama","Houston County",1,23,1211,579,632
050,01,069,"Alabama","Houston County",1,24,1239,614,625
050,01,069,"Alabama","Houston County",1,25,1256,619,637
050,01,069,"Alabama","Houston County",1,26,1360,644,716
050,01,069,"Alabama","Houston County",1,27,1355,642,713
050,01,069,"Alabama","Houston County",1,28,1413,672,741
050,01,069,"Alabama","Houston County",1,29,1424,661,763
050,01,069,"Alabama","Houston County",1,30,1439,646,793
050,01,069,"Alabama","Houston County",1,31,1302,613,689
050,01,069,"Alabama","Houston County",1,32,1338,616,722
050,01,069,"Alabama","Houston County",1,33,1353,642,711
050,01,069,"Alabama","Houston County",1,34,1365,640,725
050,01,069,"Alabama","Houston County",1,35,1363,637,726
050,01,069,"Alabama","Houston County",1,36,1377,665,712
050,01,069,"Alabama","Houston County",1,37,1378,681,697
050,01,069,"Alabama","Houston County",1,38,1394,669,725
050,01,069,"Alabama","Houston County",1,39,1350,669,681
050,01,069,"Alabama","Houston County",1,40,1357,650,707
050,01,069,"Alabama","Houston County",1,41,1275,613,662
050,01,069,"Alabama","Houston County",1,42,1302,613,689
050,01,069,"Alabama","Houston County",1,43,1302,590,712
050,01,069,"Alabama","Houston County",1,44,1266,584,682
050,01,069,"Alabama","Houston County",1,45,1268,604,664
050,01,069,"Alabama","Houston County",1,46,1291,605,686
050,01,069,"Alabama","Houston County",1,47,1309,617,692
050,01,069,"Alabama","Houston County",1,48,1410,674,736
050,01,069,"Alabama","Houston County",1,49,1446,701,745
050,01,069,"Alabama","Houston County",1,50,1407,696,711
050,01,069,"Alabama","Houston County",1,51,1302,629,673
050,01,069,"Alabama","Houston County",1,52,1315,665,650
050,01,069,"Alabama","Houston County",1,53,1325,659,666
050,01,069,"Alabama","Houston County",1,54,1346,639,707
050,01,069,"Alabama","Houston County",1,55,1442,688,754
050,01,069,"Alabama","Houston County",1,56,1490,728,762
050,01,069,"Alabama","Houston County",1,57,1480,701,779
050,01,069,"Alabama","Houston County",1,58,1505,715,790
050,01,069,"Alabama","Houston County",1,59,1457,679,778
050,01,069,"Alabama","Houston County",1,60,1480,671,809
050,01,069,"Alabama","Houston County",1,61,1417,663,754
050,01,069,"Alabama","Houston County",1,62,1438,699,739
050,01,069,"Alabama","Houston County",1,63,1386,694,692
050,01,069,"Alabama","Houston County",1,64,1338,645,693
050,01,069,"Alabama","Houston County",1,65,1305,589,716
050,01,069,"Alabama","Houston County",1,66,1300,568,732
050,01,069,"Alabama","Houston County",1,67,1288,606,682
050,01,069,"Alabama","Houston County",1,68,1205,571,634
050,01,069,"Alabama","Houston County",1,69,1109,487,622
050,01,069,"Alabama","Houston County",1,70,1096,516,580
050,01,069,"Alabama","Houston County",1,71,1104,511,593
050,01,069,"Alabama","Houston County",1,72,1113,531,582
050,01,069,"Alabama","Houston County",1,73,1097,505,592
050,01,069,"Alabama","Houston County",1,74,825,365,460
050,01,069,"Alabama","Houston County",1,75,855,376,479
050,01,069,"Alabama","Houston County",1,76,788,359,429
050,01,069,"Alabama","Houston County",1,77,726,318,408
050,01,069,"Alabama","Houston County",1,78,664,278,386
050,01,069,"Alabama","Houston County",1,79,567,239,328
050,01,069,"Alabama","Houston County",1,80,526,215,311
050,01,069,"Alabama","Houston County",1,81,527,222,305
050,01,069,"Alabama","Houston County",1,82,463,194,269
050,01,069,"Alabama","Houston County",1,83,384,159,225
050,01,069,"Alabama","Houston County",1,84,377,143,234
050,01,069,"Alabama","Houston County",1,85,1940,648,1292
050,01,069,"Alabama","Houston County",2,0,1330,683,647
050,01,069,"Alabama","Houston County",2,1,1339,685,654
050,01,069,"Alabama","Houston County",2,2,1347,672,675
050,01,069,"Alabama","Houston County",2,3,1330,684,646
050,01,069,"Alabama","Houston County",2,4,1369,723,646
050,01,069,"Alabama","Houston County",2,5,1313,691,622
050,01,069,"Alabama","Houston County",2,6,1298,703,595
050,01,069,"Alabama","Houston County",2,7,1319,701,618
050,01,069,"Alabama","Houston County",2,8,1349,700,649
050,01,069,"Alabama","Houston County",2,9,1354,693,661
050,01,069,"Alabama","Houston County",2,10,1420,712,708
050,01,069,"Alabama","Houston County",2,11,1427,714,713
050,01,069,"Alabama","Houston County",2,12,1488,765,723
050,01,069,"Alabama","Houston County",2,13,1471,781,690
050,01,069,"Alabama","Houston County",2,14,1449,769,680
050,01,069,"Alabama","Houston County",2,15,1398,740,658
050,01,069,"Alabama","Houston County",2,16,1462,774,688
050,01,069,"Alabama","Houston County",2,17,1465,745,720
050,01,069,"Alabama","Houston County",2,18,1255,639,616
050,01,069,"Alabama","Houston County",2,19,1068,554,514
050,01,069,"Alabama","Houston County",2,20,1129,567,562
050,01,069,"Alabama","Houston County",2,21,1117,551,566
050,01,069,"Alabama","Houston County",2,22,1144,559,585
050,01,069,"Alabama","Houston County",2,23,1203,579,624
050,01,069,"Alabama","Houston County",2,24,1238,609,629
050,01,069,"Alabama","Houston County",2,25,1261,623,638
050,01,069,"Alabama","Houston County",2,26,1340,641,699
050,01,069,"Alabama","Houston County",2,27,1356,642,714
050,01,069,"Alabama","Houston County",2,28,1394,665,729
050,01,069,"Alabama","Houston County",2,29,1422,665,757
050,01,069,"Alabama","Houston County",2,30,1436,644,792
050,01,069,"Alabama","Houston County",2,31,1335,620,715
050,01,069,"Alabama","Houston County",2,32,1331,617,714
050,01,069,"Alabama","Houston County",2,33,1350,637,713
050,01,069,"Alabama","Houston County",2,34,1361,638,723
050,01,069,"Alabama","Houston County",2,35,1366,638,728
050,01,069,"Alabama","Houston County",2,36,1364,657,707
050,01,069,"Alabama","Houston County",2,37,1378,678,700
050,01,069,"Alabama","Houston County",2,38,1391,672,719
050,01,069,"Alabama","Houston County",2,39,1361,670,691
050,01,069,"Alabama","Houston County",2,40,1361,657,704
050,01,069,"Alabama","Houston County",2,41,1289,619,670
050,01,069,"Alabama","Houston County",2,42,1291,612,679
050,01,069,"Alabama","Houston County",2,43,1313,600,713
050,01,069,"Alabama","Houston County",2,44,1262,579,683
050,01,069,"Alabama","Houston County",2,45,1279,606,673
050,01,069,"Alabama","Houston County",2,46,1280,600,680
050,01,069,"Alabama","Houston County",2,47,1304,614,690
050,01,069,"Alabama","Houston County",2,48,1382,655,727
050,01,069,"Alabama","Houston County",2,49,1454,704,750
050,01,069,"Alabama","Houston County",2,50,1422,701,721
050,01,069,"Alabama","Houston County",2,51,1326,648,678
050,01,069,"Alabama","Houston County",2,52,1312,658,654
050,01,069,"Alabama","Houston County",2,53,1319,660,659
050,01,069,"Alabama","Houston County",2,54,1337,640,697
050,01,069,"Alabama","Houston County",2,55,1418,676,742
050,01,069,"Alabama","Houston County",2,56,1487,722,765
050,01,069,"Alabama","Houston County",2,57,1484,707,777
050,01,069,"Alabama","Houston County",2,58,1498,709,789
050,01,069,"Alabama","Houston County",2,59,1477,689,788
050,01,069,"Alabama","Houston County",2,60,1468,669,799
050,01,069,"Alabama","Houston County",2,61,1425,659,766
050,01,069,"Alabama","Houston County",2,62,1433,689,744
050,01,069,"Alabama","Houston County",2,63,1412,700,712
050,01,069,"Alabama","Houston County",2,64,1343,652,691
050,01,069,"Alabama","Houston County",2,65,1308,601,707
050,01,069,"Alabama","Houston County",2,66,1301,574,727
050,01,069,"Alabama","Houston County",2,67,1283,596,687
050,01,069,"Alabama","Houston County",2,68,1209,571,638
050,01,069,"Alabama","Houston County",2,69,1139,509,630
050,01,069,"Alabama","Houston County",2,70,1090,502,588
050,01,069,"Alabama","Houston County",2,71,1096,513,583
050,01,069,"Alabama","Houston County",2,72,1090,512,578
050,01,069,"Alabama","Houston County",2,73,1146,531,615
050,01,069,"Alabama","Houston County",2,74,838,373,465
050,01,069,"Alabama","Houston County",2,75,853,374,479
050,01,069,"Alabama","Houston County",2,76,798,362,436
050,01,069,"Alabama","Houston County",2,77,750,331,419
050,01,069,"Alabama","Houston County",2,78,664,281,383
050,01,069,"Alabama","Houston County",2,79,587,248,339
050,01,069,"Alabama","Houston County",2,80,530,220,310
050,01,069,"Alabama","Houston County",2,81,519,214,305
050,01,069,"Alabama","Houston County",2,82,471,198,273
050,01,069,"Alabama","Houston County",2,83,392,160,232
050,01,069,"Alabama","Houston County",2,84,377,146,231
050,01,069,"Alabama","Houston County",2,85,1939,648,1291
050,01,069,"Alabama","Houston County",3,0,1285,632,653
050,01,069,"Alabama","Houston County",3,1,1331,686,645
050,01,069,"Alabama","Houston County",3,2,1347,712,635
050,01,069,"Alabama","Houston County",3,3,1348,677,671
050,01,069,"Alabama","Houston County",3,4,1334,684,650
050,01,069,"Alabama","Houston County",3,5,1356,711,645
050,01,069,"Alabama","Houston County",3,6,1329,687,642
050,01,069,"Alabama","Houston County",3,7,1296,703,593
050,01,069,"Alabama","Houston County",3,8,1303,685,618
050,01,069,"Alabama","Houston County",3,9,1335,718,617
050,01,069,"Alabama","Houston County",3,10,1364,681,683
050,01,069,"Alabama","Houston County",3,11,1410,708,702
050,01,069,"Alabama","Houston County",3,12,1465,734,731
050,01,069,"Alabama","Houston County",3,13,1449,740,709
050,01,069,"Alabama","Houston County",3,14,1490,790,700
050,01,069,"Alabama","Houston County",3,15,1436,774,662
050,01,069,"Alabama","Houston County",3,16,1394,737,657
050,01,069,"Alabama","Houston County",3,17,1454,770,684
050,01,069,"Alabama","Houston County",3,18,1270,667,603
050,01,069,"Alabama","Houston County",3,19,1024,521,503
050,01,069,"Alabama","Houston County",3,20,1178,596,582
050,01,069,"Alabama","Houston County",3,21,1193,575,618
050,01,069,"Alabama","Houston County",3,22,1218,587,631
050,01,069,"Alabama","Houston County",3,23,1245,616,629
050,01,069,"Alabama","Houston County",3,24,1272,628,644
050,01,069,"Alabama","Houston County",3,25,1269,612,657
050,01,069,"Alabama","Houston County",3,26,1279,627,652
050,01,069,"Alabama","Houston County",3,27,1371,662,709
050,01,069,"Alabama","Houston County",3,28,1336,629,707
050,01,069,"Alabama","Houston County",3,29,1407,675,732
050,01,069,"Alabama","Houston County",3,30,1426,644,782
050,01,069,"Alabama","Houston County",3,31,1455,650,805
050,01,069,"Alabama","Houston County",3,32,1337,625,712
050,01,069,"Alabama","Houston County",3,33,1340,647,693
050,01,069,"Alabama","Houston County",3,34,1347,625,722
050,01,069,"Alabama","Houston County",3,35,1369,646,723
050,01,069,"Alabama","Houston County",3,36,1376,635,741
050,01,069,"Alabama","Houston County",3,37,1373,657,716
050,01,069,"Alabama","Houston County",3,38,1378,667,711
050,01,069,"Alabama","Houston County",3,39,1374,656,718
050,01,069,"Alabama","Houston County",3,40,1371,670,701
050,01,069,"Alabama","Houston County",3,41,1348,666,682
050,01,069,"Alabama","Houston County",3,42,1286,621,665
050,01,069,"Alabama","Houston County",3,43,1279,585,694
050,01,069,"Alabama","Houston County",3,44,1302,601,701
050,01,069,"Alabama","Houston County",3,45,1250,586,664
050,01,069,"Alabama","Houston County",3,46,1271,595,676
050,01,069,"Alabama","Houston County",3,47,1272,593,679
050,01,069,"Alabama","Houston County",3,48,1286,605,681
050,01,069,"Alabama","Houston County",3,49,1374,644,730
050,01,069,"Alabama","Houston County",3,50,1449,701,748
050,01,069,"Alabama","Houston County",3,51,1448,718,730
050,01,069,"Alabama","Houston County",3,52,1324,635,689
050,01,069,"Alabama","Houston County",3,53,1297,637,660
050,01,069,"Alabama","Houston County",3,54,1320,662,658
050,01,069,"Alabama","Houston County",3,55,1326,649,677
050,01,069,"Alabama","Houston County",3,56,1389,655,734
050,01,069,"Alabama","Houston County",3,57,1485,714,771
050,01,069,"Alabama","Houston County",3,58,1510,716,794
050,01,069,"Alabama","Houston County",3,59,1463,699,764
050,01,069,"Alabama","Houston County",3,60,1471,688,783
050,01,069,"Alabama","Houston County",3,61,1441,653,788
050,01,069,"Alabama","Houston County",3,62,1417,658,759
050,01,069,"Alabama","Houston County",3,63,1429,677,752
050,01,069,"Alabama","Houston County",3,64,1408,700,708
050,01,069,"Alabama","Houston County",3,65,1323,631,692
050,01,069,"Alabama","Houston County",3,66,1302,595,707
050,01,069,"Alabama","Houston County",3,67,1298,566,732
050,01,069,"Alabama","Houston County",3,68,1252,575,677
050,01,069,"Alabama","Houston County",3,69,1179,556,623
050,01,069,"Alabama","Houston County",3,70,1120,500,620
050,01,069,"Alabama","Houston County",3,71,1055,478,577
050,01,069,"Alabama","Houston County",3,72,1084,500,584
050,01,069,"Alabama","Houston County",3,73,1048,486,562
050,01,069,"Alabama","Houston County",3,74,1121,515,606
050,01,069,"Alabama","Houston County",3,75,797,345,452
050,01,069,"Alabama","Houston County",3,76,807,346,461
050,01,069,"Alabama","Houston County",3,77,766,337,429
050,01,069,"Alabama","Houston County",3,78,713,298,415
050,01,069,"Alabama","Houston County",3,79,621,267,354
050,01,069,"Alabama","Houston County",3,80,552,230,322
050,01,069,"Alabama","Houston County",3,81,495,196,299
050,01,069,"Alabama","Houston County",3,82,470,186,284
050,01,069,"Alabama","Houston County",3,83,426,177,249
050,01,069,"Alabama","Houston County",3,84,366,139,227
050,01,069,"Alabama","Houston County",3,85,1896,635,1261
050,01,069,"Alabama","Houston County",4,0,1286,631,655
050,01,069,"Alabama","Houston County",4,1,1318,643,675
050,01,069,"Alabama","Houston County",4,2,1383,717,666
050,01,069,"Alabama","Houston County",4,3,1397,749,648
050,01,069,"Alabama","Houston County",4,4,1362,698,664
050,01,069,"Alabama","Houston County",4,5,1352,698,654
050,01,069,"Alabama","Houston County",4,6,1358,715,643
050,01,069,"Alabama","Houston County",4,7,1337,700,637
050,01,069,"Alabama","Houston County",4,8,1287,701,586
050,01,069,"Alabama","Houston County",4,9,1320,684,636
050,01,069,"Alabama","Houston County",4,10,1338,722,616
050,01,069,"Alabama","Houston County",4,11,1352,678,674
050,01,069,"Alabama","Houston County",4,12,1420,722,698
050,01,069,"Alabama","Houston County",4,13,1449,729,720
050,01,069,"Alabama","Houston County",4,14,1443,738,705
050,01,069,"Alabama","Houston County",4,15,1486,786,700
050,01,069,"Alabama","Houston County",4,16,1442,775,667
050,01,069,"Alabama","Houston County",4,17,1393,738,655
050,01,069,"Alabama","Houston County",4,18,1212,648,564
050,01,069,"Alabama","Houston County",4,19,1043,546,497
050,01,069,"Alabama","Houston County",4,20,1086,547,539
050,01,069,"Alabama","Houston County",4,21,1243,622,621
050,01,069,"Alabama","Houston County",4,22,1256,612,644
050,01,069,"Alabama","Houston County",4,23,1297,607,690
050,01,069,"Alabama","Houston County",4,24,1277,641,636
050,01,069,"Alabama","Houston County",4,25,1320,642,678
050,01,069,"Alabama","Houston County",4,26,1289,619,670
050,01,069,"Alabama","Houston County",4,27,1300,626,674
050,01,069,"Alabama","Houston County",4,28,1385,666,719
050,01,069,"Alabama","Houston County",4,29,1371,654,717
050,01,069,"Alabama","Houston County",4,30,1383,650,733
050,01,069,"Alabama","Houston County",4,31,1421,640,781
050,01,069,"Alabama","Houston County",4,32,1473,664,809
050,01,069,"Alabama","Houston County",4,33,1363,645,718
050,01,069,"Alabama","Houston County",4,34,1350,639,711
050,01,069,"Alabama","Houston County",4,35,1343,628,715
050,01,069,"Alabama","Houston County",4,36,1387,658,729
050,01,069,"Alabama","Houston County",4,37,1394,659,735
050,01,069,"Alabama","Houston County",4,38,1386,663,723
050,01,069,"Alabama","Houston County",4,39,1394,672,722
050,01,069,"Alabama","Houston County",4,40,1360,648,712
050,01,069,"Alabama","Houston County",4,41,1336,644,692
050,01,069,"Alabama","Houston County",4,42,1375,682,693
050,01,069,"Alabama","Houston County",4,43,1284,611,673
050,01,069,"Alabama","Houston County",4,44,1291,591,700
050,01,069,"Alabama","Houston County",4,45,1322,600,722
050,01,069,"Alabama","Houston County",4,46,1261,591,670
050,01,069,"Alabama","Houston County",4,47,1281,598,683
050,01,069,"Alabama","Houston County",4,48,1259,579,680
050,01,069,"Alabama","Houston County",4,49,1276,591,685
050,01,069,"Alabama","Houston County",4,50,1381,647,734
050,01,069,"Alabama","Houston County",4,51,1464,701,763
050,01,069,"Alabama","Houston County",4,52,1436,715,721
050,01,069,"Alabama","Houston County",4,53,1332,626,706
050,01,069,"Alabama","Houston County",4,54,1301,636,665
050,01,069,"Alabama","Houston County",4,55,1315,660,655
050,01,069,"Alabama","Houston County",4,56,1340,655,685
050,01,069,"Alabama","Houston County",4,57,1366,641,725
050,01,069,"Alabama","Houston County",4,58,1479,715,764
050,01,069,"Alabama","Houston County",4,59,1495,710,785
050,01,069,"Alabama","Houston County",4,60,1461,716,745
050,01,069,"Alabama","Houston County",4,61,1457,679,778
050,01,069,"Alabama","Houston County",4,62,1429,637,792
050,01,069,"Alabama","Houston County",4,63,1409,662,747
050,01,069,"Alabama","Houston County",4,64,1422,655,767
050,01,069,"Alabama","Houston County",4,65,1392,688,704
050,01,069,"Alabama","Houston County",4,66,1320,635,685
050,01,069,"Alabama","Houston County",4,67,1298,592,706
050,01,069,"Alabama","Houston County",4,68,1262,553,709
050,01,069,"Alabama","Houston County",4,69,1217,558,659
050,01,069,"Alabama","Houston County",4,70,1140,526,614
050,01,069,"Alabama","Houston County",4,71,1106,478,628
050,01,069,"Alabama","Houston County",4,72,1039,469,570
050,01,069,"Alabama","Houston County",4,73,1046,478,568
050,01,069,"Alabama","Houston County",4,74,1027,471,556
050,01,069,"Alabama","Houston County",4,75,1090,498,592
050,01,069,"Alabama","Houston County",4,76,770,325,445
050,01,069,"Alabama","Houston County",4,77,799,339,460
050,01,069,"Alabama","Houston County",4,78,738,320,418
050,01,069,"Alabama","Houston County",4,79,663,280,383
050,01,069,"Alabama","Houston County",4,80,587,248,339
050,01,069,"Alabama","Houston County",4,81,525,215,310
050,01,069,"Alabama","Houston County",4,82,454,186,268
050,01,069,"Alabama","Houston County",4,83,431,170,261
050,01,069,"Alabama","Houston County",4,84,390,161,229
050,01,069,"Alabama","Houston County",4,85,1925,639,1286
050,01,069,"Alabama","Houston County",5,0,1293,636,657
050,01,069,"Alabama","Houston County",5,1,1295,622,673
050,01,069,"Alabama","Houston County",5,2,1337,658,679
050,01,069,"Alabama","Houston County",5,3,1374,707,667
050,01,069,"Alabama","Houston County",5,4,1364,707,657
050,01,069,"Alabama","Houston County",5,5,1346,694,652
050,01,069,"Alabama","Houston County",5,6,1390,740,650
050,01,069,"Alabama","Houston County",5,7,1353,717,636
050,01,069,"Alabama","Houston County",5,8,1350,704,646
050,01,069,"Alabama","Houston County",5,9,1277,686,591
050,01,069,"Alabama","Houston County",5,10,1342,690,652
050,01,069,"Alabama","Houston County",5,11,1365,733,632
050,01,069,"Alabama","Houston County",5,12,1340,671,669
050,01,069,"Alabama","Houston County",5,13,1437,736,701
050,01,069,"Alabama","Houston County",5,14,1477,753,724
050,01,069,"Alabama","Houston County",5,15,1466,763,703
050,01,069,"Alabama","Houston County",5,16,1488,776,712
050,01,069,"Alabama","Houston County",5,17,1459,782,677
050,01,069,"Alabama","Houston County",5,18,1192,643,549
050,01,069,"Alabama","Houston County",5,19,1005,534,471
050,01,069,"Alabama","Houston County",5,20,1122,575,547
050,01,069,"Alabama","Houston County",5,21,1157,582,575
050,01,069,"Alabama","Houston County",5,22,1329,655,674
050,01,069,"Alabama","Houston County",5,23,1288,634,654
050,01,069,"Alabama","Houston County",5,24,1335,638,697
050,01,069,"Alabama","Houston County",5,25,1285,653,632
050,01,069,"Alabama","Houston County",5,26,1324,651,673
050,01,069,"Alabama","Houston County",5,27,1320,639,681
050,01,069,"Alabama","Houston County",5,28,1310,626,684
050,01,069,"Alabama","Houston County",5,29,1365,638,727
050,01,069,"Alabama","Houston County",5,30,1362,635,727
050,01,069,"Alabama","Houston County",5,31,1386,658,728
050,01,069,"Alabama","Houston County",5,32,1401,625,776
050,01,069,"Alabama","Houston County",5,33,1436,649,787
050,01,069,"Alabama","Houston County",5,34,1359,645,714
050,01,069,"Alabama","Houston County",5,35,1362,647,715
050,01,069,"Alabama","Houston County",5,36,1354,642,712
050,01,069,"Alabama","Houston County",5,37,1406,679,727
050,01,069,"Alabama","Houston County",5,38,1395,647,748
050,01,069,"Alabama","Houston County",5,39,1400,675,725
050,01,069,"Alabama","Houston County",5,40,1398,679,719
050,01,069,"Alabama","Houston County",5,41,1364,645,719
050,01,069,"Alabama","Houston County",5,42,1361,669,692
050,01,069,"Alabama","Houston County",5,43,1361,658,703
050,01,069,"Alabama","Houston County",5,44,1300,617,683
050,01,069,"Alabama","Houston County",5,45,1291,593,698
050,01,069,"Alabama","Houston County",5,46,1307,589,718
050,01,069,"Alabama","Houston County",5,47,1261,594,667
050,01,069,"Alabama","Houston County",5,48,1263,598,665
050,01,069,"Alabama","Houston County",5,49,1270,589,681
050,01,069,"Alabama","Houston County",5,50,1249,594,655
050,01,069,"Alabama","Houston County",5,51,1387,647,740
050,01,069,"Alabama","Houston County",5,52,1454,706,748
050,01,069,"Alabama","Houston County",5,53,1416,694,722
050,01,069,"Alabama","Houston County",5,54,1313,614,699
050,01,069,"Alabama","Houston County",5,55,1293,636,657
050,01,069,"Alabama","Houston County",5,56,1298,658,640
050,01,069,"Alabama","Houston County",5,57,1338,643,695
050,01,069,"Alabama","Houston County",5,58,1368,642,726
050,01,069,"Alabama","Houston County",5,59,1481,711,770
050,01,069,"Alabama","Houston County",5,60,1481,714,767
050,01,069,"Alabama","Houston County",5,61,1458,711,747
050,01,069,"Alabama","Houston County",5,62,1469,687,782
050,01,069,"Alabama","Houston County",5,63,1429,643,786
050,01,069,"Alabama","Houston County",5,64,1393,649,744
050,01,069,"Alabama","Houston County",5,65,1428,653,775
050,01,069,"Alabama","Houston County",5,66,1369,667,702
050,01,069,"Alabama","Houston County",5,67,1307,629,678
050,01,069,"Alabama","Houston County",5,68,1270,571,699
050,01,069,"Alabama","Houston County",5,69,1245,540,705
050,01,069,"Alabama","Houston County",5,70,1209,545,664
050,01,069,"Alabama","Houston County",5,71,1104,511,593
050,01,069,"Alabama","Houston County",5,72,1089,467,622
050,01,069,"Alabama","Houston County",5,73,1009,454,555
050,01,069,"Alabama","Houston County",5,74,1040,473,567
050,01,069,"Alabama","Houston County",5,75,1004,452,552
050,01,069,"Alabama","Houston County",5,76,1047,460,587
050,01,069,"Alabama","Houston County",5,77,744,308,436
050,01,069,"Alabama","Houston County",5,78,772,317,455
050,01,069,"Alabama","Houston County",5,79,697,308,389
050,01,069,"Alabama","Houston County",5,80,624,262,362
050,01,069,"Alabama","Houston County",5,81,554,230,324
050,01,069,"Alabama","Houston County",5,82,481,195,286
050,01,069,"Alabama","Houston County",5,83,414,175,239
050,01,069,"Alabama","Houston County",5,84,408,158,250
050,01,069,"Alabama","Houston County",5,85,1998,675,1323
050,01,071,"Alabama","Jackson County",1,0,559,286,273
050,01,071,"Alabama","Jackson County",1,1,558,281,277
050,01,071,"Alabama","Jackson County",1,2,580,300,280
050,01,071,"Alabama","Jackson County",1,3,552,289,263
050,01,071,"Alabama","Jackson County",1,4,595,306,289
050,01,071,"Alabama","Jackson County",1,5,557,285,272
050,01,071,"Alabama","Jackson County",1,6,562,280,282
050,01,071,"Alabama","Jackson County",1,7,550,291,259
050,01,071,"Alabama","Jackson County",1,8,594,320,274
050,01,071,"Alabama","Jackson County",1,9,580,307,273
050,01,071,"Alabama","Jackson County",1,10,602,304,298
050,01,071,"Alabama","Jackson County",1,11,656,334,322
050,01,071,"Alabama","Jackson County",1,12,678,350,328
050,01,071,"Alabama","Jackson County",1,13,665,360,305
050,01,071,"Alabama","Jackson County",1,14,633,345,288
050,01,071,"Alabama","Jackson County",1,15,686,368,318
050,01,071,"Alabama","Jackson County",1,16,686,351,335
050,01,071,"Alabama","Jackson County",1,17,658,335,323
050,01,071,"Alabama","Jackson County",1,18,579,303,276
050,01,071,"Alabama","Jackson County",1,19,490,265,225
050,01,071,"Alabama","Jackson County",1,20,518,267,251
050,01,071,"Alabama","Jackson County",1,21,529,265,264
050,01,071,"Alabama","Jackson County",1,22,554,285,269
050,01,071,"Alabama","Jackson County",1,23,579,304,275
050,01,071,"Alabama","Jackson County",1,24,596,312,284
050,01,071,"Alabama","Jackson County",1,25,588,293,295
050,01,071,"Alabama","Jackson County",1,26,595,281,314
050,01,071,"Alabama","Jackson County",1,27,624,311,313
050,01,071,"Alabama","Jackson County",1,28,655,332,323
050,01,071,"Alabama","Jackson County",1,29,665,337,328
050,01,071,"Alabama","Jackson County",1,30,639,320,319
050,01,071,"Alabama","Jackson County",1,31,587,301,286
050,01,071,"Alabama","Jackson County",1,32,540,270,270
050,01,071,"Alabama","Jackson County",1,33,539,271,268
050,01,071,"Alabama","Jackson County",1,34,542,270,272
050,01,071,"Alabama","Jackson County",1,35,580,295,285
050,01,071,"Alabama","Jackson County",1,36,556,263,293
050,01,071,"Alabama","Jackson County",1,37,601,279,322
050,01,071,"Alabama","Jackson County",1,38,593,293,300
050,01,071,"Alabama","Jackson County",1,39,622,302,320
050,01,071,"Alabama","Jackson County",1,40,641,320,321
050,01,071,"Alabama","Jackson County",1,41,621,292,329
050,01,071,"Alabama","Jackson County",1,42,643,303,340
050,01,071,"Alabama","Jackson County",1,43,646,319,327
050,01,071,"Alabama","Jackson County",1,44,673,339,334
050,01,071,"Alabama","Jackson County",1,45,678,348,330
050,01,071,"Alabama","Jackson County",1,46,672,353,319
050,01,071,"Alabama","Jackson County",1,47,713,367,346
050,01,071,"Alabama","Jackson County",1,48,734,372,362
050,01,071,"Alabama","Jackson County",1,49,771,403,368
050,01,071,"Alabama","Jackson County",1,50,711,372,339
050,01,071,"Alabama","Jackson County",1,51,692,360,332
050,01,071,"Alabama","Jackson County",1,52,676,341,335
050,01,071,"Alabama","Jackson County",1,53,724,369,355
050,01,071,"Alabama","Jackson County",1,54,674,333,341
050,01,071,"Alabama","Jackson County",1,55,715,337,378
050,01,071,"Alabama","Jackson County",1,56,777,395,382
050,01,071,"Alabama","Jackson County",1,57,762,385,377
050,01,071,"Alabama","Jackson County",1,58,770,366,404
050,01,071,"Alabama","Jackson County",1,59,772,360,412
050,01,071,"Alabama","Jackson County",1,60,795,402,393
050,01,071,"Alabama","Jackson County",1,61,774,395,379
050,01,071,"Alabama","Jackson County",1,62,835,412,423
050,01,071,"Alabama","Jackson County",1,63,820,400,420
050,01,071,"Alabama","Jackson County",1,64,785,386,399
050,01,071,"Alabama","Jackson County",1,65,755,373,382
050,01,071,"Alabama","Jackson County",1,66,754,370,384
050,01,071,"Alabama","Jackson County",1,67,721,349,372
050,01,071,"Alabama","Jackson County",1,68,651,309,342
050,01,071,"Alabama","Jackson County",1,69,606,281,325
050,01,071,"Alabama","Jackson County",1,70,607,290,317
050,01,071,"Alabama","Jackson County",1,71,608,279,329
050,01,071,"Alabama","Jackson County",1,72,655,304,351
050,01,071,"Alabama","Jackson County",1,73,634,291,343
050,01,071,"Alabama","Jackson County",1,74,445,203,242
050,01,071,"Alabama","Jackson County",1,75,464,208,256
050,01,071,"Alabama","Jackson County",1,76,463,209,254
050,01,071,"Alabama","Jackson County",1,77,470,203,267
050,01,071,"Alabama","Jackson County",1,78,374,176,198
050,01,071,"Alabama","Jackson County",1,79,343,164,179
050,01,071,"Alabama","Jackson County",1,80,308,140,168
050,01,071,"Alabama","Jackson County",1,81,281,131,150
050,01,071,"Alabama","Jackson County",1,82,263,118,145
050,01,071,"Alabama","Jackson County",1,83,232,95,137
050,01,071,"Alabama","Jackson County",1,84,207,77,130
050,01,071,"Alabama","Jackson County",1,85,942,291,651
050,01,071,"Alabama","Jackson County",2,0,546,274,272
050,01,071,"Alabama","Jackson County",2,1,557,282,275
050,01,071,"Alabama","Jackson County",2,2,570,294,276
050,01,071,"Alabama","Jackson County",2,3,561,293,268
050,01,071,"Alabama","Jackson County",2,4,587,302,285
050,01,071,"Alabama","Jackson County",2,5,571,292,279
050,01,071,"Alabama","Jackson County",2,6,562,281,281
050,01,071,"Alabama","Jackson County",2,7,551,288,263
050,01,071,"Alabama","Jackson County",2,8,580,311,269
050,01,071,"Alabama","Jackson County",2,9,584,311,273
050,01,071,"Alabama","Jackson County",2,10,600,307,293
050,01,071,"Alabama","Jackson County",2,11,640,324,316
050,01,071,"Alabama","Jackson County",2,12,678,347,331
050,01,071,"Alabama","Jackson County",2,13,665,355,310
050,01,071,"Alabama","Jackson County",2,14,639,349,290
050,01,071,"Alabama","Jackson County",2,15,675,363,312
050,01,071,"Alabama","Jackson County",2,16,687,356,331
050,01,071,"Alabama","Jackson County",2,17,668,341,327
050,01,071,"Alabama","Jackson County",2,18,568,298,270
050,01,071,"Alabama","Jackson County",2,19,484,259,225
050,01,071,"Alabama","Jackson County",2,20,523,271,252
050,01,071,"Alabama","Jackson County",2,21,528,265,263
050,01,071,"Alabama","Jackson County",2,22,555,285,270
050,01,071,"Alabama","Jackson County",2,23,583,305,278
050,01,071,"Alabama","Jackson County",2,24,599,316,283
050,01,071,"Alabama","Jackson County",2,25,590,299,291
050,01,071,"Alabama","Jackson County",2,26,596,285,311
050,01,071,"Alabama","Jackson County",2,27,617,305,312
050,01,071,"Alabama","Jackson County",2,28,649,326,323
050,01,071,"Alabama","Jackson County",2,29,662,336,326
050,01,071,"Alabama","Jackson County",2,30,649,326,323
050,01,071,"Alabama","Jackson County",2,31,596,301,295
050,01,071,"Alabama","Jackson County",2,32,556,279,277
050,01,071,"Alabama","Jackson County",2,33,538,271,267
050,01,071,"Alabama","Jackson County",2,34,542,270,272
050,01,071,"Alabama","Jackson County",2,35,571,289,282
050,01,071,"Alabama","Jackson County",2,36,562,270,292
050,01,071,"Alabama","Jackson County",2,37,591,278,313
050,01,071,"Alabama","Jackson County",2,38,596,291,305
050,01,071,"Alabama","Jackson County",2,39,614,300,314
050,01,071,"Alabama","Jackson County",2,40,642,320,322
050,01,071,"Alabama","Jackson County",2,41,624,298,326
050,01,071,"Alabama","Jackson County",2,42,634,298,336
050,01,071,"Alabama","Jackson County",2,43,654,319,335
050,01,071,"Alabama","Jackson County",2,44,659,332,327
050,01,071,"Alabama","Jackson County",2,45,682,349,333
050,01,071,"Alabama","Jackson County",2,46,674,351,323
050,01,071,"Alabama","Jackson County",2,47,700,362,338
050,01,071,"Alabama","Jackson County",2,48,728,373,355
050,01,071,"Alabama","Jackson County",2,49,766,399,367
050,01,071,"Alabama","Jackson County",2,50,724,379,345
050,01,071,"Alabama","Jackson County",2,51,691,359,332
050,01,071,"Alabama","Jackson County",2,52,676,343,333
050,01,071,"Alabama","Jackson County",2,53,714,362,352
050,01,071,"Alabama","Jackson County",2,54,680,337,343
050,01,071,"Alabama","Jackson County",2,55,709,338,371
050,01,071,"Alabama","Jackson County",2,56,766,382,384
050,01,071,"Alabama","Jackson County",2,57,762,385,377
050,01,071,"Alabama","Jackson County",2,58,770,371,399
050,01,071,"Alabama","Jackson County",2,59,770,358,412
050,01,071,"Alabama","Jackson County",2,60,790,393,397
050,01,071,"Alabama","Jackson County",2,61,781,398,383
050,01,071,"Alabama","Jackson County",2,62,812,401,411
050,01,071,"Alabama","Jackson County",2,63,828,405,423
050,01,071,"Alabama","Jackson County",2,64,782,383,399
050,01,071,"Alabama","Jackson County",2,65,755,371,384
050,01,071,"Alabama","Jackson County",2,66,756,370,386
050,01,071,"Alabama","Jackson County",2,67,729,355,374
050,01,071,"Alabama","Jackson County",2,68,658,314,344
050,01,071,"Alabama","Jackson County",2,69,620,290,330
050,01,071,"Alabama","Jackson County",2,70,603,287,316
050,01,071,"Alabama","Jackson County",2,71,609,282,327
050,01,071,"Alabama","Jackson County",2,72,629,291,338
050,01,071,"Alabama","Jackson County",2,73,672,310,362
050,01,071,"Alabama","Jackson County",2,74,452,205,247
050,01,071,"Alabama","Jackson County",2,75,460,207,253
050,01,071,"Alabama","Jackson County",2,76,453,202,251
050,01,071,"Alabama","Jackson County",2,77,473,206,267
050,01,071,"Alabama","Jackson County",2,78,389,177,212
050,01,071,"Alabama","Jackson County",2,79,341,157,184
050,01,071,"Alabama","Jackson County",2,80,309,144,165
050,01,071,"Alabama","Jackson County",2,81,275,125,150
050,01,071,"Alabama","Jackson County",2,82,259,117,142
050,01,071,"Alabama","Jackson County",2,83,231,96,135
050,01,071,"Alabama","Jackson County",2,84,212,81,131
050,01,071,"Alabama","Jackson County",2,85,952,296,656
050,01,071,"Alabama","Jackson County",3,0,528,271,257
050,01,071,"Alabama","Jackson County",3,1,554,268,286
050,01,071,"Alabama","Jackson County",3,2,582,291,291
050,01,071,"Alabama","Jackson County",3,3,582,287,295
050,01,071,"Alabama","Jackson County",3,4,555,284,271
050,01,071,"Alabama","Jackson County",3,5,587,302,285
050,01,071,"Alabama","Jackson County",3,6,565,294,271
050,01,071,"Alabama","Jackson County",3,7,572,289,283
050,01,071,"Alabama","Jackson County",3,8,554,292,262
050,01,071,"Alabama","Jackson County",3,9,603,320,283
050,01,071,"Alabama","Jackson County",3,10,590,312,278
050,01,071,"Alabama","Jackson County",3,11,614,317,297
050,01,071,"Alabama","Jackson County",3,12,651,332,319
050,01,071,"Alabama","Jackson County",3,13,692,353,339
050,01,071,"Alabama","Jackson County",3,14,687,359,328
050,01,071,"Alabama","Jackson County",3,15,662,360,302
050,01,071,"Alabama","Jackson County",3,16,688,363,325
050,01,071,"Alabama","Jackson County",3,17,685,362,323
050,01,071,"Alabama","Jackson County",3,18,574,302,272
050,01,071,"Alabama","Jackson County",3,19,472,252,220
050,01,071,"Alabama","Jackson County",3,20,526,276,250
050,01,071,"Alabama","Jackson County",3,21,566,282,284
050,01,071,"Alabama","Jackson County",3,22,570,286,284
050,01,071,"Alabama","Jackson County",3,23,600,301,299
050,01,071,"Alabama","Jackson County",3,24,591,314,277
050,01,071,"Alabama","Jackson County",3,25,604,328,276
050,01,071,"Alabama","Jackson County",3,26,596,296,300
050,01,071,"Alabama","Jackson County",3,27,604,295,309
050,01,071,"Alabama","Jackson County",3,28,634,314,320
050,01,071,"Alabama","Jackson County",3,29,626,303,323
050,01,071,"Alabama","Jackson County",3,30,676,339,337
050,01,071,"Alabama","Jackson County",3,31,646,321,325
050,01,071,"Alabama","Jackson County",3,32,618,313,305
050,01,071,"Alabama","Jackson County",3,33,557,277,280
050,01,071,"Alabama","Jackson County",3,34,559,277,282
050,01,071,"Alabama","Jackson County",3,35,562,284,278
050,01,071,"Alabama","Jackson County",3,36,590,297,293
050,01,071,"Alabama","Jackson County",3,37,585,281,304
050,01,071,"Alabama","Jackson County",3,38,619,308,311
050,01,071,"Alabama","Jackson County",3,39,597,280,317
050,01,071,"Alabama","Jackson County",3,40,614,299,315
050,01,071,"Alabama","Jackson County",3,41,649,323,326
050,01,071,"Alabama","Jackson County",3,42,633,307,326
050,01,071,"Alabama","Jackson County",3,43,638,298,340
050,01,071,"Alabama","Jackson County",3,44,673,337,336
050,01,071,"Alabama","Jackson County",3,45,653,322,331
050,01,071,"Alabama","Jackson County",3,46,678,339,339
050,01,071,"Alabama","Jackson County",3,47,677,355,322
050,01,071,"Alabama","Jackson County",3,48,698,362,336
050,01,071,"Alabama","Jackson County",3,49,745,382,363
050,01,071,"Alabama","Jackson County",3,50,747,389,358
050,01,071,"Alabama","Jackson County",3,51,733,387,346
050,01,071,"Alabama","Jackson County",3,52,700,363,337
050,01,071,"Alabama","Jackson County",3,53,700,352,348
050,01,071,"Alabama","Jackson County",3,54,699,360,339
050,01,071,"Alabama","Jackson County",3,55,675,334,341
050,01,071,"Alabama","Jackson County",3,56,707,340,367
050,01,071,"Alabama","Jackson County",3,57,753,377,376
050,01,071,"Alabama","Jackson County",3,58,762,388,374
050,01,071,"Alabama","Jackson County",3,59,773,370,403
050,01,071,"Alabama","Jackson County",3,60,763,355,408
050,01,071,"Alabama","Jackson County",3,61,775,389,386
050,01,071,"Alabama","Jackson County",3,62,775,383,392
050,01,071,"Alabama","Jackson County",3,63,796,397,399
050,01,071,"Alabama","Jackson County",3,64,822,398,424
050,01,071,"Alabama","Jackson County",3,65,763,378,385
050,01,071,"Alabama","Jackson County",3,66,747,365,382
050,01,071,"Alabama","Jackson County",3,67,747,364,383
050,01,071,"Alabama","Jackson County",3,68,688,341,347
050,01,071,"Alabama","Jackson County",3,69,646,307,339
050,01,071,"Alabama","Jackson County",3,70,603,283,320
050,01,071,"Alabama","Jackson County",3,71,580,273,307
050,01,071,"Alabama","Jackson County",3,72,587,276,311
050,01,071,"Alabama","Jackson County",3,73,608,284,324
050,01,071,"Alabama","Jackson County",3,74,652,293,359
050,01,071,"Alabama","Jackson County",3,75,435,199,236
050,01,071,"Alabama","Jackson County",3,76,443,196,247
050,01,071,"Alabama","Jackson County",3,77,420,188,232
050,01,071,"Alabama","Jackson County",3,78,455,199,256
050,01,071,"Alabama","Jackson County",3,79,362,163,199
050,01,071,"Alabama","Jackson County",3,80,307,140,167
050,01,071,"Alabama","Jackson County",3,81,268,121,147
050,01,071,"Alabama","Jackson County",3,82,235,101,134
050,01,071,"Alabama","Jackson County",3,83,229,101,128
050,01,071,"Alabama","Jackson County",3,84,215,90,125
050,01,071,"Alabama","Jackson County",3,85,968,313,655
050,01,071,"Alabama","Jackson County",4,0,560,290,270
050,01,071,"Alabama","Jackson County",4,1,595,315,280
050,01,071,"Alabama","Jackson County",4,2,557,264,293
050,01,071,"Alabama","Jackson County",4,3,592,289,303
050,01,071,"Alabama","Jackson County",4,4,593,295,298
050,01,071,"Alabama","Jackson County",4,5,577,285,292
050,01,071,"Alabama","Jackson County",4,6,611,305,306
050,01,071,"Alabama","Jackson County",4,7,577,298,279
050,01,071,"Alabama","Jackson County",4,8,572,292,280
050,01,071,"Alabama","Jackson County",4,9,564,302,262
050,01,071,"Alabama","Jackson County",4,10,599,324,275
050,01,071,"Alabama","Jackson County",4,11,594,316,278
050,01,071,"Alabama","Jackson County",4,12,617,310,307
050,01,071,"Alabama","Jackson County",4,13,642,326,316
050,01,071,"Alabama","Jackson County",4,14,680,349,331
050,01,071,"Alabama","Jackson County",4,15,700,361,339
050,01,071,"Alabama","Jackson County",4,16,654,348,306
050,01,071,"Alabama","Jackson County",4,17,679,357,322
050,01,071,"Alabama","Jackson County",4,18,593,328,265
050,01,071,"Alabama","Jackson County",4,19,456,242,214
050,01,071,"Alabama","Jackson County",4,20,501,266,235
050,01,071,"Alabama","Jackson County",4,21,545,280,265
050,01,071,"Alabama","Jackson County",4,22,599,298,301
050,01,071,"Alabama","Jackson County",4,23,625,303,322
050,01,071,"Alabama","Jackson County",4,24,617,312,305
050,01,071,"Alabama","Jackson County",4,25,606,311,295
050,01,071,"Alabama","Jackson County",4,26,607,326,281
050,01,071,"Alabama","Jackson County",4,27,600,299,301
050,01,071,"Alabama","Jackson County",4,28,609,293,316
050,01,071,"Alabama","Jackson County",4,29,631,303,328
050,01,071,"Alabama","Jackson County",4,30,639,308,331
050,01,071,"Alabama","Jackson County",4,31,693,347,346
050,01,071,"Alabama","Jackson County",4,32,669,323,346
050,01,071,"Alabama","Jackson County",4,33,625,312,313
050,01,071,"Alabama","Jackson County",4,34,558,282,276
050,01,071,"Alabama","Jackson County",4,35,570,284,286
050,01,071,"Alabama","Jackson County",4,36,580,285,295
050,01,071,"Alabama","Jackson County",4,37,598,299,299
050,01,071,"Alabama","Jackson County",4,38,582,287,295
050,01,071,"Alabama","Jackson County",4,39,630,316,314
050,01,071,"Alabama","Jackson County",4,40,601,292,309
050,01,071,"Alabama","Jackson County",4,41,626,306,320
050,01,071,"Alabama","Jackson County",4,42,656,324,332
050,01,071,"Alabama","Jackson County",4,43,645,314,331
050,01,071,"Alabama","Jackson County",4,44,642,303,339
050,01,071,"Alabama","Jackson County",4,45,683,344,339
050,01,071,"Alabama","Jackson County",4,46,648,315,333
050,01,071,"Alabama","Jackson County",4,47,672,336,336
050,01,071,"Alabama","Jackson County",4,48,673,351,322
050,01,071,"Alabama","Jackson County",4,49,714,372,342
050,01,071,"Alabama","Jackson County",4,50,742,376,366
050,01,071,"Alabama","Jackson County",4,51,752,393,359
050,01,071,"Alabama","Jackson County",4,52,726,385,341
050,01,071,"Alabama","Jackson County",4,53,738,376,362
050,01,071,"Alabama","Jackson County",4,54,687,350,337
050,01,071,"Alabama","Jackson County",4,55,706,363,343
050,01,071,"Alabama","Jackson County",4,56,670,333,337
050,01,071,"Alabama","Jackson County",4,57,710,332,378
050,01,071,"Alabama","Jackson County",4,58,756,382,374
050,01,071,"Alabama","Jackson County",4,59,758,377,381
050,01,071,"Alabama","Jackson County",4,60,780,377,403
050,01,071,"Alabama","Jackson County",4,61,768,359,409
050,01,071,"Alabama","Jackson County",4,62,769,380,389
050,01,071,"Alabama","Jackson County",4,63,771,384,387
050,01,071,"Alabama","Jackson County",4,64,793,383,410
050,01,071,"Alabama","Jackson County",4,65,806,386,420
050,01,071,"Alabama","Jackson County",4,66,767,376,391
050,01,071,"Alabama","Jackson County",4,67,754,366,388
050,01,071,"Alabama","Jackson County",4,68,707,349,358
050,01,071,"Alabama","Jackson County",4,69,681,334,347
050,01,071,"Alabama","Jackson County",4,70,627,297,330
050,01,071,"Alabama","Jackson County",4,71,589,278,311
050,01,071,"Alabama","Jackson County",4,72,551,259,292
050,01,071,"Alabama","Jackson County",4,73,558,262,296
050,01,071,"Alabama","Jackson County",4,74,573,260,313
050,01,071,"Alabama","Jackson County",4,75,624,279,345
050,01,071,"Alabama","Jackson County",4,76,415,185,230
050,01,071,"Alabama","Jackson County",4,77,411,182,229
050,01,071,"Alabama","Jackson County",4,78,399,170,229
050,01,071,"Alabama","Jackson County",4,79,420,175,245
050,01,071,"Alabama","Jackson County",4,80,332,150,182
050,01,071,"Alabama","Jackson County",4,81,267,120,147
050,01,071,"Alabama","Jackson County",4,82,237,105,132
050,01,071,"Alabama","Jackson County",4,83,212,90,122
050,01,071,"Alabama","Jackson County",4,84,212,91,121
050,01,071,"Alabama","Jackson County",4,85,999,337,662
050,01,071,"Alabama","Jackson County",5,0,551,287,264
050,01,071,"Alabama","Jackson County",5,1,570,307,263
050,01,071,"Alabama","Jackson County",5,2,620,326,294
050,01,071,"Alabama","Jackson County",5,3,590,286,304
050,01,071,"Alabama","Jackson County",5,4,609,294,315
050,01,071,"Alabama","Jackson County",5,5,604,300,304
050,01,071,"Alabama","Jackson County",5,6,589,308,281
050,01,071,"Alabama","Jackson County",5,7,623,318,305
050,01,071,"Alabama","Jackson County",5,8,592,307,285
050,01,071,"Alabama","Jackson County",5,9,595,304,291
050,01,071,"Alabama","Jackson County",5,10,595,321,274
050,01,071,"Alabama","Jackson County",5,11,623,323,300
050,01,071,"Alabama","Jackson County",5,12,599,321,278
050,01,071,"Alabama","Jackson County",5,13,634,314,320
050,01,071,"Alabama","Jackson County",5,14,656,334,322
050,01,071,"Alabama","Jackson County",5,15,702,362,340
050,01,071,"Alabama","Jackson County",5,16,696,361,335
050,01,071,"Alabama","Jackson County",5,17,664,355,309
050,01,071,"Alabama","Jackson County",5,18,581,313,268
050,01,071,"Alabama","Jackson County",5,19,477,257,220
050,01,071,"Alabama","Jackson County",5,20,496,262,234
050,01,071,"Alabama","Jackson County",5,21,521,265,256
050,01,071,"Alabama","Jackson County",5,22,594,294,300
050,01,071,"Alabama","Jackson County",5,23,668,324,344
050,01,071,"Alabama","Jackson County",5,24,654,339,315
050,01,071,"Alabama","Jackson County",5,25,620,314,306
050,01,071,"Alabama","Jackson County",5,26,611,312,299
050,01,071,"Alabama","Jackson County",5,27,626,344,282
050,01,071,"Alabama","Jackson County",5,28,612,307,305
050,01,071,"Alabama","Jackson County",5,29,628,297,331
050,01,071,"Alabama","Jackson County",5,30,648,313,335
050,01,071,"Alabama","Jackson County",5,31,641,311,330
050,01,071,"Alabama","Jackson County",5,32,710,362,348
050,01,071,"Alabama","Jackson County",5,33,665,324,341
050,01,071,"Alabama","Jackson County",5,34,629,310,319
050,01,071,"Alabama","Jackson County",5,35,570,281,289
050,01,071,"Alabama","Jackson County",5,36,600,296,304
050,01,071,"Alabama","Jackson County",5,37,592,289,303
050,01,071,"Alabama","Jackson County",5,38,596,305,291
050,01,071,"Alabama","Jackson County",5,39,575,280,295
050,01,071,"Alabama","Jackson County",5,40,640,326,314
050,01,071,"Alabama","Jackson County",5,41,600,294,306
050,01,071,"Alabama","Jackson County",5,42,636,305,331
050,01,071,"Alabama","Jackson County",5,43,673,320,353
050,01,071,"Alabama","Jackson County",5,44,637,312,325
050,01,071,"Alabama","Jackson County",5,45,647,307,340
050,01,071,"Alabama","Jackson County",5,46,693,355,338
050,01,071,"Alabama","Jackson County",5,47,648,315,333
050,01,071,"Alabama","Jackson County",5,48,685,344,341
050,01,071,"Alabama","Jackson County",5,49,688,361,327
050,01,071,"Alabama","Jackson County",5,50,726,375,351
050,01,071,"Alabama","Jackson County",5,51,749,388,361
050,01,071,"Alabama","Jackson County",5,52,774,398,376
050,01,071,"Alabama","Jackson County",5,53,743,391,352
050,01,071,"Alabama","Jackson County",5,54,724,369,355
050,01,071,"Alabama","Jackson County",5,55,691,359,332
050,01,071,"Alabama","Jackson County",5,56,702,363,339
050,01,071,"Alabama","Jackson County",5,57,685,338,347
050,01,071,"Alabama","Jackson County",5,58,728,345,383
050,01,071,"Alabama","Jackson County",5,59,753,381,372
050,01,071,"Alabama","Jackson County",5,60,758,380,378
050,01,071,"Alabama","Jackson County",5,61,782,390,392
050,01,071,"Alabama","Jackson County",5,62,759,350,409
050,01,071,"Alabama","Jackson County",5,63,785,388,397
050,01,071,"Alabama","Jackson County",5,64,752,372,380
050,01,071,"Alabama","Jackson County",5,65,774,373,401
050,01,071,"Alabama","Jackson County",5,66,804,386,418
050,01,071,"Alabama","Jackson County",5,67,762,371,391
050,01,071,"Alabama","Jackson County",5,68,726,358,368
050,01,071,"Alabama","Jackson County",5,69,706,346,360
050,01,071,"Alabama","Jackson County",5,70,664,327,337
050,01,071,"Alabama","Jackson County",5,71,618,288,330
050,01,071,"Alabama","Jackson County",5,72,569,267,302
050,01,071,"Alabama","Jackson County",5,73,531,247,284
050,01,071,"Alabama","Jackson County",5,74,533,248,285
050,01,071,"Alabama","Jackson County",5,75,551,248,303
050,01,071,"Alabama","Jackson County",5,76,594,264,330
050,01,071,"Alabama","Jackson County",5,77,388,174,214
050,01,071,"Alabama","Jackson County",5,78,401,173,228
050,01,071,"Alabama","Jackson County",5,79,371,152,219
050,01,071,"Alabama","Jackson County",5,80,392,158,234
050,01,071,"Alabama","Jackson County",5,81,296,135,161
050,01,071,"Alabama","Jackson County",5,82,238,103,135
050,01,071,"Alabama","Jackson County",5,83,216,94,122
050,01,071,"Alabama","Jackson County",5,84,196,80,116
050,01,071,"Alabama","Jackson County",5,85,1053,371,682
050,01,073,"Alabama","Jefferson County",1,0,8486,4328,4158
050,01,073,"Alabama","Jefferson County",1,1,8507,4359,4148
050,01,073,"Alabama","Jefferson County",1,2,8690,4460,4230
050,01,073,"Alabama","Jefferson County",1,3,8649,4400,4249
050,01,073,"Alabama","Jefferson County",1,4,8735,4445,4290
050,01,073,"Alabama","Jefferson County",1,5,8787,4420,4367
050,01,073,"Alabama","Jefferson County",1,6,8439,4272,4167
050,01,073,"Alabama","Jefferson County",1,7,8642,4361,4281
050,01,073,"Alabama","Jefferson County",1,8,8727,4510,4217
050,01,073,"Alabama","Jefferson County",1,9,8545,4444,4101
050,01,073,"Alabama","Jefferson County",1,10,8833,4523,4310
050,01,073,"Alabama","Jefferson County",1,11,9104,4683,4421
050,01,073,"Alabama","Jefferson County",1,12,9290,4689,4601
050,01,073,"Alabama","Jefferson County",1,13,9138,4623,4515
050,01,073,"Alabama","Jefferson County",1,14,8723,4392,4331
050,01,073,"Alabama","Jefferson County",1,15,8622,4364,4258
050,01,073,"Alabama","Jefferson County",1,16,8581,4360,4221
050,01,073,"Alabama","Jefferson County",1,17,8331,4217,4114
050,01,073,"Alabama","Jefferson County",1,18,8200,4056,4144
050,01,073,"Alabama","Jefferson County",1,19,8585,4229,4356
050,01,073,"Alabama","Jefferson County",1,20,8465,4075,4390
050,01,073,"Alabama","Jefferson County",1,21,8246,3962,4284
050,01,073,"Alabama","Jefferson County",1,22,8038,3947,4091
050,01,073,"Alabama","Jefferson County",1,23,8210,4001,4209
050,01,073,"Alabama","Jefferson County",1,24,8716,4162,4554
050,01,073,"Alabama","Jefferson County",1,25,9124,4338,4786
050,01,073,"Alabama","Jefferson County",1,26,9570,4606,4964
050,01,073,"Alabama","Jefferson County",1,27,9824,4731,5093
050,01,073,"Alabama","Jefferson County",1,28,10034,4864,5170
050,01,073,"Alabama","Jefferson County",1,29,10198,4907,5291
050,01,073,"Alabama","Jefferson County",1,30,10181,4861,5320
050,01,073,"Alabama","Jefferson County",1,31,9923,4714,5209
050,01,073,"Alabama","Jefferson County",1,32,9527,4588,4939
050,01,073,"Alabama","Jefferson County",1,33,9402,4496,4906
050,01,073,"Alabama","Jefferson County",1,34,9359,4417,4942
050,01,073,"Alabama","Jefferson County",1,35,8969,4263,4706
050,01,073,"Alabama","Jefferson County",1,36,8879,4174,4705
050,01,073,"Alabama","Jefferson County",1,37,9094,4367,4727
050,01,073,"Alabama","Jefferson County",1,38,8999,4293,4706
050,01,073,"Alabama","Jefferson County",1,39,9027,4321,4706
050,01,073,"Alabama","Jefferson County",1,40,8872,4244,4628
050,01,073,"Alabama","Jefferson County",1,41,8602,4074,4528
050,01,073,"Alabama","Jefferson County",1,42,8583,4048,4535
050,01,073,"Alabama","Jefferson County",1,43,8143,3883,4260
050,01,073,"Alabama","Jefferson County",1,44,7858,3729,4129
050,01,073,"Alabama","Jefferson County",1,45,7781,3751,4030
050,01,073,"Alabama","Jefferson County",1,46,7741,3664,4077
050,01,073,"Alabama","Jefferson County",1,47,7987,3823,4164
050,01,073,"Alabama","Jefferson County",1,48,8357,4093,4264
050,01,073,"Alabama","Jefferson County",1,49,8799,4249,4550
050,01,073,"Alabama","Jefferson County",1,50,8277,4018,4259
050,01,073,"Alabama","Jefferson County",1,51,8012,3880,4132
050,01,073,"Alabama","Jefferson County",1,52,7749,3709,4040
050,01,073,"Alabama","Jefferson County",1,53,7632,3630,4002
050,01,073,"Alabama","Jefferson County",1,54,7911,3759,4152
050,01,073,"Alabama","Jefferson County",1,55,8382,3972,4410
050,01,073,"Alabama","Jefferson County",1,56,8559,4051,4508
050,01,073,"Alabama","Jefferson County",1,57,8649,4121,4528
050,01,073,"Alabama","Jefferson County",1,58,8736,4128,4608
050,01,073,"Alabama","Jefferson County",1,59,8798,4096,4702
050,01,073,"Alabama","Jefferson County",1,60,8927,4154,4773
050,01,073,"Alabama","Jefferson County",1,61,8773,4027,4746
050,01,073,"Alabama","Jefferson County",1,62,8776,3983,4793
050,01,073,"Alabama","Jefferson County",1,63,8552,3930,4622
050,01,073,"Alabama","Jefferson County",1,64,8298,3780,4518
050,01,073,"Alabama","Jefferson County",1,65,8137,3746,4391
050,01,073,"Alabama","Jefferson County",1,66,7847,3604,4243
050,01,073,"Alabama","Jefferson County",1,67,7595,3442,4153
050,01,073,"Alabama","Jefferson County",1,68,7285,3364,3921
050,01,073,"Alabama","Jefferson County",1,69,6745,2991,3754
050,01,073,"Alabama","Jefferson County",1,70,6535,2883,3652
050,01,073,"Alabama","Jefferson County",1,71,6292,2816,3476
050,01,073,"Alabama","Jefferson County",1,72,6017,2656,3361
050,01,073,"Alabama","Jefferson County",1,73,5764,2596,3168
050,01,073,"Alabama","Jefferson County",1,74,4025,1781,2244
050,01,073,"Alabama","Jefferson County",1,75,3913,1728,2185
050,01,073,"Alabama","Jefferson County",1,76,3888,1642,2246
050,01,073,"Alabama","Jefferson County",1,77,3827,1583,2244
050,01,073,"Alabama","Jefferson County",1,78,3338,1357,1981
050,01,073,"Alabama","Jefferson County",1,79,2941,1201,1740
050,01,073,"Alabama","Jefferson County",1,80,2702,1091,1611
050,01,073,"Alabama","Jefferson County",1,81,2551,985,1566
050,01,073,"Alabama","Jefferson County",1,82,2433,946,1487
050,01,073,"Alabama","Jefferson County",1,83,2127,796,1331
050,01,073,"Alabama","Jefferson County",1,84,2016,711,1305
050,01,073,"Alabama","Jefferson County",1,85,12209,3796,8413
050,01,073,"Alabama","Jefferson County",2,0,8266,4237,4029
050,01,073,"Alabama","Jefferson County",2,1,8491,4342,4149
050,01,073,"Alabama","Jefferson County",2,2,8657,4441,4216
050,01,073,"Alabama","Jefferson County",2,3,8614,4399,4215
050,01,073,"Alabama","Jefferson County",2,4,8706,4429,4277
050,01,073,"Alabama","Jefferson County",2,5,8760,4421,4339
050,01,073,"Alabama","Jefferson County",2,6,8515,4302,4213
050,01,073,"Alabama","Jefferson County",2,7,8573,4334,4239
050,01,073,"Alabama","Jefferson County",2,8,8671,4458,4213
050,01,073,"Alabama","Jefferson County",2,9,8560,4442,4118
050,01,073,"Alabama","Jefferson County",2,10,8736,4483,4253
050,01,073,"Alabama","Jefferson County",2,11,8985,4612,4373
050,01,073,"Alabama","Jefferson County",2,12,9278,4700,4578
050,01,073,"Alabama","Jefferson County",2,13,9160,4636,4524
050,01,073,"Alabama","Jefferson County",2,14,8811,4439,4372
050,01,073,"Alabama","Jefferson County",2,15,8638,4369,4269
050,01,073,"Alabama","Jefferson County",2,16,8595,4358,4237
050,01,073,"Alabama","Jefferson County",2,17,8359,4234,4125
050,01,073,"Alabama","Jefferson County",2,18,8342,4094,4248
050,01,073,"Alabama","Jefferson County",2,19,9003,4406,4597
050,01,073,"Alabama","Jefferson County",2,20,8836,4234,4602
050,01,073,"Alabama","Jefferson County",2,21,8499,4059,4440
050,01,073,"Alabama","Jefferson County",2,22,8164,3980,4184
050,01,073,"Alabama","Jefferson County",2,23,8268,4025,4243
050,01,073,"Alabama","Jefferson County",2,24,8607,4120,4487
050,01,073,"Alabama","Jefferson County",2,25,9068,4318,4750
050,01,073,"Alabama","Jefferson County",2,26,9512,4569,4943
050,01,073,"Alabama","Jefferson County",2,27,9741,4694,5047
050,01,073,"Alabama","Jefferson County",2,28,9974,4836,5138
050,01,073,"Alabama","Jefferson County",2,29,10136,4882,5254
050,01,073,"Alabama","Jefferson County",2,30,10202,4877,5325
050,01,073,"Alabama","Jefferson County",2,31,9926,4727,5199
050,01,073,"Alabama","Jefferson County",2,32,9583,4599,4984
050,01,073,"Alabama","Jefferson County",2,33,9396,4498,4898
050,01,073,"Alabama","Jefferson County",2,34,9331,4421,4910
050,01,073,"Alabama","Jefferson County",2,35,9071,4304,4767
050,01,073,"Alabama","Jefferson County",2,36,8812,4150,4662
050,01,073,"Alabama","Jefferson County",2,37,9035,4325,4710
050,01,073,"Alabama","Jefferson County",2,38,9036,4308,4728
050,01,073,"Alabama","Jefferson County",2,39,8947,4272,4675
050,01,073,"Alabama","Jefferson County",2,40,8961,4298,4663
050,01,073,"Alabama","Jefferson County",2,41,8646,4096,4550
050,01,073,"Alabama","Jefferson County",2,42,8509,4010,4499
050,01,073,"Alabama","Jefferson County",2,43,8288,3932,4356
050,01,073,"Alabama","Jefferson County",2,44,7836,3727,4109
050,01,073,"Alabama","Jefferson County",2,45,7821,3759,4062
050,01,073,"Alabama","Jefferson County",2,46,7701,3653,4048
050,01,073,"Alabama","Jefferson County",2,47,7895,3766,4129
050,01,073,"Alabama","Jefferson County",2,48,8267,4022,4245
050,01,073,"Alabama","Jefferson County",2,49,8697,4207,4490
050,01,073,"Alabama","Jefferson County",2,50,8389,4068,4321
050,01,073,"Alabama","Jefferson County",2,51,8014,3876,4138
050,01,073,"Alabama","Jefferson County",2,52,7783,3735,4048
050,01,073,"Alabama","Jefferson County",2,53,7631,3629,4002
050,01,073,"Alabama","Jefferson County",2,54,7804,3706,4098
050,01,073,"Alabama","Jefferson County",2,55,8256,3916,4340
050,01,073,"Alabama","Jefferson County",2,56,8489,4005,4484
050,01,073,"Alabama","Jefferson County",2,57,8592,4088,4504
050,01,073,"Alabama","Jefferson County",2,58,8668,4103,4565
050,01,073,"Alabama","Jefferson County",2,59,8785,4105,4680
050,01,073,"Alabama","Jefferson County",2,60,8847,4112,4735
050,01,073,"Alabama","Jefferson County",2,61,8756,4032,4724
050,01,073,"Alabama","Jefferson County",2,62,8710,3956,4754
050,01,073,"Alabama","Jefferson County",2,63,8605,3943,4662
050,01,073,"Alabama","Jefferson County",2,64,8270,3767,4503
050,01,073,"Alabama","Jefferson County",2,65,8122,3731,4391
050,01,073,"Alabama","Jefferson County",2,66,7887,3616,4271
050,01,073,"Alabama","Jefferson County",2,67,7584,3441,4143
050,01,073,"Alabama","Jefferson County",2,68,7268,3343,3925
050,01,073,"Alabama","Jefferson County",2,69,6901,3087,3814
050,01,073,"Alabama","Jefferson County",2,70,6530,2886,3644
050,01,073,"Alabama","Jefferson County",2,71,6288,2801,3487
050,01,073,"Alabama","Jefferson County",2,72,5975,2639,3336
050,01,073,"Alabama","Jefferson County",2,73,6006,2694,3312
050,01,073,"Alabama","Jefferson County",2,74,4164,1843,2321
050,01,073,"Alabama","Jefferson County",2,75,3919,1723,2196
050,01,073,"Alabama","Jefferson County",2,76,3830,1638,2192
050,01,073,"Alabama","Jefferson County",2,77,3871,1599,2272
050,01,073,"Alabama","Jefferson County",2,78,3352,1364,1988
050,01,073,"Alabama","Jefferson County",2,79,2976,1213,1763
050,01,073,"Alabama","Jefferson County",2,80,2727,1105,1622
050,01,073,"Alabama","Jefferson County",2,81,2530,983,1547
050,01,073,"Alabama","Jefferson County",2,82,2419,930,1489
050,01,073,"Alabama","Jefferson County",2,83,2156,812,1344
050,01,073,"Alabama","Jefferson County",2,84,1997,711,1286
050,01,073,"Alabama","Jefferson County",2,85,12131,3785,8346
050,01,073,"Alabama","Jefferson County",3,0,7847,3979,3868
050,01,073,"Alabama","Jefferson County",3,1,8143,4161,3982
050,01,073,"Alabama","Jefferson County",3,2,8313,4266,4047
050,01,073,"Alabama","Jefferson County",3,3,8493,4347,4146
050,01,073,"Alabama","Jefferson County",3,4,8517,4387,4130
050,01,073,"Alabama","Jefferson County",3,5,8583,4361,4222
050,01,073,"Alabama","Jefferson County",3,6,8686,4387,4299
050,01,073,"Alabama","Jefferson County",3,7,8436,4280,4156
050,01,073,"Alabama","Jefferson County",3,8,8468,4278,4190
050,01,073,"Alabama","Jefferson County",3,9,8591,4411,4180
050,01,073,"Alabama","Jefferson County",3,10,8469,4393,4076
050,01,073,"Alabama","Jefferson County",3,11,8651,4441,4210
050,01,073,"Alabama","Jefferson County",3,12,8930,4582,4348
050,01,073,"Alabama","Jefferson County",3,13,9218,4662,4556
050,01,073,"Alabama","Jefferson County",3,14,9069,4606,4463
050,01,073,"Alabama","Jefferson County",3,15,8734,4375,4359
050,01,073,"Alabama","Jefferson County",3,16,8559,4303,4256
050,01,073,"Alabama","Jefferson County",3,17,8464,4288,4176
050,01,073,"Alabama","Jefferson County",3,18,8547,4177,4370
050,01,073,"Alabama","Jefferson County",3,19,9262,4522,4740
050,01,073,"Alabama","Jefferson County",3,20,9022,4323,4699
050,01,073,"Alabama","Jefferson County",3,21,8867,4186,4681
050,01,073,"Alabama","Jefferson County",3,22,8357,4016,4341
050,01,073,"Alabama","Jefferson County",3,23,8537,4106,4431
050,01,073,"Alabama","Jefferson County",3,24,8539,4072,4467
050,01,073,"Alabama","Jefferson County",3,25,8733,4185,4548
050,01,073,"Alabama","Jefferson County",3,26,9147,4369,4778
050,01,073,"Alabama","Jefferson County",3,27,9459,4557,4902
050,01,073,"Alabama","Jefferson County",3,28,9613,4648,4965
050,01,073,"Alabama","Jefferson County",3,29,9814,4776,5038
050,01,073,"Alabama","Jefferson County",3,30,10004,4806,5198
050,01,073,"Alabama","Jefferson County",3,31,10034,4799,5235
050,01,073,"Alabama","Jefferson County",3,32,9720,4632,5088
050,01,073,"Alabama","Jefferson County",3,33,9414,4513,4901
050,01,073,"Alabama","Jefferson County",3,34,9241,4439,4802
050,01,073,"Alabama","Jefferson County",3,35,9149,4318,4831
050,01,073,"Alabama","Jefferson County",3,36,8889,4216,4673
050,01,073,"Alabama","Jefferson County",3,37,8730,4155,4575
050,01,073,"Alabama","Jefferson County",3,38,8887,4259,4628
050,01,073,"Alabama","Jefferson County",3,39,8874,4199,4675
050,01,073,"Alabama","Jefferson County",3,40,8833,4183,4650
050,01,073,"Alabama","Jefferson County",3,41,8797,4212,4585
050,01,073,"Alabama","Jefferson County",3,42,8476,4001,4475
050,01,073,"Alabama","Jefferson County",3,43,8325,3932,4393
050,01,073,"Alabama","Jefferson County",3,44,8181,3884,4297
050,01,073,"Alabama","Jefferson County",3,45,7671,3639,4032
050,01,073,"Alabama","Jefferson County",3,46,7654,3652,4002
050,01,073,"Alabama","Jefferson County",3,47,7634,3610,4024
050,01,073,"Alabama","Jefferson County",3,48,7863,3758,4105
050,01,073,"Alabama","Jefferson County",3,49,8208,3984,4224
050,01,073,"Alabama","Jefferson County",3,50,8538,4166,4372
050,01,073,"Alabama","Jefferson County",3,51,8273,4025,4248
050,01,073,"Alabama","Jefferson County",3,52,7869,3814,4055
050,01,073,"Alabama","Jefferson County",3,53,7631,3646,3985
050,01,073,"Alabama","Jefferson County",3,54,7530,3583,3947
050,01,073,"Alabama","Jefferson County",3,55,7618,3624,3994
050,01,073,"Alabama","Jefferson County",3,56,8100,3795,4305
050,01,073,"Alabama","Jefferson County",3,57,8299,3932,4367
050,01,073,"Alabama","Jefferson County",3,58,8416,3993,4423
050,01,073,"Alabama","Jefferson County",3,59,8485,3993,4492
050,01,073,"Alabama","Jefferson County",3,60,8537,3960,4577
050,01,073,"Alabama","Jefferson County",3,61,8614,4010,4604
050,01,073,"Alabama","Jefferson County",3,62,8532,3914,4618
050,01,073,"Alabama","Jefferson County",3,63,8499,3859,4640
050,01,073,"Alabama","Jefferson County",3,64,8345,3790,4555
050,01,073,"Alabama","Jefferson County",3,65,7974,3619,4355
050,01,073,"Alabama","Jefferson County",3,66,7824,3562,4262
050,01,073,"Alabama","Jefferson County",3,67,7658,3494,4164
050,01,073,"Alabama","Jefferson County",3,68,7339,3278,4061
050,01,073,"Alabama","Jefferson County",3,69,7049,3204,3845
050,01,073,"Alabama","Jefferson County",3,70,6681,2982,3699
050,01,073,"Alabama","Jefferson County",3,71,6265,2741,3524
050,01,073,"Alabama","Jefferson County",3,72,6079,2683,3396
050,01,073,"Alabama","Jefferson County",3,73,5746,2529,3217
050,01,073,"Alabama","Jefferson County",3,74,5763,2570,3193
050,01,073,"Alabama","Jefferson County",3,75,3957,1727,2230
050,01,073,"Alabama","Jefferson County",3,76,3687,1601,2086
050,01,073,"Alabama","Jefferson County",3,77,3666,1543,2123
050,01,073,"Alabama","Jefferson County",3,78,3694,1503,2191
050,01,073,"Alabama","Jefferson County",3,79,3101,1254,1847
050,01,073,"Alabama","Jefferson County",3,80,2778,1117,1661
050,01,073,"Alabama","Jefferson County",3,81,2526,991,1535
050,01,073,"Alabama","Jefferson County",3,82,2345,910,1435
050,01,073,"Alabama","Jefferson County",3,83,2207,851,1356
050,01,073,"Alabama","Jefferson County",3,84,1952,701,1251
050,01,073,"Alabama","Jefferson County",3,85,11761,3649,8112
050,01,073,"Alabama","Jefferson County",4,0,7834,3960,3874
050,01,073,"Alabama","Jefferson County",4,1,7764,3941,3823
050,01,073,"Alabama","Jefferson County",4,2,8075,4133,3942
050,01,073,"Alabama","Jefferson County",4,3,8189,4208,3981
050,01,073,"Alabama","Jefferson County",4,4,8394,4285,4109
050,01,073,"Alabama","Jefferson County",4,5,8453,4329,4124
050,01,073,"Alabama","Jefferson County",4,6,8499,4304,4195
050,01,073,"Alabama","Jefferson County",4,7,8642,4355,4287
050,01,073,"Alabama","Jefferson County",4,8,8337,4224,4113
050,01,073,"Alabama","Jefferson County",4,9,8477,4295,4182
050,01,073,"Alabama","Jefferson County",4,10,8499,4362,4137
050,01,073,"Alabama","Jefferson County",4,11,8365,4334,4031
050,01,073,"Alabama","Jefferson County",4,12,8629,4407,4222
050,01,073,"Alabama","Jefferson County",4,13,8891,4582,4309
050,01,073,"Alabama","Jefferson County",4,14,9141,4645,4496
050,01,073,"Alabama","Jefferson County",4,15,9008,4550,4458
050,01,073,"Alabama","Jefferson County",4,16,8682,4326,4356
050,01,073,"Alabama","Jefferson County",4,17,8451,4233,4218
050,01,073,"Alabama","Jefferson County",4,18,8674,4206,4468
050,01,073,"Alabama","Jefferson County",4,19,9479,4635,4844
050,01,073,"Alabama","Jefferson County",4,20,8993,4325,4668
050,01,073,"Alabama","Jefferson County",4,21,8902,4207,4695
050,01,073,"Alabama","Jefferson County",4,22,8440,4031,4409
050,01,073,"Alabama","Jefferson County",4,23,8661,4121,4540
050,01,073,"Alabama","Jefferson County",4,24,8722,4129,4593
050,01,073,"Alabama","Jefferson County",4,25,8645,4127,4518
050,01,073,"Alabama","Jefferson County",4,26,8765,4210,4555
050,01,073,"Alabama","Jefferson County",4,27,9015,4311,4704
050,01,073,"Alabama","Jefferson County",4,28,9355,4525,4830
050,01,073,"Alabama","Jefferson County",4,29,9488,4592,4896
050,01,073,"Alabama","Jefferson County",4,30,9580,4591,4989
050,01,073,"Alabama","Jefferson County",4,31,9863,4743,5120
050,01,073,"Alabama","Jefferson County",4,32,9976,4782,5194
050,01,073,"Alabama","Jefferson County",4,33,9506,4469,5037
050,01,073,"Alabama","Jefferson County",4,34,9209,4413,4796
050,01,073,"Alabama","Jefferson County",4,35,9079,4349,4730
050,01,073,"Alabama","Jefferson County",4,36,9007,4251,4756
050,01,073,"Alabama","Jefferson County",4,37,8738,4143,4595
050,01,073,"Alabama","Jefferson County",4,38,8549,4029,4520
050,01,073,"Alabama","Jefferson County",4,39,8719,4145,4574
050,01,073,"Alabama","Jefferson County",4,40,8739,4154,4585
050,01,073,"Alabama","Jefferson County",4,41,8689,4100,4589
050,01,073,"Alabama","Jefferson County",4,42,8677,4143,4534
050,01,073,"Alabama","Jefferson County",4,43,8347,3922,4425
050,01,073,"Alabama","Jefferson County",4,44,8171,3848,4323
050,01,073,"Alabama","Jefferson County",4,45,8042,3809,4233
050,01,073,"Alabama","Jefferson County",4,46,7541,3561,3980
050,01,073,"Alabama","Jefferson County",4,47,7539,3595,3944
050,01,073,"Alabama","Jefferson County",4,48,7541,3551,3990
050,01,073,"Alabama","Jefferson County",4,49,7714,3694,4020
050,01,073,"Alabama","Jefferson County",4,50,8029,3924,4105
050,01,073,"Alabama","Jefferson County",4,51,8365,4067,4298
050,01,073,"Alabama","Jefferson County",4,52,8197,3953,4244
050,01,073,"Alabama","Jefferson County",4,53,7734,3721,4013
050,01,073,"Alabama","Jefferson County",4,54,7538,3603,3935
050,01,073,"Alabama","Jefferson County",4,55,7435,3555,3880
050,01,073,"Alabama","Jefferson County",4,56,7487,3496,3991
050,01,073,"Alabama","Jefferson County",4,57,7932,3767,4165
050,01,073,"Alabama","Jefferson County",4,58,8162,3842,4320
050,01,073,"Alabama","Jefferson County",4,59,8224,3880,4344
050,01,073,"Alabama","Jefferson County",4,60,8301,3897,4404
050,01,073,"Alabama","Jefferson County",4,61,8285,3836,4449
050,01,073,"Alabama","Jefferson County",4,62,8395,3913,4482
050,01,073,"Alabama","Jefferson County",4,63,8278,3789,4489
050,01,073,"Alabama","Jefferson County",4,64,8217,3718,4499
050,01,073,"Alabama","Jefferson County",4,65,8052,3626,4426
050,01,073,"Alabama","Jefferson County",4,66,7707,3476,4231
050,01,073,"Alabama","Jefferson County",4,67,7599,3428,4171
050,01,073,"Alabama","Jefferson County",4,68,7410,3339,4071
050,01,073,"Alabama","Jefferson County",4,69,7111,3155,3956
050,01,073,"Alabama","Jefferson County",4,70,6829,3082,3747
050,01,073,"Alabama","Jefferson County",4,71,6457,2861,3596
050,01,073,"Alabama","Jefferson County",4,72,6073,2652,3421
050,01,073,"Alabama","Jefferson County",4,73,5848,2585,3263
050,01,073,"Alabama","Jefferson County",4,74,5502,2415,3087
050,01,073,"Alabama","Jefferson County",4,75,5489,2413,3076
050,01,073,"Alabama","Jefferson County",4,76,3765,1641,2124
050,01,073,"Alabama","Jefferson County",4,77,3508,1481,2027
050,01,073,"Alabama","Jefferson County",4,78,3522,1449,2073
050,01,073,"Alabama","Jefferson County",4,79,3445,1384,2061
050,01,073,"Alabama","Jefferson County",4,80,2918,1185,1733
050,01,073,"Alabama","Jefferson County",4,81,2601,1017,1584
050,01,073,"Alabama","Jefferson County",4,82,2380,939,1441
050,01,073,"Alabama","Jefferson County",4,83,2143,824,1319
050,01,073,"Alabama","Jefferson County",4,84,2018,752,1266
050,01,073,"Alabama","Jefferson County",4,85,11433,3586,7847
050,01,073,"Alabama","Jefferson County",5,0,7909,3994,3915
050,01,073,"Alabama","Jefferson County",5,1,7765,3877,3888
050,01,073,"Alabama","Jefferson County",5,2,7701,3875,3826
050,01,073,"Alabama","Jefferson County",5,3,8021,4113,3908
050,01,073,"Alabama","Jefferson County",5,4,8175,4189,3986
050,01,073,"Alabama","Jefferson County",5,5,8356,4251,4105
050,01,073,"Alabama","Jefferson County",5,6,8412,4302,4110
050,01,073,"Alabama","Jefferson County",5,7,8437,4284,4153
050,01,073,"Alabama","Jefferson County",5,8,8643,4368,4275
050,01,073,"Alabama","Jefferson County",5,9,8290,4180,4110
050,01,073,"Alabama","Jefferson County",5,10,8419,4275,4144
050,01,073,"Alabama","Jefferson County",5,11,8463,4333,4130
050,01,073,"Alabama","Jefferson County",5,12,8349,4305,4044
050,01,073,"Alabama","Jefferson County",5,13,8629,4391,4238
050,01,073,"Alabama","Jefferson County",5,14,8810,4575,4235
050,01,073,"Alabama","Jefferson County",5,15,9178,4671,4507
050,01,073,"Alabama","Jefferson County",5,16,8999,4519,4480
050,01,073,"Alabama","Jefferson County",5,17,8624,4267,4357
050,01,073,"Alabama","Jefferson County",5,18,8630,4144,4486
050,01,073,"Alabama","Jefferson County",5,19,9586,4693,4893
050,01,073,"Alabama","Jefferson County",5,20,9008,4368,4640
050,01,073,"Alabama","Jefferson County",5,21,8741,4208,4533
050,01,073,"Alabama","Jefferson County",5,22,8398,4048,4350
050,01,073,"Alabama","Jefferson County",5,23,8650,4099,4551
050,01,073,"Alabama","Jefferson County",5,24,8915,4208,4707
050,01,073,"Alabama","Jefferson County",5,25,8867,4219,4648
050,01,073,"Alabama","Jefferson County",5,26,8714,4141,4573
050,01,073,"Alabama","Jefferson County",5,27,8695,4199,4496
050,01,073,"Alabama","Jefferson County",5,28,9048,4324,4724
050,01,073,"Alabama","Jefferson County",5,29,9291,4499,4792
050,01,073,"Alabama","Jefferson County",5,30,9352,4512,4840
050,01,073,"Alabama","Jefferson County",5,31,9473,4565,4908
050,01,073,"Alabama","Jefferson County",5,32,9828,4740,5088
050,01,073,"Alabama","Jefferson County",5,33,9823,4672,5151
050,01,073,"Alabama","Jefferson County",5,34,9411,4406,5005
050,01,073,"Alabama","Jefferson County",5,35,8983,4231,4752
050,01,073,"Alabama","Jefferson County",5,36,8976,4332,4644
050,01,073,"Alabama","Jefferson County",5,37,8926,4210,4716
050,01,073,"Alabama","Jefferson County",5,38,8650,4096,4554
050,01,073,"Alabama","Jefferson County",5,39,8425,3951,4474
050,01,073,"Alabama","Jefferson County",5,40,8621,4098,4523
050,01,073,"Alabama","Jefferson County",5,41,8543,4039,4504
050,01,073,"Alabama","Jefferson County",5,42,8523,4008,4515
050,01,073,"Alabama","Jefferson County",5,43,8611,4099,4512
050,01,073,"Alabama","Jefferson County",5,44,8272,3889,4383
050,01,073,"Alabama","Jefferson County",5,45,7997,3759,4238
050,01,073,"Alabama","Jefferson County",5,46,7970,3754,4216
050,01,073,"Alabama","Jefferson County",5,47,7475,3509,3966
050,01,073,"Alabama","Jefferson County",5,48,7474,3547,3927
050,01,073,"Alabama","Jefferson County",5,49,7480,3526,3954
050,01,073,"Alabama","Jefferson County",5,50,7620,3657,3963
050,01,073,"Alabama","Jefferson County",5,51,7913,3862,4051
050,01,073,"Alabama","Jefferson County",5,52,8235,3982,4253
050,01,073,"Alabama","Jefferson County",5,53,8082,3888,4194
050,01,073,"Alabama","Jefferson County",5,54,7658,3680,3978
050,01,073,"Alabama","Jefferson County",5,55,7460,3561,3899
050,01,073,"Alabama","Jefferson County",5,56,7278,3447,3831
050,01,073,"Alabama","Jefferson County",5,57,7357,3467,3890
050,01,073,"Alabama","Jefferson County",5,58,7857,3713,4144
050,01,073,"Alabama","Jefferson County",5,59,8036,3779,4257
050,01,073,"Alabama","Jefferson County",5,60,8105,3795,4310
050,01,073,"Alabama","Jefferson County",5,61,8103,3798,4305
050,01,073,"Alabama","Jefferson County",5,62,8187,3782,4405
050,01,073,"Alabama","Jefferson County",5,63,8178,3829,4349
050,01,073,"Alabama","Jefferson County",5,64,8096,3675,4421
050,01,073,"Alabama","Jefferson County",5,65,8000,3590,4410
050,01,073,"Alabama","Jefferson County",5,66,7837,3502,4335
050,01,073,"Alabama","Jefferson County",5,67,7520,3350,4170
050,01,073,"Alabama","Jefferson County",5,68,7418,3326,4092
050,01,073,"Alabama","Jefferson County",5,69,7218,3218,4000
050,01,073,"Alabama","Jefferson County",5,70,6963,3075,3888
050,01,073,"Alabama","Jefferson County",5,71,6608,2962,3646
050,01,073,"Alabama","Jefferson County",5,72,6290,2779,3511
050,01,073,"Alabama","Jefferson County",5,73,5835,2548,3287
050,01,073,"Alabama","Jefferson County",5,74,5643,2496,3147
050,01,073,"Alabama","Jefferson County",5,75,5284,2300,2984
050,01,073,"Alabama","Jefferson County",5,76,5234,2297,2937
050,01,073,"Alabama","Jefferson County",5,77,3619,1545,2074
050,01,073,"Alabama","Jefferson County",5,78,3386,1398,1988
050,01,073,"Alabama","Jefferson County",5,79,3302,1346,1956
050,01,073,"Alabama","Jefferson County",5,80,3258,1299,1959
050,01,073,"Alabama","Jefferson County",5,81,2742,1093,1649
050,01,073,"Alabama","Jefferson County",5,82,2458,967,1491
050,01,073,"Alabama","Jefferson County",5,83,2192,853,1339
050,01,073,"Alabama","Jefferson County",5,84,1987,737,1250
050,01,073,"Alabama","Jefferson County",5,85,11400,3678,7722
050,01,075,"Alabama","Lamar County",1,0,177,90,87
050,01,075,"Alabama","Lamar County",1,1,170,91,79
050,01,075,"Alabama","Lamar County",1,2,148,81,67
050,01,075,"Alabama","Lamar County",1,3,145,78,67
050,01,075,"Alabama","Lamar County",1,4,173,98,75
050,01,075,"Alabama","Lamar County",1,5,162,79,83
050,01,075,"Alabama","Lamar County",1,6,147,75,72
050,01,075,"Alabama","Lamar County",1,7,146,72,74
050,01,075,"Alabama","Lamar County",1,8,162,80,82
050,01,075,"Alabama","Lamar County",1,9,162,71,91
050,01,075,"Alabama","Lamar County",1,10,151,82,69
050,01,075,"Alabama","Lamar County",1,11,173,98,75
050,01,075,"Alabama","Lamar County",1,12,207,112,95
050,01,075,"Alabama","Lamar County",1,13,199,103,96
050,01,075,"Alabama","Lamar County",1,14,186,98,88
050,01,075,"Alabama","Lamar County",1,15,175,83,92
050,01,075,"Alabama","Lamar County",1,16,183,92,91
050,01,075,"Alabama","Lamar County",1,17,187,100,87
050,01,075,"Alabama","Lamar County",1,18,158,88,70
050,01,075,"Alabama","Lamar County",1,19,125,74,51
050,01,075,"Alabama","Lamar County",1,20,128,73,55
050,01,075,"Alabama","Lamar County",1,21,145,74,71
050,01,075,"Alabama","Lamar County",1,22,147,67,80
050,01,075,"Alabama","Lamar County",1,23,155,80,75
050,01,075,"Alabama","Lamar County",1,24,141,77,64
050,01,075,"Alabama","Lamar County",1,25,135,67,68
050,01,075,"Alabama","Lamar County",1,26,141,75,66
050,01,075,"Alabama","Lamar County",1,27,137,57,80
050,01,075,"Alabama","Lamar County",1,28,149,65,84
050,01,075,"Alabama","Lamar County",1,29,165,82,83
050,01,075,"Alabama","Lamar County",1,30,166,79,87
050,01,075,"Alabama","Lamar County",1,31,155,78,77
050,01,075,"Alabama","Lamar County",1,32,166,74,92
050,01,075,"Alabama","Lamar County",1,33,142,70,72
050,01,075,"Alabama","Lamar County",1,34,131,66,65
050,01,075,"Alabama","Lamar County",1,35,148,67,81
050,01,075,"Alabama","Lamar County",1,36,157,76,81
050,01,075,"Alabama","Lamar County",1,37,142,69,73
050,01,075,"Alabama","Lamar County",1,38,152,76,76
050,01,075,"Alabama","Lamar County",1,39,148,74,74
050,01,075,"Alabama","Lamar County",1,40,148,73,75
050,01,075,"Alabama","Lamar County",1,41,157,85,72
050,01,075,"Alabama","Lamar County",1,42,160,73,87
050,01,075,"Alabama","Lamar County",1,43,175,72,103
050,01,075,"Alabama","Lamar County",1,44,165,75,90
050,01,075,"Alabama","Lamar County",1,45,184,95,89
050,01,075,"Alabama","Lamar County",1,46,179,94,85
050,01,075,"Alabama","Lamar County",1,47,181,95,86
050,01,075,"Alabama","Lamar County",1,48,196,101,95
050,01,075,"Alabama","Lamar County",1,49,189,99,90
050,01,075,"Alabama","Lamar County",1,50,188,95,93
050,01,075,"Alabama","Lamar County",1,51,195,110,85
050,01,075,"Alabama","Lamar County",1,52,172,91,81
050,01,075,"Alabama","Lamar County",1,53,175,79,96
050,01,075,"Alabama","Lamar County",1,54,168,80,88
050,01,075,"Alabama","Lamar County",1,55,192,106,86
050,01,075,"Alabama","Lamar County",1,56,194,102,92
050,01,075,"Alabama","Lamar County",1,57,202,103,99
050,01,075,"Alabama","Lamar County",1,58,205,105,100
050,01,075,"Alabama","Lamar County",1,59,196,96,100
050,01,075,"Alabama","Lamar County",1,60,208,107,101
050,01,075,"Alabama","Lamar County",1,61,218,105,113
050,01,075,"Alabama","Lamar County",1,62,200,98,102
050,01,075,"Alabama","Lamar County",1,63,195,100,95
050,01,075,"Alabama","Lamar County",1,64,206,96,110
050,01,075,"Alabama","Lamar County",1,65,200,99,101
050,01,075,"Alabama","Lamar County",1,66,187,91,96
050,01,075,"Alabama","Lamar County",1,67,170,96,74
050,01,075,"Alabama","Lamar County",1,68,186,90,96
050,01,075,"Alabama","Lamar County",1,69,164,77,87
050,01,075,"Alabama","Lamar County",1,70,168,79,89
050,01,075,"Alabama","Lamar County",1,71,165,79,86
050,01,075,"Alabama","Lamar County",1,72,169,73,96
050,01,075,"Alabama","Lamar County",1,73,180,91,89
050,01,075,"Alabama","Lamar County",1,74,138,67,71
050,01,075,"Alabama","Lamar County",1,75,115,56,59
050,01,075,"Alabama","Lamar County",1,76,133,65,68
050,01,075,"Alabama","Lamar County",1,77,128,62,66
050,01,075,"Alabama","Lamar County",1,78,104,50,54
050,01,075,"Alabama","Lamar County",1,79,97,38,59
050,01,075,"Alabama","Lamar County",1,80,95,42,53
050,01,075,"Alabama","Lamar County",1,81,94,36,58
050,01,075,"Alabama","Lamar County",1,82,83,33,50
050,01,075,"Alabama","Lamar County",1,83,75,32,43
050,01,075,"Alabama","Lamar County",1,84,67,25,42
050,01,075,"Alabama","Lamar County",1,85,320,105,215
050,01,075,"Alabama","Lamar County",2,0,163,83,80
050,01,075,"Alabama","Lamar County",2,1,168,89,79
050,01,075,"Alabama","Lamar County",2,2,153,84,69
050,01,075,"Alabama","Lamar County",2,3,145,79,66
050,01,075,"Alabama","Lamar County",2,4,170,95,75
050,01,075,"Alabama","Lamar County",2,5,164,83,81
050,01,075,"Alabama","Lamar County",2,6,150,75,75
050,01,075,"Alabama","Lamar County",2,7,147,73,74
050,01,075,"Alabama","Lamar County",2,8,159,78,81
050,01,075,"Alabama","Lamar County",2,9,160,71,89
050,01,075,"Alabama","Lamar County",2,10,155,80,75
050,01,075,"Alabama","Lamar County",2,11,169,95,74
050,01,075,"Alabama","Lamar County",2,12,200,109,91
050,01,075,"Alabama","Lamar County",2,13,200,105,95
050,01,075,"Alabama","Lamar County",2,14,187,98,89
050,01,075,"Alabama","Lamar County",2,15,176,86,90
050,01,075,"Alabama","Lamar County",2,16,182,91,91
050,01,075,"Alabama","Lamar County",2,17,185,98,87
050,01,075,"Alabama","Lamar County",2,18,158,88,70
050,01,075,"Alabama","Lamar County",2,19,124,73,51
050,01,075,"Alabama","Lamar County",2,20,134,78,56
050,01,075,"Alabama","Lamar County",2,21,144,75,69
050,01,075,"Alabama","Lamar County",2,22,149,70,79
050,01,075,"Alabama","Lamar County",2,23,155,78,77
050,01,075,"Alabama","Lamar County",2,24,144,78,66
050,01,075,"Alabama","Lamar County",2,25,137,70,67
050,01,075,"Alabama","Lamar County",2,26,140,73,67
050,01,075,"Alabama","Lamar County",2,27,139,61,78
050,01,075,"Alabama","Lamar County",2,28,146,64,82
050,01,075,"Alabama","Lamar County",2,29,161,77,84
050,01,075,"Alabama","Lamar County",2,30,167,81,86
050,01,075,"Alabama","Lamar County",2,31,158,78,80
050,01,075,"Alabama","Lamar County",2,32,167,76,91
050,01,075,"Alabama","Lamar County",2,33,146,71,75
050,01,075,"Alabama","Lamar County",2,34,132,66,66
050,01,075,"Alabama","Lamar County",2,35,146,68,78
050,01,075,"Alabama","Lamar County",2,36,153,73,80
050,01,075,"Alabama","Lamar County",2,37,147,72,75
050,01,075,"Alabama","Lamar County",2,38,151,74,77
050,01,075,"Alabama","Lamar County",2,39,150,75,75
050,01,075,"Alabama","Lamar County",2,40,148,74,74
050,01,075,"Alabama","Lamar County",2,41,154,81,73
050,01,075,"Alabama","Lamar County",2,42,159,75,84
050,01,075,"Alabama","Lamar County",2,43,172,73,99
050,01,075,"Alabama","Lamar County",2,44,165,72,93
050,01,075,"Alabama","Lamar County",2,45,179,89,90
050,01,075,"Alabama","Lamar County",2,46,178,93,85
050,01,075,"Alabama","Lamar County",2,47,177,93,84
050,01,075,"Alabama","Lamar County",2,48,191,100,91
050,01,075,"Alabama","Lamar County",2,49,192,101,91
050,01,075,"Alabama","Lamar County",2,50,187,96,91
050,01,075,"Alabama","Lamar County",2,51,192,106,86
050,01,075,"Alabama","Lamar County",2,52,176,94,82
050,01,075,"Alabama","Lamar County",2,53,174,81,93
050,01,075,"Alabama","Lamar County",2,54,168,79,89
050,01,075,"Alabama","Lamar County",2,55,187,100,87
050,01,075,"Alabama","Lamar County",2,56,194,102,92
050,01,075,"Alabama","Lamar County",2,57,200,103,97
050,01,075,"Alabama","Lamar County",2,58,205,105,100
050,01,075,"Alabama","Lamar County",2,59,198,98,100
050,01,075,"Alabama","Lamar County",2,60,205,105,100
050,01,075,"Alabama","Lamar County",2,61,213,105,108
050,01,075,"Alabama","Lamar County",2,62,205,100,105
050,01,075,"Alabama","Lamar County",2,63,198,100,98
050,01,075,"Alabama","Lamar County",2,64,202,96,106
050,01,075,"Alabama","Lamar County",2,65,203,99,104
050,01,075,"Alabama","Lamar County",2,66,190,93,97
050,01,075,"Alabama","Lamar County",2,67,170,92,78
050,01,075,"Alabama","Lamar County",2,68,182,92,90
050,01,075,"Alabama","Lamar County",2,69,171,82,89
050,01,075,"Alabama","Lamar County",2,70,165,76,89
050,01,075,"Alabama","Lamar County",2,71,166,79,87
050,01,075,"Alabama","Lamar County",2,72,165,73,92
050,01,075,"Alabama","Lamar County",2,73,187,92,95
050,01,075,"Alabama","Lamar County",2,74,140,69,71
050,01,075,"Alabama","Lamar County",2,75,119,58,61
050,01,075,"Alabama","Lamar County",2,76,129,63,66
050,01,075,"Alabama","Lamar County",2,77,129,62,67
050,01,075,"Alabama","Lamar County",2,78,107,51,56
050,01,075,"Alabama","Lamar County",2,79,97,40,57
050,01,075,"Alabama","Lamar County",2,80,95,41,54
050,01,075,"Alabama","Lamar County",2,81,90,37,53
050,01,075,"Alabama","Lamar County",2,82,87,34,53
050,01,075,"Alabama","Lamar County",2,83,74,31,43
050,01,075,"Alabama","Lamar County",2,84,69,27,42
050,01,075,"Alabama","Lamar County",2,85,318,104,214
050,01,075,"Alabama","Lamar County",3,0,164,83,81
050,01,075,"Alabama","Lamar County",3,1,169,81,88
050,01,075,"Alabama","Lamar County",3,2,163,88,75
050,01,075,"Alabama","Lamar County",3,3,156,84,72
050,01,075,"Alabama","Lamar County",3,4,137,74,63
050,01,075,"Alabama","Lamar County",3,5,165,93,72
050,01,075,"Alabama","Lamar County",3,6,158,82,76
050,01,075,"Alabama","Lamar County",3,7,144,69,75
050,01,075,"Alabama","Lamar County",3,8,148,74,74
050,01,075,"Alabama","Lamar County",3,9,156,78,78
050,01,075,"Alabama","Lamar County",3,10,155,69,86
050,01,075,"Alabama","Lamar County",3,11,161,85,76
050,01,075,"Alabama","Lamar County",3,12,170,96,74
050,01,075,"Alabama","Lamar County",3,13,200,109,91
050,01,075,"Alabama","Lamar County",3,14,194,100,94
050,01,075,"Alabama","Lamar County",3,15,189,97,92
050,01,075,"Alabama","Lamar County",3,16,175,87,88
050,01,075,"Alabama","Lamar County",3,17,189,94,95
050,01,075,"Alabama","Lamar County",3,18,159,81,78
050,01,075,"Alabama","Lamar County",3,19,124,65,59
050,01,075,"Alabama","Lamar County",3,20,135,80,55
050,01,075,"Alabama","Lamar County",3,21,140,78,62
050,01,075,"Alabama","Lamar County",3,22,152,79,73
050,01,075,"Alabama","Lamar County",3,23,146,72,74
050,01,075,"Alabama","Lamar County",3,24,140,74,66
050,01,075,"Alabama","Lamar County",3,25,137,75,62
050,01,075,"Alabama","Lamar County",3,26,123,62,61
050,01,075,"Alabama","Lamar County",3,27,137,69,68
050,01,075,"Alabama","Lamar County",3,28,141,65,76
050,01,075,"Alabama","Lamar County",3,29,142,62,80
050,01,075,"Alabama","Lamar County",3,30,154,71,83
050,01,075,"Alabama","Lamar County",3,31,166,82,84
050,01,075,"Alabama","Lamar County",3,32,157,76,81
050,01,075,"Alabama","Lamar County",3,33,162,75,87
050,01,075,"Alabama","Lamar County",3,34,141,69,72
050,01,075,"Alabama","Lamar County",3,35,129,66,63
050,01,075,"Alabama","Lamar County",3,36,151,72,79
050,01,075,"Alabama","Lamar County",3,37,150,74,76
050,01,075,"Alabama","Lamar County",3,38,146,67,79
050,01,075,"Alabama","Lamar County",3,39,155,82,73
050,01,075,"Alabama","Lamar County",3,40,149,77,72
050,01,075,"Alabama","Lamar County",3,41,149,77,72
050,01,075,"Alabama","Lamar County",3,42,153,81,72
050,01,075,"Alabama","Lamar County",3,43,160,77,83
050,01,075,"Alabama","Lamar County",3,44,170,74,96
050,01,075,"Alabama","Lamar County",3,45,169,73,96
050,01,075,"Alabama","Lamar County",3,46,173,90,83
050,01,075,"Alabama","Lamar County",3,47,174,90,84
050,01,075,"Alabama","Lamar County",3,48,180,96,84
050,01,075,"Alabama","Lamar County",3,49,194,98,96
050,01,075,"Alabama","Lamar County",3,50,187,97,90
050,01,075,"Alabama","Lamar County",3,51,192,98,94
050,01,075,"Alabama","Lamar County",3,52,188,99,89
050,01,075,"Alabama","Lamar County",3,53,169,87,82
050,01,075,"Alabama","Lamar County",3,54,176,80,96
050,01,075,"Alabama","Lamar County",3,55,162,74,88
050,01,075,"Alabama","Lamar County",3,56,180,91,89
050,01,075,"Alabama","Lamar County",3,57,187,104,83
050,01,075,"Alabama","Lamar County",3,58,204,108,96
050,01,075,"Alabama","Lamar County",3,59,207,108,99
050,01,075,"Alabama","Lamar County",3,60,189,91,98
050,01,075,"Alabama","Lamar County",3,61,209,107,102
050,01,075,"Alabama","Lamar County",3,62,204,97,107
050,01,075,"Alabama","Lamar County",3,63,196,100,96
050,01,075,"Alabama","Lamar County",3,64,191,97,94
050,01,075,"Alabama","Lamar County",3,65,200,93,107
050,01,075,"Alabama","Lamar County",3,66,197,95,102
050,01,075,"Alabama","Lamar County",3,67,184,88,96
050,01,075,"Alabama","Lamar County",3,68,168,91,77
050,01,075,"Alabama","Lamar County",3,69,176,88,88
050,01,075,"Alabama","Lamar County",3,70,167,80,87
050,01,075,"Alabama","Lamar County",3,71,150,66,84
050,01,075,"Alabama","Lamar County",3,72,162,78,84
050,01,075,"Alabama","Lamar County",3,73,157,66,91
050,01,075,"Alabama","Lamar County",3,74,171,85,86
050,01,075,"Alabama","Lamar County",3,75,133,65,68
050,01,075,"Alabama","Lamar County",3,76,116,55,61
050,01,075,"Alabama","Lamar County",3,77,116,54,62
050,01,075,"Alabama","Lamar County",3,78,125,61,64
050,01,075,"Alabama","Lamar County",3,79,99,46,53
050,01,075,"Alabama","Lamar County",3,80,86,34,52
050,01,075,"Alabama","Lamar County",3,81,85,37,48
050,01,075,"Alabama","Lamar County",3,82,79,33,46
050,01,075,"Alabama","Lamar County",3,83,79,31,48
050,01,075,"Alabama","Lamar County",3,84,67,27,40
050,01,075,"Alabama","Lamar County",3,85,327,107,220
050,01,075,"Alabama","Lamar County",4,0,166,86,80
050,01,075,"Alabama","Lamar County",4,1,163,80,83
050,01,075,"Alabama","Lamar County",4,2,168,79,89
050,01,075,"Alabama","Lamar County",4,3,162,88,74
050,01,075,"Alabama","Lamar County",4,4,163,85,78
050,01,075,"Alabama","Lamar County",4,5,144,79,65
050,01,075,"Alabama","Lamar County",4,6,171,94,77
050,01,075,"Alabama","Lamar County",4,7,159,85,74
050,01,075,"Alabama","Lamar County",4,8,155,74,81
050,01,075,"Alabama","Lamar County",4,9,152,72,80
050,01,075,"Alabama","Lamar County",4,10,160,78,82
050,01,075,"Alabama","Lamar County",4,11,154,71,83
050,01,075,"Alabama","Lamar County",4,12,162,87,75
050,01,075,"Alabama","Lamar County",4,13,180,102,78
050,01,075,"Alabama","Lamar County",4,14,200,111,89
050,01,075,"Alabama","Lamar County",4,15,200,102,98
050,01,075,"Alabama","Lamar County",4,16,189,95,94
050,01,075,"Alabama","Lamar County",4,17,176,88,88
050,01,075,"Alabama","Lamar County",4,18,157,84,73
050,01,075,"Alabama","Lamar County",4,19,121,59,62
050,01,075,"Alabama","Lamar County",4,20,133,70,63
050,01,075,"Alabama","Lamar County",4,21,145,85,60
050,01,075,"Alabama","Lamar County",4,22,147,83,64
050,01,075,"Alabama","Lamar County",4,23,152,82,70
050,01,075,"Alabama","Lamar County",4,24,148,72,76
050,01,075,"Alabama","Lamar County",4,25,132,72,60
050,01,075,"Alabama","Lamar County",4,26,132,72,60
050,01,075,"Alabama","Lamar County",4,27,121,60,61
050,01,075,"Alabama","Lamar County",4,28,133,70,63
050,01,075,"Alabama","Lamar County",4,29,143,66,77
050,01,075,"Alabama","Lamar County",4,30,141,68,73
050,01,075,"Alabama","Lamar County",4,31,174,81,93
050,01,075,"Alabama","Lamar County",4,32,171,85,86
050,01,075,"Alabama","Lamar County",4,33,150,73,77
050,01,075,"Alabama","Lamar County",4,34,165,77,88
050,01,075,"Alabama","Lamar County",4,35,148,72,76
050,01,075,"Alabama","Lamar County",4,36,129,66,63
050,01,075,"Alabama","Lamar County",4,37,148,70,78
050,01,075,"Alabama","Lamar County",4,38,149,74,75
050,01,075,"Alabama","Lamar County",4,39,151,70,81
050,01,075,"Alabama","Lamar County",4,40,153,80,73
050,01,075,"Alabama","Lamar County",4,41,138,70,68
050,01,075,"Alabama","Lamar County",4,42,147,75,72
050,01,075,"Alabama","Lamar County",4,43,153,80,73
050,01,075,"Alabama","Lamar County",4,44,148,70,78
050,01,075,"Alabama","Lamar County",4,45,170,75,95
050,01,075,"Alabama","Lamar County",4,46,171,76,95
050,01,075,"Alabama","Lamar County",4,47,172,87,85
050,01,075,"Alabama","Lamar County",4,48,176,91,85
050,01,075,"Alabama","Lamar County",4,49,175,93,82
050,01,075,"Alabama","Lamar County",4,50,192,94,98
050,01,075,"Alabama","Lamar County",4,51,191,97,94
050,01,075,"Alabama","Lamar County",4,52,185,92,93
050,01,075,"Alabama","Lamar County",4,53,190,100,90
050,01,075,"Alabama","Lamar County",4,54,179,93,86
050,01,075,"Alabama","Lamar County",4,55,179,83,96
050,01,075,"Alabama","Lamar County",4,56,156,68,88
050,01,075,"Alabama","Lamar County",4,57,173,86,87
050,01,075,"Alabama","Lamar County",4,58,184,105,79
050,01,075,"Alabama","Lamar County",4,59,197,99,98
050,01,075,"Alabama","Lamar County",4,60,201,106,95
050,01,075,"Alabama","Lamar County",4,61,190,89,101
050,01,075,"Alabama","Lamar County",4,62,204,103,101
050,01,075,"Alabama","Lamar County",4,63,198,93,105
050,01,075,"Alabama","Lamar County",4,64,194,100,94
050,01,075,"Alabama","Lamar County",4,65,189,97,92
050,01,075,"Alabama","Lamar County",4,66,199,91,108
050,01,075,"Alabama","Lamar County",4,67,191,94,97
050,01,075,"Alabama","Lamar County",4,68,185,90,95
050,01,075,"Alabama","Lamar County",4,69,164,87,77
050,01,075,"Alabama","Lamar County",4,70,173,87,86
050,01,075,"Alabama","Lamar County",4,71,161,73,88
050,01,075,"Alabama","Lamar County",4,72,150,69,81
050,01,075,"Alabama","Lamar County",4,73,149,70,79
050,01,075,"Alabama","Lamar County",4,74,150,65,85
050,01,075,"Alabama","Lamar County",4,75,163,82,81
050,01,075,"Alabama","Lamar County",4,76,128,59,69
050,01,075,"Alabama","Lamar County",4,77,108,52,56
050,01,075,"Alabama","Lamar County",4,78,113,52,61
050,01,075,"Alabama","Lamar County",4,79,118,57,61
050,01,075,"Alabama","Lamar County",4,80,88,42,46
050,01,075,"Alabama","Lamar County",4,81,81,33,48
050,01,075,"Alabama","Lamar County",4,82,81,34,47
050,01,075,"Alabama","Lamar County",4,83,74,31,43
050,01,075,"Alabama","Lamar County",4,84,74,30,44
050,01,075,"Alabama","Lamar County",4,85,337,109,228
050,01,075,"Alabama","Lamar County",5,0,153,81,72
050,01,075,"Alabama","Lamar County",5,1,169,87,82
050,01,075,"Alabama","Lamar County",5,2,162,80,82
050,01,075,"Alabama","Lamar County",5,3,157,80,77
050,01,075,"Alabama","Lamar County",5,4,165,88,77
050,01,075,"Alabama","Lamar County",5,5,159,85,74
050,01,075,"Alabama","Lamar County",5,6,143,76,67
050,01,075,"Alabama","Lamar County",5,7,171,99,72
050,01,075,"Alabama","Lamar County",5,8,157,83,74
050,01,075,"Alabama","Lamar County",5,9,159,75,84
050,01,075,"Alabama","Lamar County",5,10,162,78,84
050,01,075,"Alabama","Lamar County",5,11,162,78,84
050,01,075,"Alabama","Lamar County",5,12,159,75,84
050,01,075,"Alabama","Lamar County",5,13,166,92,74
050,01,075,"Alabama","Lamar County",5,14,175,100,75
050,01,075,"Alabama","Lamar County",5,15,200,108,92
050,01,075,"Alabama","Lamar County",5,16,196,103,93
050,01,075,"Alabama","Lamar County",5,17,198,101,97
050,01,075,"Alabama","Lamar County",5,18,149,76,73
050,01,075,"Alabama","Lamar County",5,19,123,64,59
050,01,075,"Alabama","Lamar County",5,20,134,64,70
050,01,075,"Alabama","Lamar County",5,21,140,72,68
050,01,075,"Alabama","Lamar County",5,22,147,82,65
050,01,075,"Alabama","Lamar County",5,23,147,85,62
050,01,075,"Alabama","Lamar County",5,24,156,88,68
050,01,075,"Alabama","Lamar County",5,25,150,75,75
050,01,075,"Alabama","Lamar County",5,26,140,78,62
050,01,075,"Alabama","Lamar County",5,27,132,65,67
050,01,075,"Alabama","Lamar County",5,28,134,68,66
050,01,075,"Alabama","Lamar County",5,29,132,68,64
050,01,075,"Alabama","Lamar County",5,30,132,57,75
050,01,075,"Alabama","Lamar County",5,31,136,64,72
050,01,075,"Alabama","Lamar County",5,32,182,86,96
050,01,075,"Alabama","Lamar County",5,33,170,84,86
050,01,075,"Alabama","Lamar County",5,34,150,75,75
050,01,075,"Alabama","Lamar County",5,35,165,80,85
050,01,075,"Alabama","Lamar County",5,36,148,75,73
050,01,075,"Alabama","Lamar County",5,37,131,68,63
050,01,075,"Alabama","Lamar County",5,38,157,76,81
050,01,075,"Alabama","Lamar County",5,39,150,75,75
050,01,075,"Alabama","Lamar County",5,40,151,65,86
050,01,075,"Alabama","Lamar County",5,41,157,79,78
050,01,075,"Alabama","Lamar County",5,42,135,66,69
050,01,075,"Alabama","Lamar County",5,43,150,76,74
050,01,075,"Alabama","Lamar County",5,44,148,78,70
050,01,075,"Alabama","Lamar County",5,45,151,70,81
050,01,075,"Alabama","Lamar County",5,46,168,75,93
050,01,075,"Alabama","Lamar County",5,47,162,70,92
050,01,075,"Alabama","Lamar County",5,48,173,89,84
050,01,075,"Alabama","Lamar County",5,49,177,91,86
050,01,075,"Alabama","Lamar County",5,50,172,89,83
050,01,075,"Alabama","Lamar County",5,51,188,93,95
050,01,075,"Alabama","Lamar County",5,52,186,94,92
050,01,075,"Alabama","Lamar County",5,53,189,93,96
050,01,075,"Alabama","Lamar County",5,54,189,100,89
050,01,075,"Alabama","Lamar County",5,55,181,92,89
050,01,075,"Alabama","Lamar County",5,56,174,81,93
050,01,075,"Alabama","Lamar County",5,57,149,64,85
050,01,075,"Alabama","Lamar County",5,58,177,87,90
050,01,075,"Alabama","Lamar County",5,59,177,98,79
050,01,075,"Alabama","Lamar County",5,60,194,97,97
050,01,075,"Alabama","Lamar County",5,61,202,107,95
050,01,075,"Alabama","Lamar County",5,62,190,87,103
050,01,075,"Alabama","Lamar County",5,63,200,99,101
050,01,075,"Alabama","Lamar County",5,64,198,95,103
050,01,075,"Alabama","Lamar County",5,65,187,94,93
050,01,075,"Alabama","Lamar County",5,66,190,98,92
050,01,075,"Alabama","Lamar County",5,67,189,86,103
050,01,075,"Alabama","Lamar County",5,68,191,94,97
050,01,075,"Alabama","Lamar County",5,69,183,88,95
050,01,075,"Alabama","Lamar County",5,70,161,85,76
050,01,075,"Alabama","Lamar County",5,71,163,79,84
050,01,075,"Alabama","Lamar County",5,72,160,75,85
050,01,075,"Alabama","Lamar County",5,73,139,63,76
050,01,075,"Alabama","Lamar County",5,74,141,66,75
050,01,075,"Alabama","Lamar County",5,75,141,59,82
050,01,075,"Alabama","Lamar County",5,76,159,79,80
050,01,075,"Alabama","Lamar County",5,77,119,54,65
050,01,075,"Alabama","Lamar County",5,78,108,52,56
050,01,075,"Alabama","Lamar County",5,79,108,50,58
050,01,075,"Alabama","Lamar County",5,80,108,55,53
050,01,075,"Alabama","Lamar County",5,81,82,40,42
050,01,075,"Alabama","Lamar County",5,82,80,31,49
050,01,075,"Alabama","Lamar County",5,83,77,32,45
050,01,075,"Alabama","Lamar County",5,84,63,29,34
050,01,075,"Alabama","Lamar County",5,85,356,117,239
050,01,077,"Alabama","Lauderdale County",1,0,901,459,442
050,01,077,"Alabama","Lauderdale County",1,1,923,464,459
050,01,077,"Alabama","Lauderdale County",1,2,965,477,488
050,01,077,"Alabama","Lauderdale County",1,3,977,515,462
050,01,077,"Alabama","Lauderdale County",1,4,1004,509,495
050,01,077,"Alabama","Lauderdale County",1,5,1019,534,485
050,01,077,"Alabama","Lauderdale County",1,6,999,526,473
050,01,077,"Alabama","Lauderdale County",1,7,954,496,458
050,01,077,"Alabama","Lauderdale County",1,8,976,480,496
050,01,077,"Alabama","Lauderdale County",1,9,957,499,458
050,01,077,"Alabama","Lauderdale County",1,10,1061,558,503
050,01,077,"Alabama","Lauderdale County",1,11,1102,546,556
050,01,077,"Alabama","Lauderdale County",1,12,1114,547,567
050,01,077,"Alabama","Lauderdale County",1,13,1122,551,571
050,01,077,"Alabama","Lauderdale County",1,14,1107,562,545
050,01,077,"Alabama","Lauderdale County",1,15,1105,546,559
050,01,077,"Alabama","Lauderdale County",1,16,1112,558,554
050,01,077,"Alabama","Lauderdale County",1,17,1083,564,519
050,01,077,"Alabama","Lauderdale County",1,18,1377,666,711
050,01,077,"Alabama","Lauderdale County",1,19,1738,828,910
050,01,077,"Alabama","Lauderdale County",1,20,1693,776,917
050,01,077,"Alabama","Lauderdale County",1,21,1743,772,971
050,01,077,"Alabama","Lauderdale County",1,22,1605,775,830
050,01,077,"Alabama","Lauderdale County",1,23,1465,756,709
050,01,077,"Alabama","Lauderdale County",1,24,1337,673,664
050,01,077,"Alabama","Lauderdale County",1,25,1246,612,634
050,01,077,"Alabama","Lauderdale County",1,26,1183,608,575
050,01,077,"Alabama","Lauderdale County",1,27,1147,577,570
050,01,077,"Alabama","Lauderdale County",1,28,1137,573,564
050,01,077,"Alabama","Lauderdale County",1,29,1181,570,611
050,01,077,"Alabama","Lauderdale County",1,30,1125,576,549
050,01,077,"Alabama","Lauderdale County",1,31,1036,515,521
050,01,077,"Alabama","Lauderdale County",1,32,1003,499,504
050,01,077,"Alabama","Lauderdale County",1,33,1007,504,503
050,01,077,"Alabama","Lauderdale County",1,34,1035,520,515
050,01,077,"Alabama","Lauderdale County",1,35,1065,547,518
050,01,077,"Alabama","Lauderdale County",1,36,1053,530,523
050,01,077,"Alabama","Lauderdale County",1,37,1056,526,530
050,01,077,"Alabama","Lauderdale County",1,38,1063,524,539
050,01,077,"Alabama","Lauderdale County",1,39,1027,493,534
050,01,077,"Alabama","Lauderdale County",1,40,1000,483,517
050,01,077,"Alabama","Lauderdale County",1,41,943,458,485
050,01,077,"Alabama","Lauderdale County",1,42,971,495,476
050,01,077,"Alabama","Lauderdale County",1,43,986,502,484
050,01,077,"Alabama","Lauderdale County",1,44,938,437,501
050,01,077,"Alabama","Lauderdale County",1,45,1023,508,515
050,01,077,"Alabama","Lauderdale County",1,46,1022,513,509
050,01,077,"Alabama","Lauderdale County",1,47,1072,532,540
050,01,077,"Alabama","Lauderdale County",1,48,1166,566,600
050,01,077,"Alabama","Lauderdale County",1,49,1224,593,631
050,01,077,"Alabama","Lauderdale County",1,50,1186,585,601
050,01,077,"Alabama","Lauderdale County",1,51,1152,589,563
050,01,077,"Alabama","Lauderdale County",1,52,1092,539,553
050,01,077,"Alabama","Lauderdale County",1,53,1159,584,575
050,01,077,"Alabama","Lauderdale County",1,54,1194,581,613
050,01,077,"Alabama","Lauderdale County",1,55,1266,587,679
050,01,077,"Alabama","Lauderdale County",1,56,1273,623,650
050,01,077,"Alabama","Lauderdale County",1,57,1224,631,593
050,01,077,"Alabama","Lauderdale County",1,58,1285,617,668
050,01,077,"Alabama","Lauderdale County",1,59,1315,611,704
050,01,077,"Alabama","Lauderdale County",1,60,1264,598,666
050,01,077,"Alabama","Lauderdale County",1,61,1274,607,667
050,01,077,"Alabama","Lauderdale County",1,62,1315,611,704
050,01,077,"Alabama","Lauderdale County",1,63,1296,588,708
050,01,077,"Alabama","Lauderdale County",1,64,1268,579,689
050,01,077,"Alabama","Lauderdale County",1,65,1277,620,657
050,01,077,"Alabama","Lauderdale County",1,66,1200,596,604
050,01,077,"Alabama","Lauderdale County",1,67,1175,558,617
050,01,077,"Alabama","Lauderdale County",1,68,1171,538,633
050,01,077,"Alabama","Lauderdale County",1,69,1067,512,555
050,01,077,"Alabama","Lauderdale County",1,70,1066,514,552
050,01,077,"Alabama","Lauderdale County",1,71,1071,486,585
050,01,077,"Alabama","Lauderdale County",1,72,1130,518,612
050,01,077,"Alabama","Lauderdale County",1,73,1087,512,575
050,01,077,"Alabama","Lauderdale County",1,74,725,325,400
050,01,077,"Alabama","Lauderdale County",1,75,739,339,400
050,01,077,"Alabama","Lauderdale County",1,76,759,331,428
050,01,077,"Alabama","Lauderdale County",1,77,754,319,435
050,01,077,"Alabama","Lauderdale County",1,78,663,284,379
050,01,077,"Alabama","Lauderdale County",1,79,624,276,348
050,01,077,"Alabama","Lauderdale County",1,80,574,239,335
050,01,077,"Alabama","Lauderdale County",1,81,499,203,296
050,01,077,"Alabama","Lauderdale County",1,82,440,178,262
050,01,077,"Alabama","Lauderdale County",1,83,414,164,250
050,01,077,"Alabama","Lauderdale County",1,84,388,144,244
050,01,077,"Alabama","Lauderdale County",1,85,2028,672,1356
050,01,077,"Alabama","Lauderdale County",2,0,906,459,447
050,01,077,"Alabama","Lauderdale County",2,1,923,464,459
050,01,077,"Alabama","Lauderdale County",2,2,961,478,483
050,01,077,"Alabama","Lauderdale County",2,3,972,503,469
050,01,077,"Alabama","Lauderdale County",2,4,1004,512,492
050,01,077,"Alabama","Lauderdale County",2,5,1019,531,488
050,01,077,"Alabama","Lauderdale County",2,6,1006,530,476
050,01,077,"Alabama","Lauderdale County",2,7,972,507,465
050,01,077,"Alabama","Lauderdale County",2,8,972,486,486
050,01,077,"Alabama","Lauderdale County",2,9,963,496,467
050,01,077,"Alabama","Lauderdale County",2,10,1037,541,496
050,01,077,"Alabama","Lauderdale County",2,11,1090,548,542
050,01,077,"Alabama","Lauderdale County",2,12,1117,547,570
050,01,077,"Alabama","Lauderdale County",2,13,1122,552,570
050,01,077,"Alabama","Lauderdale County",2,14,1114,564,550
050,01,077,"Alabama","Lauderdale County",2,15,1104,548,556
050,01,077,"Alabama","Lauderdale County",2,16,1111,555,556
050,01,077,"Alabama","Lauderdale County",2,17,1095,564,531
050,01,077,"Alabama","Lauderdale County",2,18,1419,676,743
050,01,077,"Alabama","Lauderdale County",2,19,1853,877,976
050,01,077,"Alabama","Lauderdale County",2,20,1802,816,986
050,01,077,"Alabama","Lauderdale County",2,21,1777,785,992
050,01,077,"Alabama","Lauderdale County",2,22,1630,791,839
050,01,077,"Alabama","Lauderdale County",2,23,1492,761,731
050,01,077,"Alabama","Lauderdale County",2,24,1327,670,657
050,01,077,"Alabama","Lauderdale County",2,25,1252,618,634
050,01,077,"Alabama","Lauderdale County",2,26,1193,610,583
050,01,077,"Alabama","Lauderdale County",2,27,1148,582,566
050,01,077,"Alabama","Lauderdale County",2,28,1145,574,571
050,01,077,"Alabama","Lauderdale County",2,29,1168,566,602
050,01,077,"Alabama","Lauderdale County",2,30,1145,575,570
050,01,077,"Alabama","Lauderdale County",2,31,1053,525,528
050,01,077,"Alabama","Lauderdale County",2,32,1014,507,507
050,01,077,"Alabama","Lauderdale County",2,33,1003,498,505
050,01,077,"Alabama","Lauderdale County",2,34,1028,515,513
050,01,077,"Alabama","Lauderdale County",2,35,1072,551,521
050,01,077,"Alabama","Lauderdale County",2,36,1049,529,520
050,01,077,"Alabama","Lauderdale County",2,37,1060,529,531
050,01,077,"Alabama","Lauderdale County",2,38,1068,530,538
050,01,077,"Alabama","Lauderdale County",2,39,1031,495,536
050,01,077,"Alabama","Lauderdale County",2,40,1012,489,523
050,01,077,"Alabama","Lauderdale County",2,41,957,460,497
050,01,077,"Alabama","Lauderdale County",2,42,958,485,473
050,01,077,"Alabama","Lauderdale County",2,43,991,504,487
050,01,077,"Alabama","Lauderdale County",2,44,947,453,494
050,01,077,"Alabama","Lauderdale County",2,45,1008,495,513
050,01,077,"Alabama","Lauderdale County",2,46,1019,510,509
050,01,077,"Alabama","Lauderdale County",2,47,1056,524,532
050,01,077,"Alabama","Lauderdale County",2,48,1144,559,585
050,01,077,"Alabama","Lauderdale County",2,49,1217,592,625
050,01,077,"Alabama","Lauderdale County",2,50,1195,587,608
050,01,077,"Alabama","Lauderdale County",2,51,1157,586,571
050,01,077,"Alabama","Lauderdale County",2,52,1102,550,552
050,01,077,"Alabama","Lauderdale County",2,53,1139,573,566
050,01,077,"Alabama","Lauderdale County",2,54,1179,578,601
050,01,077,"Alabama","Lauderdale County",2,55,1253,587,666
050,01,077,"Alabama","Lauderdale County",2,56,1270,612,658
050,01,077,"Alabama","Lauderdale County",2,57,1241,632,609
050,01,077,"Alabama","Lauderdale County",2,58,1272,620,652
050,01,077,"Alabama","Lauderdale County",2,59,1311,615,696
050,01,077,"Alabama","Lauderdale County",2,60,1277,599,678
050,01,077,"Alabama","Lauderdale County",2,61,1262,601,661
050,01,077,"Alabama","Lauderdale County",2,62,1303,610,693
050,01,077,"Alabama","Lauderdale County",2,63,1313,596,717
050,01,077,"Alabama","Lauderdale County",2,64,1268,580,688
050,01,077,"Alabama","Lauderdale County",2,65,1268,608,660
050,01,077,"Alabama","Lauderdale County",2,66,1220,602,618
050,01,077,"Alabama","Lauderdale County",2,67,1181,569,612
050,01,077,"Alabama","Lauderdale County",2,68,1159,539,620
050,01,077,"Alabama","Lauderdale County",2,69,1096,518,578
050,01,077,"Alabama","Lauderdale County",2,70,1064,513,551
050,01,077,"Alabama","Lauderdale County",2,71,1070,492,578
050,01,077,"Alabama","Lauderdale County",2,72,1089,500,589
050,01,077,"Alabama","Lauderdale County",2,73,1141,538,603
050,01,077,"Alabama","Lauderdale County",2,74,760,345,415
050,01,077,"Alabama","Lauderdale County",2,75,736,336,400
050,01,077,"Alabama","Lauderdale County",2,76,742,326,416
050,01,077,"Alabama","Lauderdale County",2,77,764,329,435
050,01,077,"Alabama","Lauderdale County",2,78,673,288,385
050,01,077,"Alabama","Lauderdale County",2,79,616,266,350
050,01,077,"Alabama","Lauderdale County",2,80,577,247,330
050,01,077,"Alabama","Lauderdale County",2,81,516,208,308
050,01,077,"Alabama","Lauderdale County",2,82,448,178,270
050,01,077,"Alabama","Lauderdale County",2,83,417,165,252
050,01,077,"Alabama","Lauderdale County",2,84,383,146,237
050,01,077,"Alabama","Lauderdale County",2,85,2037,665,1372
050,01,077,"Alabama","Lauderdale County",3,0,924,458,466
050,01,077,"Alabama","Lauderdale County",3,1,908,474,434
050,01,077,"Alabama","Lauderdale County",3,2,952,486,466
050,01,077,"Alabama","Lauderdale County",3,3,1000,507,493
050,01,077,"Alabama","Lauderdale County",3,4,969,513,456
050,01,077,"Alabama","Lauderdale County",3,5,1016,512,504
050,01,077,"Alabama","Lauderdale County",3,6,1043,544,499
050,01,077,"Alabama","Lauderdale County",3,7,1030,526,504
050,01,077,"Alabama","Lauderdale County",3,8,983,516,467
050,01,077,"Alabama","Lauderdale County",3,9,961,481,480
050,01,077,"Alabama","Lauderdale County",3,10,975,502,473
050,01,077,"Alabama","Lauderdale County",3,11,1041,541,500
050,01,077,"Alabama","Lauderdale County",3,12,1104,562,542
050,01,077,"Alabama","Lauderdale County",3,13,1123,553,570
050,01,077,"Alabama","Lauderdale County",3,14,1152,579,573
050,01,077,"Alabama","Lauderdale County",3,15,1113,563,550
050,01,077,"Alabama","Lauderdale County",3,16,1116,564,552
050,01,077,"Alabama","Lauderdale County",3,17,1132,570,562
050,01,077,"Alabama","Lauderdale County",3,18,1497,704,793
050,01,077,"Alabama","Lauderdale County",3,19,1914,901,1013
050,01,077,"Alabama","Lauderdale County",3,20,1904,847,1057
050,01,077,"Alabama","Lauderdale County",3,21,1842,824,1018
050,01,077,"Alabama","Lauderdale County",3,22,1638,805,833
050,01,077,"Alabama","Lauderdale County",3,23,1539,775,764
050,01,077,"Alabama","Lauderdale County",3,24,1356,682,674
050,01,077,"Alabama","Lauderdale County",3,25,1268,643,625
050,01,077,"Alabama","Lauderdale County",3,26,1237,607,630
050,01,077,"Alabama","Lauderdale County",3,27,1135,584,551
050,01,077,"Alabama","Lauderdale County",3,28,1170,584,586
050,01,077,"Alabama","Lauderdale County",3,29,1142,576,566
050,01,077,"Alabama","Lauderdale County",3,30,1189,590,599
050,01,077,"Alabama","Lauderdale County",3,31,1162,561,601
050,01,077,"Alabama","Lauderdale County",3,32,1092,552,540
050,01,077,"Alabama","Lauderdale County",3,33,1000,492,508
050,01,077,"Alabama","Lauderdale County",3,34,1022,506,516
050,01,077,"Alabama","Lauderdale County",3,35,1083,566,517
050,01,077,"Alabama","Lauderdale County",3,36,1086,547,539
050,01,077,"Alabama","Lauderdale County",3,37,1042,526,516
050,01,077,"Alabama","Lauderdale County",3,38,1086,548,538
050,01,077,"Alabama","Lauderdale County",3,39,1070,526,544
050,01,077,"Alabama","Lauderdale County",3,40,1036,503,533
050,01,077,"Alabama","Lauderdale County",3,41,1021,490,531
050,01,077,"Alabama","Lauderdale County",3,42,967,465,502
050,01,077,"Alabama","Lauderdale County",3,43,956,485,471
050,01,077,"Alabama","Lauderdale County",3,44,998,513,485
050,01,077,"Alabama","Lauderdale County",3,45,948,464,484
050,01,077,"Alabama","Lauderdale County",3,46,996,488,508
050,01,077,"Alabama","Lauderdale County",3,47,998,498,500
050,01,077,"Alabama","Lauderdale County",3,48,1051,510,541
050,01,077,"Alabama","Lauderdale County",3,49,1154,572,582
050,01,077,"Alabama","Lauderdale County",3,50,1215,577,638
050,01,077,"Alabama","Lauderdale County",3,51,1223,611,612
050,01,077,"Alabama","Lauderdale County",3,52,1145,572,573
050,01,077,"Alabama","Lauderdale County",3,53,1097,551,546
050,01,077,"Alabama","Lauderdale County",3,54,1141,566,575
050,01,077,"Alabama","Lauderdale County",3,55,1201,584,617
050,01,077,"Alabama","Lauderdale County",3,56,1252,596,656
050,01,077,"Alabama","Lauderdale County",3,57,1273,606,667
050,01,077,"Alabama","Lauderdale County",3,58,1232,627,605
050,01,077,"Alabama","Lauderdale County",3,59,1265,620,645
050,01,077,"Alabama","Lauderdale County",3,60,1317,609,708
050,01,077,"Alabama","Lauderdale County",3,61,1273,594,679
050,01,077,"Alabama","Lauderdale County",3,62,1249,595,654
050,01,077,"Alabama","Lauderdale County",3,63,1287,602,685
050,01,077,"Alabama","Lauderdale County",3,64,1316,600,716
050,01,077,"Alabama","Lauderdale County",3,65,1249,566,683
050,01,077,"Alabama","Lauderdale County",3,66,1250,590,660
050,01,077,"Alabama","Lauderdale County",3,67,1187,588,599
050,01,077,"Alabama","Lauderdale County",3,68,1151,552,599
050,01,077,"Alabama","Lauderdale County",3,69,1152,547,605
050,01,077,"Alabama","Lauderdale County",3,70,1067,495,572
050,01,077,"Alabama","Lauderdale County",3,71,1041,494,547
050,01,077,"Alabama","Lauderdale County",3,72,1027,475,552
050,01,077,"Alabama","Lauderdale County",3,73,1053,483,570
050,01,077,"Alabama","Lauderdale County",3,74,1106,509,597
050,01,077,"Alabama","Lauderdale County",3,75,748,338,410
050,01,077,"Alabama","Lauderdale County",3,76,709,321,388
050,01,077,"Alabama","Lauderdale County",3,77,690,295,395
050,01,077,"Alabama","Lauderdale County",3,78,739,311,428
050,01,077,"Alabama","Lauderdale County",3,79,621,249,372
050,01,077,"Alabama","Lauderdale County",3,80,577,247,330
050,01,077,"Alabama","Lauderdale County",3,81,552,234,318
050,01,077,"Alabama","Lauderdale County",3,82,474,193,281
050,01,077,"Alabama","Lauderdale County",3,83,427,162,265
050,01,077,"Alabama","Lauderdale County",3,84,368,152,216
050,01,077,"Alabama","Lauderdale County",3,85,2038,666,1372
050,01,077,"Alabama","Lauderdale County",4,0,937,447,490
050,01,077,"Alabama","Lauderdale County",4,1,955,443,512
050,01,077,"Alabama","Lauderdale County",4,2,933,494,439
050,01,077,"Alabama","Lauderdale County",4,3,952,486,466
050,01,077,"Alabama","Lauderdale County",4,4,1012,505,507
050,01,077,"Alabama","Lauderdale County",4,5,1007,538,469
050,01,077,"Alabama","Lauderdale County",4,6,1061,544,517
050,01,077,"Alabama","Lauderdale County",4,7,1054,541,513
050,01,077,"Alabama","Lauderdale County",4,8,1056,541,515
050,01,077,"Alabama","Lauderdale County",4,9,1002,517,485
050,01,077,"Alabama","Lauderdale County",4,10,986,491,495
050,01,077,"Alabama","Lauderdale County",4,11,1003,530,473
050,01,077,"Alabama","Lauderdale County",4,12,1061,562,499
050,01,077,"Alabama","Lauderdale County",4,13,1124,560,564
050,01,077,"Alabama","Lauderdale County",4,14,1155,575,580
050,01,077,"Alabama","Lauderdale County",4,15,1160,579,581
050,01,077,"Alabama","Lauderdale County",4,16,1121,575,546
050,01,077,"Alabama","Lauderdale County",4,17,1139,582,557
050,01,077,"Alabama","Lauderdale County",4,18,1569,720,849
050,01,077,"Alabama","Lauderdale County",4,19,2055,961,1094
050,01,077,"Alabama","Lauderdale County",4,20,1896,841,1055
050,01,077,"Alabama","Lauderdale County",4,21,1881,819,1062
050,01,077,"Alabama","Lauderdale County",4,22,1702,852,850
050,01,077,"Alabama","Lauderdale County",4,23,1529,757,772
050,01,077,"Alabama","Lauderdale County",4,24,1358,669,689
050,01,077,"Alabama","Lauderdale County",4,25,1263,632,631
050,01,077,"Alabama","Lauderdale County",4,26,1185,609,576
050,01,077,"Alabama","Lauderdale County",4,27,1180,559,621
050,01,077,"Alabama","Lauderdale County",4,28,1152,586,566
050,01,077,"Alabama","Lauderdale County",4,29,1161,568,593
050,01,077,"Alabama","Lauderdale County",4,30,1155,581,574
050,01,077,"Alabama","Lauderdale County",4,31,1202,582,620
050,01,077,"Alabama","Lauderdale County",4,32,1175,583,592
050,01,077,"Alabama","Lauderdale County",4,33,1102,560,542
050,01,077,"Alabama","Lauderdale County",4,34,1000,486,514
050,01,077,"Alabama","Lauderdale County",4,35,1025,514,511
050,01,077,"Alabama","Lauderdale County",4,36,1078,558,520
050,01,077,"Alabama","Lauderdale County",4,37,1117,575,542
050,01,077,"Alabama","Lauderdale County",4,38,1056,535,521
050,01,077,"Alabama","Lauderdale County",4,39,1083,532,551
050,01,077,"Alabama","Lauderdale County",4,40,1082,527,555
050,01,077,"Alabama","Lauderdale County",4,41,1037,487,550
050,01,077,"Alabama","Lauderdale County",4,42,1025,496,529
050,01,077,"Alabama","Lauderdale County",4,43,982,476,506
050,01,077,"Alabama","Lauderdale County",4,44,972,480,492
050,01,077,"Alabama","Lauderdale County",4,45,997,513,484
050,01,077,"Alabama","Lauderdale County",4,46,963,471,492
050,01,077,"Alabama","Lauderdale County",4,47,992,487,505
050,01,077,"Alabama","Lauderdale County",4,48,994,487,507
050,01,077,"Alabama","Lauderdale County",4,49,1062,519,543
050,01,077,"Alabama","Lauderdale County",4,50,1159,572,587
050,01,077,"Alabama","Lauderdale County",4,51,1231,594,637
050,01,077,"Alabama","Lauderdale County",4,52,1237,609,628
050,01,077,"Alabama","Lauderdale County",4,53,1139,573,566
050,01,077,"Alabama","Lauderdale County",4,54,1106,551,555
050,01,077,"Alabama","Lauderdale County",4,55,1133,561,572
050,01,077,"Alabama","Lauderdale County",4,56,1197,595,602
050,01,077,"Alabama","Lauderdale County",4,57,1255,598,657
050,01,077,"Alabama","Lauderdale County",4,58,1293,612,681
050,01,077,"Alabama","Lauderdale County",4,59,1232,626,606
050,01,077,"Alabama","Lauderdale County",4,60,1268,611,657
050,01,077,"Alabama","Lauderdale County",4,61,1333,611,722
050,01,077,"Alabama","Lauderdale County",4,62,1281,585,696
050,01,077,"Alabama","Lauderdale County",4,63,1251,591,660
050,01,077,"Alabama","Lauderdale County",4,64,1303,603,700
050,01,077,"Alabama","Lauderdale County",4,65,1332,600,732
050,01,077,"Alabama","Lauderdale County",4,66,1246,562,684
050,01,077,"Alabama","Lauderdale County",4,67,1248,586,662
050,01,077,"Alabama","Lauderdale County",4,68,1173,580,593
050,01,077,"Alabama","Lauderdale County",4,69,1151,552,599
050,01,077,"Alabama","Lauderdale County",4,70,1130,539,591
050,01,077,"Alabama","Lauderdale County",4,71,1049,488,561
050,01,077,"Alabama","Lauderdale County",4,72,1008,468,540
050,01,077,"Alabama","Lauderdale County",4,73,1005,470,535
050,01,077,"Alabama","Lauderdale County",4,74,1022,459,563
050,01,077,"Alabama","Lauderdale County",4,75,1088,507,581
050,01,077,"Alabama","Lauderdale County",4,76,725,326,399
050,01,077,"Alabama","Lauderdale County",4,77,666,299,367
050,01,077,"Alabama","Lauderdale County",4,78,674,288,386
050,01,077,"Alabama","Lauderdale County",4,79,710,287,423
050,01,077,"Alabama","Lauderdale County",4,80,593,239,354
050,01,077,"Alabama","Lauderdale County",4,81,546,232,314
050,01,077,"Alabama","Lauderdale County",4,82,493,205,288
050,01,077,"Alabama","Lauderdale County",4,83,455,179,276
050,01,077,"Alabama","Lauderdale County",4,84,391,154,237
050,01,077,"Alabama","Lauderdale County",4,85,2004,661,1343
050,01,077,"Alabama","Lauderdale County",5,0,941,446,495
050,01,077,"Alabama","Lauderdale County",5,1,975,473,502
050,01,077,"Alabama","Lauderdale County",5,2,945,459,486
050,01,077,"Alabama","Lauderdale County",5,3,945,513,432
050,01,077,"Alabama","Lauderdale County",5,4,962,484,478
050,01,077,"Alabama","Lauderdale County",5,5,1013,502,511
050,01,077,"Alabama","Lauderdale County",5,6,975,529,446
050,01,077,"Alabama","Lauderdale County",5,7,1046,536,510
050,01,077,"Alabama","Lauderdale County",5,8,1068,555,513
050,01,077,"Alabama","Lauderdale County",5,9,1038,537,501
050,01,077,"Alabama","Lauderdale County",5,10,1001,513,488
050,01,077,"Alabama","Lauderdale County",5,11,994,500,494
050,01,077,"Alabama","Lauderdale County",5,12,1016,529,487
050,01,077,"Alabama","Lauderdale County",5,13,1076,572,504
050,01,077,"Alabama","Lauderdale County",5,14,1138,575,563
050,01,077,"Alabama","Lauderdale County",5,15,1150,576,574
050,01,077,"Alabama","Lauderdale County",5,16,1149,570,579
050,01,077,"Alabama","Lauderdale County",5,17,1120,572,548
050,01,077,"Alabama","Lauderdale County",5,18,1650,756,894
050,01,077,"Alabama","Lauderdale County",5,19,2245,1033,1212
050,01,077,"Alabama","Lauderdale County",5,20,2086,942,1144
050,01,077,"Alabama","Lauderdale County",5,21,1867,799,1068
050,01,077,"Alabama","Lauderdale County",5,22,1736,865,871
050,01,077,"Alabama","Lauderdale County",5,23,1585,829,756
050,01,077,"Alabama","Lauderdale County",5,24,1375,654,721
050,01,077,"Alabama","Lauderdale County",5,25,1293,639,654
050,01,077,"Alabama","Lauderdale County",5,26,1218,632,586
050,01,077,"Alabama","Lauderdale County",5,27,1155,585,570
050,01,077,"Alabama","Lauderdale County",5,28,1165,571,594
050,01,077,"Alabama","Lauderdale County",5,29,1153,583,570
050,01,077,"Alabama","Lauderdale County",5,30,1174,582,592
050,01,077,"Alabama","Lauderdale County",5,31,1149,564,585
050,01,077,"Alabama","Lauderdale County",5,32,1209,589,620
050,01,077,"Alabama","Lauderdale County",5,33,1168,574,594
050,01,077,"Alabama","Lauderdale County",5,34,1098,558,540
050,01,077,"Alabama","Lauderdale County",5,35,1041,530,511
050,01,077,"Alabama","Lauderdale County",5,36,1026,510,516
050,01,077,"Alabama","Lauderdale County",5,37,1102,565,537
050,01,077,"Alabama","Lauderdale County",5,38,1133,590,543
050,01,077,"Alabama","Lauderdale County",5,39,1030,511,519
050,01,077,"Alabama","Lauderdale County",5,40,1088,530,558
050,01,077,"Alabama","Lauderdale County",5,41,1061,510,551
050,01,077,"Alabama","Lauderdale County",5,42,1053,490,563
050,01,077,"Alabama","Lauderdale County",5,43,1010,483,527
050,01,077,"Alabama","Lauderdale County",5,44,986,481,505
050,01,077,"Alabama","Lauderdale County",5,45,973,487,486
050,01,077,"Alabama","Lauderdale County",5,46,987,500,487
050,01,077,"Alabama","Lauderdale County",5,47,979,484,495
050,01,077,"Alabama","Lauderdale County",5,48,998,477,521
050,01,077,"Alabama","Lauderdale County",5,49,1005,501,504
050,01,077,"Alabama","Lauderdale County",5,50,1068,515,553
050,01,077,"Alabama","Lauderdale County",5,51,1182,581,601
050,01,077,"Alabama","Lauderdale County",5,52,1250,593,657
050,01,077,"Alabama","Lauderdale County",5,53,1269,623,646
050,01,077,"Alabama","Lauderdale County",5,54,1141,583,558
050,01,077,"Alabama","Lauderdale County",5,55,1120,561,559
050,01,077,"Alabama","Lauderdale County",5,56,1134,552,582
050,01,077,"Alabama","Lauderdale County",5,57,1195,593,602
050,01,077,"Alabama","Lauderdale County",5,58,1268,594,674
050,01,077,"Alabama","Lauderdale County",5,59,1292,618,674
050,01,077,"Alabama","Lauderdale County",5,60,1231,612,619
050,01,077,"Alabama","Lauderdale County",5,61,1275,622,653
050,01,077,"Alabama","Lauderdale County",5,62,1332,606,726
050,01,077,"Alabama","Lauderdale County",5,63,1273,572,701
050,01,077,"Alabama","Lauderdale County",5,64,1245,589,656
050,01,077,"Alabama","Lauderdale County",5,65,1309,599,710
050,01,077,"Alabama","Lauderdale County",5,66,1308,581,727
050,01,077,"Alabama","Lauderdale County",5,67,1244,558,686
050,01,077,"Alabama","Lauderdale County",5,68,1237,576,661
050,01,077,"Alabama","Lauderdale County",5,69,1165,581,584
050,01,077,"Alabama","Lauderdale County",5,70,1139,548,591
050,01,077,"Alabama","Lauderdale County",5,71,1121,536,585
050,01,077,"Alabama","Lauderdale County",5,72,1023,468,555
050,01,077,"Alabama","Lauderdale County",5,73,966,454,512
050,01,077,"Alabama","Lauderdale County",5,74,969,446,523
050,01,077,"Alabama","Lauderdale County",5,75,1004,450,554
050,01,077,"Alabama","Lauderdale County",5,76,1058,488,570
050,01,077,"Alabama","Lauderdale County",5,77,692,311,381
050,01,077,"Alabama","Lauderdale County",5,78,644,286,358
050,01,077,"Alabama","Lauderdale County",5,79,641,264,377
050,01,077,"Alabama","Lauderdale County",5,80,672,270,402
050,01,077,"Alabama","Lauderdale County",5,81,568,227,341
050,01,077,"Alabama","Lauderdale County",5,82,501,210,291
050,01,077,"Alabama","Lauderdale County",5,83,474,194,280
050,01,077,"Alabama","Lauderdale County",5,84,415,167,248
050,01,077,"Alabama","Lauderdale County",5,85,2039,677,1362
050,01,079,"Alabama","Lawrence County",1,0,326,166,160
050,01,079,"Alabama","Lawrence County",1,1,322,160,162
050,01,079,"Alabama","Lawrence County",1,2,374,198,176
050,01,079,"Alabama","Lawrence County",1,3,384,202,182
050,01,079,"Alabama","Lawrence County",1,4,385,197,188
050,01,079,"Alabama","Lawrence County",1,5,389,207,182
050,01,079,"Alabama","Lawrence County",1,6,379,179,200
050,01,079,"Alabama","Lawrence County",1,7,391,213,178
050,01,079,"Alabama","Lawrence County",1,8,399,194,205
050,01,079,"Alabama","Lawrence County",1,9,389,200,189
050,01,079,"Alabama","Lawrence County",1,10,408,214,194
050,01,079,"Alabama","Lawrence County",1,11,443,213,230
050,01,079,"Alabama","Lawrence County",1,12,476,237,239
050,01,079,"Alabama","Lawrence County",1,13,472,252,220
050,01,079,"Alabama","Lawrence County",1,14,430,217,213
050,01,079,"Alabama","Lawrence County",1,15,430,225,205
050,01,079,"Alabama","Lawrence County",1,16,429,224,205
050,01,079,"Alabama","Lawrence County",1,17,422,222,200
050,01,079,"Alabama","Lawrence County",1,18,355,195,160
050,01,079,"Alabama","Lawrence County",1,19,313,165,148
050,01,079,"Alabama","Lawrence County",1,20,337,167,170
050,01,079,"Alabama","Lawrence County",1,21,334,176,158
050,01,079,"Alabama","Lawrence County",1,22,337,184,153
050,01,079,"Alabama","Lawrence County",1,23,354,179,175
050,01,079,"Alabama","Lawrence County",1,24,368,171,197
050,01,079,"Alabama","Lawrence County",1,25,402,199,203
050,01,079,"Alabama","Lawrence County",1,26,405,205,200
050,01,079,"Alabama","Lawrence County",1,27,394,203,191
050,01,079,"Alabama","Lawrence County",1,28,415,205,210
050,01,079,"Alabama","Lawrence County",1,29,431,197,234
050,01,079,"Alabama","Lawrence County",1,30,446,223,223
050,01,079,"Alabama","Lawrence County",1,31,405,214,191
050,01,079,"Alabama","Lawrence County",1,32,373,180,193
050,01,079,"Alabama","Lawrence County",1,33,376,177,199
050,01,079,"Alabama","Lawrence County",1,34,359,162,197
050,01,079,"Alabama","Lawrence County",1,35,354,175,179
050,01,079,"Alabama","Lawrence County",1,36,389,204,185
050,01,079,"Alabama","Lawrence County",1,37,394,180,214
050,01,079,"Alabama","Lawrence County",1,38,377,172,205
050,01,079,"Alabama","Lawrence County",1,39,363,185,178
050,01,079,"Alabama","Lawrence County",1,40,364,189,175
050,01,079,"Alabama","Lawrence County",1,41,362,184,178
050,01,079,"Alabama","Lawrence County",1,42,391,203,188
050,01,079,"Alabama","Lawrence County",1,43,378,184,194
050,01,079,"Alabama","Lawrence County",1,44,353,167,186
050,01,079,"Alabama","Lawrence County",1,45,364,177,187
050,01,079,"Alabama","Lawrence County",1,46,429,212,217
050,01,079,"Alabama","Lawrence County",1,47,434,216,218
050,01,079,"Alabama","Lawrence County",1,48,445,214,231
050,01,079,"Alabama","Lawrence County",1,49,485,232,253
050,01,079,"Alabama","Lawrence County",1,50,479,238,241
050,01,079,"Alabama","Lawrence County",1,51,481,251,230
050,01,079,"Alabama","Lawrence County",1,52,473,235,238
050,01,079,"Alabama","Lawrence County",1,53,489,246,243
050,01,079,"Alabama","Lawrence County",1,54,511,264,247
050,01,079,"Alabama","Lawrence County",1,55,532,262,270
050,01,079,"Alabama","Lawrence County",1,56,511,238,273
050,01,079,"Alabama","Lawrence County",1,57,529,256,273
050,01,079,"Alabama","Lawrence County",1,58,525,263,262
050,01,079,"Alabama","Lawrence County",1,59,510,246,264
050,01,079,"Alabama","Lawrence County",1,60,475,225,250
050,01,079,"Alabama","Lawrence County",1,61,471,227,244
050,01,079,"Alabama","Lawrence County",1,62,483,226,257
050,01,079,"Alabama","Lawrence County",1,63,459,212,247
050,01,079,"Alabama","Lawrence County",1,64,424,204,220
050,01,079,"Alabama","Lawrence County",1,65,412,205,207
050,01,079,"Alabama","Lawrence County",1,66,432,213,219
050,01,079,"Alabama","Lawrence County",1,67,386,180,206
050,01,079,"Alabama","Lawrence County",1,68,363,177,186
050,01,079,"Alabama","Lawrence County",1,69,372,185,187
050,01,079,"Alabama","Lawrence County",1,70,387,185,202
050,01,079,"Alabama","Lawrence County",1,71,364,171,193
050,01,079,"Alabama","Lawrence County",1,72,359,164,195
050,01,079,"Alabama","Lawrence County",1,73,369,179,190
050,01,079,"Alabama","Lawrence County",1,74,276,127,149
050,01,079,"Alabama","Lawrence County",1,75,259,104,155
050,01,079,"Alabama","Lawrence County",1,76,281,116,165
050,01,079,"Alabama","Lawrence County",1,77,261,121,140
050,01,079,"Alabama","Lawrence County",1,78,227,111,116
050,01,079,"Alabama","Lawrence County",1,79,182,88,94
050,01,079,"Alabama","Lawrence County",1,80,190,93,97
050,01,079,"Alabama","Lawrence County",1,81,168,76,92
050,01,079,"Alabama","Lawrence County",1,82,157,71,86
050,01,079,"Alabama","Lawrence County",1,83,115,53,62
050,01,079,"Alabama","Lawrence County",1,84,104,51,53
050,01,079,"Alabama","Lawrence County",1,85,524,164,360
050,01,079,"Alabama","Lawrence County",2,0,323,168,155
050,01,079,"Alabama","Lawrence County",2,1,327,162,165
050,01,079,"Alabama","Lawrence County",2,2,362,188,174
050,01,079,"Alabama","Lawrence County",2,3,381,201,180
050,01,079,"Alabama","Lawrence County",2,4,387,200,187
050,01,079,"Alabama","Lawrence County",2,5,392,207,185
050,01,079,"Alabama","Lawrence County",2,6,386,189,197
050,01,079,"Alabama","Lawrence County",2,7,390,205,185
050,01,079,"Alabama","Lawrence County",2,8,396,199,197
050,01,079,"Alabama","Lawrence County",2,9,392,201,191
050,01,079,"Alabama","Lawrence County",2,10,403,210,193
050,01,079,"Alabama","Lawrence County",2,11,432,212,220
050,01,079,"Alabama","Lawrence County",2,12,472,234,238
050,01,079,"Alabama","Lawrence County",2,13,472,248,224
050,01,079,"Alabama","Lawrence County",2,14,440,227,213
050,01,079,"Alabama","Lawrence County",2,15,431,224,207
050,01,079,"Alabama","Lawrence County",2,16,429,225,204
050,01,079,"Alabama","Lawrence County",2,17,422,223,199
050,01,079,"Alabama","Lawrence County",2,18,356,197,159
050,01,079,"Alabama","Lawrence County",2,19,310,164,146
050,01,079,"Alabama","Lawrence County",2,20,339,170,169
050,01,079,"Alabama","Lawrence County",2,21,338,177,161
050,01,079,"Alabama","Lawrence County",2,22,340,184,156
050,01,079,"Alabama","Lawrence County",2,23,357,184,173
050,01,079,"Alabama","Lawrence County",2,24,367,175,192
050,01,079,"Alabama","Lawrence County",2,25,396,195,201
050,01,079,"Alabama","Lawrence County",2,26,409,206,203
050,01,079,"Alabama","Lawrence County",2,27,400,206,194
050,01,079,"Alabama","Lawrence County",2,28,412,205,207
050,01,079,"Alabama","Lawrence County",2,29,431,201,230
050,01,079,"Alabama","Lawrence County",2,30,443,219,224
050,01,079,"Alabama","Lawrence County",2,31,417,217,200
050,01,079,"Alabama","Lawrence County",2,32,383,189,194
050,01,079,"Alabama","Lawrence County",2,33,372,175,197
050,01,079,"Alabama","Lawrence County",2,34,363,165,198
050,01,079,"Alabama","Lawrence County",2,35,358,173,185
050,01,079,"Alabama","Lawrence County",2,36,377,195,182
050,01,079,"Alabama","Lawrence County",2,37,396,187,209
050,01,079,"Alabama","Lawrence County",2,38,386,177,209
050,01,079,"Alabama","Lawrence County",2,39,366,181,185
050,01,079,"Alabama","Lawrence County",2,40,363,188,175
050,01,079,"Alabama","Lawrence County",2,41,357,184,173
050,01,079,"Alabama","Lawrence County",2,42,379,194,185
050,01,079,"Alabama","Lawrence County",2,43,385,191,194
050,01,079,"Alabama","Lawrence County",2,44,356,168,188
050,01,079,"Alabama","Lawrence County",2,45,364,177,187
050,01,079,"Alabama","Lawrence County",2,46,410,201,209
050,01,079,"Alabama","Lawrence County",2,47,434,214,220
050,01,079,"Alabama","Lawrence County",2,48,442,213,229
050,01,079,"Alabama","Lawrence County",2,49,480,229,251
050,01,079,"Alabama","Lawrence County",2,50,482,237,245
050,01,079,"Alabama","Lawrence County",2,51,478,247,231
050,01,079,"Alabama","Lawrence County",2,52,471,238,233
050,01,079,"Alabama","Lawrence County",2,53,488,245,243
050,01,079,"Alabama","Lawrence County",2,54,504,259,245
050,01,079,"Alabama","Lawrence County",2,55,528,262,266
050,01,079,"Alabama","Lawrence County",2,56,515,244,271
050,01,079,"Alabama","Lawrence County",2,57,524,252,272
050,01,079,"Alabama","Lawrence County",2,58,523,259,264
050,01,079,"Alabama","Lawrence County",2,59,510,246,264
050,01,079,"Alabama","Lawrence County",2,60,481,229,252
050,01,079,"Alabama","Lawrence County",2,61,471,228,243
050,01,079,"Alabama","Lawrence County",2,62,477,224,253
050,01,079,"Alabama","Lawrence County",2,63,464,213,251
050,01,079,"Alabama","Lawrence County",2,64,428,202,226
050,01,079,"Alabama","Lawrence County",2,65,417,207,210
050,01,079,"Alabama","Lawrence County",2,66,425,210,215
050,01,079,"Alabama","Lawrence County",2,67,395,188,207
050,01,079,"Alabama","Lawrence County",2,68,367,177,190
050,01,079,"Alabama","Lawrence County",2,69,372,185,187
050,01,079,"Alabama","Lawrence County",2,70,377,182,195
050,01,079,"Alabama","Lawrence County",2,71,365,170,195
050,01,079,"Alabama","Lawrence County",2,72,351,160,191
050,01,079,"Alabama","Lawrence County",2,73,383,184,199
050,01,079,"Alabama","Lawrence County",2,74,278,129,149
050,01,079,"Alabama","Lawrence County",2,75,262,108,154
050,01,079,"Alabama","Lawrence County",2,76,265,106,159
050,01,079,"Alabama","Lawrence County",2,77,270,121,149
050,01,079,"Alabama","Lawrence County",2,78,229,110,119
050,01,079,"Alabama","Lawrence County",2,79,187,88,99
050,01,079,"Alabama","Lawrence County",2,80,189,93,96
050,01,079,"Alabama","Lawrence County",2,81,174,81,93
050,01,079,"Alabama","Lawrence County",2,82,157,72,85
050,01,079,"Alabama","Lawrence County",2,83,122,55,67
050,01,079,"Alabama","Lawrence County",2,84,106,51,55
050,01,079,"Alabama","Lawrence County",2,85,531,170,361
050,01,079,"Alabama","Lawrence County",3,0,369,182,187
050,01,079,"Alabama","Lawrence County",3,1,323,167,156
050,01,079,"Alabama","Lawrence County",3,2,342,171,171
050,01,079,"Alabama","Lawrence County",3,3,357,182,175
050,01,079,"Alabama","Lawrence County",3,4,394,208,186
050,01,079,"Alabama","Lawrence County",3,5,382,199,183
050,01,079,"Alabama","Lawrence County",3,6,392,210,182
050,01,079,"Alabama","Lawrence County",3,7,388,192,196
050,01,079,"Alabama","Lawrence County",3,8,385,211,174
050,01,079,"Alabama","Lawrence County",3,9,396,203,193
050,01,079,"Alabama","Lawrence County",3,10,404,203,201
050,01,079,"Alabama","Lawrence County",3,11,409,211,198
050,01,079,"Alabama","Lawrence County",3,12,444,216,228
050,01,079,"Alabama","Lawrence County",3,13,491,242,249
050,01,079,"Alabama","Lawrence County",3,14,485,260,225
050,01,079,"Alabama","Lawrence County",3,15,438,225,213
050,01,079,"Alabama","Lawrence County",3,16,438,225,213
050,01,079,"Alabama","Lawrence County",3,17,434,232,202
050,01,079,"Alabama","Lawrence County",3,18,372,204,168
050,01,079,"Alabama","Lawrence County",3,19,300,170,130
050,01,079,"Alabama","Lawrence County",3,20,321,163,158
050,01,079,"Alabama","Lawrence County",3,21,346,172,174
050,01,079,"Alabama","Lawrence County",3,22,358,183,175
050,01,079,"Alabama","Lawrence County",3,23,362,196,166
050,01,079,"Alabama","Lawrence County",3,24,384,198,186
050,01,079,"Alabama","Lawrence County",3,25,378,189,189
050,01,079,"Alabama","Lawrence County",3,26,383,185,198
050,01,079,"Alabama","Lawrence County",3,27,415,211,204
050,01,079,"Alabama","Lawrence County",3,28,396,207,189
050,01,079,"Alabama","Lawrence County",3,29,400,201,199
050,01,079,"Alabama","Lawrence County",3,30,416,196,220
050,01,079,"Alabama","Lawrence County",3,31,459,223,236
050,01,079,"Alabama","Lawrence County",3,32,404,217,187
050,01,079,"Alabama","Lawrence County",3,33,394,186,208
050,01,079,"Alabama","Lawrence County",3,34,371,178,193
050,01,079,"Alabama","Lawrence County",3,35,367,167,200
050,01,079,"Alabama","Lawrence County",3,36,356,170,186
050,01,079,"Alabama","Lawrence County",3,37,394,206,188
050,01,079,"Alabama","Lawrence County",3,38,405,196,209
050,01,079,"Alabama","Lawrence County",3,39,360,165,195
050,01,079,"Alabama","Lawrence County",3,40,372,190,182
050,01,079,"Alabama","Lawrence County",3,41,374,192,182
050,01,079,"Alabama","Lawrence County",3,42,349,179,170
050,01,079,"Alabama","Lawrence County",3,43,382,193,189
050,01,079,"Alabama","Lawrence County",3,44,382,188,194
050,01,079,"Alabama","Lawrence County",3,45,363,172,191
050,01,079,"Alabama","Lawrence County",3,46,373,181,192
050,01,079,"Alabama","Lawrence County",3,47,419,208,211
050,01,079,"Alabama","Lawrence County",3,48,428,208,220
050,01,079,"Alabama","Lawrence County",3,49,449,215,234
050,01,079,"Alabama","Lawrence County",3,50,479,229,250
050,01,079,"Alabama","Lawrence County",3,51,478,234,244
050,01,079,"Alabama","Lawrence County",3,52,486,252,234
050,01,079,"Alabama","Lawrence County",3,53,480,243,237
050,01,079,"Alabama","Lawrence County",3,54,487,242,245
050,01,079,"Alabama","Lawrence County",3,55,498,249,249
050,01,079,"Alabama","Lawrence County",3,56,518,253,265
050,01,079,"Alabama","Lawrence County",3,57,504,242,262
050,01,079,"Alabama","Lawrence County",3,58,518,246,272
050,01,079,"Alabama","Lawrence County",3,59,524,264,260
050,01,079,"Alabama","Lawrence County",3,60,507,242,265
050,01,079,"Alabama","Lawrence County",3,61,472,225,247
050,01,079,"Alabama","Lawrence County",3,62,472,227,245
050,01,079,"Alabama","Lawrence County",3,63,469,217,252
050,01,079,"Alabama","Lawrence County",3,64,455,208,247
050,01,079,"Alabama","Lawrence County",3,65,420,194,226
050,01,079,"Alabama","Lawrence County",3,66,411,203,208
050,01,079,"Alabama","Lawrence County",3,67,411,203,208
050,01,079,"Alabama","Lawrence County",3,68,382,177,205
050,01,079,"Alabama","Lawrence County",3,69,354,170,184
050,01,079,"Alabama","Lawrence County",3,70,360,176,184
050,01,079,"Alabama","Lawrence County",3,71,355,170,185
050,01,079,"Alabama","Lawrence County",3,72,346,155,191
050,01,079,"Alabama","Lawrence County",3,73,329,153,176
050,01,079,"Alabama","Lawrence County",3,74,367,175,192
050,01,079,"Alabama","Lawrence County",3,75,266,125,141
050,01,079,"Alabama","Lawrence County",3,76,251,101,150
050,01,079,"Alabama","Lawrence County",3,77,240,97,143
050,01,079,"Alabama","Lawrence County",3,78,248,114,134
050,01,079,"Alabama","Lawrence County",3,79,208,94,114
050,01,079,"Alabama","Lawrence County",3,80,175,84,91
050,01,079,"Alabama","Lawrence County",3,81,174,79,95
050,01,079,"Alabama","Lawrence County",3,82,149,71,78
050,01,079,"Alabama","Lawrence County",3,83,149,65,84
050,01,079,"Alabama","Lawrence County",3,84,103,48,55
050,01,079,"Alabama","Lawrence County",3,85,525,174,351
050,01,079,"Alabama","Lawrence County",4,0,378,206,172
050,01,079,"Alabama","Lawrence County",4,1,362,184,178
050,01,079,"Alabama","Lawrence County",4,2,344,179,165
050,01,079,"Alabama","Lawrence County",4,3,366,180,186
050,01,079,"Alabama","Lawrence County",4,4,363,190,173
050,01,079,"Alabama","Lawrence County",4,5,390,205,185
050,01,079,"Alabama","Lawrence County",4,6,405,210,195
050,01,079,"Alabama","Lawrence County",4,7,410,216,194
050,01,079,"Alabama","Lawrence County",4,8,380,184,196
050,01,079,"Alabama","Lawrence County",4,9,404,211,193
050,01,079,"Alabama","Lawrence County",4,10,401,202,199
050,01,079,"Alabama","Lawrence County",4,11,396,199,197
050,01,079,"Alabama","Lawrence County",4,12,405,206,199
050,01,079,"Alabama","Lawrence County",4,13,449,215,234
050,01,079,"Alabama","Lawrence County",4,14,483,237,246
050,01,079,"Alabama","Lawrence County",4,15,470,252,218
050,01,079,"Alabama","Lawrence County",4,16,450,235,215
050,01,079,"Alabama","Lawrence County",4,17,431,218,213
050,01,079,"Alabama","Lawrence County",4,18,372,203,169
050,01,079,"Alabama","Lawrence County",4,19,285,161,124
050,01,079,"Alabama","Lawrence County",4,20,310,171,139
050,01,079,"Alabama","Lawrence County",4,21,348,176,172
050,01,079,"Alabama","Lawrence County",4,22,393,199,194
050,01,079,"Alabama","Lawrence County",4,23,374,194,180
050,01,079,"Alabama","Lawrence County",4,24,370,204,166
050,01,079,"Alabama","Lawrence County",4,25,384,202,182
050,01,079,"Alabama","Lawrence County",4,26,380,184,196
050,01,079,"Alabama","Lawrence County",4,27,390,185,205
050,01,079,"Alabama","Lawrence County",4,28,436,206,230
050,01,079,"Alabama","Lawrence County",4,29,394,206,188
050,01,079,"Alabama","Lawrence County",4,30,413,210,203
050,01,079,"Alabama","Lawrence County",4,31,422,197,225
050,01,079,"Alabama","Lawrence County",4,32,468,229,239
050,01,079,"Alabama","Lawrence County",4,33,414,221,193
050,01,079,"Alabama","Lawrence County",4,34,401,181,220
050,01,079,"Alabama","Lawrence County",4,35,365,176,189
050,01,079,"Alabama","Lawrence County",4,36,367,167,200
050,01,079,"Alabama","Lawrence County",4,37,370,175,195
050,01,079,"Alabama","Lawrence County",4,38,390,204,186
050,01,079,"Alabama","Lawrence County",4,39,391,188,203
050,01,079,"Alabama","Lawrence County",4,40,369,171,198
050,01,079,"Alabama","Lawrence County",4,41,385,194,191
050,01,079,"Alabama","Lawrence County",4,42,379,194,185
050,01,079,"Alabama","Lawrence County",4,43,354,181,173
050,01,079,"Alabama","Lawrence County",4,44,384,190,194
050,01,079,"Alabama","Lawrence County",4,45,393,201,192
050,01,079,"Alabama","Lawrence County",4,46,376,184,192
050,01,079,"Alabama","Lawrence County",4,47,360,169,191
050,01,079,"Alabama","Lawrence County",4,48,423,206,217
050,01,079,"Alabama","Lawrence County",4,49,440,211,229
050,01,079,"Alabama","Lawrence County",4,50,449,218,231
050,01,079,"Alabama","Lawrence County",4,51,480,229,251
050,01,079,"Alabama","Lawrence County",4,52,477,233,244
050,01,079,"Alabama","Lawrence County",4,53,481,246,235
050,01,079,"Alabama","Lawrence County",4,54,471,234,237
050,01,079,"Alabama","Lawrence County",4,55,492,241,251
050,01,079,"Alabama","Lawrence County",4,56,512,254,258
050,01,079,"Alabama","Lawrence County",4,57,522,260,262
050,01,079,"Alabama","Lawrence County",4,58,496,239,257
050,01,079,"Alabama","Lawrence County",4,59,510,241,269
050,01,079,"Alabama","Lawrence County",4,60,526,262,264
050,01,079,"Alabama","Lawrence County",4,61,498,241,257
050,01,079,"Alabama","Lawrence County",4,62,464,220,244
050,01,079,"Alabama","Lawrence County",4,63,465,227,238
050,01,079,"Alabama","Lawrence County",4,64,462,213,249
050,01,079,"Alabama","Lawrence County",4,65,449,205,244
050,01,079,"Alabama","Lawrence County",4,66,413,193,220
050,01,079,"Alabama","Lawrence County",4,67,394,192,202
050,01,079,"Alabama","Lawrence County",4,68,395,192,203
050,01,079,"Alabama","Lawrence County",4,69,364,169,195
050,01,079,"Alabama","Lawrence County",4,70,342,165,177
050,01,079,"Alabama","Lawrence County",4,71,354,172,182
050,01,079,"Alabama","Lawrence County",4,72,350,165,185
050,01,079,"Alabama","Lawrence County",4,73,325,144,181
050,01,079,"Alabama","Lawrence County",4,74,314,145,169
050,01,079,"Alabama","Lawrence County",4,75,345,167,178
050,01,079,"Alabama","Lawrence County",4,76,254,115,139
050,01,079,"Alabama","Lawrence County",4,77,228,95,133
050,01,079,"Alabama","Lawrence County",4,78,229,91,138
050,01,079,"Alabama","Lawrence County",4,79,228,97,131
050,01,079,"Alabama","Lawrence County",4,80,199,92,107
050,01,079,"Alabama","Lawrence County",4,81,163,70,93
050,01,079,"Alabama","Lawrence County",4,82,156,72,84
050,01,079,"Alabama","Lawrence County",4,83,137,63,74
050,01,079,"Alabama","Lawrence County",4,84,134,61,73
050,01,079,"Alabama","Lawrence County",4,85,522,173,349
050,01,079,"Alabama","Lawrence County",5,0,383,208,175
050,01,079,"Alabama","Lawrence County",5,1,379,211,168
050,01,079,"Alabama","Lawrence County",5,2,367,173,194
050,01,079,"Alabama","Lawrence County",5,3,356,187,169
050,01,079,"Alabama","Lawrence County",5,4,367,173,194
050,01,079,"Alabama","Lawrence County",5,5,375,203,172
050,01,079,"Alabama","Lawrence County",5,6,407,218,189
050,01,079,"Alabama","Lawrence County",5,7,413,213,200
050,01,079,"Alabama","Lawrence County",5,8,414,216,198
050,01,079,"Alabama","Lawrence County",5,9,390,192,198
050,01,079,"Alabama","Lawrence County",5,10,409,216,193
050,01,079,"Alabama","Lawrence County",5,11,403,201,202
050,01,079,"Alabama","Lawrence County",5,12,408,205,203
050,01,079,"Alabama","Lawrence County",5,13,402,204,198
050,01,079,"Alabama","Lawrence County",5,14,447,219,228
050,01,079,"Alabama","Lawrence County",5,15,482,240,242
050,01,079,"Alabama","Lawrence County",5,16,473,246,227
050,01,079,"Alabama","Lawrence County",5,17,441,235,206
050,01,079,"Alabama","Lawrence County",5,18,374,201,173
050,01,079,"Alabama","Lawrence County",5,19,289,155,134
050,01,079,"Alabama","Lawrence County",5,20,317,168,149
050,01,079,"Alabama","Lawrence County",5,21,345,185,160
050,01,079,"Alabama","Lawrence County",5,22,390,197,193
050,01,079,"Alabama","Lawrence County",5,23,426,215,211
050,01,079,"Alabama","Lawrence County",5,24,385,202,183
050,01,079,"Alabama","Lawrence County",5,25,395,215,180
050,01,079,"Alabama","Lawrence County",5,26,392,200,192
050,01,079,"Alabama","Lawrence County",5,27,399,188,211
050,01,079,"Alabama","Lawrence County",5,28,393,183,210
050,01,079,"Alabama","Lawrence County",5,29,448,214,234
050,01,079,"Alabama","Lawrence County",5,30,390,207,183
050,01,079,"Alabama","Lawrence County",5,31,428,212,216
050,01,079,"Alabama","Lawrence County",5,32,429,202,227
050,01,079,"Alabama","Lawrence County",5,33,492,242,250
050,01,079,"Alabama","Lawrence County",5,34,406,222,184
050,01,079,"Alabama","Lawrence County",5,35,411,184,227
050,01,079,"Alabama","Lawrence County",5,36,359,172,187
050,01,079,"Alabama","Lawrence County",5,37,371,167,204
050,01,079,"Alabama","Lawrence County",5,38,379,181,198
050,01,079,"Alabama","Lawrence County",5,39,382,200,182
050,01,079,"Alabama","Lawrence County",5,40,398,193,205
050,01,079,"Alabama","Lawrence County",5,41,377,180,197
050,01,079,"Alabama","Lawrence County",5,42,386,193,193
050,01,079,"Alabama","Lawrence County",5,43,373,196,177
050,01,079,"Alabama","Lawrence County",5,44,354,177,177
050,01,079,"Alabama","Lawrence County",5,45,392,196,196
050,01,079,"Alabama","Lawrence County",5,46,392,199,193
050,01,079,"Alabama","Lawrence County",5,47,374,186,188
050,01,079,"Alabama","Lawrence County",5,48,371,174,197
050,01,079,"Alabama","Lawrence County",5,49,438,214,224
050,01,079,"Alabama","Lawrence County",5,50,447,216,231
050,01,079,"Alabama","Lawrence County",5,51,447,217,230
050,01,079,"Alabama","Lawrence County",5,52,486,232,254
050,01,079,"Alabama","Lawrence County",5,53,473,228,245
050,01,079,"Alabama","Lawrence County",5,54,500,250,250
050,01,079,"Alabama","Lawrence County",5,55,468,230,238
050,01,079,"Alabama","Lawrence County",5,56,492,239,253
050,01,079,"Alabama","Lawrence County",5,57,501,251,250
050,01,079,"Alabama","Lawrence County",5,58,527,258,269
050,01,079,"Alabama","Lawrence County",5,59,497,238,259
050,01,079,"Alabama","Lawrence County",5,60,515,238,277
050,01,079,"Alabama","Lawrence County",5,61,518,261,257
050,01,079,"Alabama","Lawrence County",5,62,500,243,257
050,01,079,"Alabama","Lawrence County",5,63,463,220,243
050,01,079,"Alabama","Lawrence County",5,64,464,220,244
050,01,079,"Alabama","Lawrence County",5,65,470,214,256
050,01,079,"Alabama","Lawrence County",5,66,437,197,240
050,01,079,"Alabama","Lawrence County",5,67,402,189,213
050,01,079,"Alabama","Lawrence County",5,68,386,182,204
050,01,079,"Alabama","Lawrence County",5,69,379,185,194
050,01,079,"Alabama","Lawrence County",5,70,357,166,191
050,01,079,"Alabama","Lawrence County",5,71,334,160,174
050,01,079,"Alabama","Lawrence County",5,72,340,164,176
050,01,079,"Alabama","Lawrence County",5,73,338,157,181
050,01,079,"Alabama","Lawrence County",5,74,315,139,176
050,01,079,"Alabama","Lawrence County",5,75,299,144,155
050,01,079,"Alabama","Lawrence County",5,76,333,160,173
050,01,079,"Alabama","Lawrence County",5,77,233,104,129
050,01,079,"Alabama","Lawrence County",5,78,219,90,129
050,01,079,"Alabama","Lawrence County",5,79,209,74,135
050,01,079,"Alabama","Lawrence County",5,80,222,94,128
050,01,079,"Alabama","Lawrence County",5,81,188,80,108
050,01,079,"Alabama","Lawrence County",5,82,144,63,81
050,01,079,"Alabama","Lawrence County",5,83,148,67,81
050,01,079,"Alabama","Lawrence County",5,84,123,58,65
050,01,079,"Alabama","Lawrence County",5,85,557,193,364
050,01,081,"Alabama","Lee County",1,0,1856,952,904
050,01,081,"Alabama","Lee County",1,1,1914,1007,907
050,01,081,"Alabama","Lee County",1,2,1960,1040,920
050,01,081,"Alabama","Lee County",1,3,2046,1046,1000
050,01,081,"Alabama","Lee County",1,4,2086,1032,1054
050,01,081,"Alabama","Lee County",1,5,2084,1063,1021
050,01,081,"Alabama","Lee County",1,6,2006,1063,943
050,01,081,"Alabama","Lee County",1,7,2008,1008,1000
050,01,081,"Alabama","Lee County",1,8,1989,1008,981
050,01,081,"Alabama","Lee County",1,9,2049,1111,938
050,01,081,"Alabama","Lee County",1,10,2114,1105,1009
050,01,081,"Alabama","Lee County",1,11,2152,1075,1077
050,01,081,"Alabama","Lee County",1,12,2264,1163,1101
050,01,081,"Alabama","Lee County",1,13,2270,1163,1107
050,01,081,"Alabama","Lee County",1,14,2206,1151,1055
050,01,081,"Alabama","Lee County",1,15,2148,1114,1034
050,01,081,"Alabama","Lee County",1,16,2057,1042,1015
050,01,081,"Alabama","Lee County",1,17,2057,1067,990
050,01,081,"Alabama","Lee County",1,18,3130,1477,1653
050,01,081,"Alabama","Lee County",1,19,5045,2509,2536
050,01,081,"Alabama","Lee County",1,20,5086,2497,2589
050,01,081,"Alabama","Lee County",1,21,4997,2621,2376
050,01,081,"Alabama","Lee County",1,22,4935,2658,2277
050,01,081,"Alabama","Lee County",1,23,4038,2194,1844
050,01,081,"Alabama","Lee County",1,24,3114,1636,1478
050,01,081,"Alabama","Lee County",1,25,2715,1407,1308
050,01,081,"Alabama","Lee County",1,26,2571,1294,1277
050,01,081,"Alabama","Lee County",1,27,2433,1192,1241
050,01,081,"Alabama","Lee County",1,28,2419,1195,1224
050,01,081,"Alabama","Lee County",1,29,2430,1197,1233
050,01,081,"Alabama","Lee County",1,30,2406,1197,1209
050,01,081,"Alabama","Lee County",1,31,2282,1136,1146
050,01,081,"Alabama","Lee County",1,32,2262,1093,1169
050,01,081,"Alabama","Lee County",1,33,2220,1065,1155
050,01,081,"Alabama","Lee County",1,34,2179,1076,1103
050,01,081,"Alabama","Lee County",1,35,2244,1100,1144
050,01,081,"Alabama","Lee County",1,36,2277,1098,1179
050,01,081,"Alabama","Lee County",1,37,2231,1110,1121
050,01,081,"Alabama","Lee County",1,38,2182,1069,1113
050,01,081,"Alabama","Lee County",1,39,2205,1055,1150
050,01,081,"Alabama","Lee County",1,40,2198,1067,1131
050,01,081,"Alabama","Lee County",1,41,2124,1031,1093
050,01,081,"Alabama","Lee County",1,42,2128,1050,1078
050,01,081,"Alabama","Lee County",1,43,1990,982,1008
050,01,081,"Alabama","Lee County",1,44,1944,939,1005
050,01,081,"Alabama","Lee County",1,45,1975,948,1027
050,01,081,"Alabama","Lee County",1,46,1918,912,1006
050,01,081,"Alabama","Lee County",1,47,2035,961,1074
050,01,081,"Alabama","Lee County",1,48,2129,1036,1093
050,01,081,"Alabama","Lee County",1,49,2271,1121,1150
050,01,081,"Alabama","Lee County",1,50,2131,1029,1102
050,01,081,"Alabama","Lee County",1,51,2020,983,1037
050,01,081,"Alabama","Lee County",1,52,1958,963,995
050,01,081,"Alabama","Lee County",1,53,1897,943,954
050,01,081,"Alabama","Lee County",1,54,1931,958,973
050,01,081,"Alabama","Lee County",1,55,2022,1024,998
050,01,081,"Alabama","Lee County",1,56,2038,997,1041
050,01,081,"Alabama","Lee County",1,57,2037,995,1042
050,01,081,"Alabama","Lee County",1,58,2047,994,1053
050,01,081,"Alabama","Lee County",1,59,1973,979,994
050,01,081,"Alabama","Lee County",1,60,1966,997,969
050,01,081,"Alabama","Lee County",1,61,1880,919,961
050,01,081,"Alabama","Lee County",1,62,1851,876,975
050,01,081,"Alabama","Lee County",1,63,1815,873,942
050,01,081,"Alabama","Lee County",1,64,1757,858,899
050,01,081,"Alabama","Lee County",1,65,1625,751,874
050,01,081,"Alabama","Lee County",1,66,1506,697,809
050,01,081,"Alabama","Lee County",1,67,1501,709,792
050,01,081,"Alabama","Lee County",1,68,1510,674,836
050,01,081,"Alabama","Lee County",1,69,1397,641,756
050,01,081,"Alabama","Lee County",1,70,1364,646,718
050,01,081,"Alabama","Lee County",1,71,1305,649,656
050,01,081,"Alabama","Lee County",1,72,1317,641,676
050,01,081,"Alabama","Lee County",1,73,1263,568,695
050,01,081,"Alabama","Lee County",1,74,890,420,470
050,01,081,"Alabama","Lee County",1,75,859,409,450
050,01,081,"Alabama","Lee County",1,76,842,388,454
050,01,081,"Alabama","Lee County",1,77,793,368,425
050,01,081,"Alabama","Lee County",1,78,670,304,366
050,01,081,"Alabama","Lee County",1,79,619,268,351
050,01,081,"Alabama","Lee County",1,80,544,231,313
050,01,081,"Alabama","Lee County",1,81,509,219,290
050,01,081,"Alabama","Lee County",1,82,452,194,258
050,01,081,"Alabama","Lee County",1,83,399,171,228
050,01,081,"Alabama","Lee County",1,84,354,147,207
050,01,081,"Alabama","Lee County",1,85,1826,619,1207
050,01,081,"Alabama","Lee County",2,0,1861,941,920
050,01,081,"Alabama","Lee County",2,1,1899,996,903
050,01,081,"Alabama","Lee County",2,2,1957,1032,925
050,01,081,"Alabama","Lee County",2,3,2026,1047,979
050,01,081,"Alabama","Lee County",2,4,2085,1039,1046
050,01,081,"Alabama","Lee County",2,5,2091,1060,1031
050,01,081,"Alabama","Lee County",2,6,2032,1063,969
050,01,081,"Alabama","Lee County",2,7,2010,1022,988
050,01,081,"Alabama","Lee County",2,8,1993,1010,983
050,01,081,"Alabama","Lee County",2,9,2040,1092,948
050,01,081,"Alabama","Lee County",2,10,2099,1108,991
050,01,081,"Alabama","Lee County",2,11,2140,1082,1058
050,01,081,"Alabama","Lee County",2,12,2250,1149,1101
050,01,081,"Alabama","Lee County",2,13,2275,1167,1108
050,01,081,"Alabama","Lee County",2,14,2230,1157,1073
050,01,081,"Alabama","Lee County",2,15,2163,1122,1041
050,01,081,"Alabama","Lee County",2,16,2090,1064,1026
050,01,081,"Alabama","Lee County",2,17,2069,1070,999
050,01,081,"Alabama","Lee County",2,18,3131,1480,1651
050,01,081,"Alabama","Lee County",2,19,5022,2500,2522
050,01,081,"Alabama","Lee County",2,20,5114,2506,2608
050,01,081,"Alabama","Lee County",2,21,4991,2615,2376
050,01,081,"Alabama","Lee County",2,22,4902,2632,2270
050,01,081,"Alabama","Lee County",2,23,4013,2186,1827
050,01,081,"Alabama","Lee County",2,24,3120,1637,1483
050,01,081,"Alabama","Lee County",2,25,2720,1412,1308
050,01,081,"Alabama","Lee County",2,26,2550,1291,1259
050,01,081,"Alabama","Lee County",2,27,2422,1192,1230
050,01,081,"Alabama","Lee County",2,28,2405,1189,1216
050,01,081,"Alabama","Lee County",2,29,2423,1196,1227
050,01,081,"Alabama","Lee County",2,30,2419,1197,1222
050,01,081,"Alabama","Lee County",2,31,2312,1150,1162
050,01,081,"Alabama","Lee County",2,32,2269,1100,1169
050,01,081,"Alabama","Lee County",2,33,2222,1065,1157
050,01,081,"Alabama","Lee County",2,34,2196,1077,1119
050,01,081,"Alabama","Lee County",2,35,2253,1103,1150
050,01,081,"Alabama","Lee County",2,36,2261,1096,1165
050,01,081,"Alabama","Lee County",2,37,2246,1111,1135
050,01,081,"Alabama","Lee County",2,38,2200,1082,1118
050,01,081,"Alabama","Lee County",2,39,2197,1061,1136
050,01,081,"Alabama","Lee County",2,40,2221,1073,1148
050,01,081,"Alabama","Lee County",2,41,2152,1042,1110
050,01,081,"Alabama","Lee County",2,42,2121,1042,1079
050,01,081,"Alabama","Lee County",2,43,2041,1009,1032
050,01,081,"Alabama","Lee County",2,44,1942,946,996
050,01,081,"Alabama","Lee County",2,45,1984,956,1028
050,01,081,"Alabama","Lee County",2,46,1934,923,1011
050,01,081,"Alabama","Lee County",2,47,2010,951,1059
050,01,081,"Alabama","Lee County",2,48,2107,1016,1091
050,01,081,"Alabama","Lee County",2,49,2248,1101,1147
050,01,081,"Alabama","Lee County",2,50,2172,1054,1118
050,01,081,"Alabama","Lee County",2,51,2039,991,1048
050,01,081,"Alabama","Lee County",2,52,1968,967,1001
050,01,081,"Alabama","Lee County",2,53,1916,948,968
050,01,081,"Alabama","Lee County",2,54,1925,960,965
050,01,081,"Alabama","Lee County",2,55,1999,1007,992
050,01,081,"Alabama","Lee County",2,56,2045,1009,1036
050,01,081,"Alabama","Lee County",2,57,2040,997,1043
050,01,081,"Alabama","Lee County",2,58,2047,997,1050
050,01,081,"Alabama","Lee County",2,59,1992,981,1011
050,01,081,"Alabama","Lee County",2,60,1964,991,973
050,01,081,"Alabama","Lee County",2,61,1903,939,964
050,01,081,"Alabama","Lee County",2,62,1852,885,967
050,01,081,"Alabama","Lee County",2,63,1838,882,956
050,01,081,"Alabama","Lee County",2,64,1760,855,905
050,01,081,"Alabama","Lee County",2,65,1648,774,874
050,01,081,"Alabama","Lee County",2,66,1541,714,827
050,01,081,"Alabama","Lee County",2,67,1504,707,797
050,01,081,"Alabama","Lee County",2,68,1505,680,825
050,01,081,"Alabama","Lee County",2,69,1436,652,784
050,01,081,"Alabama","Lee County",2,70,1366,641,725
050,01,081,"Alabama","Lee County",2,71,1318,646,672
050,01,081,"Alabama","Lee County",2,72,1291,628,663
050,01,081,"Alabama","Lee County",2,73,1326,615,711
050,01,081,"Alabama","Lee County",2,74,926,430,496
050,01,081,"Alabama","Lee County",2,75,867,412,455
050,01,081,"Alabama","Lee County",2,76,842,391,451
050,01,081,"Alabama","Lee County",2,77,815,375,440
050,01,081,"Alabama","Lee County",2,78,688,317,371
050,01,081,"Alabama","Lee County",2,79,620,269,351
050,01,081,"Alabama","Lee County",2,80,554,235,319
050,01,081,"Alabama","Lee County",2,81,510,219,291
050,01,081,"Alabama","Lee County",2,82,463,196,267
050,01,081,"Alabama","Lee County",2,83,403,175,228
050,01,081,"Alabama","Lee County",2,84,357,147,210
050,01,081,"Alabama","Lee County",2,85,1856,631,1225
050,01,081,"Alabama","Lee County",3,0,1781,889,892
050,01,081,"Alabama","Lee County",3,1,1906,978,928
050,01,081,"Alabama","Lee County",3,2,1929,1004,925
050,01,081,"Alabama","Lee County",3,3,1999,1072,927
050,01,081,"Alabama","Lee County",3,4,2065,1083,982
050,01,081,"Alabama","Lee County",3,5,2111,1065,1046
050,01,081,"Alabama","Lee County",3,6,2135,1068,1067
050,01,081,"Alabama","Lee County",3,7,2102,1082,1020
050,01,081,"Alabama","Lee County",3,8,2044,1032,1012
050,01,081,"Alabama","Lee County",3,9,2028,1041,987
050,01,081,"Alabama","Lee County",3,10,2038,1083,955
050,01,081,"Alabama","Lee County",3,11,2115,1117,998
050,01,081,"Alabama","Lee County",3,12,2175,1130,1045
050,01,081,"Alabama","Lee County",3,13,2291,1165,1126
050,01,081,"Alabama","Lee County",3,14,2245,1165,1080
050,01,081,"Alabama","Lee County",3,15,2299,1196,1103
050,01,081,"Alabama","Lee County",3,16,2186,1125,1061
050,01,081,"Alabama","Lee County",3,17,2116,1062,1054
050,01,081,"Alabama","Lee County",3,18,3184,1522,1662
050,01,081,"Alabama","Lee County",3,19,4993,2492,2501
050,01,081,"Alabama","Lee County",3,20,5076,2492,2584
050,01,081,"Alabama","Lee County",3,21,5045,2618,2427
050,01,081,"Alabama","Lee County",3,22,4860,2650,2210
050,01,081,"Alabama","Lee County",3,23,3959,2170,1789
050,01,081,"Alabama","Lee County",3,24,3148,1613,1535
050,01,081,"Alabama","Lee County",3,25,2839,1425,1414
050,01,081,"Alabama","Lee County",3,26,2530,1316,1214
050,01,081,"Alabama","Lee County",3,27,2447,1207,1240
050,01,081,"Alabama","Lee County",3,28,2405,1194,1211
050,01,081,"Alabama","Lee County",3,29,2424,1198,1226
050,01,081,"Alabama","Lee County",3,30,2450,1213,1237
050,01,081,"Alabama","Lee County",3,31,2412,1192,1220
050,01,081,"Alabama","Lee County",3,32,2346,1153,1193
050,01,081,"Alabama","Lee County",3,33,2251,1059,1192
050,01,081,"Alabama","Lee County",3,34,2247,1080,1167
050,01,081,"Alabama","Lee County",3,35,2231,1080,1151
050,01,081,"Alabama","Lee County",3,36,2260,1094,1166
050,01,081,"Alabama","Lee County",3,37,2270,1097,1173
050,01,081,"Alabama","Lee County",3,38,2258,1118,1140
050,01,081,"Alabama","Lee County",3,39,2218,1091,1127
050,01,081,"Alabama","Lee County",3,40,2216,1068,1148
050,01,081,"Alabama","Lee County",3,41,2233,1065,1168
050,01,081,"Alabama","Lee County",3,42,2189,1055,1134
050,01,081,"Alabama","Lee County",3,43,2154,1055,1099
050,01,081,"Alabama","Lee County",3,44,2053,1008,1045
050,01,081,"Alabama","Lee County",3,45,1958,973,985
050,01,081,"Alabama","Lee County",3,46,2012,964,1048
050,01,081,"Alabama","Lee County",3,47,1965,937,1028
050,01,081,"Alabama","Lee County",3,48,2010,939,1071
050,01,081,"Alabama","Lee County",3,49,2114,1022,1092
050,01,081,"Alabama","Lee County",3,50,2286,1125,1161
050,01,081,"Alabama","Lee County",3,51,2205,1081,1124
050,01,081,"Alabama","Lee County",3,52,2097,1015,1082
050,01,081,"Alabama","Lee County",3,53,2037,985,1052
050,01,081,"Alabama","Lee County",3,54,1948,971,977
050,01,081,"Alabama","Lee County",3,55,1956,973,983
050,01,081,"Alabama","Lee County",3,56,2012,1022,990
050,01,081,"Alabama","Lee County",3,57,2054,1028,1026
050,01,081,"Alabama","Lee County",3,58,2044,991,1053
050,01,081,"Alabama","Lee County",3,59,2085,1016,1069
050,01,081,"Alabama","Lee County",3,60,2012,990,1022
050,01,081,"Alabama","Lee County",3,61,1958,985,973
050,01,081,"Alabama","Lee County",3,62,1903,925,978
050,01,081,"Alabama","Lee County",3,63,1895,892,1003
050,01,081,"Alabama","Lee County",3,64,1848,892,956
050,01,081,"Alabama","Lee County",3,65,1747,838,909
050,01,081,"Alabama","Lee County",3,66,1673,774,899
050,01,081,"Alabama","Lee County",3,67,1541,702,839
050,01,081,"Alabama","Lee County",3,68,1502,703,799
050,01,081,"Alabama","Lee County",3,69,1469,668,801
050,01,081,"Alabama","Lee County",3,70,1426,647,779
050,01,081,"Alabama","Lee County",3,71,1348,634,714
050,01,081,"Alabama","Lee County",3,72,1303,615,688
050,01,081,"Alabama","Lee County",3,73,1276,615,661
050,01,081,"Alabama","Lee County",3,74,1313,602,711
050,01,081,"Alabama","Lee County",3,75,900,426,474
050,01,081,"Alabama","Lee County",3,76,845,396,449
050,01,081,"Alabama","Lee County",3,77,803,367,436
050,01,081,"Alabama","Lee County",3,78,789,363,426
050,01,081,"Alabama","Lee County",3,79,665,309,356
050,01,081,"Alabama","Lee County",3,80,589,246,343
050,01,081,"Alabama","Lee County",3,81,517,217,300
050,01,081,"Alabama","Lee County",3,82,479,197,282
050,01,081,"Alabama","Lee County",3,83,443,194,249
050,01,081,"Alabama","Lee County",3,84,388,155,233
050,01,081,"Alabama","Lee County",3,85,1918,663,1255
050,01,081,"Alabama","Lee County",4,0,1949,1012,937
050,01,081,"Alabama","Lee County",4,1,1803,889,914
050,01,081,"Alabama","Lee County",4,2,1913,969,944
050,01,081,"Alabama","Lee County",4,3,1969,1031,938
050,01,081,"Alabama","Lee County",4,4,2028,1071,957
050,01,081,"Alabama","Lee County",4,5,2131,1106,1025
050,01,081,"Alabama","Lee County",4,6,2140,1083,1057
050,01,081,"Alabama","Lee County",4,7,2220,1104,1116
050,01,081,"Alabama","Lee County",4,8,2148,1097,1051
050,01,081,"Alabama","Lee County",4,9,2074,1053,1021
050,01,081,"Alabama","Lee County",4,10,2078,1053,1025
050,01,081,"Alabama","Lee County",4,11,2088,1106,982
050,01,081,"Alabama","Lee County",4,12,2184,1156,1028
050,01,081,"Alabama","Lee County",4,13,2172,1132,1040
050,01,081,"Alabama","Lee County",4,14,2317,1196,1121
050,01,081,"Alabama","Lee County",4,15,2298,1194,1104
050,01,081,"Alabama","Lee County",4,16,2299,1194,1105
050,01,081,"Alabama","Lee County",4,17,2209,1131,1078
050,01,081,"Alabama","Lee County",4,18,3150,1482,1668
050,01,081,"Alabama","Lee County",4,19,4964,2504,2460
050,01,081,"Alabama","Lee County",4,20,4943,2408,2535
050,01,081,"Alabama","Lee County",4,21,5032,2609,2423
050,01,081,"Alabama","Lee County",4,22,4958,2640,2318
050,01,081,"Alabama","Lee County",4,23,3946,2176,1770
050,01,081,"Alabama","Lee County",4,24,3146,1612,1534
050,01,081,"Alabama","Lee County",4,25,2859,1473,1386
050,01,081,"Alabama","Lee County",4,26,2594,1302,1292
050,01,081,"Alabama","Lee County",4,27,2412,1233,1179
050,01,081,"Alabama","Lee County",4,28,2401,1177,1224
050,01,081,"Alabama","Lee County",4,29,2450,1237,1213
050,01,081,"Alabama","Lee County",4,30,2471,1212,1259
050,01,081,"Alabama","Lee County",4,31,2435,1165,1270
050,01,081,"Alabama","Lee County",4,32,2402,1162,1240
050,01,081,"Alabama","Lee County",4,33,2356,1163,1193
050,01,081,"Alabama","Lee County",4,34,2322,1104,1218
050,01,081,"Alabama","Lee County",4,35,2259,1084,1175
050,01,081,"Alabama","Lee County",4,36,2246,1070,1176
050,01,081,"Alabama","Lee County",4,37,2288,1104,1184
050,01,081,"Alabama","Lee County",4,38,2302,1114,1188
050,01,081,"Alabama","Lee County",4,39,2283,1115,1168
050,01,081,"Alabama","Lee County",4,40,2236,1111,1125
050,01,081,"Alabama","Lee County",4,41,2241,1092,1149
050,01,081,"Alabama","Lee County",4,42,2306,1118,1188
050,01,081,"Alabama","Lee County",4,43,2193,1042,1151
050,01,081,"Alabama","Lee County",4,44,2135,1059,1076
050,01,081,"Alabama","Lee County",4,45,2086,1030,1056
050,01,081,"Alabama","Lee County",4,46,2003,980,1023
050,01,081,"Alabama","Lee County",4,47,2033,972,1061
050,01,081,"Alabama","Lee County",4,48,2009,961,1048
050,01,081,"Alabama","Lee County",4,49,2050,963,1087
050,01,081,"Alabama","Lee County",4,50,2134,1026,1108
050,01,081,"Alabama","Lee County",4,51,2318,1135,1183
050,01,081,"Alabama","Lee County",4,52,2253,1104,1149
050,01,081,"Alabama","Lee County",4,53,2114,1021,1093
050,01,081,"Alabama","Lee County",4,54,2065,1005,1060
050,01,081,"Alabama","Lee County",4,55,1982,993,989
050,01,081,"Alabama","Lee County",4,56,1987,991,996
050,01,081,"Alabama","Lee County",4,57,2024,1028,996
050,01,081,"Alabama","Lee County",4,58,2070,1029,1041
050,01,081,"Alabama","Lee County",4,59,2046,990,1056
050,01,081,"Alabama","Lee County",4,60,2099,1021,1078
050,01,081,"Alabama","Lee County",4,61,2026,991,1035
050,01,081,"Alabama","Lee County",4,62,1988,994,994
050,01,081,"Alabama","Lee County",4,63,1915,915,1000
050,01,081,"Alabama","Lee County",4,64,1921,900,1021
050,01,081,"Alabama","Lee County",4,65,1866,909,957
050,01,081,"Alabama","Lee County",4,66,1755,842,913
050,01,081,"Alabama","Lee County",4,67,1691,772,919
050,01,081,"Alabama","Lee County",4,68,1555,705,850
050,01,081,"Alabama","Lee County",4,69,1492,696,796
050,01,081,"Alabama","Lee County",4,70,1466,668,798
050,01,081,"Alabama","Lee County",4,71,1400,643,757
050,01,081,"Alabama","Lee County",4,72,1325,619,706
050,01,081,"Alabama","Lee County",4,73,1275,587,688
050,01,081,"Alabama","Lee County",4,74,1259,599,660
050,01,081,"Alabama","Lee County",4,75,1267,581,686
050,01,081,"Alabama","Lee County",4,76,891,416,475
050,01,081,"Alabama","Lee County",4,77,809,379,430
050,01,081,"Alabama","Lee County",4,78,778,355,423
050,01,081,"Alabama","Lee County",4,79,778,356,422
050,01,081,"Alabama","Lee County",4,80,664,299,365
050,01,081,"Alabama","Lee County",4,81,571,238,333
050,01,081,"Alabama","Lee County",4,82,472,190,282
050,01,081,"Alabama","Lee County",4,83,462,200,262
050,01,081,"Alabama","Lee County",4,84,413,171,242
050,01,081,"Alabama","Lee County",4,85,2036,716,1320
050,01,081,"Alabama","Lee County",5,0,1904,971,933
050,01,081,"Alabama","Lee County",5,1,1974,1034,940
050,01,081,"Alabama","Lee County",5,2,1850,922,928
050,01,081,"Alabama","Lee County",5,3,1939,985,954
050,01,081,"Alabama","Lee County",5,4,2033,1045,988
050,01,081,"Alabama","Lee County",5,5,2056,1068,988
050,01,081,"Alabama","Lee County",5,6,2157,1121,1036
050,01,081,"Alabama","Lee County",5,7,2136,1068,1068
050,01,081,"Alabama","Lee County",5,8,2190,1087,1103
050,01,081,"Alabama","Lee County",5,9,2173,1129,1044
050,01,081,"Alabama","Lee County",5,10,2068,1035,1033
050,01,081,"Alabama","Lee County",5,11,2109,1068,1041
050,01,081,"Alabama","Lee County",5,12,2139,1141,998
050,01,081,"Alabama","Lee County",5,13,2195,1161,1034
050,01,081,"Alabama","Lee County",5,14,2222,1143,1079
050,01,081,"Alabama","Lee County",5,15,2357,1217,1140
050,01,081,"Alabama","Lee County",5,16,2339,1226,1113
050,01,081,"Alabama","Lee County",5,17,2324,1207,1117
050,01,081,"Alabama","Lee County",5,18,3189,1518,1671
050,01,081,"Alabama","Lee County",5,19,4888,2435,2453
050,01,081,"Alabama","Lee County",5,20,4978,2464,2514
050,01,081,"Alabama","Lee County",5,21,4910,2552,2358
050,01,081,"Alabama","Lee County",5,22,4973,2645,2328
050,01,081,"Alabama","Lee County",5,23,4064,2205,1859
050,01,081,"Alabama","Lee County",5,24,3074,1615,1459
050,01,081,"Alabama","Lee County",5,25,2801,1413,1388
050,01,081,"Alabama","Lee County",5,26,2615,1326,1289
050,01,081,"Alabama","Lee County",5,27,2472,1214,1258
050,01,081,"Alabama","Lee County",5,28,2359,1193,1166
050,01,081,"Alabama","Lee County",5,29,2382,1181,1201
050,01,081,"Alabama","Lee County",5,30,2423,1232,1191
050,01,081,"Alabama","Lee County",5,31,2470,1199,1271
050,01,081,"Alabama","Lee County",5,32,2472,1195,1277
050,01,081,"Alabama","Lee County",5,33,2413,1174,1239
050,01,081,"Alabama","Lee County",5,34,2359,1162,1197
050,01,081,"Alabama","Lee County",5,35,2351,1117,1234
050,01,081,"Alabama","Lee County",5,36,2305,1095,1210
050,01,081,"Alabama","Lee County",5,37,2249,1070,1179
050,01,081,"Alabama","Lee County",5,38,2319,1122,1197
050,01,081,"Alabama","Lee County",5,39,2341,1129,1212
050,01,081,"Alabama","Lee County",5,40,2279,1112,1167
050,01,081,"Alabama","Lee County",5,41,2293,1126,1167
050,01,081,"Alabama","Lee County",5,42,2276,1122,1154
050,01,081,"Alabama","Lee County",5,43,2355,1131,1224
050,01,081,"Alabama","Lee County",5,44,2164,1033,1131
050,01,081,"Alabama","Lee County",5,45,2155,1061,1094
050,01,081,"Alabama","Lee County",5,46,2058,1021,1037
050,01,081,"Alabama","Lee County",5,47,2030,1011,1019
050,01,081,"Alabama","Lee County",5,48,2053,984,1069
050,01,081,"Alabama","Lee County",5,49,2029,971,1058
050,01,081,"Alabama","Lee County",5,50,2031,953,1078
050,01,081,"Alabama","Lee County",5,51,2141,1025,1116
050,01,081,"Alabama","Lee County",5,52,2316,1122,1194
050,01,081,"Alabama","Lee County",5,53,2293,1124,1169
050,01,081,"Alabama","Lee County",5,54,2155,1046,1109
050,01,081,"Alabama","Lee County",5,55,2098,1029,1069
050,01,081,"Alabama","Lee County",5,56,1994,993,1001
050,01,081,"Alabama","Lee County",5,57,2008,1006,1002
050,01,081,"Alabama","Lee County",5,58,2034,1029,1005
050,01,081,"Alabama","Lee County",5,59,2105,1039,1066
050,01,081,"Alabama","Lee County",5,60,2057,994,1063
050,01,081,"Alabama","Lee County",5,61,2142,1046,1096
050,01,081,"Alabama","Lee County",5,62,2031,980,1051
050,01,081,"Alabama","Lee County",5,63,2039,1005,1034
050,01,081,"Alabama","Lee County",5,64,1912,905,1007
050,01,081,"Alabama","Lee County",5,65,1912,883,1029
050,01,081,"Alabama","Lee County",5,66,1887,920,967
050,01,081,"Alabama","Lee County",5,67,1778,849,929
050,01,081,"Alabama","Lee County",5,68,1684,778,906
050,01,081,"Alabama","Lee County",5,69,1552,711,841
050,01,081,"Alabama","Lee County",5,70,1507,702,805
050,01,081,"Alabama","Lee County",5,71,1444,660,784
050,01,081,"Alabama","Lee County",5,72,1372,618,754
050,01,081,"Alabama","Lee County",5,73,1303,607,696
050,01,081,"Alabama","Lee County",5,74,1263,582,681
050,01,081,"Alabama","Lee County",5,75,1229,577,652
050,01,081,"Alabama","Lee County",5,76,1258,569,689
050,01,081,"Alabama","Lee County",5,77,852,396,456
050,01,081,"Alabama","Lee County",5,78,795,373,422
050,01,081,"Alabama","Lee County",5,79,763,341,422
050,01,081,"Alabama","Lee County",5,80,748,335,413
050,01,081,"Alabama","Lee County",5,81,634,288,346
050,01,081,"Alabama","Lee County",5,82,529,218,311
050,01,081,"Alabama","Lee County",5,83,460,188,272
050,01,081,"Alabama","Lee County",5,84,440,182,258
050,01,081,"Alabama","Lee County",5,85,2185,795,1390
050,01,083,"Alabama","Limestone County",1,0,1031,532,499
050,01,083,"Alabama","Limestone County",1,1,1081,559,522
050,01,083,"Alabama","Limestone County",1,2,1131,571,560
050,01,083,"Alabama","Limestone County",1,3,1157,596,561
050,01,083,"Alabama","Limestone County",1,4,1250,623,627
050,01,083,"Alabama","Limestone County",1,5,1238,612,626
050,01,083,"Alabama","Limestone County",1,6,1214,590,624
050,01,083,"Alabama","Limestone County",1,7,1211,610,601
050,01,083,"Alabama","Limestone County",1,8,1265,642,623
050,01,083,"Alabama","Limestone County",1,9,1338,672,666
050,01,083,"Alabama","Limestone County",1,10,1316,641,675
050,01,083,"Alabama","Limestone County",1,11,1424,727,697
050,01,083,"Alabama","Limestone County",1,12,1442,718,724
050,01,083,"Alabama","Limestone County",1,13,1420,718,702
050,01,083,"Alabama","Limestone County",1,14,1468,749,719
050,01,083,"Alabama","Limestone County",1,15,1423,726,697
050,01,083,"Alabama","Limestone County",1,16,1424,718,706
050,01,083,"Alabama","Limestone County",1,17,1400,670,730
050,01,083,"Alabama","Limestone County",1,18,1200,654,546
050,01,083,"Alabama","Limestone County",1,19,1037,552,485
050,01,083,"Alabama","Limestone County",1,20,1081,571,510
050,01,083,"Alabama","Limestone County",1,21,1086,583,503
050,01,083,"Alabama","Limestone County",1,22,1148,597,551
050,01,083,"Alabama","Limestone County",1,23,1152,574,578
050,01,083,"Alabama","Limestone County",1,24,1175,625,550
050,01,083,"Alabama","Limestone County",1,25,1201,647,554
050,01,083,"Alabama","Limestone County",1,26,1250,653,597
050,01,083,"Alabama","Limestone County",1,27,1305,667,638
050,01,083,"Alabama","Limestone County",1,28,1391,684,707
050,01,083,"Alabama","Limestone County",1,29,1394,734,660
050,01,083,"Alabama","Limestone County",1,30,1381,712,669
050,01,083,"Alabama","Limestone County",1,31,1338,704,634
050,01,083,"Alabama","Limestone County",1,32,1291,663,628
050,01,083,"Alabama","Limestone County",1,33,1398,724,674
050,01,083,"Alabama","Limestone County",1,34,1435,737,698
050,01,083,"Alabama","Limestone County",1,35,1429,735,694
050,01,083,"Alabama","Limestone County",1,36,1410,726,684
050,01,083,"Alabama","Limestone County",1,37,1502,777,725
050,01,083,"Alabama","Limestone County",1,38,1516,807,709
050,01,083,"Alabama","Limestone County",1,39,1439,760,679
050,01,083,"Alabama","Limestone County",1,40,1425,752,673
050,01,083,"Alabama","Limestone County",1,41,1400,735,665
050,01,083,"Alabama","Limestone County",1,42,1453,736,717
050,01,083,"Alabama","Limestone County",1,43,1372,698,674
050,01,083,"Alabama","Limestone County",1,44,1395,728,667
050,01,083,"Alabama","Limestone County",1,45,1353,707,646
050,01,083,"Alabama","Limestone County",1,46,1374,710,664
050,01,083,"Alabama","Limestone County",1,47,1384,694,690
050,01,083,"Alabama","Limestone County",1,48,1529,775,754
050,01,083,"Alabama","Limestone County",1,49,1645,868,777
050,01,083,"Alabama","Limestone County",1,50,1550,808,742
050,01,083,"Alabama","Limestone County",1,51,1464,751,713
050,01,083,"Alabama","Limestone County",1,52,1459,770,689
050,01,083,"Alabama","Limestone County",1,53,1469,754,715
050,01,083,"Alabama","Limestone County",1,54,1548,783,765
050,01,083,"Alabama","Limestone County",1,55,1588,801,787
050,01,083,"Alabama","Limestone County",1,56,1532,779,753
050,01,083,"Alabama","Limestone County",1,57,1492,779,713
050,01,083,"Alabama","Limestone County",1,58,1489,761,728
050,01,083,"Alabama","Limestone County",1,59,1491,756,735
050,01,083,"Alabama","Limestone County",1,60,1443,727,716
050,01,083,"Alabama","Limestone County",1,61,1365,705,660
050,01,083,"Alabama","Limestone County",1,62,1306,657,649
050,01,083,"Alabama","Limestone County",1,63,1313,637,676
050,01,083,"Alabama","Limestone County",1,64,1205,598,607
050,01,083,"Alabama","Limestone County",1,65,1131,539,592
050,01,083,"Alabama","Limestone County",1,66,1078,507,571
050,01,083,"Alabama","Limestone County",1,67,1034,490,544
050,01,083,"Alabama","Limestone County",1,68,985,488,497
050,01,083,"Alabama","Limestone County",1,69,960,468,492
050,01,083,"Alabama","Limestone County",1,70,935,452,483
050,01,083,"Alabama","Limestone County",1,71,912,431,481
050,01,083,"Alabama","Limestone County",1,72,960,435,525
050,01,083,"Alabama","Limestone County",1,73,926,408,518
050,01,083,"Alabama","Limestone County",1,74,672,316,356
050,01,083,"Alabama","Limestone County",1,75,669,311,358
050,01,083,"Alabama","Limestone County",1,76,631,296,335
050,01,083,"Alabama","Limestone County",1,77,622,297,325
050,01,083,"Alabama","Limestone County",1,78,505,227,278
050,01,083,"Alabama","Limestone County",1,79,477,206,271
050,01,083,"Alabama","Limestone County",1,80,411,176,235
050,01,083,"Alabama","Limestone County",1,81,378,159,219
050,01,083,"Alabama","Limestone County",1,82,360,144,216
050,01,083,"Alabama","Limestone County",1,83,308,131,177
050,01,083,"Alabama","Limestone County",1,84,311,128,183
050,01,083,"Alabama","Limestone County",1,85,1464,506,958
050,01,083,"Alabama","Limestone County",2,0,1077,550,527
050,01,083,"Alabama","Limestone County",2,1,1086,558,528
050,01,083,"Alabama","Limestone County",2,2,1140,577,563
050,01,083,"Alabama","Limestone County",2,3,1165,596,569
050,01,083,"Alabama","Limestone County",2,4,1242,622,620
050,01,083,"Alabama","Limestone County",2,5,1256,621,635
050,01,083,"Alabama","Limestone County",2,6,1231,603,628
050,01,083,"Alabama","Limestone County",2,7,1223,612,611
050,01,083,"Alabama","Limestone County",2,8,1267,644,623
050,01,083,"Alabama","Limestone County",2,9,1326,668,658
050,01,083,"Alabama","Limestone County",2,10,1334,659,675
050,01,083,"Alabama","Limestone County",2,11,1410,715,695
050,01,083,"Alabama","Limestone County",2,12,1456,732,724
050,01,083,"Alabama","Limestone County",2,13,1432,723,709
050,01,083,"Alabama","Limestone County",2,14,1463,743,720
050,01,083,"Alabama","Limestone County",2,15,1443,736,707
050,01,083,"Alabama","Limestone County",2,16,1436,724,712
050,01,083,"Alabama","Limestone County",2,17,1409,684,725
050,01,083,"Alabama","Limestone County",2,18,1199,636,563
050,01,083,"Alabama","Limestone County",2,19,1029,550,479
050,01,083,"Alabama","Limestone County",2,20,1105,582,523
050,01,083,"Alabama","Limestone County",2,21,1104,589,515
050,01,083,"Alabama","Limestone County",2,22,1149,597,552
050,01,083,"Alabama","Limestone County",2,23,1171,589,582
050,01,083,"Alabama","Limestone County",2,24,1182,623,559
050,01,083,"Alabama","Limestone County",2,25,1208,646,562
050,01,083,"Alabama","Limestone County",2,26,1250,654,596
050,01,083,"Alabama","Limestone County",2,27,1304,666,638
050,01,083,"Alabama","Limestone County",2,28,1375,678,697
050,01,083,"Alabama","Limestone County",2,29,1406,725,681
050,01,083,"Alabama","Limestone County",2,30,1402,720,682
050,01,083,"Alabama","Limestone County",2,31,1355,708,647
050,01,083,"Alabama","Limestone County",2,32,1311,671,640
050,01,083,"Alabama","Limestone County",2,33,1381,711,670
050,01,083,"Alabama","Limestone County",2,34,1427,732,695
050,01,083,"Alabama","Limestone County",2,35,1440,731,709
050,01,083,"Alabama","Limestone County",2,36,1414,724,690
050,01,083,"Alabama","Limestone County",2,37,1487,764,723
050,01,083,"Alabama","Limestone County",2,38,1520,801,719
050,01,083,"Alabama","Limestone County",2,39,1457,767,690
050,01,083,"Alabama","Limestone County",2,40,1444,760,684
050,01,083,"Alabama","Limestone County",2,41,1408,736,672
050,01,083,"Alabama","Limestone County",2,42,1431,725,706
050,01,083,"Alabama","Limestone County",2,43,1404,710,694
050,01,083,"Alabama","Limestone County",2,44,1376,713,663
050,01,083,"Alabama","Limestone County",2,45,1376,715,661
050,01,083,"Alabama","Limestone County",2,46,1371,704,667
050,01,083,"Alabama","Limestone County",2,47,1388,696,692
050,01,083,"Alabama","Limestone County",2,48,1497,757,740
050,01,083,"Alabama","Limestone County",2,49,1630,850,780
050,01,083,"Alabama","Limestone County",2,50,1574,820,754
050,01,083,"Alabama","Limestone County",2,51,1485,765,720
050,01,083,"Alabama","Limestone County",2,52,1460,764,696
050,01,083,"Alabama","Limestone County",2,53,1470,755,715
050,01,083,"Alabama","Limestone County",2,54,1521,769,752
050,01,083,"Alabama","Limestone County",2,55,1583,797,786
050,01,083,"Alabama","Limestone County",2,56,1556,786,770
050,01,083,"Alabama","Limestone County",2,57,1508,778,730
050,01,083,"Alabama","Limestone County",2,58,1487,761,726
050,01,083,"Alabama","Limestone County",2,59,1503,761,742
050,01,083,"Alabama","Limestone County",2,60,1457,736,721
050,01,083,"Alabama","Limestone County",2,61,1384,713,671
050,01,083,"Alabama","Limestone County",2,62,1324,666,658
050,01,083,"Alabama","Limestone County",2,63,1327,645,682
050,01,083,"Alabama","Limestone County",2,64,1230,606,624
050,01,083,"Alabama","Limestone County",2,65,1153,554,599
050,01,083,"Alabama","Limestone County",2,66,1105,522,583
050,01,083,"Alabama","Limestone County",2,67,1043,493,550
050,01,083,"Alabama","Limestone County",2,68,989,482,507
050,01,083,"Alabama","Limestone County",2,69,974,475,499
050,01,083,"Alabama","Limestone County",2,70,937,452,485
050,01,083,"Alabama","Limestone County",2,71,924,436,488
050,01,083,"Alabama","Limestone County",2,72,937,431,506
050,01,083,"Alabama","Limestone County",2,73,984,439,545
050,01,083,"Alabama","Limestone County",2,74,688,317,371
050,01,083,"Alabama","Limestone County",2,75,664,308,356
050,01,083,"Alabama","Limestone County",2,76,634,298,336
050,01,083,"Alabama","Limestone County",2,77,631,300,331
050,01,083,"Alabama","Limestone County",2,78,523,237,286
050,01,083,"Alabama","Limestone County",2,79,477,209,268
050,01,083,"Alabama","Limestone County",2,80,424,183,241
050,01,083,"Alabama","Limestone County",2,81,381,159,222
050,01,083,"Alabama","Limestone County",2,82,362,147,215
050,01,083,"Alabama","Limestone County",2,83,319,133,186
050,01,083,"Alabama","Limestone County",2,84,306,125,181
050,01,083,"Alabama","Limestone County",2,85,1482,514,968
050,01,083,"Alabama","Limestone County",3,0,1085,517,568
050,01,083,"Alabama","Limestone County",3,1,1154,599,555
050,01,083,"Alabama","Limestone County",3,2,1173,590,583
050,01,083,"Alabama","Limestone County",3,3,1199,595,604
050,01,083,"Alabama","Limestone County",3,4,1220,632,588
050,01,083,"Alabama","Limestone County",3,5,1332,673,659
050,01,083,"Alabama","Limestone County",3,6,1329,674,655
050,01,083,"Alabama","Limestone County",3,7,1271,626,645
050,01,083,"Alabama","Limestone County",3,8,1279,640,639
050,01,083,"Alabama","Limestone County",3,9,1327,689,638
050,01,083,"Alabama","Limestone County",3,10,1388,707,681
050,01,083,"Alabama","Limestone County",3,11,1402,697,705
050,01,083,"Alabama","Limestone County",3,12,1444,726,718
050,01,083,"Alabama","Limestone County",3,13,1513,764,749
050,01,083,"Alabama","Limestone County",3,14,1473,735,738
050,01,083,"Alabama","Limestone County",3,15,1494,759,735
050,01,083,"Alabama","Limestone County",3,16,1453,734,719
050,01,083,"Alabama","Limestone County",3,17,1451,729,722
050,01,083,"Alabama","Limestone County",3,18,1229,622,607
050,01,083,"Alabama","Limestone County",3,19,991,517,474
050,01,083,"Alabama","Limestone County",3,20,1145,614,531
050,01,083,"Alabama","Limestone County",3,21,1170,606,564
050,01,083,"Alabama","Limestone County",3,22,1181,627,554
050,01,083,"Alabama","Limestone County",3,23,1247,616,631
050,01,083,"Alabama","Limestone County",3,24,1235,620,615
050,01,083,"Alabama","Limestone County",3,25,1264,660,604
050,01,083,"Alabama","Limestone County",3,26,1281,676,605
050,01,083,"Alabama","Limestone County",3,27,1328,683,645
050,01,083,"Alabama","Limestone County",3,28,1387,698,689
050,01,083,"Alabama","Limestone County",3,29,1481,718,763
050,01,083,"Alabama","Limestone County",3,30,1458,758,700
050,01,083,"Alabama","Limestone County",3,31,1485,780,705
050,01,083,"Alabama","Limestone County",3,32,1405,732,673
050,01,083,"Alabama","Limestone County",3,33,1430,735,695
050,01,083,"Alabama","Limestone County",3,34,1423,734,689
050,01,083,"Alabama","Limestone County",3,35,1428,720,708
050,01,083,"Alabama","Limestone County",3,36,1508,761,747
050,01,083,"Alabama","Limestone County",3,37,1448,734,714
050,01,083,"Alabama","Limestone County",3,38,1504,774,730
050,01,083,"Alabama","Limestone County",3,39,1565,811,754
050,01,083,"Alabama","Limestone County",3,40,1540,812,728
050,01,083,"Alabama","Limestone County",3,41,1495,790,705
050,01,083,"Alabama","Limestone County",3,42,1456,773,683
050,01,083,"Alabama","Limestone County",3,43,1470,737,733
050,01,083,"Alabama","Limestone County",3,44,1445,725,720
050,01,083,"Alabama","Limestone County",3,45,1381,709,672
050,01,083,"Alabama","Limestone County",3,46,1383,703,680
050,01,083,"Alabama","Limestone County",3,47,1416,729,687
050,01,083,"Alabama","Limestone County",3,48,1439,721,718
050,01,083,"Alabama","Limestone County",3,49,1529,770,759
050,01,083,"Alabama","Limestone County",3,50,1672,862,810
050,01,083,"Alabama","Limestone County",3,51,1601,841,760
050,01,083,"Alabama","Limestone County",3,52,1532,778,754
050,01,083,"Alabama","Limestone County",3,53,1451,761,690
050,01,083,"Alabama","Limestone County",3,54,1470,750,720
050,01,083,"Alabama","Limestone County",3,55,1567,800,767
050,01,083,"Alabama","Limestone County",3,56,1580,783,797
050,01,083,"Alabama","Limestone County",3,57,1559,796,763
050,01,083,"Alabama","Limestone County",3,58,1518,762,756
050,01,083,"Alabama","Limestone County",3,59,1538,783,755
050,01,083,"Alabama","Limestone County",3,60,1551,788,763
050,01,083,"Alabama","Limestone County",3,61,1472,749,723
050,01,083,"Alabama","Limestone County",3,62,1402,729,673
050,01,083,"Alabama","Limestone County",3,63,1331,662,669
050,01,083,"Alabama","Limestone County",3,64,1326,641,685
050,01,083,"Alabama","Limestone County",3,65,1251,603,648
050,01,083,"Alabama","Limestone County",3,66,1148,538,610
050,01,083,"Alabama","Limestone County",3,67,1085,512,573
050,01,083,"Alabama","Limestone County",3,68,1033,480,553
050,01,083,"Alabama","Limestone County",3,69,991,485,506
050,01,083,"Alabama","Limestone County",3,70,973,469,504
050,01,083,"Alabama","Limestone County",3,71,912,424,488
050,01,083,"Alabama","Limestone County",3,72,922,441,481
050,01,083,"Alabama","Limestone County",3,73,923,419,504
050,01,083,"Alabama","Limestone County",3,74,974,430,544
050,01,083,"Alabama","Limestone County",3,75,670,304,366
050,01,083,"Alabama","Limestone County",3,76,648,292,356
050,01,083,"Alabama","Limestone County",3,77,622,296,326
050,01,083,"Alabama","Limestone County",3,78,591,276,315
050,01,083,"Alabama","Limestone County",3,79,489,214,275
050,01,083,"Alabama","Limestone County",3,80,450,190,260
050,01,083,"Alabama","Limestone County",3,81,402,173,229
050,01,083,"Alabama","Limestone County",3,82,330,133,197
050,01,083,"Alabama","Limestone County",3,83,344,142,202
050,01,083,"Alabama","Limestone County",3,84,290,114,176
050,01,083,"Alabama","Limestone County",3,85,1551,539,1012
050,01,083,"Alabama","Limestone County",4,0,1177,575,602
050,01,083,"Alabama","Limestone County",4,1,1169,562,607
050,01,083,"Alabama","Limestone County",4,2,1188,636,552
050,01,083,"Alabama","Limestone County",4,3,1262,638,624
050,01,083,"Alabama","Limestone County",4,4,1259,625,634
050,01,083,"Alabama","Limestone County",4,5,1298,653,645
050,01,083,"Alabama","Limestone County",4,6,1378,685,693
050,01,083,"Alabama","Limestone County",4,7,1361,691,670
050,01,083,"Alabama","Limestone County",4,8,1359,686,673
050,01,083,"Alabama","Limestone County",4,9,1304,665,639
050,01,083,"Alabama","Limestone County",4,10,1370,717,653
050,01,083,"Alabama","Limestone County",4,11,1444,728,716
050,01,083,"Alabama","Limestone County",4,12,1451,721,730
050,01,083,"Alabama","Limestone County",4,13,1492,758,734
050,01,083,"Alabama","Limestone County",4,14,1538,763,775
050,01,083,"Alabama","Limestone County",4,15,1476,757,719
050,01,083,"Alabama","Limestone County",4,16,1523,792,731
050,01,083,"Alabama","Limestone County",4,17,1485,753,732
050,01,083,"Alabama","Limestone County",4,18,1241,646,595
050,01,083,"Alabama","Limestone County",4,19,982,500,482
050,01,083,"Alabama","Limestone County",4,20,1108,608,500
050,01,083,"Alabama","Limestone County",4,21,1219,657,562
050,01,083,"Alabama","Limestone County",4,22,1252,648,604
050,01,083,"Alabama","Limestone County",4,23,1235,638,597
050,01,083,"Alabama","Limestone County",4,24,1322,682,640
050,01,083,"Alabama","Limestone County",4,25,1321,667,654
050,01,083,"Alabama","Limestone County",4,26,1289,678,611
050,01,083,"Alabama","Limestone County",4,27,1360,737,623
050,01,083,"Alabama","Limestone County",4,28,1396,715,681
050,01,083,"Alabama","Limestone County",4,29,1474,754,720
050,01,083,"Alabama","Limestone County",4,30,1532,736,796
050,01,083,"Alabama","Limestone County",4,31,1588,846,742
050,01,083,"Alabama","Limestone County",4,32,1548,815,733
050,01,083,"Alabama","Limestone County",4,33,1488,779,709
050,01,083,"Alabama","Limestone County",4,34,1524,804,720
050,01,083,"Alabama","Limestone County",4,35,1480,745,735
050,01,083,"Alabama","Limestone County",4,36,1510,783,727
050,01,083,"Alabama","Limestone County",4,37,1567,809,758
050,01,083,"Alabama","Limestone County",4,38,1497,757,740
050,01,083,"Alabama","Limestone County",4,39,1570,797,773
050,01,083,"Alabama","Limestone County",4,40,1670,880,790
050,01,083,"Alabama","Limestone County",4,41,1602,856,746
050,01,083,"Alabama","Limestone County",4,42,1555,819,736
050,01,083,"Alabama","Limestone County",4,43,1495,794,701
050,01,083,"Alabama","Limestone County",4,44,1525,765,760
050,01,083,"Alabama","Limestone County",4,45,1489,757,732
050,01,083,"Alabama","Limestone County",4,46,1447,739,708
050,01,083,"Alabama","Limestone County",4,47,1432,732,700
050,01,083,"Alabama","Limestone County",4,48,1460,755,705
050,01,083,"Alabama","Limestone County",4,49,1507,755,752
050,01,083,"Alabama","Limestone County",4,50,1573,790,783
050,01,083,"Alabama","Limestone County",4,51,1721,894,827
050,01,083,"Alabama","Limestone County",4,52,1683,875,808
050,01,083,"Alabama","Limestone County",4,53,1589,817,772
050,01,083,"Alabama","Limestone County",4,54,1456,757,699
050,01,083,"Alabama","Limestone County",4,55,1502,771,731
050,01,083,"Alabama","Limestone County",4,56,1601,816,785
050,01,083,"Alabama","Limestone County",4,57,1626,817,809
050,01,083,"Alabama","Limestone County",4,58,1581,793,788
050,01,083,"Alabama","Limestone County",4,59,1546,779,767
050,01,083,"Alabama","Limestone County",4,60,1552,785,767
050,01,083,"Alabama","Limestone County",4,61,1571,804,767
050,01,083,"Alabama","Limestone County",4,62,1473,740,733
050,01,083,"Alabama","Limestone County",4,63,1416,726,690
050,01,083,"Alabama","Limestone County",4,64,1339,664,675
050,01,083,"Alabama","Limestone County",4,65,1340,669,671
050,01,083,"Alabama","Limestone County",4,66,1261,598,663
050,01,083,"Alabama","Limestone County",4,67,1139,531,608
050,01,083,"Alabama","Limestone County",4,68,1068,497,571
050,01,083,"Alabama","Limestone County",4,69,1026,478,548
050,01,083,"Alabama","Limestone County",4,70,996,478,518
050,01,083,"Alabama","Limestone County",4,71,959,451,508
050,01,083,"Alabama","Limestone County",4,72,902,422,480
050,01,083,"Alabama","Limestone County",4,73,909,435,474
050,01,083,"Alabama","Limestone County",4,74,904,412,492
050,01,083,"Alabama","Limestone County",4,75,948,400,548
050,01,083,"Alabama","Limestone County",4,76,655,288,367
050,01,083,"Alabama","Limestone County",4,77,633,295,338
050,01,083,"Alabama","Limestone County",4,78,612,277,335
050,01,083,"Alabama","Limestone County",4,79,557,261,296
050,01,083,"Alabama","Limestone County",4,80,455,194,261
050,01,083,"Alabama","Limestone County",4,81,424,176,248
050,01,083,"Alabama","Limestone County",4,82,369,153,216
050,01,083,"Alabama","Limestone County",4,83,307,125,182
050,01,083,"Alabama","Limestone County",4,84,325,133,192
050,01,083,"Alabama","Limestone County",4,85,1631,568,1063
050,01,083,"Alabama","Limestone County",5,0,1195,583,612
050,01,083,"Alabama","Limestone County",5,1,1262,624,638
050,01,083,"Alabama","Limestone County",5,2,1251,595,656
050,01,083,"Alabama","Limestone County",5,3,1276,680,596
050,01,083,"Alabama","Limestone County",5,4,1333,674,659
050,01,083,"Alabama","Limestone County",5,5,1298,634,664
050,01,083,"Alabama","Limestone County",5,6,1374,682,692
050,01,083,"Alabama","Limestone County",5,7,1429,705,724
050,01,083,"Alabama","Limestone County",5,8,1415,737,678
050,01,083,"Alabama","Limestone County",5,9,1397,708,689
050,01,083,"Alabama","Limestone County",5,10,1355,682,673
050,01,083,"Alabama","Limestone County",5,11,1420,739,681
050,01,083,"Alabama","Limestone County",5,12,1491,753,738
050,01,083,"Alabama","Limestone County",5,13,1499,734,765
050,01,083,"Alabama","Limestone County",5,14,1544,776,768
050,01,083,"Alabama","Limestone County",5,15,1606,793,813
050,01,083,"Alabama","Limestone County",5,16,1532,781,751
050,01,083,"Alabama","Limestone County",5,17,1524,801,723
050,01,083,"Alabama","Limestone County",5,18,1304,706,598
050,01,083,"Alabama","Limestone County",5,19,1029,537,492
050,01,083,"Alabama","Limestone County",5,20,1096,558,538
050,01,083,"Alabama","Limestone County",5,21,1212,663,549
050,01,083,"Alabama","Limestone County",5,22,1319,687,632
050,01,083,"Alabama","Limestone County",5,23,1365,709,656
050,01,083,"Alabama","Limestone County",5,24,1371,726,645
050,01,083,"Alabama","Limestone County",5,25,1401,723,678
050,01,083,"Alabama","Limestone County",5,26,1405,716,689
050,01,083,"Alabama","Limestone County",5,27,1429,756,673
050,01,083,"Alabama","Limestone County",5,28,1454,770,684
050,01,083,"Alabama","Limestone County",5,29,1521,779,742
050,01,083,"Alabama","Limestone County",5,30,1545,781,764
050,01,083,"Alabama","Limestone County",5,31,1626,818,808
050,01,083,"Alabama","Limestone County",5,32,1643,863,780
050,01,083,"Alabama","Limestone County",5,33,1613,838,775
050,01,083,"Alabama","Limestone County",5,34,1579,835,744
050,01,083,"Alabama","Limestone County",5,35,1537,787,750
050,01,083,"Alabama","Limestone County",5,36,1585,805,780
050,01,083,"Alabama","Limestone County",5,37,1530,788,742
050,01,083,"Alabama","Limestone County",5,38,1618,825,793
050,01,083,"Alabama","Limestone County",5,39,1541,770,771
050,01,083,"Alabama","Limestone County",5,40,1609,824,785
050,01,083,"Alabama","Limestone County",5,41,1725,904,821
050,01,083,"Alabama","Limestone County",5,42,1652,891,761
050,01,083,"Alabama","Limestone County",5,43,1590,836,754
050,01,083,"Alabama","Limestone County",5,44,1500,787,713
050,01,083,"Alabama","Limestone County",5,45,1558,781,777
050,01,083,"Alabama","Limestone County",5,46,1524,761,763
050,01,083,"Alabama","Limestone County",5,47,1483,753,730
050,01,083,"Alabama","Limestone County",5,48,1498,778,720
050,01,083,"Alabama","Limestone County",5,49,1507,777,730
050,01,083,"Alabama","Limestone County",5,50,1527,754,773
050,01,083,"Alabama","Limestone County",5,51,1627,807,820
050,01,083,"Alabama","Limestone County",5,52,1756,914,842
050,01,083,"Alabama","Limestone County",5,53,1733,905,828
050,01,083,"Alabama","Limestone County",5,54,1614,823,791
050,01,083,"Alabama","Limestone County",5,55,1513,792,721
050,01,083,"Alabama","Limestone County",5,56,1511,773,738
050,01,083,"Alabama","Limestone County",5,57,1627,819,808
050,01,083,"Alabama","Limestone County",5,58,1652,815,837
050,01,083,"Alabama","Limestone County",5,59,1608,810,798
050,01,083,"Alabama","Limestone County",5,60,1543,763,780
050,01,083,"Alabama","Limestone County",5,61,1574,812,762
050,01,083,"Alabama","Limestone County",5,62,1582,805,777
050,01,083,"Alabama","Limestone County",5,63,1470,728,742
050,01,083,"Alabama","Limestone County",5,64,1415,737,678
050,01,083,"Alabama","Limestone County",5,65,1350,669,681
050,01,083,"Alabama","Limestone County",5,66,1368,674,694
050,01,083,"Alabama","Limestone County",5,67,1252,598,654
050,01,083,"Alabama","Limestone County",5,68,1154,532,622
050,01,083,"Alabama","Limestone County",5,69,1066,489,577
050,01,083,"Alabama","Limestone County",5,70,1031,471,560
050,01,083,"Alabama","Limestone County",5,71,985,469,516
050,01,083,"Alabama","Limestone County",5,72,950,449,501
050,01,083,"Alabama","Limestone County",5,73,884,413,471
050,01,083,"Alabama","Limestone County",5,74,886,424,462
050,01,083,"Alabama","Limestone County",5,75,874,388,486
050,01,083,"Alabama","Limestone County",5,76,937,393,544
050,01,083,"Alabama","Limestone County",5,77,641,286,355
050,01,083,"Alabama","Limestone County",5,78,609,275,334
050,01,083,"Alabama","Limestone County",5,79,576,258,318
050,01,083,"Alabama","Limestone County",5,80,523,243,280
050,01,083,"Alabama","Limestone County",5,81,437,183,254
050,01,083,"Alabama","Limestone County",5,82,393,159,234
050,01,083,"Alabama","Limestone County",5,83,345,142,203
050,01,083,"Alabama","Limestone County",5,84,296,115,181
050,01,083,"Alabama","Limestone County",5,85,1775,626,1149
050,01,085,"Alabama","Lowndes County",1,0,112,57,55
050,01,085,"Alabama","Lowndes County",1,1,125,67,58
050,01,085,"Alabama","Lowndes County",1,2,127,75,52
050,01,085,"Alabama","Lowndes County",1,3,130,64,66
050,01,085,"Alabama","Lowndes County",1,4,124,70,54
050,01,085,"Alabama","Lowndes County",1,5,123,73,50
050,01,085,"Alabama","Lowndes County",1,6,121,60,61
050,01,085,"Alabama","Lowndes County",1,7,130,68,62
050,01,085,"Alabama","Lowndes County",1,8,122,51,71
050,01,085,"Alabama","Lowndes County",1,9,137,70,67
050,01,085,"Alabama","Lowndes County",1,10,138,65,73
050,01,085,"Alabama","Lowndes County",1,11,136,65,71
050,01,085,"Alabama","Lowndes County",1,12,146,69,77
050,01,085,"Alabama","Lowndes County",1,13,134,64,70
050,01,085,"Alabama","Lowndes County",1,14,121,60,61
050,01,085,"Alabama","Lowndes County",1,15,120,59,61
050,01,085,"Alabama","Lowndes County",1,16,121,55,66
050,01,085,"Alabama","Lowndes County",1,17,106,62,44
050,01,085,"Alabama","Lowndes County",1,18,117,63,54
050,01,085,"Alabama","Lowndes County",1,19,115,58,57
050,01,085,"Alabama","Lowndes County",1,20,113,58,55
050,01,085,"Alabama","Lowndes County",1,21,97,45,52
050,01,085,"Alabama","Lowndes County",1,22,133,62,71
050,01,085,"Alabama","Lowndes County",1,23,123,65,58
050,01,085,"Alabama","Lowndes County",1,24,127,61,66
050,01,085,"Alabama","Lowndes County",1,25,129,66,63
050,01,085,"Alabama","Lowndes County",1,26,115,65,50
050,01,085,"Alabama","Lowndes County",1,27,117,58,59
050,01,085,"Alabama","Lowndes County",1,28,142,65,77
050,01,085,"Alabama","Lowndes County",1,29,156,71,85
050,01,085,"Alabama","Lowndes County",1,30,144,60,84
050,01,085,"Alabama","Lowndes County",1,31,141,56,85
050,01,085,"Alabama","Lowndes County",1,32,125,56,69
050,01,085,"Alabama","Lowndes County",1,33,108,55,53
050,01,085,"Alabama","Lowndes County",1,34,121,62,59
050,01,085,"Alabama","Lowndes County",1,35,111,64,47
050,01,085,"Alabama","Lowndes County",1,36,97,46,51
050,01,085,"Alabama","Lowndes County",1,37,104,60,44
050,01,085,"Alabama","Lowndes County",1,38,116,52,64
050,01,085,"Alabama","Lowndes County",1,39,127,59,68
050,01,085,"Alabama","Lowndes County",1,40,138,61,77
050,01,085,"Alabama","Lowndes County",1,41,105,44,61
050,01,085,"Alabama","Lowndes County",1,42,99,42,57
050,01,085,"Alabama","Lowndes County",1,43,105,52,53
050,01,085,"Alabama","Lowndes County",1,44,101,52,49
050,01,085,"Alabama","Lowndes County",1,45,98,48,50
050,01,085,"Alabama","Lowndes County",1,46,110,50,60
050,01,085,"Alabama","Lowndes County",1,47,111,51,60
050,01,085,"Alabama","Lowndes County",1,48,107,50,57
050,01,085,"Alabama","Lowndes County",1,49,133,63,70
050,01,085,"Alabama","Lowndes County",1,50,123,56,67
050,01,085,"Alabama","Lowndes County",1,51,137,63,74
050,01,085,"Alabama","Lowndes County",1,52,137,63,74
050,01,085,"Alabama","Lowndes County",1,53,135,60,75
050,01,085,"Alabama","Lowndes County",1,54,147,73,74
050,01,085,"Alabama","Lowndes County",1,55,162,77,85
050,01,085,"Alabama","Lowndes County",1,56,174,90,84
050,01,085,"Alabama","Lowndes County",1,57,175,79,96
050,01,085,"Alabama","Lowndes County",1,58,164,77,87
050,01,085,"Alabama","Lowndes County",1,59,149,69,80
050,01,085,"Alabama","Lowndes County",1,60,156,65,91
050,01,085,"Alabama","Lowndes County",1,61,152,60,92
050,01,085,"Alabama","Lowndes County",1,62,162,76,86
050,01,085,"Alabama","Lowndes County",1,63,147,69,78
050,01,085,"Alabama","Lowndes County",1,64,140,67,73
050,01,085,"Alabama","Lowndes County",1,65,153,75,78
050,01,085,"Alabama","Lowndes County",1,66,142,72,70
050,01,085,"Alabama","Lowndes County",1,67,138,64,74
050,01,085,"Alabama","Lowndes County",1,68,103,43,60
050,01,085,"Alabama","Lowndes County",1,69,107,54,53
050,01,085,"Alabama","Lowndes County",1,70,99,45,54
050,01,085,"Alabama","Lowndes County",1,71,120,47,73
050,01,085,"Alabama","Lowndes County",1,72,115,49,66
050,01,085,"Alabama","Lowndes County",1,73,101,51,50
050,01,085,"Alabama","Lowndes County",1,74,83,34,49
050,01,085,"Alabama","Lowndes County",1,75,87,32,55
050,01,085,"Alabama","Lowndes County",1,76,77,33,44
050,01,085,"Alabama","Lowndes County",1,77,70,36,34
050,01,085,"Alabama","Lowndes County",1,78,65,28,37
050,01,085,"Alabama","Lowndes County",1,79,65,25,40
050,01,085,"Alabama","Lowndes County",1,80,75,31,44
050,01,085,"Alabama","Lowndes County",1,81,61,25,36
050,01,085,"Alabama","Lowndes County",1,82,42,13,29
050,01,085,"Alabama","Lowndes County",1,83,39,18,21
050,01,085,"Alabama","Lowndes County",1,84,39,15,24
050,01,085,"Alabama","Lowndes County",1,85,222,73,149
050,01,085,"Alabama","Lowndes County",2,0,118,61,57
050,01,085,"Alabama","Lowndes County",2,1,121,65,56
050,01,085,"Alabama","Lowndes County",2,2,126,73,53
050,01,085,"Alabama","Lowndes County",2,3,131,68,63
050,01,085,"Alabama","Lowndes County",2,4,126,69,57
050,01,085,"Alabama","Lowndes County",2,5,120,70,50
050,01,085,"Alabama","Lowndes County",2,6,120,62,58
050,01,085,"Alabama","Lowndes County",2,7,126,64,62
050,01,085,"Alabama","Lowndes County",2,8,124,55,69
050,01,085,"Alabama","Lowndes County",2,9,130,63,67
050,01,085,"Alabama","Lowndes County",2,10,137,66,71
050,01,085,"Alabama","Lowndes County",2,11,137,65,72
050,01,085,"Alabama","Lowndes County",2,12,144,68,76
050,01,085,"Alabama","Lowndes County",2,13,138,67,71
050,01,085,"Alabama","Lowndes County",2,14,124,61,63
050,01,085,"Alabama","Lowndes County",2,15,122,59,63
050,01,085,"Alabama","Lowndes County",2,16,121,55,66
050,01,085,"Alabama","Lowndes County",2,17,109,60,49
050,01,085,"Alabama","Lowndes County",2,18,110,60,50
050,01,085,"Alabama","Lowndes County",2,19,116,59,57
050,01,085,"Alabama","Lowndes County",2,20,116,59,57
050,01,085,"Alabama","Lowndes County",2,21,100,46,54
050,01,085,"Alabama","Lowndes County",2,22,130,61,69
050,01,085,"Alabama","Lowndes County",2,23,124,64,60
050,01,085,"Alabama","Lowndes County",2,24,130,64,66
050,01,085,"Alabama","Lowndes County",2,25,128,66,62
050,01,085,"Alabama","Lowndes County",2,26,118,64,54
050,01,085,"Alabama","Lowndes County",2,27,116,59,57
050,01,085,"Alabama","Lowndes County",2,28,138,63,75
050,01,085,"Alabama","Lowndes County",2,29,151,68,83
050,01,085,"Alabama","Lowndes County",2,30,146,63,83
050,01,085,"Alabama","Lowndes County",2,31,141,57,84
050,01,085,"Alabama","Lowndes County",2,32,129,55,74
050,01,085,"Alabama","Lowndes County",2,33,111,55,56
050,01,085,"Alabama","Lowndes County",2,34,117,61,56
050,01,085,"Alabama","Lowndes County",2,35,115,64,51
050,01,085,"Alabama","Lowndes County",2,36,99,50,49
050,01,085,"Alabama","Lowndes County",2,37,103,57,46
050,01,085,"Alabama","Lowndes County",2,38,112,52,60
050,01,085,"Alabama","Lowndes County",2,39,123,57,66
050,01,085,"Alabama","Lowndes County",2,40,136,60,76
050,01,085,"Alabama","Lowndes County",2,41,115,49,66
050,01,085,"Alabama","Lowndes County",2,42,98,40,58
050,01,085,"Alabama","Lowndes County",2,43,105,51,54
050,01,085,"Alabama","Lowndes County",2,44,99,50,49
050,01,085,"Alabama","Lowndes County",2,45,99,49,50
050,01,085,"Alabama","Lowndes County",2,46,104,48,56
050,01,085,"Alabama","Lowndes County",2,47,108,50,58
050,01,085,"Alabama","Lowndes County",2,48,105,48,57
050,01,085,"Alabama","Lowndes County",2,49,126,59,67
050,01,085,"Alabama","Lowndes County",2,50,127,59,68
050,01,085,"Alabama","Lowndes County",2,51,133,60,73
050,01,085,"Alabama","Lowndes County",2,52,140,65,75
050,01,085,"Alabama","Lowndes County",2,53,134,60,74
050,01,085,"Alabama","Lowndes County",2,54,143,69,74
050,01,085,"Alabama","Lowndes County",2,55,159,76,83
050,01,085,"Alabama","Lowndes County",2,56,174,88,86
050,01,085,"Alabama","Lowndes County",2,57,175,82,93
050,01,085,"Alabama","Lowndes County",2,58,165,77,88
050,01,085,"Alabama","Lowndes County",2,59,152,70,82
050,01,085,"Alabama","Lowndes County",2,60,154,66,88
050,01,085,"Alabama","Lowndes County",2,61,147,59,88
050,01,085,"Alabama","Lowndes County",2,62,159,72,87
050,01,085,"Alabama","Lowndes County",2,63,152,71,81
050,01,085,"Alabama","Lowndes County",2,64,142,67,75
050,01,085,"Alabama","Lowndes County",2,65,148,72,76
050,01,085,"Alabama","Lowndes County",2,66,144,72,72
050,01,085,"Alabama","Lowndes County",2,67,139,66,73
050,01,085,"Alabama","Lowndes County",2,68,109,48,61
050,01,085,"Alabama","Lowndes County",2,69,105,52,53
050,01,085,"Alabama","Lowndes County",2,70,99,46,53
050,01,085,"Alabama","Lowndes County",2,71,113,46,67
050,01,085,"Alabama","Lowndes County",2,72,110,45,65
050,01,085,"Alabama","Lowndes County",2,73,105,52,53
050,01,085,"Alabama","Lowndes County",2,74,82,35,47
050,01,085,"Alabama","Lowndes County",2,75,87,33,54
050,01,085,"Alabama","Lowndes County",2,76,77,31,46
050,01,085,"Alabama","Lowndes County",2,77,72,35,37
050,01,085,"Alabama","Lowndes County",2,78,63,27,36
050,01,085,"Alabama","Lowndes County",2,79,64,26,38
050,01,085,"Alabama","Lowndes County",2,80,71,27,44
050,01,085,"Alabama","Lowndes County",2,81,63,26,37
050,01,085,"Alabama","Lowndes County",2,82,43,15,28
050,01,085,"Alabama","Lowndes County",2,83,39,16,23
050,01,085,"Alabama","Lowndes County",2,84,36,13,23
050,01,085,"Alabama","Lowndes County",2,85,218,71,147
050,01,085,"Alabama","Lowndes County",3,0,120,71,49
050,01,085,"Alabama","Lowndes County",3,1,129,61,68
050,01,085,"Alabama","Lowndes County",3,2,109,59,50
050,01,085,"Alabama","Lowndes County",3,3,113,70,43
050,01,085,"Alabama","Lowndes County",3,4,117,55,62
050,01,085,"Alabama","Lowndes County",3,5,119,62,57
050,01,085,"Alabama","Lowndes County",3,6,104,59,45
050,01,085,"Alabama","Lowndes County",3,7,122,61,61
050,01,085,"Alabama","Lowndes County",3,8,119,64,55
050,01,085,"Alabama","Lowndes County",3,9,114,52,62
050,01,085,"Alabama","Lowndes County",3,10,118,60,58
050,01,085,"Alabama","Lowndes County",3,11,127,55,72
050,01,085,"Alabama","Lowndes County",3,12,129,63,66
050,01,085,"Alabama","Lowndes County",3,13,133,68,65
050,01,085,"Alabama","Lowndes County",3,14,134,64,70
050,01,085,"Alabama","Lowndes County",3,15,128,66,62
050,01,085,"Alabama","Lowndes County",3,16,119,59,60
050,01,085,"Alabama","Lowndes County",3,17,116,54,62
050,01,085,"Alabama","Lowndes County",3,18,93,56,37
050,01,085,"Alabama","Lowndes County",3,19,95,48,47
050,01,085,"Alabama","Lowndes County",3,20,111,61,50
050,01,085,"Alabama","Lowndes County",3,21,113,51,62
050,01,085,"Alabama","Lowndes County",3,22,107,48,59
050,01,085,"Alabama","Lowndes County",3,23,103,56,47
050,01,085,"Alabama","Lowndes County",3,24,127,68,59
050,01,085,"Alabama","Lowndes County",3,25,103,52,51
050,01,085,"Alabama","Lowndes County",3,26,108,54,54
050,01,085,"Alabama","Lowndes County",3,27,117,65,52
050,01,085,"Alabama","Lowndes County",3,28,114,51,63
050,01,085,"Alabama","Lowndes County",3,29,120,53,67
050,01,085,"Alabama","Lowndes County",3,30,141,66,75
050,01,085,"Alabama","Lowndes County",3,31,148,62,86
050,01,085,"Alabama","Lowndes County",3,32,134,56,78
050,01,085,"Alabama","Lowndes County",3,33,126,55,71
050,01,085,"Alabama","Lowndes County",3,34,113,62,51
050,01,085,"Alabama","Lowndes County",3,35,118,63,55
050,01,085,"Alabama","Lowndes County",3,36,98,54,44
050,01,085,"Alabama","Lowndes County",3,37,103,56,47
050,01,085,"Alabama","Lowndes County",3,38,102,50,52
050,01,085,"Alabama","Lowndes County",3,39,110,57,53
050,01,085,"Alabama","Lowndes County",3,40,126,62,64
050,01,085,"Alabama","Lowndes County",3,41,135,67,68
050,01,085,"Alabama","Lowndes County",3,42,101,37,64
050,01,085,"Alabama","Lowndes County",3,43,103,44,59
050,01,085,"Alabama","Lowndes County",3,44,98,49,49
050,01,085,"Alabama","Lowndes County",3,45,98,49,49
050,01,085,"Alabama","Lowndes County",3,46,97,50,47
050,01,085,"Alabama","Lowndes County",3,47,103,48,55
050,01,085,"Alabama","Lowndes County",3,48,107,47,60
050,01,085,"Alabama","Lowndes County",3,49,103,48,55
050,01,085,"Alabama","Lowndes County",3,50,116,54,62
050,01,085,"Alabama","Lowndes County",3,51,137,67,70
050,01,085,"Alabama","Lowndes County",3,52,136,65,71
050,01,085,"Alabama","Lowndes County",3,53,133,60,73
050,01,085,"Alabama","Lowndes County",3,54,127,54,73
050,01,085,"Alabama","Lowndes County",3,55,139,66,73
050,01,085,"Alabama","Lowndes County",3,56,152,76,76
050,01,085,"Alabama","Lowndes County",3,57,170,84,86
050,01,085,"Alabama","Lowndes County",3,58,169,81,88
050,01,085,"Alabama","Lowndes County",3,59,163,71,92
050,01,085,"Alabama","Lowndes County",3,60,150,73,77
050,01,085,"Alabama","Lowndes County",3,61,148,65,83
050,01,085,"Alabama","Lowndes County",3,62,148,65,83
050,01,085,"Alabama","Lowndes County",3,63,160,70,90
050,01,085,"Alabama","Lowndes County",3,64,149,68,81
050,01,085,"Alabama","Lowndes County",3,65,139,66,73
050,01,085,"Alabama","Lowndes County",3,66,146,72,74
050,01,085,"Alabama","Lowndes County",3,67,137,67,70
050,01,085,"Alabama","Lowndes County",3,68,137,68,69
050,01,085,"Alabama","Lowndes County",3,69,106,46,60
050,01,085,"Alabama","Lowndes County",3,70,100,49,51
050,01,085,"Alabama","Lowndes County",3,71,95,43,52
050,01,085,"Alabama","Lowndes County",3,72,103,40,63
050,01,085,"Alabama","Lowndes County",3,73,102,40,62
050,01,085,"Alabama","Lowndes County",3,74,99,47,52
050,01,085,"Alabama","Lowndes County",3,75,78,34,44
050,01,085,"Alabama","Lowndes County",3,76,85,31,54
050,01,085,"Alabama","Lowndes County",3,77,70,28,42
050,01,085,"Alabama","Lowndes County",3,78,65,30,35
050,01,085,"Alabama","Lowndes County",3,79,59,26,33
050,01,085,"Alabama","Lowndes County",3,80,62,24,38
050,01,085,"Alabama","Lowndes County",3,81,61,24,37
050,01,085,"Alabama","Lowndes County",3,82,58,22,36
050,01,085,"Alabama","Lowndes County",3,83,43,17,26
050,01,085,"Alabama","Lowndes County",3,84,29,9,20
050,01,085,"Alabama","Lowndes County",3,85,229,78,151
050,01,085,"Alabama","Lowndes County",4,0,116,59,57
050,01,085,"Alabama","Lowndes County",4,1,106,59,47
050,01,085,"Alabama","Lowndes County",4,2,129,58,71
050,01,085,"Alabama","Lowndes County",4,3,117,62,55
050,01,085,"Alabama","Lowndes County",4,4,116,71,45
050,01,085,"Alabama","Lowndes County",4,5,114,53,61
050,01,085,"Alabama","Lowndes County",4,6,117,61,56
050,01,085,"Alabama","Lowndes County",4,7,101,62,39
050,01,085,"Alabama","Lowndes County",4,8,120,64,56
050,01,085,"Alabama","Lowndes County",4,9,114,64,50
050,01,085,"Alabama","Lowndes County",4,10,109,54,55
050,01,085,"Alabama","Lowndes County",4,11,116,58,58
050,01,085,"Alabama","Lowndes County",4,12,129,60,69
050,01,085,"Alabama","Lowndes County",4,13,128,65,63
050,01,085,"Alabama","Lowndes County",4,14,136,72,64
050,01,085,"Alabama","Lowndes County",4,15,135,67,68
050,01,085,"Alabama","Lowndes County",4,16,118,60,58
050,01,085,"Alabama","Lowndes County",4,17,114,56,58
050,01,085,"Alabama","Lowndes County",4,18,102,52,50
050,01,085,"Alabama","Lowndes County",4,19,80,50,30
050,01,085,"Alabama","Lowndes County",4,20,99,54,45
050,01,085,"Alabama","Lowndes County",4,21,111,59,52
050,01,085,"Alabama","Lowndes County",4,22,131,56,75
050,01,085,"Alabama","Lowndes County",4,23,90,45,45
050,01,085,"Alabama","Lowndes County",4,24,118,71,47
050,01,085,"Alabama","Lowndes County",4,25,121,65,56
050,01,085,"Alabama","Lowndes County",4,26,91,39,52
050,01,085,"Alabama","Lowndes County",4,27,110,55,55
050,01,085,"Alabama","Lowndes County",4,28,113,57,56
050,01,085,"Alabama","Lowndes County",4,29,106,46,60
050,01,085,"Alabama","Lowndes County",4,30,109,47,62
050,01,085,"Alabama","Lowndes County",4,31,141,63,78
050,01,085,"Alabama","Lowndes County",4,32,153,66,87
050,01,085,"Alabama","Lowndes County",4,33,133,53,80
050,01,085,"Alabama","Lowndes County",4,34,127,63,64
050,01,085,"Alabama","Lowndes County",4,35,99,55,44
050,01,085,"Alabama","Lowndes County",4,36,113,59,54
050,01,085,"Alabama","Lowndes County",4,37,105,62,43
050,01,085,"Alabama","Lowndes County",4,38,90,41,49
050,01,085,"Alabama","Lowndes County",4,39,102,54,48
050,01,085,"Alabama","Lowndes County",4,40,107,56,51
050,01,085,"Alabama","Lowndes County",4,41,130,74,56
050,01,085,"Alabama","Lowndes County",4,42,133,62,71
050,01,085,"Alabama","Lowndes County",4,43,105,41,64
050,01,085,"Alabama","Lowndes County",4,44,97,43,54
050,01,085,"Alabama","Lowndes County",4,45,105,52,53
050,01,085,"Alabama","Lowndes County",4,46,89,45,44
050,01,085,"Alabama","Lowndes County",4,47,103,54,49
050,01,085,"Alabama","Lowndes County",4,48,99,45,54
050,01,085,"Alabama","Lowndes County",4,49,100,44,56
050,01,085,"Alabama","Lowndes County",4,50,107,48,59
050,01,085,"Alabama","Lowndes County",4,51,113,55,58
050,01,085,"Alabama","Lowndes County",4,52,139,71,68
050,01,085,"Alabama","Lowndes County",4,53,127,60,67
050,01,085,"Alabama","Lowndes County",4,54,131,60,71
050,01,085,"Alabama","Lowndes County",4,55,124,55,69
050,01,085,"Alabama","Lowndes County",4,56,134,66,68
050,01,085,"Alabama","Lowndes County",4,57,147,70,77
050,01,085,"Alabama","Lowndes County",4,58,161,81,80
050,01,085,"Alabama","Lowndes County",4,59,156,75,81
050,01,085,"Alabama","Lowndes County",4,60,169,74,95
050,01,085,"Alabama","Lowndes County",4,61,149,69,80
050,01,085,"Alabama","Lowndes County",4,62,145,62,83
050,01,085,"Alabama","Lowndes County",4,63,143,62,81
050,01,085,"Alabama","Lowndes County",4,64,156,68,88
050,01,085,"Alabama","Lowndes County",4,65,140,64,76
050,01,085,"Alabama","Lowndes County",4,66,135,66,69
050,01,085,"Alabama","Lowndes County",4,67,138,66,72
050,01,085,"Alabama","Lowndes County",4,68,137,66,71
050,01,085,"Alabama","Lowndes County",4,69,134,64,70
050,01,085,"Alabama","Lowndes County",4,70,104,45,59
050,01,085,"Alabama","Lowndes County",4,71,97,47,50
050,01,085,"Alabama","Lowndes County",4,72,91,43,48
050,01,085,"Alabama","Lowndes County",4,73,98,36,62
050,01,085,"Alabama","Lowndes County",4,74,96,36,60
050,01,085,"Alabama","Lowndes County",4,75,102,49,53
050,01,085,"Alabama","Lowndes County",4,76,76,33,43
050,01,085,"Alabama","Lowndes County",4,77,80,32,48
050,01,085,"Alabama","Lowndes County",4,78,63,22,41
050,01,085,"Alabama","Lowndes County",4,79,58,29,29
050,01,085,"Alabama","Lowndes County",4,80,58,24,34
050,01,085,"Alabama","Lowndes County",4,81,55,22,33
050,01,085,"Alabama","Lowndes County",4,82,57,21,36
050,01,085,"Alabama","Lowndes County",4,83,60,25,35
050,01,085,"Alabama","Lowndes County",4,84,30,7,23
050,01,085,"Alabama","Lowndes County",4,85,226,76,150
050,01,085,"Alabama","Lowndes County",5,0,116,60,56
050,01,085,"Alabama","Lowndes County",5,1,127,59,68
050,01,085,"Alabama","Lowndes County",5,2,103,55,48
050,01,085,"Alabama","Lowndes County",5,3,132,62,70
050,01,085,"Alabama","Lowndes County",5,4,119,65,54
050,01,085,"Alabama","Lowndes County",5,5,115,70,45
050,01,085,"Alabama","Lowndes County",5,6,115,51,64
050,01,085,"Alabama","Lowndes County",5,7,120,63,57
050,01,085,"Alabama","Lowndes County",5,8,106,64,42
050,01,085,"Alabama","Lowndes County",5,9,119,62,57
050,01,085,"Alabama","Lowndes County",5,10,115,65,50
050,01,085,"Alabama","Lowndes County",5,11,109,54,55
050,01,085,"Alabama","Lowndes County",5,12,114,58,56
050,01,085,"Alabama","Lowndes County",5,13,129,59,70
050,01,085,"Alabama","Lowndes County",5,14,119,58,61
050,01,085,"Alabama","Lowndes County",5,15,138,72,66
050,01,085,"Alabama","Lowndes County",5,16,136,70,66
050,01,085,"Alabama","Lowndes County",5,17,115,57,58
050,01,085,"Alabama","Lowndes County",5,18,104,53,51
050,01,085,"Alabama","Lowndes County",5,19,81,43,38
050,01,085,"Alabama","Lowndes County",5,20,84,51,33
050,01,085,"Alabama","Lowndes County",5,21,93,45,48
050,01,085,"Alabama","Lowndes County",5,22,137,72,65
050,01,085,"Alabama","Lowndes County",5,23,117,57,60
050,01,085,"Alabama","Lowndes County",5,24,106,54,52
050,01,085,"Alabama","Lowndes County",5,25,109,64,45
050,01,085,"Alabama","Lowndes County",5,26,108,53,55
050,01,085,"Alabama","Lowndes County",5,27,85,39,46
050,01,085,"Alabama","Lowndes County",5,28,114,54,60
050,01,085,"Alabama","Lowndes County",5,29,110,56,54
050,01,085,"Alabama","Lowndes County",5,30,110,44,66
050,01,085,"Alabama","Lowndes County",5,31,107,42,65
050,01,085,"Alabama","Lowndes County",5,32,138,64,74
050,01,085,"Alabama","Lowndes County",5,33,158,73,85
050,01,085,"Alabama","Lowndes County",5,34,138,61,77
050,01,085,"Alabama","Lowndes County",5,35,125,62,63
050,01,085,"Alabama","Lowndes County",5,36,90,49,41
050,01,085,"Alabama","Lowndes County",5,37,110,61,49
050,01,085,"Alabama","Lowndes County",5,38,103,50,53
050,01,085,"Alabama","Lowndes County",5,39,88,40,48
050,01,085,"Alabama","Lowndes County",5,40,102,52,50
050,01,085,"Alabama","Lowndes County",5,41,111,62,49
050,01,085,"Alabama","Lowndes County",5,42,113,61,52
050,01,085,"Alabama","Lowndes County",5,43,139,67,72
050,01,085,"Alabama","Lowndes County",5,44,111,45,66
050,01,085,"Alabama","Lowndes County",5,45,96,44,52
050,01,085,"Alabama","Lowndes County",5,46,100,46,54
050,01,085,"Alabama","Lowndes County",5,47,90,44,46
050,01,085,"Alabama","Lowndes County",5,48,93,48,45
050,01,085,"Alabama","Lowndes County",5,49,97,44,53
050,01,085,"Alabama","Lowndes County",5,50,98,41,57
050,01,085,"Alabama","Lowndes County",5,51,107,48,59
050,01,085,"Alabama","Lowndes County",5,52,120,62,58
050,01,085,"Alabama","Lowndes County",5,53,129,62,67
050,01,085,"Alabama","Lowndes County",5,54,129,59,70
050,01,085,"Alabama","Lowndes County",5,55,137,62,75
050,01,085,"Alabama","Lowndes County",5,56,126,59,67
050,01,085,"Alabama","Lowndes County",5,57,135,62,73
050,01,085,"Alabama","Lowndes County",5,58,141,68,73
050,01,085,"Alabama","Lowndes County",5,59,163,81,82
050,01,085,"Alabama","Lowndes County",5,60,157,79,78
050,01,085,"Alabama","Lowndes County",5,61,163,69,94
050,01,085,"Alabama","Lowndes County",5,62,144,67,77
050,01,085,"Alabama","Lowndes County",5,63,137,62,75
050,01,085,"Alabama","Lowndes County",5,64,145,63,82
050,01,085,"Alabama","Lowndes County",5,65,152,66,86
050,01,085,"Alabama","Lowndes County",5,66,136,64,72
050,01,085,"Alabama","Lowndes County",5,67,129,60,69
050,01,085,"Alabama","Lowndes County",5,68,137,65,72
050,01,085,"Alabama","Lowndes County",5,69,137,64,73
050,01,085,"Alabama","Lowndes County",5,70,129,60,69
050,01,085,"Alabama","Lowndes County",5,71,104,46,58
050,01,085,"Alabama","Lowndes County",5,72,88,42,46
050,01,085,"Alabama","Lowndes County",5,73,82,38,44
050,01,085,"Alabama","Lowndes County",5,74,96,34,62
050,01,085,"Alabama","Lowndes County",5,75,95,36,59
050,01,085,"Alabama","Lowndes County",5,76,98,46,52
050,01,085,"Alabama","Lowndes County",5,77,71,32,39
050,01,085,"Alabama","Lowndes County",5,78,75,26,49
050,01,085,"Alabama","Lowndes County",5,79,58,21,37
050,01,085,"Alabama","Lowndes County",5,80,54,24,30
050,01,085,"Alabama","Lowndes County",5,81,50,20,30
050,01,085,"Alabama","Lowndes County",5,82,53,19,34
050,01,085,"Alabama","Lowndes County",5,83,59,24,35
050,01,085,"Alabama","Lowndes County",5,84,48,16,32
050,01,085,"Alabama","Lowndes County",5,85,221,70,151
050,01,087,"Alabama","Macon County",1,0,179,93,86
050,01,087,"Alabama","Macon County",1,1,197,108,89
050,01,087,"Alabama","Macon County",1,2,198,110,88
050,01,087,"Alabama","Macon County",1,3,188,99,89
050,01,087,"Alabama","Macon County",1,4,177,94,83
050,01,087,"Alabama","Macon County",1,5,187,92,95
050,01,087,"Alabama","Macon County",1,6,189,89,100
050,01,087,"Alabama","Macon County",1,7,171,88,83
050,01,087,"Alabama","Macon County",1,8,183,91,92
050,01,087,"Alabama","Macon County",1,9,168,83,85
050,01,087,"Alabama","Macon County",1,10,181,97,84
050,01,087,"Alabama","Macon County",1,11,193,108,85
050,01,087,"Alabama","Macon County",1,12,195,96,99
050,01,087,"Alabama","Macon County",1,13,189,95,94
050,01,087,"Alabama","Macon County",1,14,199,97,102
050,01,087,"Alabama","Macon County",1,15,179,104,75
050,01,087,"Alabama","Macon County",1,16,183,98,85
050,01,087,"Alabama","Macon County",1,17,214,103,111
050,01,087,"Alabama","Macon County",1,18,542,252,290
050,01,087,"Alabama","Macon County",1,19,736,296,440
050,01,087,"Alabama","Macon County",1,20,646,230,416
050,01,087,"Alabama","Macon County",1,21,611,259,352
050,01,087,"Alabama","Macon County",1,22,503,226,277
050,01,087,"Alabama","Macon County",1,23,372,189,183
050,01,087,"Alabama","Macon County",1,24,281,134,147
050,01,087,"Alabama","Macon County",1,25,247,105,142
050,01,087,"Alabama","Macon County",1,26,246,119,127
050,01,087,"Alabama","Macon County",1,27,245,117,128
050,01,087,"Alabama","Macon County",1,28,256,128,128
050,01,087,"Alabama","Macon County",1,29,213,100,113
050,01,087,"Alabama","Macon County",1,30,248,110,138
050,01,087,"Alabama","Macon County",1,31,203,102,101
050,01,087,"Alabama","Macon County",1,32,184,84,100
050,01,087,"Alabama","Macon County",1,33,174,81,93
050,01,087,"Alabama","Macon County",1,34,172,70,102
050,01,087,"Alabama","Macon County",1,35,179,68,111
050,01,087,"Alabama","Macon County",1,36,157,74,83
050,01,087,"Alabama","Macon County",1,37,179,81,98
050,01,087,"Alabama","Macon County",1,38,172,81,91
050,01,087,"Alabama","Macon County",1,39,195,97,98
050,01,087,"Alabama","Macon County",1,40,158,76,82
050,01,087,"Alabama","Macon County",1,41,170,89,81
050,01,087,"Alabama","Macon County",1,42,165,72,93
050,01,087,"Alabama","Macon County",1,43,168,76,92
050,01,087,"Alabama","Macon County",1,44,169,82,87
050,01,087,"Alabama","Macon County",1,45,184,87,97
050,01,087,"Alabama","Macon County",1,46,197,93,104
050,01,087,"Alabama","Macon County",1,47,196,81,115
050,01,087,"Alabama","Macon County",1,48,222,97,125
050,01,087,"Alabama","Macon County",1,49,207,93,114
050,01,087,"Alabama","Macon County",1,50,201,99,102
050,01,087,"Alabama","Macon County",1,51,204,99,105
050,01,087,"Alabama","Macon County",1,52,227,103,124
050,01,087,"Alabama","Macon County",1,53,220,98,122
050,01,087,"Alabama","Macon County",1,54,244,104,140
050,01,087,"Alabama","Macon County",1,55,251,121,130
050,01,087,"Alabama","Macon County",1,56,266,120,146
050,01,087,"Alabama","Macon County",1,57,257,104,153
050,01,087,"Alabama","Macon County",1,58,245,103,142
050,01,087,"Alabama","Macon County",1,59,266,115,151
050,01,087,"Alabama","Macon County",1,60,262,129,133
050,01,087,"Alabama","Macon County",1,61,261,129,132
050,01,087,"Alabama","Macon County",1,62,265,136,129
050,01,087,"Alabama","Macon County",1,63,260,121,139
050,01,087,"Alabama","Macon County",1,64,240,103,137
050,01,087,"Alabama","Macon County",1,65,244,101,143
050,01,087,"Alabama","Macon County",1,66,250,100,150
050,01,087,"Alabama","Macon County",1,67,289,128,161
050,01,087,"Alabama","Macon County",1,68,270,118,152
050,01,087,"Alabama","Macon County",1,69,255,101,154
050,01,087,"Alabama","Macon County",1,70,265,122,143
050,01,087,"Alabama","Macon County",1,71,223,106,117
050,01,087,"Alabama","Macon County",1,72,217,95,122
050,01,087,"Alabama","Macon County",1,73,214,102,112
050,01,087,"Alabama","Macon County",1,74,154,63,91
050,01,087,"Alabama","Macon County",1,75,161,64,97
050,01,087,"Alabama","Macon County",1,76,157,63,94
050,01,087,"Alabama","Macon County",1,77,150,61,89
050,01,087,"Alabama","Macon County",1,78,137,61,76
050,01,087,"Alabama","Macon County",1,79,114,47,67
050,01,087,"Alabama","Macon County",1,80,111,46,65
050,01,087,"Alabama","Macon County",1,81,91,32,59
050,01,087,"Alabama","Macon County",1,82,79,27,52
050,01,087,"Alabama","Macon County",1,83,62,21,41
050,01,087,"Alabama","Macon County",1,84,67,20,47
050,01,087,"Alabama","Macon County",1,85,381,116,265
050,01,087,"Alabama","Macon County",2,0,166,88,78
050,01,087,"Alabama","Macon County",2,1,193,105,88
050,01,087,"Alabama","Macon County",2,2,197,108,89
050,01,087,"Alabama","Macon County",2,3,188,100,88
050,01,087,"Alabama","Macon County",2,4,181,95,86
050,01,087,"Alabama","Macon County",2,5,188,94,94
050,01,087,"Alabama","Macon County",2,6,188,92,96
050,01,087,"Alabama","Macon County",2,7,176,89,87
050,01,087,"Alabama","Macon County",2,8,180,90,90
050,01,087,"Alabama","Macon County",2,9,171,84,87
050,01,087,"Alabama","Macon County",2,10,177,94,83
050,01,087,"Alabama","Macon County",2,11,191,106,85
050,01,087,"Alabama","Macon County",2,12,195,100,95
050,01,087,"Alabama","Macon County",2,13,190,97,93
050,01,087,"Alabama","Macon County",2,14,198,98,100
050,01,087,"Alabama","Macon County",2,15,184,104,80
050,01,087,"Alabama","Macon County",2,16,183,101,82
050,01,087,"Alabama","Macon County",2,17,207,101,106
050,01,087,"Alabama","Macon County",2,18,539,247,292
050,01,087,"Alabama","Macon County",2,19,728,290,438
050,01,087,"Alabama","Macon County",2,20,653,233,420
050,01,087,"Alabama","Macon County",2,21,607,259,348
050,01,087,"Alabama","Macon County",2,22,505,223,282
050,01,087,"Alabama","Macon County",2,23,368,187,181
050,01,087,"Alabama","Macon County",2,24,283,134,149
050,01,087,"Alabama","Macon County",2,25,246,104,142
050,01,087,"Alabama","Macon County",2,26,241,115,126
050,01,087,"Alabama","Macon County",2,27,242,116,126
050,01,087,"Alabama","Macon County",2,28,249,123,126
050,01,087,"Alabama","Macon County",2,29,224,106,118
050,01,087,"Alabama","Macon County",2,30,239,107,132
050,01,087,"Alabama","Macon County",2,31,210,103,107
050,01,087,"Alabama","Macon County",2,32,186,87,99
050,01,087,"Alabama","Macon County",2,33,180,83,97
050,01,087,"Alabama","Macon County",2,34,171,71,100
050,01,087,"Alabama","Macon County",2,35,177,69,108
050,01,087,"Alabama","Macon County",2,36,160,71,89
050,01,087,"Alabama","Macon County",2,37,173,78,95
050,01,087,"Alabama","Macon County",2,38,176,83,93
050,01,087,"Alabama","Macon County",2,39,186,90,96
050,01,087,"Alabama","Macon County",2,40,168,82,86
050,01,087,"Alabama","Macon County",2,41,165,84,81
050,01,087,"Alabama","Macon County",2,42,163,74,89
050,01,087,"Alabama","Macon County",2,43,171,76,95
050,01,087,"Alabama","Macon County",2,44,167,79,88
050,01,087,"Alabama","Macon County",2,45,182,86,96
050,01,087,"Alabama","Macon County",2,46,193,90,103
050,01,087,"Alabama","Macon County",2,47,194,83,111
050,01,087,"Alabama","Macon County",2,48,218,95,123
050,01,087,"Alabama","Macon County",2,49,209,93,116
050,01,087,"Alabama","Macon County",2,50,200,96,104
050,01,087,"Alabama","Macon County",2,51,203,99,104
050,01,087,"Alabama","Macon County",2,52,223,102,121
050,01,087,"Alabama","Macon County",2,53,221,99,122
050,01,087,"Alabama","Macon County",2,54,238,102,136
050,01,087,"Alabama","Macon County",2,55,247,115,132
050,01,087,"Alabama","Macon County",2,56,263,120,143
050,01,087,"Alabama","Macon County",2,57,256,107,149
050,01,087,"Alabama","Macon County",2,58,249,103,146
050,01,087,"Alabama","Macon County",2,59,263,114,149
050,01,087,"Alabama","Macon County",2,60,263,126,137
050,01,087,"Alabama","Macon County",2,61,260,130,130
050,01,087,"Alabama","Macon County",2,62,260,130,130
050,01,087,"Alabama","Macon County",2,63,266,127,139
050,01,087,"Alabama","Macon County",2,64,240,105,135
050,01,087,"Alabama","Macon County",2,65,244,102,142
050,01,087,"Alabama","Macon County",2,66,247,99,148
050,01,087,"Alabama","Macon County",2,67,278,122,156
050,01,087,"Alabama","Macon County",2,68,269,118,151
050,01,087,"Alabama","Macon County",2,69,258,105,153
050,01,087,"Alabama","Macon County",2,70,261,116,145
050,01,087,"Alabama","Macon County",2,71,230,109,121
050,01,087,"Alabama","Macon County",2,72,217,97,120
050,01,087,"Alabama","Macon County",2,73,219,102,117
050,01,087,"Alabama","Macon County",2,74,158,68,90
050,01,087,"Alabama","Macon County",2,75,158,63,95
050,01,087,"Alabama","Macon County",2,76,153,61,92
050,01,087,"Alabama","Macon County",2,77,152,63,89
050,01,087,"Alabama","Macon County",2,78,134,60,74
050,01,087,"Alabama","Macon County",2,79,118,49,69
050,01,087,"Alabama","Macon County",2,80,110,46,64
050,01,087,"Alabama","Macon County",2,81,92,34,58
050,01,087,"Alabama","Macon County",2,82,81,28,53
050,01,087,"Alabama","Macon County",2,83,65,21,44
050,01,087,"Alabama","Macon County",2,84,65,20,45
050,01,087,"Alabama","Macon County",2,85,377,115,262
050,01,087,"Alabama","Macon County",3,0,190,105,85
050,01,087,"Alabama","Macon County",3,1,163,86,77
050,01,087,"Alabama","Macon County",3,2,174,91,83
050,01,087,"Alabama","Macon County",3,3,193,98,95
050,01,087,"Alabama","Macon County",3,4,177,86,91
050,01,087,"Alabama","Macon County",3,5,161,87,74
050,01,087,"Alabama","Macon County",3,6,177,91,86
050,01,087,"Alabama","Macon County",3,7,181,87,94
050,01,087,"Alabama","Macon County",3,8,170,85,85
050,01,087,"Alabama","Macon County",3,9,178,91,87
050,01,087,"Alabama","Macon County",3,10,154,77,77
050,01,087,"Alabama","Macon County",3,11,179,93,86
050,01,087,"Alabama","Macon County",3,12,188,106,82
050,01,087,"Alabama","Macon County",3,13,189,94,95
050,01,087,"Alabama","Macon County",3,14,205,103,102
050,01,087,"Alabama","Macon County",3,15,199,100,99
050,01,087,"Alabama","Macon County",3,16,189,109,80
050,01,087,"Alabama","Macon County",3,17,193,109,84
050,01,087,"Alabama","Macon County",3,18,521,234,287
050,01,087,"Alabama","Macon County",3,19,696,275,421
050,01,087,"Alabama","Macon County",3,20,618,227,391
050,01,087,"Alabama","Macon County",3,21,556,237,319
050,01,087,"Alabama","Macon County",3,22,469,199,270
050,01,087,"Alabama","Macon County",3,23,356,188,168
050,01,087,"Alabama","Macon County",3,24,285,143,142
050,01,087,"Alabama","Macon County",3,25,245,108,137
050,01,087,"Alabama","Macon County",3,26,203,92,111
050,01,087,"Alabama","Macon County",3,27,203,100,103
050,01,087,"Alabama","Macon County",3,28,218,100,118
050,01,087,"Alabama","Macon County",3,29,233,114,119
050,01,087,"Alabama","Macon County",3,30,213,104,109
050,01,087,"Alabama","Macon County",3,31,222,97,125
050,01,087,"Alabama","Macon County",3,32,193,92,101
050,01,087,"Alabama","Macon County",3,33,182,87,95
050,01,087,"Alabama","Macon County",3,34,177,86,91
050,01,087,"Alabama","Macon County",3,35,169,73,96
050,01,087,"Alabama","Macon County",3,36,173,69,104
050,01,087,"Alabama","Macon County",3,37,157,71,86
050,01,087,"Alabama","Macon County",3,38,165,76,89
050,01,087,"Alabama","Macon County",3,39,172,75,97
050,01,087,"Alabama","Macon County",3,40,176,81,95
050,01,087,"Alabama","Macon County",3,41,169,81,88
050,01,087,"Alabama","Macon County",3,42,167,87,80
050,01,087,"Alabama","Macon County",3,43,154,67,87
050,01,087,"Alabama","Macon County",3,44,177,81,96
050,01,087,"Alabama","Macon County",3,45,160,75,85
050,01,087,"Alabama","Macon County",3,46,181,88,93
050,01,087,"Alabama","Macon County",3,47,190,88,102
050,01,087,"Alabama","Macon County",3,48,192,82,110
050,01,087,"Alabama","Macon County",3,49,221,98,123
050,01,087,"Alabama","Macon County",3,50,211,96,115
050,01,087,"Alabama","Macon County",3,51,195,91,104
050,01,087,"Alabama","Macon County",3,52,190,95,95
050,01,087,"Alabama","Macon County",3,53,211,96,115
050,01,087,"Alabama","Macon County",3,54,213,93,120
050,01,087,"Alabama","Macon County",3,55,234,101,133
050,01,087,"Alabama","Macon County",3,56,240,111,129
050,01,087,"Alabama","Macon County",3,57,261,118,143
050,01,087,"Alabama","Macon County",3,58,248,106,142
050,01,087,"Alabama","Macon County",3,59,241,100,141
050,01,087,"Alabama","Macon County",3,60,260,111,149
050,01,087,"Alabama","Macon County",3,61,246,116,130
050,01,087,"Alabama","Macon County",3,62,256,128,128
050,01,087,"Alabama","Macon County",3,63,259,131,128
050,01,087,"Alabama","Macon County",3,64,253,119,134
050,01,087,"Alabama","Macon County",3,65,235,107,128
050,01,087,"Alabama","Macon County",3,66,239,101,138
050,01,087,"Alabama","Macon County",3,67,239,92,147
050,01,087,"Alabama","Macon County",3,68,266,114,152
050,01,087,"Alabama","Macon County",3,69,265,118,147
050,01,087,"Alabama","Macon County",3,70,258,105,153
050,01,087,"Alabama","Macon County",3,71,254,111,143
050,01,087,"Alabama","Macon County",3,72,218,101,117
050,01,087,"Alabama","Macon County",3,73,207,92,115
050,01,087,"Alabama","Macon County",3,74,210,94,116
050,01,087,"Alabama","Macon County",3,75,155,66,89
050,01,087,"Alabama","Macon County",3,76,149,61,88
050,01,087,"Alabama","Macon County",3,77,150,60,90
050,01,087,"Alabama","Macon County",3,78,136,52,84
050,01,087,"Alabama","Macon County",3,79,128,56,72
050,01,087,"Alabama","Macon County",3,80,110,45,65
050,01,087,"Alabama","Macon County",3,81,99,40,59
050,01,087,"Alabama","Macon County",3,82,86,29,57
050,01,087,"Alabama","Macon County",3,83,73,24,49
050,01,087,"Alabama","Macon County",3,84,62,21,41
050,01,087,"Alabama","Macon County",3,85,375,117,258
050,01,087,"Alabama","Macon County",4,0,158,79,79
050,01,087,"Alabama","Macon County",4,1,184,99,85
050,01,087,"Alabama","Macon County",4,2,158,84,74
050,01,087,"Alabama","Macon County",4,3,166,88,78
050,01,087,"Alabama","Macon County",4,4,185,97,88
050,01,087,"Alabama","Macon County",4,5,168,81,87
050,01,087,"Alabama","Macon County",4,6,154,81,73
050,01,087,"Alabama","Macon County",4,7,164,78,86
050,01,087,"Alabama","Macon County",4,8,178,88,90
050,01,087,"Alabama","Macon County",4,9,162,79,83
050,01,087,"Alabama","Macon County",4,10,164,84,80
050,01,087,"Alabama","Macon County",4,11,153,76,77
050,01,087,"Alabama","Macon County",4,12,173,88,85
050,01,087,"Alabama","Macon County",4,13,182,101,81
050,01,087,"Alabama","Macon County",4,14,184,88,96
050,01,087,"Alabama","Macon County",4,15,197,103,94
050,01,087,"Alabama","Macon County",4,16,197,99,98
050,01,087,"Alabama","Macon County",4,17,196,106,90
050,01,087,"Alabama","Macon County",4,18,517,245,272
050,01,087,"Alabama","Macon County",4,19,703,273,430
050,01,087,"Alabama","Macon County",4,20,607,213,394
050,01,087,"Alabama","Macon County",4,21,558,249,309
050,01,087,"Alabama","Macon County",4,22,441,196,245
050,01,087,"Alabama","Macon County",4,23,341,174,167
050,01,087,"Alabama","Macon County",4,24,275,141,134
050,01,087,"Alabama","Macon County",4,25,244,115,129
050,01,087,"Alabama","Macon County",4,26,209,106,103
050,01,087,"Alabama","Macon County",4,27,181,79,102
050,01,087,"Alabama","Macon County",4,28,196,91,105
050,01,087,"Alabama","Macon County",4,29,204,99,105
050,01,087,"Alabama","Macon County",4,30,229,113,116
050,01,087,"Alabama","Macon County",4,31,219,103,116
050,01,087,"Alabama","Macon County",4,32,217,99,118
050,01,087,"Alabama","Macon County",4,33,189,86,103
050,01,087,"Alabama","Macon County",4,34,173,81,92
050,01,087,"Alabama","Macon County",4,35,170,85,85
050,01,087,"Alabama","Macon County",4,36,160,73,87
050,01,087,"Alabama","Macon County",4,37,172,70,102
050,01,087,"Alabama","Macon County",4,38,160,78,82
050,01,087,"Alabama","Macon County",4,39,163,73,90
050,01,087,"Alabama","Macon County",4,40,160,71,89
050,01,087,"Alabama","Macon County",4,41,173,80,93
050,01,087,"Alabama","Macon County",4,42,162,74,88
050,01,087,"Alabama","Macon County",4,43,172,89,83
050,01,087,"Alabama","Macon County",4,44,151,63,88
050,01,087,"Alabama","Macon County",4,45,168,75,93
050,01,087,"Alabama","Macon County",4,46,159,75,84
050,01,087,"Alabama","Macon County",4,47,167,78,89
050,01,087,"Alabama","Macon County",4,48,187,84,103
050,01,087,"Alabama","Macon County",4,49,177,70,107
050,01,087,"Alabama","Macon County",4,50,213,93,120
050,01,087,"Alabama","Macon County",4,51,202,97,105
050,01,087,"Alabama","Macon County",4,52,183,83,100
050,01,087,"Alabama","Macon County",4,53,188,92,96
050,01,087,"Alabama","Macon County",4,54,210,98,112
050,01,087,"Alabama","Macon County",4,55,213,93,120
050,01,087,"Alabama","Macon County",4,56,231,101,130
050,01,087,"Alabama","Macon County",4,57,234,104,130
050,01,087,"Alabama","Macon County",4,58,266,120,146
050,01,087,"Alabama","Macon County",4,59,252,107,145
050,01,087,"Alabama","Macon County",4,60,245,104,141
050,01,087,"Alabama","Macon County",4,61,258,114,144
050,01,087,"Alabama","Macon County",4,62,245,113,132
050,01,087,"Alabama","Macon County",4,63,255,128,127
050,01,087,"Alabama","Macon County",4,64,247,124,123
050,01,087,"Alabama","Macon County",4,65,251,118,133
050,01,087,"Alabama","Macon County",4,66,225,106,119
050,01,087,"Alabama","Macon County",4,67,231,97,134
050,01,087,"Alabama","Macon County",4,68,236,91,145
050,01,087,"Alabama","Macon County",4,69,263,114,149
050,01,087,"Alabama","Macon County",4,70,258,114,144
050,01,087,"Alabama","Macon County",4,71,248,98,150
050,01,087,"Alabama","Macon County",4,72,247,107,140
050,01,087,"Alabama","Macon County",4,73,211,96,115
050,01,087,"Alabama","Macon County",4,74,196,83,113
050,01,087,"Alabama","Macon County",4,75,209,91,118
050,01,087,"Alabama","Macon County",4,76,147,65,82
050,01,087,"Alabama","Macon County",4,77,138,58,80
050,01,087,"Alabama","Macon County",4,78,144,56,88
050,01,087,"Alabama","Macon County",4,79,128,48,80
050,01,087,"Alabama","Macon County",4,80,118,53,65
050,01,087,"Alabama","Macon County",4,81,100,37,63
050,01,087,"Alabama","Macon County",4,82,96,37,59
050,01,087,"Alabama","Macon County",4,83,75,25,50
050,01,087,"Alabama","Macon County",4,84,67,19,48
050,01,087,"Alabama","Macon County",4,85,375,122,253
050,01,087,"Alabama","Macon County",5,0,158,81,77
050,01,087,"Alabama","Macon County",5,1,173,88,85
050,01,087,"Alabama","Macon County",5,2,182,90,92
050,01,087,"Alabama","Macon County",5,3,157,79,78
050,01,087,"Alabama","Macon County",5,4,165,81,84
050,01,087,"Alabama","Macon County",5,5,182,96,86
050,01,087,"Alabama","Macon County",5,6,164,76,88
050,01,087,"Alabama","Macon County",5,7,153,81,72
050,01,087,"Alabama","Macon County",5,8,150,68,82
050,01,087,"Alabama","Macon County",5,9,174,88,86
050,01,087,"Alabama","Macon County",5,10,155,77,78
050,01,087,"Alabama","Macon County",5,11,155,85,70
050,01,087,"Alabama","Macon County",5,12,154,78,76
050,01,087,"Alabama","Macon County",5,13,167,85,82
050,01,087,"Alabama","Macon County",5,14,183,109,74
050,01,087,"Alabama","Macon County",5,15,197,105,92
050,01,087,"Alabama","Macon County",5,16,183,96,87
050,01,087,"Alabama","Macon County",5,17,196,100,96
050,01,087,"Alabama","Macon County",5,18,525,250,275
050,01,087,"Alabama","Macon County",5,19,706,285,421
050,01,087,"Alabama","Macon County",5,20,618,217,401
050,01,087,"Alabama","Macon County",5,21,529,228,301
050,01,087,"Alabama","Macon County",5,22,444,201,243
050,01,087,"Alabama","Macon County",5,23,305,158,147
050,01,087,"Alabama","Macon County",5,24,268,137,131
050,01,087,"Alabama","Macon County",5,25,239,104,135
050,01,087,"Alabama","Macon County",5,26,216,108,108
050,01,087,"Alabama","Macon County",5,27,182,94,88
050,01,087,"Alabama","Macon County",5,28,169,72,97
050,01,087,"Alabama","Macon County",5,29,191,88,103
050,01,087,"Alabama","Macon County",5,30,213,100,113
050,01,087,"Alabama","Macon County",5,31,209,108,101
050,01,087,"Alabama","Macon County",5,32,208,101,107
050,01,087,"Alabama","Macon County",5,33,200,90,110
050,01,087,"Alabama","Macon County",5,34,201,90,111
050,01,087,"Alabama","Macon County",5,35,171,85,86
050,01,087,"Alabama","Macon County",5,36,166,87,79
050,01,087,"Alabama","Macon County",5,37,171,77,94
050,01,087,"Alabama","Macon County",5,38,168,69,99
050,01,087,"Alabama","Macon County",5,39,158,75,83
050,01,087,"Alabama","Macon County",5,40,165,69,96
050,01,087,"Alabama","Macon County",5,41,151,67,84
050,01,087,"Alabama","Macon County",5,42,175,82,93
050,01,087,"Alabama","Macon County",5,43,165,78,87
050,01,087,"Alabama","Macon County",5,44,173,90,83
050,01,087,"Alabama","Macon County",5,45,155,64,91
050,01,087,"Alabama","Macon County",5,46,167,74,93
050,01,087,"Alabama","Macon County",5,47,156,72,84
050,01,087,"Alabama","Macon County",5,48,171,80,91
050,01,087,"Alabama","Macon County",5,49,196,84,112
050,01,087,"Alabama","Macon County",5,50,181,72,109
050,01,087,"Alabama","Macon County",5,51,212,91,121
050,01,087,"Alabama","Macon County",5,52,200,93,107
050,01,087,"Alabama","Macon County",5,53,179,74,105
050,01,087,"Alabama","Macon County",5,54,191,92,99
050,01,087,"Alabama","Macon County",5,55,213,100,113
050,01,087,"Alabama","Macon County",5,56,219,101,118
050,01,087,"Alabama","Macon County",5,57,228,104,124
050,01,087,"Alabama","Macon County",5,58,239,100,139
050,01,087,"Alabama","Macon County",5,59,264,122,142
050,01,087,"Alabama","Macon County",5,60,245,103,142
050,01,087,"Alabama","Macon County",5,61,243,102,141
050,01,087,"Alabama","Macon County",5,62,263,114,149
050,01,087,"Alabama","Macon County",5,63,240,109,131
050,01,087,"Alabama","Macon County",5,64,245,123,122
050,01,087,"Alabama","Macon County",5,65,246,121,125
050,01,087,"Alabama","Macon County",5,66,247,120,127
050,01,087,"Alabama","Macon County",5,67,221,104,117
050,01,087,"Alabama","Macon County",5,68,228,90,138
050,01,087,"Alabama","Macon County",5,69,234,89,145
050,01,087,"Alabama","Macon County",5,70,250,110,140
050,01,087,"Alabama","Macon County",5,71,250,111,139
050,01,087,"Alabama","Macon County",5,72,235,94,141
050,01,087,"Alabama","Macon County",5,73,236,100,136
050,01,087,"Alabama","Macon County",5,74,199,88,111
050,01,087,"Alabama","Macon County",5,75,198,82,116
050,01,087,"Alabama","Macon County",5,76,200,89,111
050,01,087,"Alabama","Macon County",5,77,146,66,80
050,01,087,"Alabama","Macon County",5,78,131,52,79
050,01,087,"Alabama","Macon County",5,79,140,53,87
050,01,087,"Alabama","Macon County",5,80,120,44,76
050,01,087,"Alabama","Macon County",5,81,107,47,60
050,01,087,"Alabama","Macon County",5,82,94,32,62
050,01,087,"Alabama","Macon County",5,83,86,33,53
050,01,087,"Alabama","Macon County",5,84,69,21,48
050,01,087,"Alabama","Macon County",5,85,392,128,264
050,01,089,"Alabama","Madison County",1,0,4337,2218,2119
050,01,089,"Alabama","Madison County",1,1,4428,2268,2160
050,01,089,"Alabama","Madison County",1,2,4618,2361,2257
050,01,089,"Alabama","Madison County",1,3,4638,2379,2259
050,01,089,"Alabama","Madison County",1,4,4597,2319,2278
050,01,089,"Alabama","Madison County",1,5,4722,2421,2301
050,01,089,"Alabama","Madison County",1,6,4597,2365,2232
050,01,089,"Alabama","Madison County",1,7,4526,2312,2214
050,01,089,"Alabama","Madison County",1,8,4568,2286,2282
050,01,089,"Alabama","Madison County",1,9,4756,2442,2314
050,01,089,"Alabama","Madison County",1,10,4823,2422,2401
050,01,089,"Alabama","Madison County",1,11,4955,2548,2407
050,01,089,"Alabama","Madison County",1,12,5158,2651,2507
050,01,089,"Alabama","Madison County",1,13,5060,2588,2472
050,01,089,"Alabama","Madison County",1,14,4907,2453,2454
050,01,089,"Alabama","Madison County",1,15,4927,2524,2403
050,01,089,"Alabama","Madison County",1,16,4886,2517,2369
050,01,089,"Alabama","Madison County",1,17,4924,2479,2445
050,01,089,"Alabama","Madison County",1,18,5308,2727,2581
050,01,089,"Alabama","Madison County",1,19,5497,2701,2796
050,01,089,"Alabama","Madison County",1,20,5288,2590,2698
050,01,089,"Alabama","Madison County",1,21,5187,2596,2591
050,01,089,"Alabama","Madison County",1,22,5093,2502,2591
050,01,089,"Alabama","Madison County",1,23,5114,2534,2580
050,01,089,"Alabama","Madison County",1,24,5224,2639,2585
050,01,089,"Alabama","Madison County",1,25,5328,2715,2613
050,01,089,"Alabama","Madison County",1,26,5491,2867,2624
050,01,089,"Alabama","Madison County",1,27,5455,2873,2582
050,01,089,"Alabama","Madison County",1,28,5573,2819,2754
050,01,089,"Alabama","Madison County",1,29,5650,2821,2829
050,01,089,"Alabama","Madison County",1,30,5587,2808,2779
050,01,089,"Alabama","Madison County",1,31,5380,2684,2696
050,01,089,"Alabama","Madison County",1,32,5346,2661,2685
050,01,089,"Alabama","Madison County",1,33,5283,2639,2644
050,01,089,"Alabama","Madison County",1,34,5370,2661,2709
050,01,089,"Alabama","Madison County",1,35,5363,2683,2680
050,01,089,"Alabama","Madison County",1,36,5111,2572,2539
050,01,089,"Alabama","Madison County",1,37,5118,2554,2564
050,01,089,"Alabama","Madison County",1,38,5103,2602,2501
050,01,089,"Alabama","Madison County",1,39,4986,2467,2519
050,01,089,"Alabama","Madison County",1,40,4817,2387,2430
050,01,089,"Alabama","Madison County",1,41,4706,2298,2408
050,01,089,"Alabama","Madison County",1,42,4665,2268,2397
050,01,089,"Alabama","Madison County",1,43,4521,2177,2344
050,01,089,"Alabama","Madison County",1,44,4265,2078,2187
050,01,089,"Alabama","Madison County",1,45,4413,2147,2266
050,01,089,"Alabama","Madison County",1,46,4380,2102,2278
050,01,089,"Alabama","Madison County",1,47,4586,2210,2376
050,01,089,"Alabama","Madison County",1,48,4908,2366,2542
050,01,089,"Alabama","Madison County",1,49,5257,2596,2661
050,01,089,"Alabama","Madison County",1,50,5002,2467,2535
050,01,089,"Alabama","Madison County",1,51,4931,2428,2503
050,01,089,"Alabama","Madison County",1,52,5008,2465,2543
050,01,089,"Alabama","Madison County",1,53,5166,2524,2642
050,01,089,"Alabama","Madison County",1,54,5371,2617,2754
050,01,089,"Alabama","Madison County",1,55,5821,2872,2949
050,01,089,"Alabama","Madison County",1,56,6018,2933,3085
050,01,089,"Alabama","Madison County",1,57,6007,2957,3050
050,01,089,"Alabama","Madison County",1,58,6123,3018,3105
050,01,089,"Alabama","Madison County",1,59,5840,2938,2902
050,01,089,"Alabama","Madison County",1,60,5575,2848,2727
050,01,089,"Alabama","Madison County",1,61,5374,2719,2655
050,01,089,"Alabama","Madison County",1,62,5217,2593,2624
050,01,089,"Alabama","Madison County",1,63,4906,2420,2486
050,01,089,"Alabama","Madison County",1,64,4550,2179,2371
050,01,089,"Alabama","Madison County",1,65,4260,2034,2226
050,01,089,"Alabama","Madison County",1,66,4092,1988,2104
050,01,089,"Alabama","Madison County",1,67,3881,1850,2031
050,01,089,"Alabama","Madison County",1,68,3662,1731,1931
050,01,089,"Alabama","Madison County",1,69,3343,1568,1775
050,01,089,"Alabama","Madison County",1,70,3275,1487,1788
050,01,089,"Alabama","Madison County",1,71,3257,1483,1774
050,01,089,"Alabama","Madison County",1,72,3303,1503,1800
050,01,089,"Alabama","Madison County",1,73,3239,1515,1724
050,01,089,"Alabama","Madison County",1,74,2319,1004,1315
050,01,089,"Alabama","Madison County",1,75,2278,987,1291
050,01,089,"Alabama","Madison County",1,76,2240,979,1261
050,01,089,"Alabama","Madison County",1,77,2257,1009,1248
050,01,089,"Alabama","Madison County",1,78,1884,800,1084
050,01,089,"Alabama","Madison County",1,79,1705,710,995
050,01,089,"Alabama","Madison County",1,80,1646,686,960
050,01,089,"Alabama","Madison County",1,81,1587,649,938
050,01,089,"Alabama","Madison County",1,82,1485,603,882
050,01,089,"Alabama","Madison County",1,83,1270,530,740
050,01,089,"Alabama","Madison County",1,84,1195,520,675
050,01,089,"Alabama","Madison County",1,85,6267,2312,3955
050,01,089,"Alabama","Madison County",2,0,4345,2228,2117
050,01,089,"Alabama","Madison County",2,1,4423,2261,2162
050,01,089,"Alabama","Madison County",2,2,4603,2355,2248
050,01,089,"Alabama","Madison County",2,3,4634,2377,2257
050,01,089,"Alabama","Madison County",2,4,4649,2355,2294
050,01,089,"Alabama","Madison County",2,5,4706,2404,2302
050,01,089,"Alabama","Madison County",2,6,4664,2398,2266
050,01,089,"Alabama","Madison County",2,7,4569,2338,2231
050,01,089,"Alabama","Madison County",2,8,4574,2298,2276
050,01,089,"Alabama","Madison County",2,9,4741,2417,2324
050,01,089,"Alabama","Madison County",2,10,4832,2434,2398
050,01,089,"Alabama","Madison County",2,11,4922,2516,2406
050,01,089,"Alabama","Madison County",2,12,5145,2643,2502
050,01,089,"Alabama","Madison County",2,13,5104,2612,2492
050,01,089,"Alabama","Madison County",2,14,4959,2491,2468
050,01,089,"Alabama","Madison County",2,15,4936,2512,2424
050,01,089,"Alabama","Madison County",2,16,4922,2530,2392
050,01,089,"Alabama","Madison County",2,17,4927,2486,2441
050,01,089,"Alabama","Madison County",2,18,5386,2756,2630
050,01,089,"Alabama","Madison County",2,19,5631,2764,2867
050,01,089,"Alabama","Madison County",2,20,5453,2672,2781
050,01,089,"Alabama","Madison County",2,21,5232,2610,2622
050,01,089,"Alabama","Madison County",2,22,5178,2572,2606
050,01,089,"Alabama","Madison County",2,23,5190,2575,2615
050,01,089,"Alabama","Madison County",2,24,5233,2631,2602
050,01,089,"Alabama","Madison County",2,25,5371,2738,2633
050,01,089,"Alabama","Madison County",2,26,5505,2858,2647
050,01,089,"Alabama","Madison County",2,27,5505,2889,2616
050,01,089,"Alabama","Madison County",2,28,5592,2859,2733
050,01,089,"Alabama","Madison County",2,29,5674,2848,2826
050,01,089,"Alabama","Madison County",2,30,5678,2857,2821
050,01,089,"Alabama","Madison County",2,31,5466,2733,2733
050,01,089,"Alabama","Madison County",2,32,5377,2677,2700
050,01,089,"Alabama","Madison County",2,33,5328,2657,2671
050,01,089,"Alabama","Madison County",2,34,5378,2669,2709
050,01,089,"Alabama","Madison County",2,35,5418,2709,2709
050,01,089,"Alabama","Madison County",2,36,5150,2587,2563
050,01,089,"Alabama","Madison County",2,37,5144,2576,2568
050,01,089,"Alabama","Madison County",2,38,5148,2609,2539
050,01,089,"Alabama","Madison County",2,39,5017,2501,2516
050,01,089,"Alabama","Madison County",2,40,4914,2428,2486
050,01,089,"Alabama","Madison County",2,41,4759,2338,2421
050,01,089,"Alabama","Madison County",2,42,4672,2276,2396
050,01,089,"Alabama","Madison County",2,43,4610,2227,2383
050,01,089,"Alabama","Madison County",2,44,4316,2102,2214
050,01,089,"Alabama","Madison County",2,45,4409,2145,2264
050,01,089,"Alabama","Madison County",2,46,4395,2119,2276
050,01,089,"Alabama","Madison County",2,47,4546,2188,2358
050,01,089,"Alabama","Madison County",2,48,4850,2342,2508
050,01,089,"Alabama","Madison County",2,49,5211,2564,2647
050,01,089,"Alabama","Madison County",2,50,5087,2509,2578
050,01,089,"Alabama","Madison County",2,51,4940,2433,2507
050,01,089,"Alabama","Madison County",2,52,4992,2453,2539
050,01,089,"Alabama","Madison County",2,53,5128,2507,2621
050,01,089,"Alabama","Madison County",2,54,5316,2597,2719
050,01,089,"Alabama","Madison County",2,55,5727,2815,2912
050,01,089,"Alabama","Madison County",2,56,5994,2932,3062
050,01,089,"Alabama","Madison County",2,57,6019,2960,3059
050,01,089,"Alabama","Madison County",2,58,6099,3005,3094
050,01,089,"Alabama","Madison County",2,59,5923,2962,2961
050,01,089,"Alabama","Madison County",2,60,5624,2863,2761
050,01,089,"Alabama","Madison County",2,61,5407,2735,2672
050,01,089,"Alabama","Madison County",2,62,5231,2617,2614
050,01,089,"Alabama","Madison County",2,63,5018,2483,2535
050,01,089,"Alabama","Madison County",2,64,4603,2217,2386
050,01,089,"Alabama","Madison County",2,65,4316,2054,2262
050,01,089,"Alabama","Madison County",2,66,4138,1995,2143
050,01,089,"Alabama","Madison County",2,67,3914,1868,2046
050,01,089,"Alabama","Madison County",2,68,3684,1741,1943
050,01,089,"Alabama","Madison County",2,69,3436,1611,1825
050,01,089,"Alabama","Madison County",2,70,3273,1495,1778
050,01,089,"Alabama","Madison County",2,71,3253,1480,1773
050,01,089,"Alabama","Madison County",2,72,3233,1468,1765
050,01,089,"Alabama","Madison County",2,73,3384,1571,1813
050,01,089,"Alabama","Madison County",2,74,2388,1053,1335
050,01,089,"Alabama","Madison County",2,75,2284,989,1295
050,01,089,"Alabama","Madison County",2,76,2220,970,1250
050,01,089,"Alabama","Madison County",2,77,2286,1017,1269
050,01,089,"Alabama","Madison County",2,78,1933,831,1102
050,01,089,"Alabama","Madison County",2,79,1732,724,1008
050,01,089,"Alabama","Madison County",2,80,1633,673,960
050,01,089,"Alabama","Madison County",2,81,1574,652,922
050,01,089,"Alabama","Madison County",2,82,1502,607,895
050,01,089,"Alabama","Madison County",2,83,1289,535,754
050,01,089,"Alabama","Madison County",2,84,1197,518,679
050,01,089,"Alabama","Madison County",2,85,6335,2348,3987
050,01,089,"Alabama","Madison County",3,0,4269,2188,2081
050,01,089,"Alabama","Madison County",3,1,4323,2234,2089
050,01,089,"Alabama","Madison County",3,2,4501,2294,2207
050,01,089,"Alabama","Madison County",3,3,4715,2415,2300
050,01,089,"Alabama","Madison County",3,4,4705,2414,2291
050,01,089,"Alabama","Madison County",3,5,4699,2383,2316
050,01,089,"Alabama","Madison County",3,6,4807,2457,2350
050,01,089,"Alabama","Madison County",3,7,4789,2433,2356
050,01,089,"Alabama","Madison County",3,8,4671,2400,2271
050,01,089,"Alabama","Madison County",3,9,4638,2345,2293
050,01,089,"Alabama","Madison County",3,10,4855,2464,2391
050,01,089,"Alabama","Madison County",3,11,4900,2471,2429
050,01,089,"Alabama","Madison County",3,12,4986,2539,2447
050,01,089,"Alabama","Madison County",3,13,5205,2681,2524
050,01,089,"Alabama","Madison County",3,14,5201,2644,2557
050,01,089,"Alabama","Madison County",3,15,5036,2522,2514
050,01,089,"Alabama","Madison County",3,16,4980,2539,2441
050,01,089,"Alabama","Madison County",3,17,5009,2584,2425
050,01,089,"Alabama","Madison County",3,18,5482,2813,2669
050,01,089,"Alabama","Madison County",3,19,5647,2805,2842
050,01,089,"Alabama","Madison County",3,20,5445,2712,2733
050,01,089,"Alabama","Madison County",3,21,5289,2629,2660
050,01,089,"Alabama","Madison County",3,22,5151,2565,2586
050,01,089,"Alabama","Madison County",3,23,5443,2763,2680
050,01,089,"Alabama","Madison County",3,24,5468,2757,2711
050,01,089,"Alabama","Madison County",3,25,5425,2767,2658
050,01,089,"Alabama","Madison County",3,26,5548,2858,2690
050,01,089,"Alabama","Madison County",3,27,5657,2961,2696
050,01,089,"Alabama","Madison County",3,28,5638,2981,2657
050,01,089,"Alabama","Madison County",3,29,5731,2963,2768
050,01,089,"Alabama","Madison County",3,30,5812,2917,2895
050,01,089,"Alabama","Madison County",3,31,5860,2974,2886
050,01,089,"Alabama","Madison County",3,32,5600,2813,2787
050,01,089,"Alabama","Madison County",3,33,5419,2670,2749
050,01,089,"Alabama","Madison County",3,34,5426,2711,2715
050,01,089,"Alabama","Madison County",3,35,5526,2756,2770
050,01,089,"Alabama","Madison County",3,36,5494,2758,2736
050,01,089,"Alabama","Madison County",3,37,5210,2617,2593
050,01,089,"Alabama","Madison County",3,38,5245,2644,2601
050,01,089,"Alabama","Madison County",3,39,5236,2667,2569
050,01,089,"Alabama","Madison County",3,40,5103,2542,2561
050,01,089,"Alabama","Madison County",3,41,4993,2454,2539
050,01,089,"Alabama","Madison County",3,42,4836,2377,2459
050,01,089,"Alabama","Madison County",3,43,4757,2319,2438
050,01,089,"Alabama","Madison County",3,44,4679,2279,2400
050,01,089,"Alabama","Madison County",3,45,4384,2140,2244
050,01,089,"Alabama","Madison County",3,46,4495,2204,2291
050,01,089,"Alabama","Madison County",3,47,4427,2136,2291
050,01,089,"Alabama","Madison County",3,48,4590,2207,2383
050,01,089,"Alabama","Madison County",3,49,4876,2349,2527
050,01,089,"Alabama","Madison County",3,50,5194,2563,2631
050,01,089,"Alabama","Madison County",3,51,5139,2532,2607
050,01,089,"Alabama","Madison County",3,52,4954,2453,2501
050,01,089,"Alabama","Madison County",3,53,5031,2454,2577
050,01,089,"Alabama","Madison County",3,54,5131,2488,2643
050,01,089,"Alabama","Madison County",3,55,5370,2654,2716
050,01,089,"Alabama","Madison County",3,56,5786,2853,2933
050,01,089,"Alabama","Madison County",3,57,5962,2904,3058
050,01,089,"Alabama","Madison County",3,58,5985,2973,3012
050,01,089,"Alabama","Madison County",3,59,6039,2975,3064
050,01,089,"Alabama","Madison County",3,60,5892,2957,2935
050,01,089,"Alabama","Madison County",3,61,5556,2831,2725
050,01,089,"Alabama","Madison County",3,62,5348,2687,2661
050,01,089,"Alabama","Madison County",3,63,5162,2553,2609
050,01,089,"Alabama","Madison County",3,64,4949,2427,2522
050,01,089,"Alabama","Madison County",3,65,4527,2164,2363
050,01,089,"Alabama","Madison County",3,66,4234,2001,2233
050,01,089,"Alabama","Madison County",3,67,4060,1946,2114
050,01,089,"Alabama","Madison County",3,68,3882,1854,2028
050,01,089,"Alabama","Madison County",3,69,3606,1703,1903
050,01,089,"Alabama","Madison County",3,70,3372,1551,1821
050,01,089,"Alabama","Madison County",3,71,3240,1470,1770
050,01,089,"Alabama","Madison County",3,72,3159,1436,1723
050,01,089,"Alabama","Madison County",3,73,3161,1419,1742
050,01,089,"Alabama","Madison County",3,74,3297,1525,1772
050,01,089,"Alabama","Madison County",3,75,2356,1027,1329
050,01,089,"Alabama","Madison County",3,76,2212,971,1241
050,01,089,"Alabama","Madison County",3,77,2121,916,1205
050,01,089,"Alabama","Madison County",3,78,2184,966,1218
050,01,089,"Alabama","Madison County",3,79,1883,812,1071
050,01,089,"Alabama","Madison County",3,80,1617,665,952
050,01,089,"Alabama","Madison County",3,81,1562,646,916
050,01,089,"Alabama","Madison County",3,82,1510,630,880
050,01,089,"Alabama","Madison County",3,83,1390,547,843
050,01,089,"Alabama","Madison County",3,84,1212,490,722
050,01,089,"Alabama","Madison County",3,85,6407,2417,3990
050,01,089,"Alabama","Madison County",4,0,4397,2219,2178
050,01,089,"Alabama","Madison County",4,1,4306,2191,2115
050,01,089,"Alabama","Madison County",4,2,4474,2315,2159
050,01,089,"Alabama","Madison County",4,3,4601,2318,2283
050,01,089,"Alabama","Madison County",4,4,4846,2438,2408
050,01,089,"Alabama","Madison County",4,5,4794,2465,2329
050,01,089,"Alabama","Madison County",4,6,4801,2466,2335
050,01,089,"Alabama","Madison County",4,7,4881,2478,2403
050,01,089,"Alabama","Madison County",4,8,4823,2448,2375
050,01,089,"Alabama","Madison County",4,9,4810,2448,2362
050,01,089,"Alabama","Madison County",4,10,4734,2369,2365
050,01,089,"Alabama","Madison County",4,11,4929,2500,2429
050,01,089,"Alabama","Madison County",4,12,4944,2486,2458
050,01,089,"Alabama","Madison County",4,13,5053,2585,2468
050,01,089,"Alabama","Madison County",4,14,5289,2738,2551
050,01,089,"Alabama","Madison County",4,15,5278,2674,2604
050,01,089,"Alabama","Madison County",4,16,5130,2578,2552
050,01,089,"Alabama","Madison County",4,17,5100,2599,2501
050,01,089,"Alabama","Madison County",4,18,5683,2979,2704
050,01,089,"Alabama","Madison County",4,19,5862,2912,2950
050,01,089,"Alabama","Madison County",4,20,5585,2803,2782
050,01,089,"Alabama","Madison County",4,21,5271,2638,2633
050,01,089,"Alabama","Madison County",4,22,5285,2633,2652
050,01,089,"Alabama","Madison County",4,23,5402,2747,2655
050,01,089,"Alabama","Madison County",4,24,5800,2976,2824
050,01,089,"Alabama","Madison County",4,25,5703,2876,2827
050,01,089,"Alabama","Madison County",4,26,5570,2861,2709
050,01,089,"Alabama","Madison County",4,27,5619,2912,2707
050,01,089,"Alabama","Madison County",4,28,5728,2972,2756
050,01,089,"Alabama","Madison County",4,29,5799,3062,2737
050,01,089,"Alabama","Madison County",4,30,5805,3023,2782
050,01,089,"Alabama","Madison County",4,31,5893,2931,2962
050,01,089,"Alabama","Madison County",4,32,5935,2990,2945
050,01,089,"Alabama","Madison County",4,33,5668,2820,2848
050,01,089,"Alabama","Madison County",4,34,5519,2709,2810
050,01,089,"Alabama","Madison County",4,35,5530,2772,2758
050,01,089,"Alabama","Madison County",4,36,5641,2815,2826
050,01,089,"Alabama","Madison County",4,37,5534,2761,2773
050,01,089,"Alabama","Madison County",4,38,5290,2672,2618
050,01,089,"Alabama","Madison County",4,39,5272,2634,2638
050,01,089,"Alabama","Madison County",4,40,5296,2695,2601
050,01,089,"Alabama","Madison County",4,41,5222,2579,2643
050,01,089,"Alabama","Madison County",4,42,5154,2550,2604
050,01,089,"Alabama","Madison County",4,43,4898,2398,2500
050,01,089,"Alabama","Madison County",4,44,4820,2366,2454
050,01,089,"Alabama","Madison County",4,45,4686,2273,2413
050,01,089,"Alabama","Madison County",4,46,4439,2195,2244
050,01,089,"Alabama","Madison County",4,47,4526,2208,2318
050,01,089,"Alabama","Madison County",4,48,4535,2203,2332
050,01,089,"Alabama","Madison County",4,49,4613,2199,2414
050,01,089,"Alabama","Madison County",4,50,4932,2351,2581
050,01,089,"Alabama","Madison County",4,51,5243,2578,2665
050,01,089,"Alabama","Madison County",4,52,5130,2537,2593
050,01,089,"Alabama","Madison County",4,53,5007,2472,2535
050,01,089,"Alabama","Madison County",4,54,5057,2458,2599
050,01,089,"Alabama","Madison County",4,55,5138,2498,2640
050,01,089,"Alabama","Madison County",4,56,5322,2622,2700
050,01,089,"Alabama","Madison County",4,57,5745,2820,2925
050,01,089,"Alabama","Madison County",4,58,5941,2893,3048
050,01,089,"Alabama","Madison County",4,59,5935,2903,3032
050,01,089,"Alabama","Madison County",4,60,5997,2945,3052
050,01,089,"Alabama","Madison County",4,61,5860,2934,2926
050,01,089,"Alabama","Madison County",4,62,5513,2785,2728
050,01,089,"Alabama","Madison County",4,63,5343,2655,2688
050,01,089,"Alabama","Madison County",4,64,5115,2520,2595
050,01,089,"Alabama","Madison County",4,65,4873,2376,2497
050,01,089,"Alabama","Madison County",4,66,4498,2171,2327
050,01,089,"Alabama","Madison County",4,67,4150,1959,2191
050,01,089,"Alabama","Madison County",4,68,3990,1891,2099
050,01,089,"Alabama","Madison County",4,69,3806,1813,1993
050,01,089,"Alabama","Madison County",4,70,3566,1662,1904
050,01,089,"Alabama","Madison County",4,71,3320,1515,1805
050,01,089,"Alabama","Madison County",4,72,3161,1431,1730
050,01,089,"Alabama","Madison County",4,73,3113,1400,1713
050,01,089,"Alabama","Madison County",4,74,3113,1388,1725
050,01,089,"Alabama","Madison County",4,75,3216,1462,1754
050,01,089,"Alabama","Madison County",4,76,2288,1009,1279
050,01,089,"Alabama","Madison County",4,77,2152,929,1223
050,01,089,"Alabama","Madison County",4,78,2046,883,1163
050,01,089,"Alabama","Madison County",4,79,2139,942,1197
050,01,089,"Alabama","Madison County",4,80,1778,750,1028
050,01,089,"Alabama","Madison County",4,81,1517,618,899
050,01,089,"Alabama","Madison County",4,82,1482,611,871
050,01,089,"Alabama","Madison County",4,83,1402,565,837
050,01,089,"Alabama","Madison County",4,84,1306,500,806
050,01,089,"Alabama","Madison County",4,85,6638,2485,4153
050,01,089,"Alabama","Madison County",5,0,4462,2259,2203
050,01,089,"Alabama","Madison County",5,1,4553,2298,2255
050,01,089,"Alabama","Madison County",5,2,4491,2306,2185
050,01,089,"Alabama","Madison County",5,3,4635,2367,2268
050,01,089,"Alabama","Madison County",5,4,4714,2371,2343
050,01,089,"Alabama","Madison County",5,5,4983,2529,2454
050,01,089,"Alabama","Madison County",5,6,4833,2489,2344
050,01,089,"Alabama","Madison County",5,7,4852,2495,2357
050,01,089,"Alabama","Madison County",5,8,4978,2497,2481
050,01,089,"Alabama","Madison County",5,9,5004,2529,2475
050,01,089,"Alabama","Madison County",5,10,4925,2532,2393
050,01,089,"Alabama","Madison County",5,11,4824,2417,2407
050,01,089,"Alabama","Madison County",5,12,5069,2566,2503
050,01,089,"Alabama","Madison County",5,13,5054,2538,2516
050,01,089,"Alabama","Madison County",5,14,5135,2621,2514
050,01,089,"Alabama","Madison County",5,15,5367,2782,2585
050,01,089,"Alabama","Madison County",5,16,5359,2715,2644
050,01,089,"Alabama","Madison County",5,17,5230,2641,2589
050,01,089,"Alabama","Madison County",5,18,5934,3095,2839
050,01,089,"Alabama","Madison County",5,19,6213,3113,3100
050,01,089,"Alabama","Madison County",5,20,5795,2911,2884
050,01,089,"Alabama","Madison County",5,21,5411,2739,2672
050,01,089,"Alabama","Madison County",5,22,5291,2669,2622
050,01,089,"Alabama","Madison County",5,23,5548,2805,2743
050,01,089,"Alabama","Madison County",5,24,5728,2903,2825
050,01,089,"Alabama","Madison County",5,25,6110,3132,2978
050,01,089,"Alabama","Madison County",5,26,5879,2981,2898
050,01,089,"Alabama","Madison County",5,27,5787,2982,2805
050,01,089,"Alabama","Madison County",5,28,5774,2973,2801
050,01,089,"Alabama","Madison County",5,29,5876,3055,2821
050,01,089,"Alabama","Madison County",5,30,5979,3121,2858
050,01,089,"Alabama","Madison County",5,31,6027,3114,2913
050,01,089,"Alabama","Madison County",5,32,6114,3022,3092
050,01,089,"Alabama","Madison County",5,33,6060,3032,3028
050,01,089,"Alabama","Madison County",5,34,5809,2913,2896
050,01,089,"Alabama","Madison County",5,35,5631,2778,2853
050,01,089,"Alabama","Madison County",5,36,5575,2796,2779
050,01,089,"Alabama","Madison County",5,37,5705,2845,2860
050,01,089,"Alabama","Madison County",5,38,5669,2824,2845
050,01,089,"Alabama","Madison County",5,39,5348,2694,2654
050,01,089,"Alabama","Madison County",5,40,5356,2676,2680
050,01,089,"Alabama","Madison County",5,41,5447,2757,2690
050,01,089,"Alabama","Madison County",5,42,5285,2611,2674
050,01,089,"Alabama","Madison County",5,43,5250,2592,2658
050,01,089,"Alabama","Madison County",5,44,4985,2441,2544
050,01,089,"Alabama","Madison County",5,45,4834,2353,2481
050,01,089,"Alabama","Madison County",5,46,4754,2284,2470
050,01,089,"Alabama","Madison County",5,47,4525,2223,2302
050,01,089,"Alabama","Madison County",5,48,4601,2244,2357
050,01,089,"Alabama","Madison County",5,49,4548,2212,2336
050,01,089,"Alabama","Madison County",5,50,4664,2232,2432
050,01,089,"Alabama","Madison County",5,51,4984,2386,2598
050,01,089,"Alabama","Madison County",5,52,5313,2597,2716
050,01,089,"Alabama","Madison County",5,53,5155,2550,2605
050,01,089,"Alabama","Madison County",5,54,5018,2456,2562
050,01,089,"Alabama","Madison County",5,55,5083,2469,2614
050,01,089,"Alabama","Madison County",5,56,5150,2472,2678
050,01,089,"Alabama","Madison County",5,57,5331,2611,2720
050,01,089,"Alabama","Madison County",5,58,5726,2811,2915
050,01,089,"Alabama","Madison County",5,59,5878,2850,3028
050,01,089,"Alabama","Madison County",5,60,5899,2887,3012
050,01,089,"Alabama","Madison County",5,61,5997,2933,3064
050,01,089,"Alabama","Madison County",5,62,5825,2912,2913
050,01,089,"Alabama","Madison County",5,63,5453,2755,2698
050,01,089,"Alabama","Madison County",5,64,5269,2610,2659
050,01,089,"Alabama","Madison County",5,65,5101,2523,2578
050,01,089,"Alabama","Madison County",5,66,4841,2360,2481
050,01,089,"Alabama","Madison County",5,67,4440,2121,2319
050,01,089,"Alabama","Madison County",5,68,4125,1942,2183
050,01,089,"Alabama","Madison County",5,69,3949,1875,2074
050,01,089,"Alabama","Madison County",5,70,3754,1769,1985
050,01,089,"Alabama","Madison County",5,71,3509,1620,1889
050,01,089,"Alabama","Madison County",5,72,3248,1480,1768
050,01,089,"Alabama","Madison County",5,73,3112,1392,1720
050,01,089,"Alabama","Madison County",5,74,3090,1368,1722
050,01,089,"Alabama","Madison County",5,75,3047,1341,1706
050,01,089,"Alabama","Madison County",5,76,3140,1440,1700
050,01,089,"Alabama","Madison County",5,77,2236,980,1256
050,01,089,"Alabama","Madison County",5,78,2095,903,1192
050,01,089,"Alabama","Madison County",5,79,2001,851,1150
050,01,089,"Alabama","Madison County",5,80,2026,888,1138
050,01,089,"Alabama","Madison County",5,81,1696,722,974
050,01,089,"Alabama","Madison County",5,82,1442,588,854
050,01,089,"Alabama","Madison County",5,83,1373,550,823
050,01,089,"Alabama","Madison County",5,84,1314,525,789
050,01,089,"Alabama","Madison County",5,85,7000,2588,4412
050,01,091,"Alabama","Marengo County",1,0,198,101,97
050,01,091,"Alabama","Marengo County",1,1,204,105,99
050,01,091,"Alabama","Marengo County",1,2,229,116,113
050,01,091,"Alabama","Marengo County",1,3,252,133,119
050,01,091,"Alabama","Marengo County",1,4,254,118,136
050,01,091,"Alabama","Marengo County",1,5,246,125,121
050,01,091,"Alabama","Marengo County",1,6,223,113,110
050,01,091,"Alabama","Marengo County",1,7,219,118,101
050,01,091,"Alabama","Marengo County",1,8,229,105,124
050,01,091,"Alabama","Marengo County",1,9,221,111,110
050,01,091,"Alabama","Marengo County",1,10,227,101,126
050,01,091,"Alabama","Marengo County",1,11,276,130,146
050,01,091,"Alabama","Marengo County",1,12,273,138,135
050,01,091,"Alabama","Marengo County",1,13,271,140,131
050,01,091,"Alabama","Marengo County",1,14,259,129,130
050,01,091,"Alabama","Marengo County",1,15,249,134,115
050,01,091,"Alabama","Marengo County",1,16,260,127,133
050,01,091,"Alabama","Marengo County",1,17,243,121,122
050,01,091,"Alabama","Marengo County",1,18,231,124,107
050,01,091,"Alabama","Marengo County",1,19,212,112,100
050,01,091,"Alabama","Marengo County",1,20,205,101,104
050,01,091,"Alabama","Marengo County",1,21,208,106,102
050,01,091,"Alabama","Marengo County",1,22,212,109,103
050,01,091,"Alabama","Marengo County",1,23,206,112,94
050,01,091,"Alabama","Marengo County",1,24,236,111,125
050,01,091,"Alabama","Marengo County",1,25,245,114,131
050,01,091,"Alabama","Marengo County",1,26,247,124,123
050,01,091,"Alabama","Marengo County",1,27,246,110,136
050,01,091,"Alabama","Marengo County",1,28,253,116,137
050,01,091,"Alabama","Marengo County",1,29,242,117,125
050,01,091,"Alabama","Marengo County",1,30,219,111,108
050,01,091,"Alabama","Marengo County",1,31,225,107,118
050,01,091,"Alabama","Marengo County",1,32,226,113,113
050,01,091,"Alabama","Marengo County",1,33,243,110,133
050,01,091,"Alabama","Marengo County",1,34,207,101,106
050,01,091,"Alabama","Marengo County",1,35,211,99,112
050,01,091,"Alabama","Marengo County",1,36,206,93,113
050,01,091,"Alabama","Marengo County",1,37,211,95,116
050,01,091,"Alabama","Marengo County",1,38,185,83,102
050,01,091,"Alabama","Marengo County",1,39,210,100,110
050,01,091,"Alabama","Marengo County",1,40,224,110,114
050,01,091,"Alabama","Marengo County",1,41,218,98,120
050,01,091,"Alabama","Marengo County",1,42,228,98,130
050,01,091,"Alabama","Marengo County",1,43,206,96,110
050,01,091,"Alabama","Marengo County",1,44,214,115,99
050,01,091,"Alabama","Marengo County",1,45,244,117,127
050,01,091,"Alabama","Marengo County",1,46,214,88,126
050,01,091,"Alabama","Marengo County",1,47,231,104,127
050,01,091,"Alabama","Marengo County",1,48,251,119,132
050,01,091,"Alabama","Marengo County",1,49,266,117,149
050,01,091,"Alabama","Marengo County",1,50,255,114,141
050,01,091,"Alabama","Marengo County",1,51,238,112,126
050,01,091,"Alabama","Marengo County",1,52,243,104,139
050,01,091,"Alabama","Marengo County",1,53,258,124,134
050,01,091,"Alabama","Marengo County",1,54,260,128,132
050,01,091,"Alabama","Marengo County",1,55,265,135,130
050,01,091,"Alabama","Marengo County",1,56,266,123,143
050,01,091,"Alabama","Marengo County",1,57,261,120,141
050,01,091,"Alabama","Marengo County",1,58,269,116,153
050,01,091,"Alabama","Marengo County",1,59,256,107,149
050,01,091,"Alabama","Marengo County",1,60,259,114,145
050,01,091,"Alabama","Marengo County",1,61,294,133,161
050,01,091,"Alabama","Marengo County",1,62,281,139,142
050,01,091,"Alabama","Marengo County",1,63,271,129,142
050,01,091,"Alabama","Marengo County",1,64,263,125,138
050,01,091,"Alabama","Marengo County",1,65,273,135,138
050,01,091,"Alabama","Marengo County",1,66,259,121,138
050,01,091,"Alabama","Marengo County",1,67,239,120,119
050,01,091,"Alabama","Marengo County",1,68,234,117,117
050,01,091,"Alabama","Marengo County",1,69,217,110,107
050,01,091,"Alabama","Marengo County",1,70,224,108,116
050,01,091,"Alabama","Marengo County",1,71,227,103,124
050,01,091,"Alabama","Marengo County",1,72,214,98,116
050,01,091,"Alabama","Marengo County",1,73,226,105,121
050,01,091,"Alabama","Marengo County",1,74,155,62,93
050,01,091,"Alabama","Marengo County",1,75,151,68,83
050,01,091,"Alabama","Marengo County",1,76,150,71,79
050,01,091,"Alabama","Marengo County",1,77,144,58,86
050,01,091,"Alabama","Marengo County",1,78,125,55,70
050,01,091,"Alabama","Marengo County",1,79,121,59,62
050,01,091,"Alabama","Marengo County",1,80,116,53,63
050,01,091,"Alabama","Marengo County",1,81,90,35,55
050,01,091,"Alabama","Marengo County",1,82,94,36,58
050,01,091,"Alabama","Marengo County",1,83,82,32,50
050,01,091,"Alabama","Marengo County",1,84,71,27,44
050,01,091,"Alabama","Marengo County",1,85,459,149,310
050,01,091,"Alabama","Marengo County",2,0,204,110,94
050,01,091,"Alabama","Marengo County",2,1,203,105,98
050,01,091,"Alabama","Marengo County",2,2,227,116,111
050,01,091,"Alabama","Marengo County",2,3,244,126,118
050,01,091,"Alabama","Marengo County",2,4,252,120,132
050,01,091,"Alabama","Marengo County",2,5,245,123,122
050,01,091,"Alabama","Marengo County",2,6,228,116,112
050,01,091,"Alabama","Marengo County",2,7,219,116,103
050,01,091,"Alabama","Marengo County",2,8,226,109,117
050,01,091,"Alabama","Marengo County",2,9,221,108,113
050,01,091,"Alabama","Marengo County",2,10,226,103,123
050,01,091,"Alabama","Marengo County",2,11,263,123,140
050,01,091,"Alabama","Marengo County",2,12,274,136,138
050,01,091,"Alabama","Marengo County",2,13,271,139,132
050,01,091,"Alabama","Marengo County",2,14,263,132,131
050,01,091,"Alabama","Marengo County",2,15,254,134,120
050,01,091,"Alabama","Marengo County",2,16,258,129,129
050,01,091,"Alabama","Marengo County",2,17,246,121,125
050,01,091,"Alabama","Marengo County",2,18,223,118,105
050,01,091,"Alabama","Marengo County",2,19,206,109,97
050,01,091,"Alabama","Marengo County",2,20,209,104,105
050,01,091,"Alabama","Marengo County",2,21,206,105,101
050,01,091,"Alabama","Marengo County",2,22,210,107,103
050,01,091,"Alabama","Marengo County",2,23,211,112,99
050,01,091,"Alabama","Marengo County",2,24,231,112,119
050,01,091,"Alabama","Marengo County",2,25,239,110,129
050,01,091,"Alabama","Marengo County",2,26,246,120,126
050,01,091,"Alabama","Marengo County",2,27,246,113,133
050,01,091,"Alabama","Marengo County",2,28,252,115,137
050,01,091,"Alabama","Marengo County",2,29,242,116,126
050,01,091,"Alabama","Marengo County",2,30,226,114,112
050,01,091,"Alabama","Marengo County",2,31,223,109,114
050,01,091,"Alabama","Marengo County",2,32,225,111,114
050,01,091,"Alabama","Marengo County",2,33,236,109,127
050,01,091,"Alabama","Marengo County",2,34,215,104,111
050,01,091,"Alabama","Marengo County",2,35,211,100,111
050,01,091,"Alabama","Marengo County",2,36,207,95,112
050,01,091,"Alabama","Marengo County",2,37,209,95,114
050,01,091,"Alabama","Marengo County",2,38,193,86,107
050,01,091,"Alabama","Marengo County",2,39,204,96,108
050,01,091,"Alabama","Marengo County",2,40,224,109,115
050,01,091,"Alabama","Marengo County",2,41,220,101,119
050,01,091,"Alabama","Marengo County",2,42,225,98,127
050,01,091,"Alabama","Marengo County",2,43,213,98,115
050,01,091,"Alabama","Marengo County",2,44,210,110,100
050,01,091,"Alabama","Marengo County",2,45,239,117,122
050,01,091,"Alabama","Marengo County",2,46,219,95,124
050,01,091,"Alabama","Marengo County",2,47,226,100,126
050,01,091,"Alabama","Marengo County",2,48,248,116,132
050,01,091,"Alabama","Marengo County",2,49,265,118,147
050,01,091,"Alabama","Marengo County",2,50,255,114,141
050,01,091,"Alabama","Marengo County",2,51,241,111,130
050,01,091,"Alabama","Marengo County",2,52,240,104,136
050,01,091,"Alabama","Marengo County",2,53,255,119,136
050,01,091,"Alabama","Marengo County",2,54,258,127,131
050,01,091,"Alabama","Marengo County",2,55,262,131,131
050,01,091,"Alabama","Marengo County",2,56,266,126,140
050,01,091,"Alabama","Marengo County",2,57,263,120,143
050,01,091,"Alabama","Marengo County",2,58,267,116,151
050,01,091,"Alabama","Marengo County",2,59,260,110,150
050,01,091,"Alabama","Marengo County",2,60,260,113,147
050,01,091,"Alabama","Marengo County",2,61,279,124,155
050,01,091,"Alabama","Marengo County",2,62,280,136,144
050,01,091,"Alabama","Marengo County",2,63,273,129,144
050,01,091,"Alabama","Marengo County",2,64,261,124,137
050,01,091,"Alabama","Marengo County",2,65,265,131,134
050,01,091,"Alabama","Marengo County",2,66,260,123,137
050,01,091,"Alabama","Marengo County",2,67,241,120,121
050,01,091,"Alabama","Marengo County",2,68,229,115,114
050,01,091,"Alabama","Marengo County",2,69,221,110,111
050,01,091,"Alabama","Marengo County",2,70,221,106,115
050,01,091,"Alabama","Marengo County",2,71,225,103,122
050,01,091,"Alabama","Marengo County",2,72,213,97,116
050,01,091,"Alabama","Marengo County",2,73,231,107,124
050,01,091,"Alabama","Marengo County",2,74,163,68,95
050,01,091,"Alabama","Marengo County",2,75,150,65,85
050,01,091,"Alabama","Marengo County",2,76,146,69,77
050,01,091,"Alabama","Marengo County",2,77,148,62,86
050,01,091,"Alabama","Marengo County",2,78,125,54,71
050,01,091,"Alabama","Marengo County",2,79,119,56,63
050,01,091,"Alabama","Marengo County",2,80,116,54,62
050,01,091,"Alabama","Marengo County",2,81,94,38,56
050,01,091,"Alabama","Marengo County",2,82,92,34,58
050,01,091,"Alabama","Marengo County",2,83,82,32,50
050,01,091,"Alabama","Marengo County",2,84,71,27,44
050,01,091,"Alabama","Marengo County",2,85,455,147,308
050,01,091,"Alabama","Marengo County",3,0,245,130,115
050,01,091,"Alabama","Marengo County",3,1,197,106,91
050,01,091,"Alabama","Marengo County",3,2,210,108,102
050,01,091,"Alabama","Marengo County",3,3,216,105,111
050,01,091,"Alabama","Marengo County",3,4,241,118,123
050,01,091,"Alabama","Marengo County",3,5,255,123,132
050,01,091,"Alabama","Marengo County",3,6,242,122,120
050,01,091,"Alabama","Marengo County",3,7,231,114,117
050,01,091,"Alabama","Marengo County",3,8,218,111,107
050,01,091,"Alabama","Marengo County",3,9,222,103,119
050,01,091,"Alabama","Marengo County",3,10,214,103,111
050,01,091,"Alabama","Marengo County",3,11,228,105,123
050,01,091,"Alabama","Marengo County",3,12,255,121,134
050,01,091,"Alabama","Marengo County",3,13,274,138,136
050,01,091,"Alabama","Marengo County",3,14,265,138,127
050,01,091,"Alabama","Marengo County",3,15,255,133,122
050,01,091,"Alabama","Marengo County",3,16,253,128,125
050,01,091,"Alabama","Marengo County",3,17,252,125,127
050,01,091,"Alabama","Marengo County",3,18,215,107,108
050,01,091,"Alabama","Marengo County",3,19,203,106,97
050,01,091,"Alabama","Marengo County",3,20,202,109,93
050,01,091,"Alabama","Marengo County",3,21,215,110,105
050,01,091,"Alabama","Marengo County",3,22,208,106,102
050,01,091,"Alabama","Marengo County",3,23,197,100,97
050,01,091,"Alabama","Marengo County",3,24,199,106,93
050,01,091,"Alabama","Marengo County",3,25,237,119,118
050,01,091,"Alabama","Marengo County",3,26,225,102,123
050,01,091,"Alabama","Marengo County",3,27,243,115,128
050,01,091,"Alabama","Marengo County",3,28,248,118,130
050,01,091,"Alabama","Marengo County",3,29,237,104,133
050,01,091,"Alabama","Marengo County",3,30,241,116,125
050,01,091,"Alabama","Marengo County",3,31,219,112,107
050,01,091,"Alabama","Marengo County",3,32,227,118,109
050,01,091,"Alabama","Marengo County",3,33,215,108,107
050,01,091,"Alabama","Marengo County",3,34,235,109,126
050,01,091,"Alabama","Marengo County",3,35,206,101,105
050,01,091,"Alabama","Marengo County",3,36,202,91,111
050,01,091,"Alabama","Marengo County",3,37,213,95,118
050,01,091,"Alabama","Marengo County",3,38,202,93,109
050,01,091,"Alabama","Marengo County",3,39,182,77,105
050,01,091,"Alabama","Marengo County",3,40,208,101,107
050,01,091,"Alabama","Marengo County",3,41,225,109,116
050,01,091,"Alabama","Marengo County",3,42,210,89,121
050,01,091,"Alabama","Marengo County",3,43,233,106,127
050,01,091,"Alabama","Marengo County",3,44,202,88,114
050,01,091,"Alabama","Marengo County",3,45,214,113,101
050,01,091,"Alabama","Marengo County",3,46,238,117,121
050,01,091,"Alabama","Marengo County",3,47,215,92,123
050,01,091,"Alabama","Marengo County",3,48,218,95,123
050,01,091,"Alabama","Marengo County",3,49,250,117,133
050,01,091,"Alabama","Marengo County",3,50,262,117,145
050,01,091,"Alabama","Marengo County",3,51,260,114,146
050,01,091,"Alabama","Marengo County",3,52,234,107,127
050,01,091,"Alabama","Marengo County",3,53,247,104,143
050,01,091,"Alabama","Marengo County",3,54,246,111,135
050,01,091,"Alabama","Marengo County",3,55,248,125,123
050,01,091,"Alabama","Marengo County",3,56,269,130,139
050,01,091,"Alabama","Marengo County",3,57,253,123,130
050,01,091,"Alabama","Marengo County",3,58,266,120,146
050,01,091,"Alabama","Marengo County",3,59,269,120,149
050,01,091,"Alabama","Marengo County",3,60,258,104,154
050,01,091,"Alabama","Marengo County",3,61,257,105,152
050,01,091,"Alabama","Marengo County",3,62,268,114,154
050,01,091,"Alabama","Marengo County",3,63,276,130,146
050,01,091,"Alabama","Marengo County",3,64,262,120,142
050,01,091,"Alabama","Marengo County",3,65,254,125,129
050,01,091,"Alabama","Marengo County",3,66,261,128,133
050,01,091,"Alabama","Marengo County",3,67,251,119,132
050,01,091,"Alabama","Marengo County",3,68,232,119,113
050,01,091,"Alabama","Marengo County",3,69,219,109,110
050,01,091,"Alabama","Marengo County",3,70,218,103,115
050,01,091,"Alabama","Marengo County",3,71,213,103,110
050,01,091,"Alabama","Marengo County",3,72,209,93,116
050,01,091,"Alabama","Marengo County",3,73,208,101,107
050,01,091,"Alabama","Marengo County",3,74,223,103,120
050,01,091,"Alabama","Marengo County",3,75,149,64,85
050,01,091,"Alabama","Marengo County",3,76,143,59,84
050,01,091,"Alabama","Marengo County",3,77,130,58,72
050,01,091,"Alabama","Marengo County",3,78,133,58,75
050,01,091,"Alabama","Marengo County",3,79,116,56,60
050,01,091,"Alabama","Marengo County",3,80,112,48,64
050,01,091,"Alabama","Marengo County",3,81,106,54,52
050,01,091,"Alabama","Marengo County",3,82,91,35,56
050,01,091,"Alabama","Marengo County",3,83,79,30,49
050,01,091,"Alabama","Marengo County",3,84,74,29,45
050,01,091,"Alabama","Marengo County",3,85,432,140,292
050,01,091,"Alabama","Marengo County",4,0,223,119,104
050,01,091,"Alabama","Marengo County",4,1,238,125,113
050,01,091,"Alabama","Marengo County",4,2,196,107,89
050,01,091,"Alabama","Marengo County",4,3,206,102,104
050,01,091,"Alabama","Marengo County",4,4,210,103,107
050,01,091,"Alabama","Marengo County",4,5,243,116,127
050,01,091,"Alabama","Marengo County",4,6,254,119,135
050,01,091,"Alabama","Marengo County",4,7,241,114,127
050,01,091,"Alabama","Marengo County",4,8,232,116,116
050,01,091,"Alabama","Marengo County",4,9,206,109,97
050,01,091,"Alabama","Marengo County",4,10,218,102,116
050,01,091,"Alabama","Marengo County",4,11,222,109,113
050,01,091,"Alabama","Marengo County",4,12,228,108,120
050,01,091,"Alabama","Marengo County",4,13,253,122,131
050,01,091,"Alabama","Marengo County",4,14,271,136,135
050,01,091,"Alabama","Marengo County",4,15,260,137,123
050,01,091,"Alabama","Marengo County",4,16,251,133,118
050,01,091,"Alabama","Marengo County",4,17,247,123,124
050,01,091,"Alabama","Marengo County",4,18,218,109,109
050,01,091,"Alabama","Marengo County",4,19,175,92,83
050,01,091,"Alabama","Marengo County",4,20,206,101,105
050,01,091,"Alabama","Marengo County",4,21,209,116,93
050,01,091,"Alabama","Marengo County",4,22,212,103,109
050,01,091,"Alabama","Marengo County",4,23,197,97,100
050,01,091,"Alabama","Marengo County",4,24,192,100,92
050,01,091,"Alabama","Marengo County",4,25,200,99,101
050,01,091,"Alabama","Marengo County",4,26,233,119,114
050,01,091,"Alabama","Marengo County",4,27,219,103,116
050,01,091,"Alabama","Marengo County",4,28,238,114,124
050,01,091,"Alabama","Marengo County",4,29,243,113,130
050,01,091,"Alabama","Marengo County",4,30,247,109,138
050,01,091,"Alabama","Marengo County",4,31,233,113,120
050,01,091,"Alabama","Marengo County",4,32,217,112,105
050,01,091,"Alabama","Marengo County",4,33,231,120,111
050,01,091,"Alabama","Marengo County",4,34,217,111,106
050,01,091,"Alabama","Marengo County",4,35,234,116,118
050,01,091,"Alabama","Marengo County",4,36,209,105,104
050,01,091,"Alabama","Marengo County",4,37,200,91,109
050,01,091,"Alabama","Marengo County",4,38,217,102,115
050,01,091,"Alabama","Marengo County",4,39,199,94,105
050,01,091,"Alabama","Marengo County",4,40,191,82,109
050,01,091,"Alabama","Marengo County",4,41,216,102,114
050,01,091,"Alabama","Marengo County",4,42,222,107,115
050,01,091,"Alabama","Marengo County",4,43,215,92,123
050,01,091,"Alabama","Marengo County",4,44,235,105,130
050,01,091,"Alabama","Marengo County",4,45,202,93,109
050,01,091,"Alabama","Marengo County",4,46,211,116,95
050,01,091,"Alabama","Marengo County",4,47,242,121,121
050,01,091,"Alabama","Marengo County",4,48,215,93,122
050,01,091,"Alabama","Marengo County",4,49,222,98,124
050,01,091,"Alabama","Marengo County",4,50,255,122,133
050,01,091,"Alabama","Marengo County",4,51,262,120,142
050,01,091,"Alabama","Marengo County",4,52,250,110,140
050,01,091,"Alabama","Marengo County",4,53,231,116,115
050,01,091,"Alabama","Marengo County",4,54,240,98,142
050,01,091,"Alabama","Marengo County",4,55,246,110,136
050,01,091,"Alabama","Marengo County",4,56,242,118,124
050,01,091,"Alabama","Marengo County",4,57,257,127,130
050,01,091,"Alabama","Marengo County",4,58,253,124,129
050,01,091,"Alabama","Marengo County",4,59,265,120,145
050,01,091,"Alabama","Marengo County",4,60,259,113,146
050,01,091,"Alabama","Marengo County",4,61,247,100,147
050,01,091,"Alabama","Marengo County",4,62,262,108,154
050,01,091,"Alabama","Marengo County",4,63,260,106,154
050,01,091,"Alabama","Marengo County",4,64,278,130,148
050,01,091,"Alabama","Marengo County",4,65,256,122,134
050,01,091,"Alabama","Marengo County",4,66,248,124,124
050,01,091,"Alabama","Marengo County",4,67,252,124,128
050,01,091,"Alabama","Marengo County",4,68,241,117,124
050,01,091,"Alabama","Marengo County",4,69,223,114,109
050,01,091,"Alabama","Marengo County",4,70,211,105,106
050,01,091,"Alabama","Marengo County",4,71,208,97,111
050,01,091,"Alabama","Marengo County",4,72,207,100,107
050,01,091,"Alabama","Marengo County",4,73,205,96,109
050,01,091,"Alabama","Marengo County",4,74,200,96,104
050,01,091,"Alabama","Marengo County",4,75,210,98,112
050,01,091,"Alabama","Marengo County",4,76,138,57,81
050,01,091,"Alabama","Marengo County",4,77,135,55,80
050,01,091,"Alabama","Marengo County",4,78,121,55,66
050,01,091,"Alabama","Marengo County",4,79,136,61,75
050,01,091,"Alabama","Marengo County",4,80,105,46,59
050,01,091,"Alabama","Marengo County",4,81,108,49,59
050,01,091,"Alabama","Marengo County",4,82,104,51,53
050,01,091,"Alabama","Marengo County",4,83,75,30,45
050,01,091,"Alabama","Marengo County",4,84,63,21,42
050,01,091,"Alabama","Marengo County",4,85,422,140,282
050,01,091,"Alabama","Marengo County",5,0,217,116,101
050,01,091,"Alabama","Marengo County",5,1,204,115,89
050,01,091,"Alabama","Marengo County",5,2,244,124,120
050,01,091,"Alabama","Marengo County",5,3,189,103,86
050,01,091,"Alabama","Marengo County",5,4,199,102,97
050,01,091,"Alabama","Marengo County",5,5,223,113,110
050,01,091,"Alabama","Marengo County",5,6,248,121,127
050,01,091,"Alabama","Marengo County",5,7,246,117,129
050,01,091,"Alabama","Marengo County",5,8,256,124,132
050,01,091,"Alabama","Marengo County",5,9,243,120,123
050,01,091,"Alabama","Marengo County",5,10,209,111,98
050,01,091,"Alabama","Marengo County",5,11,221,103,118
050,01,091,"Alabama","Marengo County",5,12,220,101,119
050,01,091,"Alabama","Marengo County",5,13,228,116,112
050,01,091,"Alabama","Marengo County",5,14,263,129,134
050,01,091,"Alabama","Marengo County",5,15,268,132,136
050,01,091,"Alabama","Marengo County",5,16,256,132,124
050,01,091,"Alabama","Marengo County",5,17,248,131,117
050,01,091,"Alabama","Marengo County",5,18,206,104,102
050,01,091,"Alabama","Marengo County",5,19,184,95,89
050,01,091,"Alabama","Marengo County",5,20,182,87,95
050,01,091,"Alabama","Marengo County",5,21,216,107,109
050,01,091,"Alabama","Marengo County",5,22,214,115,99
050,01,091,"Alabama","Marengo County",5,23,220,110,110
050,01,091,"Alabama","Marengo County",5,24,202,95,107
050,01,091,"Alabama","Marengo County",5,25,177,96,81
050,01,091,"Alabama","Marengo County",5,26,195,98,97
050,01,091,"Alabama","Marengo County",5,27,214,99,115
050,01,091,"Alabama","Marengo County",5,28,214,97,117
050,01,091,"Alabama","Marengo County",5,29,259,114,145
050,01,091,"Alabama","Marengo County",5,30,256,118,138
050,01,091,"Alabama","Marengo County",5,31,249,113,136
050,01,091,"Alabama","Marengo County",5,32,239,122,117
050,01,091,"Alabama","Marengo County",5,33,226,116,110
050,01,091,"Alabama","Marengo County",5,34,228,121,107
050,01,091,"Alabama","Marengo County",5,35,210,107,103
050,01,091,"Alabama","Marengo County",5,36,234,114,120
050,01,091,"Alabama","Marengo County",5,37,207,100,107
050,01,091,"Alabama","Marengo County",5,38,205,97,108
050,01,091,"Alabama","Marengo County",5,39,211,94,117
050,01,091,"Alabama","Marengo County",5,40,197,89,108
050,01,091,"Alabama","Marengo County",5,41,192,79,113
050,01,091,"Alabama","Marengo County",5,42,209,93,116
050,01,091,"Alabama","Marengo County",5,43,217,108,109
050,01,091,"Alabama","Marengo County",5,44,210,89,121
050,01,091,"Alabama","Marengo County",5,45,234,110,124
050,01,091,"Alabama","Marengo County",5,46,197,91,106
050,01,091,"Alabama","Marengo County",5,47,218,115,103
050,01,091,"Alabama","Marengo County",5,48,245,122,123
050,01,091,"Alabama","Marengo County",5,49,215,89,126
050,01,091,"Alabama","Marengo County",5,50,223,99,124
050,01,091,"Alabama","Marengo County",5,51,255,121,134
050,01,091,"Alabama","Marengo County",5,52,256,116,140
050,01,091,"Alabama","Marengo County",5,53,251,110,141
050,01,091,"Alabama","Marengo County",5,54,223,111,112
050,01,091,"Alabama","Marengo County",5,55,235,96,139
050,01,091,"Alabama","Marengo County",5,56,250,110,140
050,01,091,"Alabama","Marengo County",5,57,235,118,117
050,01,091,"Alabama","Marengo County",5,58,257,128,129
050,01,091,"Alabama","Marengo County",5,59,254,125,129
050,01,091,"Alabama","Marengo County",5,60,263,118,145
050,01,091,"Alabama","Marengo County",5,61,252,112,140
050,01,091,"Alabama","Marengo County",5,62,242,96,146
050,01,091,"Alabama","Marengo County",5,63,251,100,151
050,01,091,"Alabama","Marengo County",5,64,255,107,148
050,01,091,"Alabama","Marengo County",5,65,276,131,145
050,01,091,"Alabama","Marengo County",5,66,252,118,134
050,01,091,"Alabama","Marengo County",5,67,237,119,118
050,01,091,"Alabama","Marengo County",5,68,247,123,124
050,01,091,"Alabama","Marengo County",5,69,231,114,117
050,01,091,"Alabama","Marengo County",5,70,218,110,108
050,01,091,"Alabama","Marengo County",5,71,200,101,99
050,01,091,"Alabama","Marengo County",5,72,199,90,109
050,01,091,"Alabama","Marengo County",5,73,202,100,102
050,01,091,"Alabama","Marengo County",5,74,196,92,104
050,01,091,"Alabama","Marengo County",5,75,185,89,96
050,01,091,"Alabama","Marengo County",5,76,203,92,111
050,01,091,"Alabama","Marengo County",5,77,130,53,77
050,01,091,"Alabama","Marengo County",5,78,127,51,76
050,01,091,"Alabama","Marengo County",5,79,119,54,65
050,01,091,"Alabama","Marengo County",5,80,125,53,72
050,01,091,"Alabama","Marengo County",5,81,100,44,56
050,01,091,"Alabama","Marengo County",5,82,103,45,58
050,01,091,"Alabama","Marengo County",5,83,91,49,42
050,01,091,"Alabama","Marengo County",5,84,61,22,39
050,01,091,"Alabama","Marengo County",5,85,416,135,281
050,01,093,"Alabama","Marion County",1,0,309,159,150
050,01,093,"Alabama","Marion County",1,1,323,161,162
050,01,093,"Alabama","Marion County",1,2,289,161,128
050,01,093,"Alabama","Marion County",1,3,321,176,145
050,01,093,"Alabama","Marion County",1,4,321,172,149
050,01,093,"Alabama","Marion County",1,5,319,157,162
050,01,093,"Alabama","Marion County",1,6,334,148,186
050,01,093,"Alabama","Marion County",1,7,345,174,171
050,01,093,"Alabama","Marion County",1,8,341,176,165
050,01,093,"Alabama","Marion County",1,9,331,173,158
050,01,093,"Alabama","Marion County",1,10,342,181,161
050,01,093,"Alabama","Marion County",1,11,369,189,180
050,01,093,"Alabama","Marion County",1,12,381,196,185
050,01,093,"Alabama","Marion County",1,13,370,203,167
050,01,093,"Alabama","Marion County",1,14,360,196,164
050,01,093,"Alabama","Marion County",1,15,366,202,164
050,01,093,"Alabama","Marion County",1,16,384,194,190
050,01,093,"Alabama","Marion County",1,17,389,189,200
050,01,093,"Alabama","Marion County",1,18,320,173,147
050,01,093,"Alabama","Marion County",1,19,273,154,119
050,01,093,"Alabama","Marion County",1,20,300,170,130
050,01,093,"Alabama","Marion County",1,21,311,177,134
050,01,093,"Alabama","Marion County",1,22,301,161,140
050,01,093,"Alabama","Marion County",1,23,324,170,154
050,01,093,"Alabama","Marion County",1,24,324,171,153
050,01,093,"Alabama","Marion County",1,25,322,164,158
050,01,093,"Alabama","Marion County",1,26,305,156,149
050,01,093,"Alabama","Marion County",1,27,340,168,172
050,01,093,"Alabama","Marion County",1,28,363,185,178
050,01,093,"Alabama","Marion County",1,29,356,175,181
050,01,093,"Alabama","Marion County",1,30,358,174,184
050,01,093,"Alabama","Marion County",1,31,348,175,173
050,01,093,"Alabama","Marion County",1,32,348,169,179
050,01,093,"Alabama","Marion County",1,33,321,164,157
050,01,093,"Alabama","Marion County",1,34,304,154,150
050,01,093,"Alabama","Marion County",1,35,303,150,153
050,01,093,"Alabama","Marion County",1,36,306,139,167
050,01,093,"Alabama","Marion County",1,37,297,153,144
050,01,093,"Alabama","Marion County",1,38,346,179,167
050,01,093,"Alabama","Marion County",1,39,357,164,193
050,01,093,"Alabama","Marion County",1,40,360,169,191
050,01,093,"Alabama","Marion County",1,41,345,176,169
050,01,093,"Alabama","Marion County",1,42,346,186,160
050,01,093,"Alabama","Marion County",1,43,320,150,170
050,01,093,"Alabama","Marion County",1,44,303,146,157
050,01,093,"Alabama","Marion County",1,45,344,169,175
050,01,093,"Alabama","Marion County",1,46,357,182,175
050,01,093,"Alabama","Marion County",1,47,364,193,171
050,01,093,"Alabama","Marion County",1,48,435,245,190
050,01,093,"Alabama","Marion County",1,49,467,239,228
050,01,093,"Alabama","Marion County",1,50,416,197,219
050,01,093,"Alabama","Marion County",1,51,397,205,192
050,01,093,"Alabama","Marion County",1,52,378,198,180
050,01,093,"Alabama","Marion County",1,53,434,225,209
050,01,093,"Alabama","Marion County",1,54,442,215,227
050,01,093,"Alabama","Marion County",1,55,446,236,210
050,01,093,"Alabama","Marion County",1,56,409,223,186
050,01,093,"Alabama","Marion County",1,57,429,215,214
050,01,093,"Alabama","Marion County",1,58,433,219,214
050,01,093,"Alabama","Marion County",1,59,442,222,220
050,01,093,"Alabama","Marion County",1,60,414,201,213
050,01,093,"Alabama","Marion County",1,61,411,186,225
050,01,093,"Alabama","Marion County",1,62,409,194,215
050,01,093,"Alabama","Marion County",1,63,403,205,198
050,01,093,"Alabama","Marion County",1,64,382,196,186
050,01,093,"Alabama","Marion County",1,65,369,189,180
050,01,093,"Alabama","Marion County",1,66,357,175,182
050,01,093,"Alabama","Marion County",1,67,334,169,165
050,01,093,"Alabama","Marion County",1,68,357,174,183
050,01,093,"Alabama","Marion County",1,69,338,156,182
050,01,093,"Alabama","Marion County",1,70,339,153,186
050,01,093,"Alabama","Marion County",1,71,351,165,186
050,01,093,"Alabama","Marion County",1,72,354,163,191
050,01,093,"Alabama","Marion County",1,73,363,170,193
050,01,093,"Alabama","Marion County",1,74,251,110,141
050,01,093,"Alabama","Marion County",1,75,244,110,134
050,01,093,"Alabama","Marion County",1,76,267,123,144
050,01,093,"Alabama","Marion County",1,77,263,113,150
050,01,093,"Alabama","Marion County",1,78,227,97,130
050,01,093,"Alabama","Marion County",1,79,194,85,109
050,01,093,"Alabama","Marion County",1,80,176,77,99
050,01,093,"Alabama","Marion County",1,81,202,87,115
050,01,093,"Alabama","Marion County",1,82,181,75,106
050,01,093,"Alabama","Marion County",1,83,147,60,87
050,01,093,"Alabama","Marion County",1,84,145,62,83
050,01,093,"Alabama","Marion County",1,85,674,242,432
050,01,093,"Alabama","Marion County",2,0,333,170,163
050,01,093,"Alabama","Marion County",2,1,315,158,157
050,01,093,"Alabama","Marion County",2,2,299,163,136
050,01,093,"Alabama","Marion County",2,3,312,171,141
050,01,093,"Alabama","Marion County",2,4,321,172,149
050,01,093,"Alabama","Marion County",2,5,321,160,161
050,01,093,"Alabama","Marion County",2,6,329,150,179
050,01,093,"Alabama","Marion County",2,7,342,168,174
050,01,093,"Alabama","Marion County",2,8,343,178,165
050,01,093,"Alabama","Marion County",2,9,336,176,160
050,01,093,"Alabama","Marion County",2,10,342,180,162
050,01,093,"Alabama","Marion County",2,11,359,185,174
050,01,093,"Alabama","Marion County",2,12,380,196,184
050,01,093,"Alabama","Marion County",2,13,372,203,169
050,01,093,"Alabama","Marion County",2,14,364,200,164
050,01,093,"Alabama","Marion County",2,15,366,200,166
050,01,093,"Alabama","Marion County",2,16,379,195,184
050,01,093,"Alabama","Marion County",2,17,386,190,196
050,01,093,"Alabama","Marion County",2,18,321,170,151
050,01,093,"Alabama","Marion County",2,19,268,149,119
050,01,093,"Alabama","Marion County",2,20,301,171,130
050,01,093,"Alabama","Marion County",2,21,309,175,134
050,01,093,"Alabama","Marion County",2,22,308,164,144
050,01,093,"Alabama","Marion County",2,23,320,168,152
050,01,093,"Alabama","Marion County",2,24,326,171,155
050,01,093,"Alabama","Marion County",2,25,322,164,158
050,01,093,"Alabama","Marion County",2,26,310,159,151
050,01,093,"Alabama","Marion County",2,27,330,165,165
050,01,093,"Alabama","Marion County",2,28,355,179,176
050,01,093,"Alabama","Marion County",2,29,353,174,179
050,01,093,"Alabama","Marion County",2,30,356,174,182
050,01,093,"Alabama","Marion County",2,31,346,172,174
050,01,093,"Alabama","Marion County",2,32,346,167,179
050,01,093,"Alabama","Marion County",2,33,318,158,160
050,01,093,"Alabama","Marion County",2,34,306,155,151
050,01,093,"Alabama","Marion County",2,35,301,148,153
050,01,093,"Alabama","Marion County",2,36,303,140,163
050,01,093,"Alabama","Marion County",2,37,296,145,151
050,01,093,"Alabama","Marion County",2,38,333,170,163
050,01,093,"Alabama","Marion County",2,39,346,161,185
050,01,093,"Alabama","Marion County",2,40,356,166,190
050,01,093,"Alabama","Marion County",2,41,345,171,174
050,01,093,"Alabama","Marion County",2,42,344,182,162
050,01,093,"Alabama","Marion County",2,43,325,155,170
050,01,093,"Alabama","Marion County",2,44,300,143,157
050,01,093,"Alabama","Marion County",2,45,329,161,168
050,01,093,"Alabama","Marion County",2,46,349,174,175
050,01,093,"Alabama","Marion County",2,47,357,186,171
050,01,093,"Alabama","Marion County",2,48,416,230,186
050,01,093,"Alabama","Marion County",2,49,458,235,223
050,01,093,"Alabama","Marion County",2,50,428,206,222
050,01,093,"Alabama","Marion County",2,51,396,200,196
050,01,093,"Alabama","Marion County",2,52,383,200,183
050,01,093,"Alabama","Marion County",2,53,412,212,200
050,01,093,"Alabama","Marion County",2,54,435,212,223
050,01,093,"Alabama","Marion County",2,55,442,230,212
050,01,093,"Alabama","Marion County",2,56,414,223,191
050,01,093,"Alabama","Marion County",2,57,421,214,207
050,01,093,"Alabama","Marion County",2,58,428,214,214
050,01,093,"Alabama","Marion County",2,59,439,219,220
050,01,093,"Alabama","Marion County",2,60,419,205,214
050,01,093,"Alabama","Marion County",2,61,408,187,221
050,01,093,"Alabama","Marion County",2,62,400,189,211
050,01,093,"Alabama","Marion County",2,63,404,201,203
050,01,093,"Alabama","Marion County",2,64,380,195,185
050,01,093,"Alabama","Marion County",2,65,368,185,183
050,01,093,"Alabama","Marion County",2,66,354,173,181
050,01,093,"Alabama","Marion County",2,67,338,168,170
050,01,093,"Alabama","Marion County",2,68,349,171,178
050,01,093,"Alabama","Marion County",2,69,335,155,180
050,01,093,"Alabama","Marion County",2,70,336,152,184
050,01,093,"Alabama","Marion County",2,71,347,160,187
050,01,093,"Alabama","Marion County",2,72,345,160,185
050,01,093,"Alabama","Marion County",2,73,376,176,200
050,01,093,"Alabama","Marion County",2,74,258,116,142
050,01,093,"Alabama","Marion County",2,75,239,108,131
050,01,093,"Alabama","Marion County",2,76,256,116,140
050,01,093,"Alabama","Marion County",2,77,261,114,147
050,01,093,"Alabama","Marion County",2,78,225,95,130
050,01,093,"Alabama","Marion County",2,79,196,86,110
050,01,093,"Alabama","Marion County",2,80,177,75,102
050,01,093,"Alabama","Marion County",2,81,193,82,111
050,01,093,"Alabama","Marion County",2,82,182,76,106
050,01,093,"Alabama","Marion County",2,83,152,62,90
050,01,093,"Alabama","Marion County",2,84,146,61,85
050,01,093,"Alabama","Marion County",2,85,682,246,436
050,01,093,"Alabama","Marion County",3,0,276,126,150
050,01,093,"Alabama","Marion County",3,1,353,185,168
050,01,093,"Alabama","Marion County",3,2,306,151,155
050,01,093,"Alabama","Marion County",3,3,306,165,141
050,01,093,"Alabama","Marion County",3,4,328,177,151
050,01,093,"Alabama","Marion County",3,5,320,178,142
050,01,093,"Alabama","Marion County",3,6,327,163,164
050,01,093,"Alabama","Marion County",3,7,340,162,178
050,01,093,"Alabama","Marion County",3,8,348,170,178
050,01,093,"Alabama","Marion County",3,9,336,175,161
050,01,093,"Alabama","Marion County",3,10,332,176,156
050,01,093,"Alabama","Marion County",3,11,343,181,162
050,01,093,"Alabama","Marion County",3,12,360,185,175
050,01,093,"Alabama","Marion County",3,13,388,206,182
050,01,093,"Alabama","Marion County",3,14,377,201,176
050,01,093,"Alabama","Marion County",3,15,353,186,167
050,01,093,"Alabama","Marion County",3,16,372,196,176
050,01,093,"Alabama","Marion County",3,17,384,195,189
050,01,093,"Alabama","Marion County",3,18,322,169,153
050,01,093,"Alabama","Marion County",3,19,270,144,126
050,01,093,"Alabama","Marion County",3,20,305,173,132
050,01,093,"Alabama","Marion County",3,21,312,176,136
050,01,093,"Alabama","Marion County",3,22,342,181,161
050,01,093,"Alabama","Marion County",3,23,327,175,152
050,01,093,"Alabama","Marion County",3,24,311,154,157
050,01,093,"Alabama","Marion County",3,25,321,172,149
050,01,093,"Alabama","Marion County",3,26,309,148,161
050,01,093,"Alabama","Marion County",3,27,318,162,156
050,01,093,"Alabama","Marion County",3,28,328,163,165
050,01,093,"Alabama","Marion County",3,29,357,184,173
050,01,093,"Alabama","Marion County",3,30,356,176,180
050,01,093,"Alabama","Marion County",3,31,369,181,188
050,01,093,"Alabama","Marion County",3,32,358,180,178
050,01,093,"Alabama","Marion County",3,33,339,170,169
050,01,093,"Alabama","Marion County",3,34,308,150,158
050,01,093,"Alabama","Marion County",3,35,306,155,151
050,01,093,"Alabama","Marion County",3,36,306,147,159
050,01,093,"Alabama","Marion County",3,37,296,143,153
050,01,093,"Alabama","Marion County",3,38,320,164,156
050,01,093,"Alabama","Marion County",3,39,322,160,162
050,01,093,"Alabama","Marion County",3,40,351,162,189
050,01,093,"Alabama","Marion County",3,41,354,168,186
050,01,093,"Alabama","Marion County",3,42,353,177,176
050,01,093,"Alabama","Marion County",3,43,340,175,165
050,01,093,"Alabama","Marion County",3,44,303,146,157
050,01,093,"Alabama","Marion County",3,45,301,143,158
050,01,093,"Alabama","Marion County",3,46,334,160,174
050,01,093,"Alabama","Marion County",3,47,339,167,172
050,01,093,"Alabama","Marion County",3,48,349,178,171
050,01,093,"Alabama","Marion County",3,49,416,224,192
050,01,093,"Alabama","Marion County",3,50,448,230,218
050,01,093,"Alabama","Marion County",3,51,416,198,218
050,01,093,"Alabama","Marion County",3,52,395,204,191
050,01,093,"Alabama","Marion County",3,53,367,189,178
050,01,093,"Alabama","Marion County",3,54,412,207,205
050,01,093,"Alabama","Marion County",3,55,449,222,227
050,01,093,"Alabama","Marion County",3,56,421,220,201
050,01,093,"Alabama","Marion County",3,57,408,218,190
050,01,093,"Alabama","Marion County",3,58,405,202,203
050,01,093,"Alabama","Marion County",3,59,427,216,211
050,01,093,"Alabama","Marion County",3,60,432,214,218
050,01,093,"Alabama","Marion County",3,61,426,210,216
050,01,093,"Alabama","Marion County",3,62,393,187,206
050,01,093,"Alabama","Marion County",3,63,393,184,209
050,01,093,"Alabama","Marion County",3,64,392,195,197
050,01,093,"Alabama","Marion County",3,65,369,181,188
050,01,093,"Alabama","Marion County",3,66,364,187,177
050,01,093,"Alabama","Marion County",3,67,353,168,185
050,01,093,"Alabama","Marion County",3,68,335,165,170
050,01,093,"Alabama","Marion County",3,69,339,159,180
050,01,093,"Alabama","Marion County",3,70,326,150,176
050,01,093,"Alabama","Marion County",3,71,330,143,187
050,01,093,"Alabama","Marion County",3,72,335,155,180
050,01,093,"Alabama","Marion County",3,73,332,151,181
050,01,093,"Alabama","Marion County",3,74,360,168,192
050,01,093,"Alabama","Marion County",3,75,235,104,131
050,01,093,"Alabama","Marion County",3,76,236,104,132
050,01,093,"Alabama","Marion County",3,77,222,96,126
050,01,093,"Alabama","Marion County",3,78,249,109,140
050,01,093,"Alabama","Marion County",3,79,215,94,121
050,01,093,"Alabama","Marion County",3,80,174,68,106
050,01,093,"Alabama","Marion County",3,81,166,69,97
050,01,093,"Alabama","Marion County",3,82,169,72,97
050,01,093,"Alabama","Marion County",3,83,166,65,101
050,01,093,"Alabama","Marion County",3,84,140,55,85
050,01,093,"Alabama","Marion County",3,85,711,267,444
050,01,093,"Alabama","Marion County",4,0,317,165,152
050,01,093,"Alabama","Marion County",4,1,268,126,142
050,01,093,"Alabama","Marion County",4,2,354,182,172
050,01,093,"Alabama","Marion County",4,3,310,152,158
050,01,093,"Alabama","Marion County",4,4,302,168,134
050,01,093,"Alabama","Marion County",4,5,323,176,147
050,01,093,"Alabama","Marion County",4,6,325,174,151
050,01,093,"Alabama","Marion County",4,7,332,160,172
050,01,093,"Alabama","Marion County",4,8,342,156,186
050,01,093,"Alabama","Marion County",4,9,326,156,170
050,01,093,"Alabama","Marion County",4,10,347,183,164
050,01,093,"Alabama","Marion County",4,11,344,177,167
050,01,093,"Alabama","Marion County",4,12,360,188,172
050,01,093,"Alabama","Marion County",4,13,376,198,178
050,01,093,"Alabama","Marion County",4,14,400,210,190
050,01,093,"Alabama","Marion County",4,15,386,202,184
050,01,093,"Alabama","Marion County",4,16,366,184,182
050,01,093,"Alabama","Marion County",4,17,364,191,173
050,01,093,"Alabama","Marion County",4,18,334,180,154
050,01,093,"Alabama","Marion County",4,19,254,133,121
050,01,093,"Alabama","Marion County",4,20,298,163,135
050,01,093,"Alabama","Marion County",4,21,306,173,133
050,01,093,"Alabama","Marion County",4,22,332,175,157
050,01,093,"Alabama","Marion County",4,23,356,202,154
050,01,093,"Alabama","Marion County",4,24,332,187,145
050,01,093,"Alabama","Marion County",4,25,316,161,155
050,01,093,"Alabama","Marion County",4,26,321,170,151
050,01,093,"Alabama","Marion County",4,27,300,145,155
050,01,093,"Alabama","Marion County",4,28,318,167,151
050,01,093,"Alabama","Marion County",4,29,316,159,157
050,01,093,"Alabama","Marion County",4,30,363,187,176
050,01,093,"Alabama","Marion County",4,31,342,174,168
050,01,093,"Alabama","Marion County",4,32,377,184,193
050,01,093,"Alabama","Marion County",4,33,343,177,166
050,01,093,"Alabama","Marion County",4,34,351,164,187
050,01,093,"Alabama","Marion County",4,35,317,155,162
050,01,093,"Alabama","Marion County",4,36,331,170,161
050,01,093,"Alabama","Marion County",4,37,312,150,162
050,01,093,"Alabama","Marion County",4,38,315,158,157
050,01,093,"Alabama","Marion County",4,39,297,152,145
050,01,093,"Alabama","Marion County",4,40,326,165,161
050,01,093,"Alabama","Marion County",4,41,351,167,184
050,01,093,"Alabama","Marion County",4,42,357,169,188
050,01,093,"Alabama","Marion County",4,43,359,186,173
050,01,093,"Alabama","Marion County",4,44,343,180,163
050,01,093,"Alabama","Marion County",4,45,317,151,166
050,01,093,"Alabama","Marion County",4,46,314,147,167
050,01,093,"Alabama","Marion County",4,47,340,169,171
050,01,093,"Alabama","Marion County",4,48,352,176,176
050,01,093,"Alabama","Marion County",4,49,375,187,188
050,01,093,"Alabama","Marion County",4,50,421,228,193
050,01,093,"Alabama","Marion County",4,51,454,236,218
050,01,093,"Alabama","Marion County",4,52,423,207,216
050,01,093,"Alabama","Marion County",4,53,397,200,197
050,01,093,"Alabama","Marion County",4,54,358,186,172
050,01,093,"Alabama","Marion County",4,55,429,220,209
050,01,093,"Alabama","Marion County",4,56,440,218,222
050,01,093,"Alabama","Marion County",4,57,424,228,196
050,01,093,"Alabama","Marion County",4,58,401,211,190
050,01,093,"Alabama","Marion County",4,59,411,208,203
050,01,093,"Alabama","Marion County",4,60,426,216,210
050,01,093,"Alabama","Marion County",4,61,432,215,217
050,01,093,"Alabama","Marion County",4,62,416,213,203
050,01,093,"Alabama","Marion County",4,63,404,191,213
050,01,093,"Alabama","Marion County",4,64,386,186,200
050,01,093,"Alabama","Marion County",4,65,385,187,198
050,01,093,"Alabama","Marion County",4,66,369,183,186
050,01,093,"Alabama","Marion County",4,67,367,188,179
050,01,093,"Alabama","Marion County",4,68,357,172,185
050,01,093,"Alabama","Marion County",4,69,325,158,167
050,01,093,"Alabama","Marion County",4,70,335,161,174
050,01,093,"Alabama","Marion County",4,71,314,144,170
050,01,093,"Alabama","Marion County",4,72,324,142,182
050,01,093,"Alabama","Marion County",4,73,322,149,173
050,01,093,"Alabama","Marion County",4,74,326,146,180
050,01,093,"Alabama","Marion County",4,75,343,159,184
050,01,093,"Alabama","Marion County",4,76,239,105,134
050,01,093,"Alabama","Marion County",4,77,216,93,123
050,01,093,"Alabama","Marion County",4,78,209,93,116
050,01,093,"Alabama","Marion County",4,79,241,106,135
050,01,093,"Alabama","Marion County",4,80,205,87,118
050,01,093,"Alabama","Marion County",4,81,159,61,98
050,01,093,"Alabama","Marion County",4,82,153,67,86
050,01,093,"Alabama","Marion County",4,83,155,63,92
050,01,093,"Alabama","Marion County",4,84,161,63,98
050,01,093,"Alabama","Marion County",4,85,748,284,464
050,01,093,"Alabama","Marion County",5,0,307,163,144
050,01,093,"Alabama","Marion County",5,1,339,160,179
050,01,093,"Alabama","Marion County",5,2,273,127,146
050,01,093,"Alabama","Marion County",5,3,356,182,174
050,01,093,"Alabama","Marion County",5,4,320,164,156
050,01,093,"Alabama","Marion County",5,5,314,173,141
050,01,093,"Alabama","Marion County",5,6,327,180,147
050,01,093,"Alabama","Marion County",5,7,332,181,151
050,01,093,"Alabama","Marion County",5,8,339,166,173
050,01,093,"Alabama","Marion County",5,9,349,165,184
050,01,093,"Alabama","Marion County",5,10,327,160,167
050,01,093,"Alabama","Marion County",5,11,331,173,158
050,01,093,"Alabama","Marion County",5,12,333,168,165
050,01,093,"Alabama","Marion County",5,13,353,184,169
050,01,093,"Alabama","Marion County",5,14,377,199,178
050,01,093,"Alabama","Marion County",5,15,394,207,187
050,01,093,"Alabama","Marion County",5,16,390,209,181
050,01,093,"Alabama","Marion County",5,17,375,189,186
050,01,093,"Alabama","Marion County",5,18,302,162,140
050,01,093,"Alabama","Marion County",5,19,261,139,122
050,01,093,"Alabama","Marion County",5,20,289,147,142
050,01,093,"Alabama","Marion County",5,21,325,173,152
050,01,093,"Alabama","Marion County",5,22,338,183,155
050,01,093,"Alabama","Marion County",5,23,348,192,156
050,01,093,"Alabama","Marion County",5,24,356,199,157
050,01,093,"Alabama","Marion County",5,25,333,184,149
050,01,093,"Alabama","Marion County",5,26,315,163,152
050,01,093,"Alabama","Marion County",5,27,337,182,155
050,01,093,"Alabama","Marion County",5,28,312,155,157
050,01,093,"Alabama","Marion County",5,29,334,174,160
050,01,093,"Alabama","Marion County",5,30,328,162,166
050,01,093,"Alabama","Marion County",5,31,360,187,173
050,01,093,"Alabama","Marion County",5,32,361,187,174
050,01,093,"Alabama","Marion County",5,33,378,183,195
050,01,093,"Alabama","Marion County",5,34,333,177,156
050,01,093,"Alabama","Marion County",5,35,350,169,181
050,01,093,"Alabama","Marion County",5,36,325,164,161
050,01,093,"Alabama","Marion County",5,37,341,175,166
050,01,093,"Alabama","Marion County",5,38,318,158,160
050,01,093,"Alabama","Marion County",5,39,301,148,153
050,01,093,"Alabama","Marion County",5,40,302,149,153
050,01,093,"Alabama","Marion County",5,41,335,172,163
050,01,093,"Alabama","Marion County",5,42,360,172,188
050,01,093,"Alabama","Marion County",5,43,362,167,195
050,01,093,"Alabama","Marion County",5,44,348,182,166
050,01,093,"Alabama","Marion County",5,45,343,182,161
050,01,093,"Alabama","Marion County",5,46,317,150,167
050,01,093,"Alabama","Marion County",5,47,311,147,164
050,01,093,"Alabama","Marion County",5,48,352,182,170
050,01,093,"Alabama","Marion County",5,49,346,169,177
050,01,093,"Alabama","Marion County",5,50,371,180,191
050,01,093,"Alabama","Marion County",5,51,420,226,194
050,01,093,"Alabama","Marion County",5,52,462,248,214
050,01,093,"Alabama","Marion County",5,53,414,200,214
050,01,093,"Alabama","Marion County",5,54,386,191,195
050,01,093,"Alabama","Marion County",5,55,368,193,175
050,01,093,"Alabama","Marion County",5,56,421,212,209
050,01,093,"Alabama","Marion County",5,57,434,220,214
050,01,093,"Alabama","Marion County",5,58,418,228,190
050,01,093,"Alabama","Marion County",5,59,394,208,186
050,01,093,"Alabama","Marion County",5,60,400,202,198
050,01,093,"Alabama","Marion County",5,61,436,219,217
050,01,093,"Alabama","Marion County",5,62,421,213,208
050,01,093,"Alabama","Marion County",5,63,427,216,211
050,01,093,"Alabama","Marion County",5,64,386,186,200
050,01,093,"Alabama","Marion County",5,65,384,180,204
050,01,093,"Alabama","Marion County",5,66,380,189,191
050,01,093,"Alabama","Marion County",5,67,366,176,190
050,01,093,"Alabama","Marion County",5,68,365,186,179
050,01,093,"Alabama","Marion County",5,69,352,170,182
050,01,093,"Alabama","Marion County",5,70,313,154,159
050,01,093,"Alabama","Marion County",5,71,328,153,175
050,01,093,"Alabama","Marion County",5,72,308,146,162
050,01,093,"Alabama","Marion County",5,73,315,140,175
050,01,093,"Alabama","Marion County",5,74,306,143,163
050,01,093,"Alabama","Marion County",5,75,303,132,171
050,01,093,"Alabama","Marion County",5,76,340,153,187
050,01,093,"Alabama","Marion County",5,77,215,92,123
050,01,093,"Alabama","Marion County",5,78,206,93,113
050,01,093,"Alabama","Marion County",5,79,203,93,110
050,01,093,"Alabama","Marion County",5,80,225,95,130
050,01,093,"Alabama","Marion County",5,81,187,78,109
050,01,093,"Alabama","Marion County",5,82,145,55,90
050,01,093,"Alabama","Marion County",5,83,136,55,81
050,01,093,"Alabama","Marion County",5,84,147,58,89
050,01,093,"Alabama","Marion County",5,85,805,310,495
050,01,095,"Alabama","Marshall County",1,0,1379,703,676
050,01,095,"Alabama","Marshall County",1,1,1388,699,689
050,01,095,"Alabama","Marshall County",1,2,1432,723,709
050,01,095,"Alabama","Marshall County",1,3,1401,716,685
050,01,095,"Alabama","Marshall County",1,4,1397,713,684
050,01,095,"Alabama","Marshall County",1,5,1397,691,706
050,01,095,"Alabama","Marshall County",1,6,1300,688,612
050,01,095,"Alabama","Marshall County",1,7,1279,655,624
050,01,095,"Alabama","Marshall County",1,8,1355,697,658
050,01,095,"Alabama","Marshall County",1,9,1357,724,633
050,01,095,"Alabama","Marshall County",1,10,1345,695,650
050,01,095,"Alabama","Marshall County",1,11,1406,718,688
050,01,095,"Alabama","Marshall County",1,12,1491,771,720
050,01,095,"Alabama","Marshall County",1,13,1463,747,716
050,01,095,"Alabama","Marshall County",1,14,1469,762,707
050,01,095,"Alabama","Marshall County",1,15,1460,746,714
050,01,095,"Alabama","Marshall County",1,16,1445,729,716
050,01,095,"Alabama","Marshall County",1,17,1355,683,672
050,01,095,"Alabama","Marshall County",1,18,1198,615,583
050,01,095,"Alabama","Marshall County",1,19,1030,527,503
050,01,095,"Alabama","Marshall County",1,20,1046,555,491
050,01,095,"Alabama","Marshall County",1,21,1116,600,516
050,01,095,"Alabama","Marshall County",1,22,1092,594,498
050,01,095,"Alabama","Marshall County",1,23,1118,578,540
050,01,095,"Alabama","Marshall County",1,24,1108,575,533
050,01,095,"Alabama","Marshall County",1,25,1130,588,542
050,01,095,"Alabama","Marshall County",1,26,1187,585,602
050,01,095,"Alabama","Marshall County",1,27,1207,627,580
050,01,095,"Alabama","Marshall County",1,28,1263,655,608
050,01,095,"Alabama","Marshall County",1,29,1314,658,656
050,01,095,"Alabama","Marshall County",1,30,1246,627,619
050,01,095,"Alabama","Marshall County",1,31,1147,571,576
050,01,095,"Alabama","Marshall County",1,32,1124,564,560
050,01,095,"Alabama","Marshall County",1,33,1158,597,561
050,01,095,"Alabama","Marshall County",1,34,1161,600,561
050,01,095,"Alabama","Marshall County",1,35,1167,599,568
050,01,095,"Alabama","Marshall County",1,36,1148,589,559
050,01,095,"Alabama","Marshall County",1,37,1220,628,592
050,01,095,"Alabama","Marshall County",1,38,1115,531,584
050,01,095,"Alabama","Marshall County",1,39,1188,597,591
050,01,095,"Alabama","Marshall County",1,40,1208,614,594
050,01,095,"Alabama","Marshall County",1,41,1085,532,553
050,01,095,"Alabama","Marshall County",1,42,1154,607,547
050,01,095,"Alabama","Marshall County",1,43,1062,539,523
050,01,095,"Alabama","Marshall County",1,44,1047,505,542
050,01,095,"Alabama","Marshall County",1,45,1154,571,583
050,01,095,"Alabama","Marshall County",1,46,1154,580,574
050,01,095,"Alabama","Marshall County",1,47,1169,572,597
050,01,095,"Alabama","Marshall County",1,48,1265,614,651
050,01,095,"Alabama","Marshall County",1,49,1402,711,691
050,01,095,"Alabama","Marshall County",1,50,1298,668,630
050,01,095,"Alabama","Marshall County",1,51,1229,636,593
050,01,095,"Alabama","Marshall County",1,52,1207,635,572
050,01,095,"Alabama","Marshall County",1,53,1219,639,580
050,01,095,"Alabama","Marshall County",1,54,1219,626,593
050,01,095,"Alabama","Marshall County",1,55,1248,635,613
050,01,095,"Alabama","Marshall County",1,56,1307,636,671
050,01,095,"Alabama","Marshall County",1,57,1349,647,702
050,01,095,"Alabama","Marshall County",1,58,1336,654,682
050,01,095,"Alabama","Marshall County",1,59,1301,661,640
050,01,095,"Alabama","Marshall County",1,60,1277,639,638
050,01,095,"Alabama","Marshall County",1,61,1247,611,636
050,01,095,"Alabama","Marshall County",1,62,1288,635,653
050,01,095,"Alabama","Marshall County",1,63,1239,609,630
050,01,095,"Alabama","Marshall County",1,64,1195,588,607
050,01,095,"Alabama","Marshall County",1,65,1107,524,583
050,01,095,"Alabama","Marshall County",1,66,1140,533,607
050,01,095,"Alabama","Marshall County",1,67,1048,489,559
050,01,095,"Alabama","Marshall County",1,68,1001,465,536
050,01,095,"Alabama","Marshall County",1,69,970,446,524
050,01,095,"Alabama","Marshall County",1,70,915,429,486
050,01,095,"Alabama","Marshall County",1,71,938,427,511
050,01,095,"Alabama","Marshall County",1,72,984,444,540
050,01,095,"Alabama","Marshall County",1,73,974,463,511
050,01,095,"Alabama","Marshall County",1,74,630,285,345
050,01,095,"Alabama","Marshall County",1,75,678,296,382
050,01,095,"Alabama","Marshall County",1,76,686,307,379
050,01,095,"Alabama","Marshall County",1,77,725,308,417
050,01,095,"Alabama","Marshall County",1,78,559,246,313
050,01,095,"Alabama","Marshall County",1,79,487,220,267
050,01,095,"Alabama","Marshall County",1,80,486,209,277
050,01,095,"Alabama","Marshall County",1,81,467,182,285
050,01,095,"Alabama","Marshall County",1,82,371,140,231
050,01,095,"Alabama","Marshall County",1,83,330,136,194
050,01,095,"Alabama","Marshall County",1,84,277,110,167
050,01,095,"Alabama","Marshall County",1,85,1577,519,1058
050,01,095,"Alabama","Marshall County",2,0,1375,695,680
050,01,095,"Alabama","Marshall County",2,1,1384,700,684
050,01,095,"Alabama","Marshall County",2,2,1426,717,709
050,01,095,"Alabama","Marshall County",2,3,1403,713,690
050,01,095,"Alabama","Marshall County",2,4,1404,718,686
050,01,095,"Alabama","Marshall County",2,5,1399,697,702
050,01,095,"Alabama","Marshall County",2,6,1325,688,637
050,01,095,"Alabama","Marshall County",2,7,1284,661,623
050,01,095,"Alabama","Marshall County",2,8,1335,686,649
050,01,095,"Alabama","Marshall County",2,9,1353,716,637
050,01,095,"Alabama","Marshall County",2,10,1344,698,646
050,01,095,"Alabama","Marshall County",2,11,1385,706,679
050,01,095,"Alabama","Marshall County",2,12,1480,762,718
050,01,095,"Alabama","Marshall County",2,13,1473,755,718
050,01,095,"Alabama","Marshall County",2,14,1472,760,712
050,01,095,"Alabama","Marshall County",2,15,1470,755,715
050,01,095,"Alabama","Marshall County",2,16,1451,734,717
050,01,095,"Alabama","Marshall County",2,17,1377,693,684
050,01,095,"Alabama","Marshall County",2,18,1195,614,581
050,01,095,"Alabama","Marshall County",2,19,1036,529,507
050,01,095,"Alabama","Marshall County",2,20,1061,556,505
050,01,095,"Alabama","Marshall County",2,21,1096,590,506
050,01,095,"Alabama","Marshall County",2,22,1118,603,515
050,01,095,"Alabama","Marshall County",2,23,1115,583,532
050,01,095,"Alabama","Marshall County",2,24,1110,575,535
050,01,095,"Alabama","Marshall County",2,25,1129,586,543
050,01,095,"Alabama","Marshall County",2,26,1175,586,589
050,01,095,"Alabama","Marshall County",2,27,1205,621,584
050,01,095,"Alabama","Marshall County",2,28,1252,646,606
050,01,095,"Alabama","Marshall County",2,29,1301,655,646
050,01,095,"Alabama","Marshall County",2,30,1271,640,631
050,01,095,"Alabama","Marshall County",2,31,1162,583,579
050,01,095,"Alabama","Marshall County",2,32,1130,566,564
050,01,095,"Alabama","Marshall County",2,33,1145,587,558
050,01,095,"Alabama","Marshall County",2,34,1165,601,564
050,01,095,"Alabama","Marshall County",2,35,1176,605,571
050,01,095,"Alabama","Marshall County",2,36,1150,591,559
050,01,095,"Alabama","Marshall County",2,37,1206,618,588
050,01,095,"Alabama","Marshall County",2,38,1142,556,586
050,01,095,"Alabama","Marshall County",2,39,1165,578,587
050,01,095,"Alabama","Marshall County",2,40,1214,615,599
050,01,095,"Alabama","Marshall County",2,41,1114,551,563
050,01,095,"Alabama","Marshall County",2,42,1124,586,538
050,01,095,"Alabama","Marshall County",2,43,1089,557,532
050,01,095,"Alabama","Marshall County",2,44,1040,509,531
050,01,095,"Alabama","Marshall County",2,45,1135,560,575
050,01,095,"Alabama","Marshall County",2,46,1149,574,575
050,01,095,"Alabama","Marshall County",2,47,1159,570,589
050,01,095,"Alabama","Marshall County",2,48,1234,599,635
050,01,095,"Alabama","Marshall County",2,49,1375,691,684
050,01,095,"Alabama","Marshall County",2,50,1326,680,646
050,01,095,"Alabama","Marshall County",2,51,1244,644,600
050,01,095,"Alabama","Marshall County",2,52,1207,632,575
050,01,095,"Alabama","Marshall County",2,53,1214,637,577
050,01,095,"Alabama","Marshall County",2,54,1213,629,584
050,01,095,"Alabama","Marshall County",2,55,1237,631,606
050,01,095,"Alabama","Marshall County",2,56,1290,631,659
050,01,095,"Alabama","Marshall County",2,57,1344,647,697
050,01,095,"Alabama","Marshall County",2,58,1336,647,689
050,01,095,"Alabama","Marshall County",2,59,1316,661,655
050,01,095,"Alabama","Marshall County",2,60,1274,641,633
050,01,095,"Alabama","Marshall County",2,61,1253,614,639
050,01,095,"Alabama","Marshall County",2,62,1275,627,648
050,01,095,"Alabama","Marshall County",2,63,1268,625,643
050,01,095,"Alabama","Marshall County",2,64,1195,587,608
050,01,095,"Alabama","Marshall County",2,65,1131,541,590
050,01,095,"Alabama","Marshall County",2,66,1133,531,602
050,01,095,"Alabama","Marshall County",2,67,1058,493,565
050,01,095,"Alabama","Marshall County",2,68,1001,464,537
050,01,095,"Alabama","Marshall County",2,69,981,454,527
050,01,095,"Alabama","Marshall County",2,70,915,426,489
050,01,095,"Alabama","Marshall County",2,71,930,422,508
050,01,095,"Alabama","Marshall County",2,72,953,434,519
050,01,095,"Alabama","Marshall County",2,73,1015,482,533
050,01,095,"Alabama","Marshall County",2,74,665,306,359
050,01,095,"Alabama","Marshall County",2,75,664,291,373
050,01,095,"Alabama","Marshall County",2,76,665,293,372
050,01,095,"Alabama","Marshall County",2,77,729,314,415
050,01,095,"Alabama","Marshall County",2,78,577,248,329
050,01,095,"Alabama","Marshall County",2,79,492,220,272
050,01,095,"Alabama","Marshall County",2,80,475,206,269
050,01,095,"Alabama","Marshall County",2,81,461,185,276
050,01,095,"Alabama","Marshall County",2,82,394,149,245
050,01,095,"Alabama","Marshall County",2,83,329,133,196
050,01,095,"Alabama","Marshall County",2,84,287,115,172
050,01,095,"Alabama","Marshall County",2,85,1577,520,1057
050,01,095,"Alabama","Marshall County",3,0,1444,726,718
050,01,095,"Alabama","Marshall County",3,1,1400,701,699
050,01,095,"Alabama","Marshall County",3,2,1382,704,678
050,01,095,"Alabama","Marshall County",3,3,1464,733,731
050,01,095,"Alabama","Marshall County",3,4,1428,716,712
050,01,095,"Alabama","Marshall County",3,5,1438,737,701
050,01,095,"Alabama","Marshall County",3,6,1412,687,725
050,01,095,"Alabama","Marshall County",3,7,1322,690,632
050,01,095,"Alabama","Marshall County",3,8,1301,660,641
050,01,095,"Alabama","Marshall County",3,9,1321,676,645
050,01,095,"Alabama","Marshall County",3,10,1351,713,638
050,01,095,"Alabama","Marshall County",3,11,1350,694,656
050,01,095,"Alabama","Marshall County",3,12,1422,723,699
050,01,095,"Alabama","Marshall County",3,13,1486,768,718
050,01,095,"Alabama","Marshall County",3,14,1519,779,740
050,01,095,"Alabama","Marshall County",3,15,1482,766,716
050,01,095,"Alabama","Marshall County",3,16,1492,762,730
050,01,095,"Alabama","Marshall County",3,17,1462,730,732
050,01,095,"Alabama","Marshall County",3,18,1237,638,599
050,01,095,"Alabama","Marshall County",3,19,1044,534,510
050,01,095,"Alabama","Marshall County",3,20,1100,549,551
050,01,095,"Alabama","Marshall County",3,21,1095,586,509
050,01,095,"Alabama","Marshall County",3,22,1160,610,550
050,01,095,"Alabama","Marshall County",3,23,1154,623,531
050,01,095,"Alabama","Marshall County",3,24,1139,591,548
050,01,095,"Alabama","Marshall County",3,25,1117,585,532
050,01,095,"Alabama","Marshall County",3,26,1145,591,554
050,01,095,"Alabama","Marshall County",3,27,1163,583,580
050,01,095,"Alabama","Marshall County",3,28,1228,622,606
050,01,095,"Alabama","Marshall County",3,29,1240,634,606
050,01,095,"Alabama","Marshall County",3,30,1321,679,642
050,01,095,"Alabama","Marshall County",3,31,1247,631,616
050,01,095,"Alabama","Marshall County",3,32,1175,582,593
050,01,095,"Alabama","Marshall County",3,33,1151,568,583
050,01,095,"Alabama","Marshall County",3,34,1154,587,567
050,01,095,"Alabama","Marshall County",3,35,1148,593,555
050,01,095,"Alabama","Marshall County",3,36,1210,617,593
050,01,095,"Alabama","Marshall County",3,37,1150,578,572
050,01,095,"Alabama","Marshall County",3,38,1229,633,596
050,01,095,"Alabama","Marshall County",3,39,1152,568,584
050,01,095,"Alabama","Marshall County",3,40,1175,583,592
050,01,095,"Alabama","Marshall County",3,41,1228,633,595
050,01,095,"Alabama","Marshall County",3,42,1113,547,566
050,01,095,"Alabama","Marshall County",3,43,1109,583,526
050,01,095,"Alabama","Marshall County",3,44,1097,558,539
050,01,095,"Alabama","Marshall County",3,45,1029,509,520
050,01,095,"Alabama","Marshall County",3,46,1147,558,589
050,01,095,"Alabama","Marshall County",3,47,1157,578,579
050,01,095,"Alabama","Marshall County",3,48,1122,555,567
050,01,095,"Alabama","Marshall County",3,49,1248,622,626
050,01,095,"Alabama","Marshall County",3,50,1377,681,696
050,01,095,"Alabama","Marshall County",3,51,1312,673,639
050,01,095,"Alabama","Marshall County",3,52,1222,650,572
050,01,095,"Alabama","Marshall County",3,53,1192,617,575
050,01,095,"Alabama","Marshall County",3,54,1230,647,583
050,01,095,"Alabama","Marshall County",3,55,1197,618,579
050,01,095,"Alabama","Marshall County",3,56,1222,610,612
050,01,095,"Alabama","Marshall County",3,57,1280,633,647
050,01,095,"Alabama","Marshall County",3,58,1322,621,701
050,01,095,"Alabama","Marshall County",3,59,1327,642,685
050,01,095,"Alabama","Marshall County",3,60,1319,660,659
050,01,095,"Alabama","Marshall County",3,61,1284,650,634
050,01,095,"Alabama","Marshall County",3,62,1257,597,660
050,01,095,"Alabama","Marshall County",3,63,1240,601,639
050,01,095,"Alabama","Marshall County",3,64,1237,611,626
050,01,095,"Alabama","Marshall County",3,65,1180,572,608
050,01,095,"Alabama","Marshall County",3,66,1108,527,581
050,01,095,"Alabama","Marshall County",3,67,1100,509,591
050,01,095,"Alabama","Marshall County",3,68,1040,473,567
050,01,095,"Alabama","Marshall County",3,69,987,452,535
050,01,095,"Alabama","Marshall County",3,70,952,440,512
050,01,095,"Alabama","Marshall County",3,71,891,405,486
050,01,095,"Alabama","Marshall County",3,72,892,402,490
050,01,095,"Alabama","Marshall County",3,73,917,415,502
050,01,095,"Alabama","Marshall County",3,74,978,460,518
050,01,095,"Alabama","Marshall County",3,75,628,286,342
050,01,095,"Alabama","Marshall County",3,76,630,275,355
050,01,095,"Alabama","Marshall County",3,77,629,267,362
050,01,095,"Alabama","Marshall County",3,78,671,290,381
050,01,095,"Alabama","Marshall County",3,79,549,236,313
050,01,095,"Alabama","Marshall County",3,80,437,194,243
050,01,095,"Alabama","Marshall County",3,81,432,189,243
050,01,095,"Alabama","Marshall County",3,82,423,170,253
050,01,095,"Alabama","Marshall County",3,83,352,131,221
050,01,095,"Alabama","Marshall County",3,84,270,101,169
050,01,095,"Alabama","Marshall County",3,85,1542,515,1027
050,01,095,"Alabama","Marshall County",4,0,1498,789,709
050,01,095,"Alabama","Marshall County",4,1,1490,750,740
050,01,095,"Alabama","Marshall County",4,2,1408,704,704
050,01,095,"Alabama","Marshall County",4,3,1415,743,672
050,01,095,"Alabama","Marshall County",4,4,1486,739,747
050,01,095,"Alabama","Marshall County",4,5,1442,713,729
050,01,095,"Alabama","Marshall County",4,6,1454,743,711
050,01,095,"Alabama","Marshall County",4,7,1404,685,719
050,01,095,"Alabama","Marshall County",4,8,1366,720,646
050,01,095,"Alabama","Marshall County",4,9,1335,670,665
050,01,095,"Alabama","Marshall County",4,10,1340,688,652
050,01,095,"Alabama","Marshall County",4,11,1371,729,642
050,01,095,"Alabama","Marshall County",4,12,1383,698,685
050,01,095,"Alabama","Marshall County",4,13,1444,734,710
050,01,095,"Alabama","Marshall County",4,14,1506,775,731
050,01,095,"Alabama","Marshall County",4,15,1535,779,756
050,01,095,"Alabama","Marshall County",4,16,1507,770,737
050,01,095,"Alabama","Marshall County",4,17,1497,748,749
050,01,095,"Alabama","Marshall County",4,18,1301,670,631
050,01,095,"Alabama","Marshall County",4,19,1078,542,536
050,01,095,"Alabama","Marshall County",4,20,1105,560,545
050,01,095,"Alabama","Marshall County",4,21,1117,563,554
050,01,095,"Alabama","Marshall County",4,22,1130,585,545
050,01,095,"Alabama","Marshall County",4,23,1216,637,579
050,01,095,"Alabama","Marshall County",4,24,1196,638,558
050,01,095,"Alabama","Marshall County",4,25,1165,603,562
050,01,095,"Alabama","Marshall County",4,26,1126,588,538
050,01,095,"Alabama","Marshall County",4,27,1138,580,558
050,01,095,"Alabama","Marshall County",4,28,1176,587,589
050,01,095,"Alabama","Marshall County",4,29,1210,612,598
050,01,095,"Alabama","Marshall County",4,30,1242,635,607
050,01,095,"Alabama","Marshall County",4,31,1327,686,641
050,01,095,"Alabama","Marshall County",4,32,1270,657,613
050,01,095,"Alabama","Marshall County",4,33,1196,592,604
050,01,095,"Alabama","Marshall County",4,34,1152,568,584
050,01,095,"Alabama","Marshall County",4,35,1161,578,583
050,01,095,"Alabama","Marshall County",4,36,1166,600,566
050,01,095,"Alabama","Marshall County",4,37,1234,631,603
050,01,095,"Alabama","Marshall County",4,38,1143,578,565
050,01,095,"Alabama","Marshall County",4,39,1242,641,601
050,01,095,"Alabama","Marshall County",4,40,1171,581,590
050,01,095,"Alabama","Marshall County",4,41,1176,585,591
050,01,095,"Alabama","Marshall County",4,42,1223,631,592
050,01,095,"Alabama","Marshall County",4,43,1113,543,570
050,01,095,"Alabama","Marshall County",4,44,1113,583,530
050,01,095,"Alabama","Marshall County",4,45,1108,561,547
050,01,095,"Alabama","Marshall County",4,46,1037,510,527
050,01,095,"Alabama","Marshall County",4,47,1143,550,593
050,01,095,"Alabama","Marshall County",4,48,1158,576,582
050,01,095,"Alabama","Marshall County",4,49,1144,568,576
050,01,095,"Alabama","Marshall County",4,50,1270,636,634
050,01,095,"Alabama","Marshall County",4,51,1384,693,691
050,01,095,"Alabama","Marshall County",4,52,1340,683,657
050,01,095,"Alabama","Marshall County",4,53,1220,647,573
050,01,095,"Alabama","Marshall County",4,54,1208,625,583
050,01,095,"Alabama","Marshall County",4,55,1223,656,567
050,01,095,"Alabama","Marshall County",4,56,1216,626,590
050,01,095,"Alabama","Marshall County",4,57,1202,595,607
050,01,095,"Alabama","Marshall County",4,58,1280,642,638
050,01,095,"Alabama","Marshall County",4,59,1326,627,699
050,01,095,"Alabama","Marshall County",4,60,1326,637,689
050,01,095,"Alabama","Marshall County",4,61,1318,667,651
050,01,095,"Alabama","Marshall County",4,62,1280,631,649
050,01,095,"Alabama","Marshall County",4,63,1246,593,653
050,01,095,"Alabama","Marshall County",4,64,1222,588,634
050,01,095,"Alabama","Marshall County",4,65,1241,604,637
050,01,095,"Alabama","Marshall County",4,66,1166,561,605
050,01,095,"Alabama","Marshall County",4,67,1121,529,592
050,01,095,"Alabama","Marshall County",4,68,1094,504,590
050,01,095,"Alabama","Marshall County",4,69,1022,468,554
050,01,095,"Alabama","Marshall County",4,70,952,435,517
050,01,095,"Alabama","Marshall County",4,71,941,425,516
050,01,095,"Alabama","Marshall County",4,72,855,393,462
050,01,095,"Alabama","Marshall County",4,73,865,378,487
050,01,095,"Alabama","Marshall County",4,74,882,401,481
050,01,095,"Alabama","Marshall County",4,75,934,439,495
050,01,095,"Alabama","Marshall County",4,76,594,269,325
050,01,095,"Alabama","Marshall County",4,77,605,255,350
050,01,095,"Alabama","Marshall County",4,78,583,244,339
050,01,095,"Alabama","Marshall County",4,79,629,269,360
050,01,095,"Alabama","Marshall County",4,80,518,220,298
050,01,095,"Alabama","Marshall County",4,81,413,176,237
050,01,095,"Alabama","Marshall County",4,82,390,170,220
050,01,095,"Alabama","Marshall County",4,83,386,154,232
050,01,095,"Alabama","Marshall County",4,84,310,110,200
050,01,095,"Alabama","Marshall County",4,85,1508,510,998
050,01,095,"Alabama","Marshall County",5,0,1525,802,723
050,01,095,"Alabama","Marshall County",5,1,1526,802,724
050,01,095,"Alabama","Marshall County",5,2,1486,744,742
050,01,095,"Alabama","Marshall County",5,3,1454,758,696
050,01,095,"Alabama","Marshall County",5,4,1454,748,706
050,01,095,"Alabama","Marshall County",5,5,1499,750,749
050,01,095,"Alabama","Marshall County",5,6,1457,710,747
050,01,095,"Alabama","Marshall County",5,7,1457,753,704
050,01,095,"Alabama","Marshall County",5,8,1433,702,731
050,01,095,"Alabama","Marshall County",5,9,1357,716,641
050,01,095,"Alabama","Marshall County",5,10,1350,683,667
050,01,095,"Alabama","Marshall County",5,11,1369,698,671
050,01,095,"Alabama","Marshall County",5,12,1419,740,679
050,01,095,"Alabama","Marshall County",5,13,1409,715,694
050,01,095,"Alabama","Marshall County",5,14,1447,736,711
050,01,095,"Alabama","Marshall County",5,15,1510,782,728
050,01,095,"Alabama","Marshall County",5,16,1559,788,771
050,01,095,"Alabama","Marshall County",5,17,1507,769,738
050,01,095,"Alabama","Marshall County",5,18,1313,683,630
050,01,095,"Alabama","Marshall County",5,19,1119,560,559
050,01,095,"Alabama","Marshall County",5,20,1126,570,556
050,01,095,"Alabama","Marshall County",5,21,1164,590,574
050,01,095,"Alabama","Marshall County",5,22,1164,569,595
050,01,095,"Alabama","Marshall County",5,23,1165,603,562
050,01,095,"Alabama","Marshall County",5,24,1229,654,575
050,01,095,"Alabama","Marshall County",5,25,1228,660,568
050,01,095,"Alabama","Marshall County",5,26,1195,600,595
050,01,095,"Alabama","Marshall County",5,27,1160,596,564
050,01,095,"Alabama","Marshall County",5,28,1141,586,555
050,01,095,"Alabama","Marshall County",5,29,1172,580,592
050,01,095,"Alabama","Marshall County",5,30,1243,625,618
050,01,095,"Alabama","Marshall County",5,31,1246,624,622
050,01,095,"Alabama","Marshall County",5,32,1343,696,647
050,01,095,"Alabama","Marshall County",5,33,1281,667,614
050,01,095,"Alabama","Marshall County",5,34,1204,591,613
050,01,095,"Alabama","Marshall County",5,35,1149,573,576
050,01,095,"Alabama","Marshall County",5,36,1177,575,602
050,01,095,"Alabama","Marshall County",5,37,1200,621,579
050,01,095,"Alabama","Marshall County",5,38,1223,629,594
050,01,095,"Alabama","Marshall County",5,39,1164,592,572
050,01,095,"Alabama","Marshall County",5,40,1218,623,595
050,01,095,"Alabama","Marshall County",5,41,1168,584,584
050,01,095,"Alabama","Marshall County",5,42,1197,605,592
050,01,095,"Alabama","Marshall County",5,43,1232,636,596
050,01,095,"Alabama","Marshall County",5,44,1127,548,579
050,01,095,"Alabama","Marshall County",5,45,1091,571,520
050,01,095,"Alabama","Marshall County",5,46,1128,576,552
050,01,095,"Alabama","Marshall County",5,47,1064,531,533
050,01,095,"Alabama","Marshall County",5,48,1137,537,600
050,01,095,"Alabama","Marshall County",5,49,1178,582,596
050,01,095,"Alabama","Marshall County",5,50,1140,568,572
050,01,095,"Alabama","Marshall County",5,51,1288,637,651
050,01,095,"Alabama","Marshall County",5,52,1391,696,695
050,01,095,"Alabama","Marshall County",5,53,1346,678,668
050,01,095,"Alabama","Marshall County",5,54,1239,643,596
050,01,095,"Alabama","Marshall County",5,55,1223,629,594
050,01,095,"Alabama","Marshall County",5,56,1220,652,568
050,01,095,"Alabama","Marshall County",5,57,1203,618,585
050,01,095,"Alabama","Marshall County",5,58,1221,602,619
050,01,095,"Alabama","Marshall County",5,59,1290,650,640
050,01,095,"Alabama","Marshall County",5,60,1340,639,701
050,01,095,"Alabama","Marshall County",5,61,1348,654,694
050,01,095,"Alabama","Marshall County",5,62,1307,647,660
050,01,095,"Alabama","Marshall County",5,63,1294,641,653
050,01,095,"Alabama","Marshall County",5,64,1242,584,658
050,01,095,"Alabama","Marshall County",5,65,1239,586,653
050,01,095,"Alabama","Marshall County",5,66,1221,601,620
050,01,095,"Alabama","Marshall County",5,67,1164,567,597
050,01,095,"Alabama","Marshall County",5,68,1118,526,592
050,01,095,"Alabama","Marshall County",5,69,1081,492,589
050,01,095,"Alabama","Marshall County",5,70,1002,459,543
050,01,095,"Alabama","Marshall County",5,71,934,419,515
050,01,095,"Alabama","Marshall County",5,72,907,413,494
050,01,095,"Alabama","Marshall County",5,73,828,380,448
050,01,095,"Alabama","Marshall County",5,74,853,379,474
050,01,095,"Alabama","Marshall County",5,75,847,377,470
050,01,095,"Alabama","Marshall County",5,76,903,421,482
050,01,095,"Alabama","Marshall County",5,77,579,257,322
050,01,095,"Alabama","Marshall County",5,78,563,230,333
050,01,095,"Alabama","Marshall County",5,79,553,231,322
050,01,095,"Alabama","Marshall County",5,80,591,250,341
050,01,095,"Alabama","Marshall County",5,81,486,205,281
050,01,095,"Alabama","Marshall County",5,82,375,163,212
050,01,095,"Alabama","Marshall County",5,83,353,155,198
050,01,095,"Alabama","Marshall County",5,84,347,137,210
050,01,095,"Alabama","Marshall County",5,85,1556,531,1025
050,01,097,"Alabama","Mobile County",1,0,5317,2721,2596
050,01,097,"Alabama","Mobile County",1,1,5363,2773,2590
050,01,097,"Alabama","Mobile County",1,2,5441,2748,2693
050,01,097,"Alabama","Mobile County",1,3,5379,2731,2648
050,01,097,"Alabama","Mobile County",1,4,5447,2786,2661
050,01,097,"Alabama","Mobile County",1,5,5480,2752,2728
050,01,097,"Alabama","Mobile County",1,6,5359,2634,2725
050,01,097,"Alabama","Mobile County",1,7,5104,2511,2593
050,01,097,"Alabama","Mobile County",1,8,5237,2621,2616
050,01,097,"Alabama","Mobile County",1,9,5294,2702,2592
050,01,097,"Alabama","Mobile County",1,10,5408,2770,2638
050,01,097,"Alabama","Mobile County",1,11,5609,2807,2802
050,01,097,"Alabama","Mobile County",1,12,5767,2922,2845
050,01,097,"Alabama","Mobile County",1,13,5716,2922,2794
050,01,097,"Alabama","Mobile County",1,14,5492,2809,2683
050,01,097,"Alabama","Mobile County",1,15,5322,2712,2610
050,01,097,"Alabama","Mobile County",1,16,5498,2789,2709
050,01,097,"Alabama","Mobile County",1,17,5501,2795,2706
050,01,097,"Alabama","Mobile County",1,18,5141,2646,2495
050,01,097,"Alabama","Mobile County",1,19,4984,2496,2488
050,01,097,"Alabama","Mobile County",1,20,5160,2573,2587
050,01,097,"Alabama","Mobile County",1,21,5108,2497,2611
050,01,097,"Alabama","Mobile County",1,22,5235,2516,2719
050,01,097,"Alabama","Mobile County",1,23,5338,2654,2684
050,01,097,"Alabama","Mobile County",1,24,5442,2684,2758
050,01,097,"Alabama","Mobile County",1,25,5588,2731,2857
050,01,097,"Alabama","Mobile County",1,26,5823,2870,2953
050,01,097,"Alabama","Mobile County",1,27,5859,2860,2999
050,01,097,"Alabama","Mobile County",1,28,5886,2797,3089
050,01,097,"Alabama","Mobile County",1,29,6088,2916,3172
050,01,097,"Alabama","Mobile County",1,30,5976,2832,3144
050,01,097,"Alabama","Mobile County",1,31,5808,2757,3051
050,01,097,"Alabama","Mobile County",1,32,5749,2709,3040
050,01,097,"Alabama","Mobile County",1,33,5480,2607,2873
050,01,097,"Alabama","Mobile County",1,34,5302,2474,2828
050,01,097,"Alabama","Mobile County",1,35,5189,2395,2794
050,01,097,"Alabama","Mobile County",1,36,5234,2442,2792
050,01,097,"Alabama","Mobile County",1,37,5267,2486,2781
050,01,097,"Alabama","Mobile County",1,38,5210,2496,2714
050,01,097,"Alabama","Mobile County",1,39,5173,2482,2691
050,01,097,"Alabama","Mobile County",1,40,5038,2417,2621
050,01,097,"Alabama","Mobile County",1,41,4918,2350,2568
050,01,097,"Alabama","Mobile County",1,42,4908,2357,2551
050,01,097,"Alabama","Mobile County",1,43,4857,2314,2543
050,01,097,"Alabama","Mobile County",1,44,4713,2214,2499
050,01,097,"Alabama","Mobile County",1,45,4713,2220,2493
050,01,097,"Alabama","Mobile County",1,46,4630,2231,2399
050,01,097,"Alabama","Mobile County",1,47,4765,2300,2465
050,01,097,"Alabama","Mobile County",1,48,4995,2384,2611
050,01,097,"Alabama","Mobile County",1,49,5312,2575,2737
050,01,097,"Alabama","Mobile County",1,50,5001,2364,2637
050,01,097,"Alabama","Mobile County",1,51,4799,2279,2520
050,01,097,"Alabama","Mobile County",1,52,4783,2283,2500
050,01,097,"Alabama","Mobile County",1,53,4984,2369,2615
050,01,097,"Alabama","Mobile County",1,54,5172,2483,2689
050,01,097,"Alabama","Mobile County",1,55,5407,2609,2798
050,01,097,"Alabama","Mobile County",1,56,5568,2701,2867
050,01,097,"Alabama","Mobile County",1,57,5564,2651,2913
050,01,097,"Alabama","Mobile County",1,58,5684,2668,3016
050,01,097,"Alabama","Mobile County",1,59,5609,2611,2998
050,01,097,"Alabama","Mobile County",1,60,5552,2612,2940
050,01,097,"Alabama","Mobile County",1,61,5542,2638,2904
050,01,097,"Alabama","Mobile County",1,62,5558,2645,2913
050,01,097,"Alabama","Mobile County",1,63,5358,2542,2816
050,01,097,"Alabama","Mobile County",1,64,5226,2441,2785
050,01,097,"Alabama","Mobile County",1,65,4976,2352,2624
050,01,097,"Alabama","Mobile County",1,66,4787,2256,2531
050,01,097,"Alabama","Mobile County",1,67,4618,2130,2488
050,01,097,"Alabama","Mobile County",1,68,4554,2147,2407
050,01,097,"Alabama","Mobile County",1,69,4202,1983,2219
050,01,097,"Alabama","Mobile County",1,70,3999,1787,2212
050,01,097,"Alabama","Mobile County",1,71,3943,1775,2168
050,01,097,"Alabama","Mobile County",1,72,3889,1771,2118
050,01,097,"Alabama","Mobile County",1,73,3951,1779,2172
050,01,097,"Alabama","Mobile County",1,74,2841,1262,1579
050,01,097,"Alabama","Mobile County",1,75,2784,1224,1560
050,01,097,"Alabama","Mobile County",1,76,2712,1198,1514
050,01,097,"Alabama","Mobile County",1,77,2640,1147,1493
050,01,097,"Alabama","Mobile County",1,78,2185,925,1260
050,01,097,"Alabama","Mobile County",1,79,1916,829,1087
050,01,097,"Alabama","Mobile County",1,80,1853,736,1117
050,01,097,"Alabama","Mobile County",1,81,1730,707,1023
050,01,097,"Alabama","Mobile County",1,82,1592,659,933
050,01,097,"Alabama","Mobile County",1,83,1343,535,808
050,01,097,"Alabama","Mobile County",1,84,1184,463,721
050,01,097,"Alabama","Mobile County",1,85,6680,2260,4420
050,01,097,"Alabama","Mobile County",2,0,5266,2719,2547
050,01,097,"Alabama","Mobile County",2,1,5345,2752,2593
050,01,097,"Alabama","Mobile County",2,2,5440,2758,2682
050,01,097,"Alabama","Mobile County",2,3,5377,2726,2651
050,01,097,"Alabama","Mobile County",2,4,5440,2777,2663
050,01,097,"Alabama","Mobile County",2,5,5468,2758,2710
050,01,097,"Alabama","Mobile County",2,6,5391,2668,2723
050,01,097,"Alabama","Mobile County",2,7,5162,2541,2621
050,01,097,"Alabama","Mobile County",2,8,5186,2585,2601
050,01,097,"Alabama","Mobile County",2,9,5261,2677,2584
050,01,097,"Alabama","Mobile County",2,10,5356,2734,2622
050,01,097,"Alabama","Mobile County",2,11,5538,2785,2753
050,01,097,"Alabama","Mobile County",2,12,5747,2903,2844
050,01,097,"Alabama","Mobile County",2,13,5716,2917,2799
050,01,097,"Alabama","Mobile County",2,14,5535,2830,2705
050,01,097,"Alabama","Mobile County",2,15,5358,2734,2624
050,01,097,"Alabama","Mobile County",2,16,5465,2777,2688
050,01,097,"Alabama","Mobile County",2,17,5487,2787,2700
050,01,097,"Alabama","Mobile County",2,18,5105,2623,2482
050,01,097,"Alabama","Mobile County",2,19,4928,2474,2454
050,01,097,"Alabama","Mobile County",2,20,5169,2579,2590
050,01,097,"Alabama","Mobile County",2,21,5117,2519,2598
050,01,097,"Alabama","Mobile County",2,22,5224,2509,2715
050,01,097,"Alabama","Mobile County",2,23,5338,2642,2696
050,01,097,"Alabama","Mobile County",2,24,5391,2657,2734
050,01,097,"Alabama","Mobile County",2,25,5553,2718,2835
050,01,097,"Alabama","Mobile County",2,26,5780,2839,2941
050,01,097,"Alabama","Mobile County",2,27,5841,2858,2983
050,01,097,"Alabama","Mobile County",2,28,5870,2805,3065
050,01,097,"Alabama","Mobile County",2,29,6043,2884,3159
050,01,097,"Alabama","Mobile County",2,30,6009,2848,3161
050,01,097,"Alabama","Mobile County",2,31,5826,2758,3068
050,01,097,"Alabama","Mobile County",2,32,5738,2703,3035
050,01,097,"Alabama","Mobile County",2,33,5541,2636,2905
050,01,097,"Alabama","Mobile County",2,34,5337,2496,2841
050,01,097,"Alabama","Mobile County",2,35,5233,2423,2810
050,01,097,"Alabama","Mobile County",2,36,5172,2402,2770
050,01,097,"Alabama","Mobile County",2,37,5254,2471,2783
050,01,097,"Alabama","Mobile County",2,38,5236,2493,2743
050,01,097,"Alabama","Mobile County",2,39,5157,2475,2682
050,01,097,"Alabama","Mobile County",2,40,5099,2443,2656
050,01,097,"Alabama","Mobile County",2,41,4931,2358,2573
050,01,097,"Alabama","Mobile County",2,42,4866,2327,2539
050,01,097,"Alabama","Mobile County",2,43,4896,2333,2563
050,01,097,"Alabama","Mobile County",2,44,4689,2209,2480
050,01,097,"Alabama","Mobile County",2,45,4728,2228,2500
050,01,097,"Alabama","Mobile County",2,46,4630,2216,2414
050,01,097,"Alabama","Mobile County",2,47,4711,2274,2437
050,01,097,"Alabama","Mobile County",2,48,4942,2368,2574
050,01,097,"Alabama","Mobile County",2,49,5239,2526,2713
050,01,097,"Alabama","Mobile County",2,50,5069,2410,2659
050,01,097,"Alabama","Mobile County",2,51,4816,2283,2533
050,01,097,"Alabama","Mobile County",2,52,4779,2276,2503
050,01,097,"Alabama","Mobile County",2,53,4927,2346,2581
050,01,097,"Alabama","Mobile County",2,54,5107,2446,2661
050,01,097,"Alabama","Mobile County",2,55,5329,2564,2765
050,01,097,"Alabama","Mobile County",2,56,5544,2685,2859
050,01,097,"Alabama","Mobile County",2,57,5559,2664,2895
050,01,097,"Alabama","Mobile County",2,58,5638,2650,2988
050,01,097,"Alabama","Mobile County",2,59,5636,2631,3005
050,01,097,"Alabama","Mobile County",2,60,5538,2593,2945
050,01,097,"Alabama","Mobile County",2,61,5511,2606,2905
050,01,097,"Alabama","Mobile County",2,62,5506,2616,2890
050,01,097,"Alabama","Mobile County",2,63,5422,2574,2848
050,01,097,"Alabama","Mobile County",2,64,5207,2437,2770
050,01,097,"Alabama","Mobile County",2,65,5010,2363,2647
050,01,097,"Alabama","Mobile County",2,66,4824,2277,2547
050,01,097,"Alabama","Mobile County",2,67,4625,2144,2481
050,01,097,"Alabama","Mobile County",2,68,4509,2111,2398
050,01,097,"Alabama","Mobile County",2,69,4295,2020,2275
050,01,097,"Alabama","Mobile County",2,70,4010,1812,2198
050,01,097,"Alabama","Mobile County",2,71,3930,1757,2173
050,01,097,"Alabama","Mobile County",2,72,3818,1734,2084
050,01,097,"Alabama","Mobile County",2,73,4075,1840,2235
050,01,097,"Alabama","Mobile County",2,74,2905,1287,1618
050,01,097,"Alabama","Mobile County",2,75,2788,1225,1563
050,01,097,"Alabama","Mobile County",2,76,2669,1179,1490
050,01,097,"Alabama","Mobile County",2,77,2672,1164,1508
050,01,097,"Alabama","Mobile County",2,78,2231,949,1282
050,01,097,"Alabama","Mobile County",2,79,1927,828,1099
050,01,097,"Alabama","Mobile County",2,80,1829,737,1092
050,01,097,"Alabama","Mobile County",2,81,1717,699,1018
050,01,097,"Alabama","Mobile County",2,82,1599,656,943
050,01,097,"Alabama","Mobile County",2,83,1363,544,819
050,01,097,"Alabama","Mobile County",2,84,1201,469,732
050,01,097,"Alabama","Mobile County",2,85,6661,2268,4393
050,01,097,"Alabama","Mobile County",3,0,5132,2601,2531
050,01,097,"Alabama","Mobile County",3,1,5212,2699,2513
050,01,097,"Alabama","Mobile County",3,2,5312,2721,2591
050,01,097,"Alabama","Mobile County",3,3,5413,2741,2672
050,01,097,"Alabama","Mobile County",3,4,5346,2720,2626
050,01,097,"Alabama","Mobile County",3,5,5410,2745,2665
050,01,097,"Alabama","Mobile County",3,6,5419,2748,2671
050,01,097,"Alabama","Mobile County",3,7,5341,2660,2681
050,01,097,"Alabama","Mobile County",3,8,5192,2588,2604
050,01,097,"Alabama","Mobile County",3,9,5142,2575,2567
050,01,097,"Alabama","Mobile County",3,10,5231,2666,2565
050,01,097,"Alabama","Mobile County",3,11,5324,2727,2597
050,01,097,"Alabama","Mobile County",3,12,5516,2783,2733
050,01,097,"Alabama","Mobile County",3,13,5709,2893,2816
050,01,097,"Alabama","Mobile County",3,14,5725,2907,2818
050,01,097,"Alabama","Mobile County",3,15,5516,2801,2715
050,01,097,"Alabama","Mobile County",3,16,5405,2756,2649
050,01,097,"Alabama","Mobile County",3,17,5445,2764,2681
050,01,097,"Alabama","Mobile County",3,18,5086,2584,2502
050,01,097,"Alabama","Mobile County",3,19,4772,2411,2361
050,01,097,"Alabama","Mobile County",3,20,5041,2523,2518
050,01,097,"Alabama","Mobile County",3,21,5214,2605,2609
050,01,097,"Alabama","Mobile County",3,22,5199,2528,2671
050,01,097,"Alabama","Mobile County",3,23,5419,2627,2792
050,01,097,"Alabama","Mobile County",3,24,5473,2688,2785
050,01,097,"Alabama","Mobile County",3,25,5395,2670,2725
050,01,097,"Alabama","Mobile County",3,26,5599,2728,2871
050,01,097,"Alabama","Mobile County",3,27,5709,2788,2921
050,01,097,"Alabama","Mobile County",3,28,5781,2787,2994
050,01,097,"Alabama","Mobile County",3,29,5817,2768,3049
050,01,097,"Alabama","Mobile County",3,30,5959,2802,3157
050,01,097,"Alabama","Mobile County",3,31,5915,2797,3118
050,01,097,"Alabama","Mobile County",3,32,5786,2740,3046
050,01,097,"Alabama","Mobile County",3,33,5728,2722,3006
050,01,097,"Alabama","Mobile County",3,34,5519,2617,2902
050,01,097,"Alabama","Mobile County",3,35,5279,2457,2822
050,01,097,"Alabama","Mobile County",3,36,5162,2379,2783
050,01,097,"Alabama","Mobile County",3,37,5154,2387,2767
050,01,097,"Alabama","Mobile County",3,38,5212,2419,2793
050,01,097,"Alabama","Mobile County",3,39,5199,2471,2728
050,01,097,"Alabama","Mobile County",3,40,5136,2453,2683
050,01,097,"Alabama","Mobile County",3,41,5062,2428,2634
050,01,097,"Alabama","Mobile County",3,42,4901,2343,2558
050,01,097,"Alabama","Mobile County",3,43,4875,2325,2550
050,01,097,"Alabama","Mobile County",3,44,4869,2305,2564
050,01,097,"Alabama","Mobile County",3,45,4653,2191,2462
050,01,097,"Alabama","Mobile County",3,46,4693,2185,2508
050,01,097,"Alabama","Mobile County",3,47,4570,2179,2391
050,01,097,"Alabama","Mobile County",3,48,4727,2278,2449
050,01,097,"Alabama","Mobile County",3,49,4922,2343,2579
050,01,097,"Alabama","Mobile County",3,50,5193,2520,2673
050,01,097,"Alabama","Mobile County",3,51,5051,2403,2648
050,01,097,"Alabama","Mobile County",3,52,4783,2273,2510
050,01,097,"Alabama","Mobile County",3,53,4743,2250,2493
050,01,097,"Alabama","Mobile County",3,54,4884,2313,2571
050,01,097,"Alabama","Mobile County",3,55,5062,2417,2645
050,01,097,"Alabama","Mobile County",3,56,5329,2551,2778
050,01,097,"Alabama","Mobile County",3,57,5504,2672,2832
050,01,097,"Alabama","Mobile County",3,58,5499,2629,2870
050,01,097,"Alabama","Mobile County",3,59,5568,2634,2934
050,01,097,"Alabama","Mobile County",3,60,5568,2591,2977
050,01,097,"Alabama","Mobile County",3,61,5447,2517,2930
050,01,097,"Alabama","Mobile County",3,62,5442,2568,2874
050,01,097,"Alabama","Mobile County",3,63,5368,2534,2834
050,01,097,"Alabama","Mobile County",3,64,5331,2521,2810
050,01,097,"Alabama","Mobile County",3,65,5115,2394,2721
050,01,097,"Alabama","Mobile County",3,66,4905,2289,2616
050,01,097,"Alabama","Mobile County",3,67,4703,2204,2499
050,01,097,"Alabama","Mobile County",3,68,4512,2078,2434
050,01,097,"Alabama","Mobile County",3,69,4368,2014,2354
050,01,097,"Alabama","Mobile County",3,70,4210,1957,2253
050,01,097,"Alabama","Mobile County",3,71,3866,1730,2136
050,01,097,"Alabama","Mobile County",3,72,3771,1668,2103
050,01,097,"Alabama","Mobile County",3,73,3676,1668,2008
050,01,097,"Alabama","Mobile County",3,74,3928,1759,2169
050,01,097,"Alabama","Mobile County",3,75,2759,1220,1539
050,01,097,"Alabama","Mobile County",3,76,2662,1155,1507
050,01,097,"Alabama","Mobile County",3,77,2526,1110,1416
050,01,097,"Alabama","Mobile County",3,78,2543,1098,1445
050,01,097,"Alabama","Mobile County",3,79,2089,889,1200
050,01,097,"Alabama","Mobile County",3,80,1816,757,1059
050,01,097,"Alabama","Mobile County",3,81,1692,679,1013
050,01,097,"Alabama","Mobile County",3,82,1584,624,960
050,01,097,"Alabama","Mobile County",3,83,1437,574,863
050,01,097,"Alabama","Mobile County",3,84,1263,490,773
050,01,097,"Alabama","Mobile County",3,85,6570,2264,4306
050,01,097,"Alabama","Mobile County",4,0,4994,2570,2424
050,01,097,"Alabama","Mobile County",4,1,5124,2564,2560
050,01,097,"Alabama","Mobile County",4,2,5168,2670,2498
050,01,097,"Alabama","Mobile County",4,3,5251,2678,2573
050,01,097,"Alabama","Mobile County",4,4,5405,2753,2652
050,01,097,"Alabama","Mobile County",4,5,5312,2688,2624
050,01,097,"Alabama","Mobile County",4,6,5378,2762,2616
050,01,097,"Alabama","Mobile County",4,7,5376,2720,2656
050,01,097,"Alabama","Mobile County",4,8,5323,2639,2684
050,01,097,"Alabama","Mobile County",4,9,5107,2557,2550
050,01,097,"Alabama","Mobile County",4,10,5118,2556,2562
050,01,097,"Alabama","Mobile County",4,11,5235,2664,2571
050,01,097,"Alabama","Mobile County",4,12,5262,2706,2556
050,01,097,"Alabama","Mobile County",4,13,5488,2763,2725
050,01,097,"Alabama","Mobile County",4,14,5719,2922,2797
050,01,097,"Alabama","Mobile County",4,15,5679,2879,2800
050,01,097,"Alabama","Mobile County",4,16,5528,2800,2728
050,01,097,"Alabama","Mobile County",4,17,5415,2755,2660
050,01,097,"Alabama","Mobile County",4,18,5032,2560,2472
050,01,097,"Alabama","Mobile County",4,19,4675,2332,2343
050,01,097,"Alabama","Mobile County",4,20,4887,2453,2434
050,01,097,"Alabama","Mobile County",4,21,5112,2550,2562
050,01,097,"Alabama","Mobile County",4,22,5334,2620,2714
050,01,097,"Alabama","Mobile County",4,23,5362,2655,2707
050,01,097,"Alabama","Mobile County",4,24,5430,2616,2814
050,01,097,"Alabama","Mobile County",4,25,5414,2665,2749
050,01,097,"Alabama","Mobile County",4,26,5357,2644,2713
050,01,097,"Alabama","Mobile County",4,27,5514,2666,2848
050,01,097,"Alabama","Mobile County",4,28,5640,2723,2917
050,01,097,"Alabama","Mobile County",4,29,5731,2786,2945
050,01,097,"Alabama","Mobile County",4,30,5793,2765,3028
050,01,097,"Alabama","Mobile County",4,31,5927,2810,3117
050,01,097,"Alabama","Mobile County",4,32,5797,2715,3082
050,01,097,"Alabama","Mobile County",4,33,5753,2711,3042
050,01,097,"Alabama","Mobile County",4,34,5620,2656,2964
050,01,097,"Alabama","Mobile County",4,35,5513,2632,2881
050,01,097,"Alabama","Mobile County",4,36,5252,2443,2809
050,01,097,"Alabama","Mobile County",4,37,5140,2361,2779
050,01,097,"Alabama","Mobile County",4,38,5094,2360,2734
050,01,097,"Alabama","Mobile County",4,39,5188,2413,2775
050,01,097,"Alabama","Mobile County",4,40,5195,2453,2742
050,01,097,"Alabama","Mobile County",4,41,5089,2462,2627
050,01,097,"Alabama","Mobile County",4,42,5018,2399,2619
050,01,097,"Alabama","Mobile County",4,43,4893,2343,2550
050,01,097,"Alabama","Mobile County",4,44,4828,2296,2532
050,01,097,"Alabama","Mobile County",4,45,4848,2291,2557
050,01,097,"Alabama","Mobile County",4,46,4625,2138,2487
050,01,097,"Alabama","Mobile County",4,47,4605,2142,2463
050,01,097,"Alabama","Mobile County",4,48,4554,2191,2363
050,01,097,"Alabama","Mobile County",4,49,4662,2255,2407
050,01,097,"Alabama","Mobile County",4,50,4835,2305,2530
050,01,097,"Alabama","Mobile County",4,51,5157,2491,2666
050,01,097,"Alabama","Mobile County",4,52,5005,2385,2620
050,01,097,"Alabama","Mobile County",4,53,4733,2245,2488
050,01,097,"Alabama","Mobile County",4,54,4708,2229,2479
050,01,097,"Alabama","Mobile County",4,55,4802,2275,2527
050,01,097,"Alabama","Mobile County",4,56,5057,2419,2638
050,01,097,"Alabama","Mobile County",4,57,5266,2536,2730
050,01,097,"Alabama","Mobile County",4,58,5407,2606,2801
050,01,097,"Alabama","Mobile County",4,59,5415,2590,2825
050,01,097,"Alabama","Mobile County",4,60,5454,2570,2884
050,01,097,"Alabama","Mobile County",4,61,5487,2535,2952
050,01,097,"Alabama","Mobile County",4,62,5372,2482,2890
050,01,097,"Alabama","Mobile County",4,63,5289,2483,2806
050,01,097,"Alabama","Mobile County",4,64,5253,2473,2780
050,01,097,"Alabama","Mobile County",4,65,5196,2449,2747
050,01,097,"Alabama","Mobile County",4,66,5018,2329,2689
050,01,097,"Alabama","Mobile County",4,67,4796,2217,2579
050,01,097,"Alabama","Mobile County",4,68,4566,2122,2444
050,01,097,"Alabama","Mobile County",4,69,4379,1992,2387
050,01,097,"Alabama","Mobile County",4,70,4241,1933,2308
050,01,097,"Alabama","Mobile County",4,71,4106,1903,2203
050,01,097,"Alabama","Mobile County",4,72,3699,1651,2048
050,01,097,"Alabama","Mobile County",4,73,3619,1593,2026
050,01,097,"Alabama","Mobile County",4,74,3537,1600,1937
050,01,097,"Alabama","Mobile County",4,75,3779,1678,2101
050,01,097,"Alabama","Mobile County",4,76,2622,1152,1470
050,01,097,"Alabama","Mobile County",4,77,2547,1090,1457
050,01,097,"Alabama","Mobile County",4,78,2407,1053,1354
050,01,097,"Alabama","Mobile County",4,79,2361,1017,1344
050,01,097,"Alabama","Mobile County",4,80,1944,801,1143
050,01,097,"Alabama","Mobile County",4,81,1698,707,991
050,01,097,"Alabama","Mobile County",4,82,1550,599,951
050,01,097,"Alabama","Mobile County",4,83,1429,543,886
050,01,097,"Alabama","Mobile County",4,84,1327,524,803
050,01,097,"Alabama","Mobile County",4,85,6573,2301,4272
050,01,097,"Alabama","Mobile County",5,0,5018,2578,2440
050,01,097,"Alabama","Mobile County",5,1,5000,2548,2452
050,01,097,"Alabama","Mobile County",5,2,5113,2565,2548
050,01,097,"Alabama","Mobile County",5,3,5174,2667,2507
050,01,097,"Alabama","Mobile County",5,4,5242,2679,2563
050,01,097,"Alabama","Mobile County",5,5,5385,2715,2670
050,01,097,"Alabama","Mobile County",5,6,5289,2710,2579
050,01,097,"Alabama","Mobile County",5,7,5352,2730,2622
050,01,097,"Alabama","Mobile County",5,8,5354,2712,2642
050,01,097,"Alabama","Mobile County",5,9,5280,2618,2662
050,01,097,"Alabama","Mobile County",5,10,5100,2541,2559
050,01,097,"Alabama","Mobile County",5,11,5129,2554,2575
050,01,097,"Alabama","Mobile County",5,12,5217,2652,2565
050,01,097,"Alabama","Mobile County",5,13,5259,2698,2561
050,01,097,"Alabama","Mobile County",5,14,5488,2777,2711
050,01,097,"Alabama","Mobile County",5,15,5683,2896,2787
050,01,097,"Alabama","Mobile County",5,16,5764,2917,2847
050,01,097,"Alabama","Mobile County",5,17,5519,2777,2742
050,01,097,"Alabama","Mobile County",5,18,4989,2550,2439
050,01,097,"Alabama","Mobile County",5,19,4718,2355,2363
050,01,097,"Alabama","Mobile County",5,20,4861,2421,2440
050,01,097,"Alabama","Mobile County",5,21,4975,2524,2451
050,01,097,"Alabama","Mobile County",5,22,5183,2523,2660
050,01,097,"Alabama","Mobile County",5,23,5500,2724,2776
050,01,097,"Alabama","Mobile County",5,24,5455,2672,2783
050,01,097,"Alabama","Mobile County",5,25,5422,2605,2817
050,01,097,"Alabama","Mobile County",5,26,5418,2652,2766
050,01,097,"Alabama","Mobile County",5,27,5324,2629,2695
050,01,097,"Alabama","Mobile County",5,28,5492,2648,2844
050,01,097,"Alabama","Mobile County",5,29,5641,2737,2904
050,01,097,"Alabama","Mobile County",5,30,5646,2730,2916
050,01,097,"Alabama","Mobile County",5,31,5773,2766,3007
050,01,097,"Alabama","Mobile County",5,32,5985,2851,3134
050,01,097,"Alabama","Mobile County",5,33,5786,2722,3064
050,01,097,"Alabama","Mobile County",5,34,5712,2682,3030
050,01,097,"Alabama","Mobile County",5,35,5583,2640,2943
050,01,097,"Alabama","Mobile County",5,36,5495,2612,2883
050,01,097,"Alabama","Mobile County",5,37,5193,2401,2792
050,01,097,"Alabama","Mobile County",5,38,5105,2336,2769
050,01,097,"Alabama","Mobile County",5,39,5088,2358,2730
050,01,097,"Alabama","Mobile County",5,40,5169,2366,2803
050,01,097,"Alabama","Mobile County",5,41,5158,2438,2720
050,01,097,"Alabama","Mobile County",5,42,5103,2457,2646
050,01,097,"Alabama","Mobile County",5,43,5034,2408,2626
050,01,097,"Alabama","Mobile County",5,44,4877,2322,2555
050,01,097,"Alabama","Mobile County",5,45,4840,2306,2534
050,01,097,"Alabama","Mobile County",5,46,4837,2278,2559
050,01,097,"Alabama","Mobile County",5,47,4557,2106,2451
050,01,097,"Alabama","Mobile County",5,48,4590,2137,2453
050,01,097,"Alabama","Mobile County",5,49,4561,2173,2388
050,01,097,"Alabama","Mobile County",5,50,4603,2214,2389
050,01,097,"Alabama","Mobile County",5,51,4844,2302,2542
050,01,097,"Alabama","Mobile County",5,52,5148,2487,2661
050,01,097,"Alabama","Mobile County",5,53,5002,2388,2614
050,01,097,"Alabama","Mobile County",5,54,4689,2209,2480
050,01,097,"Alabama","Mobile County",5,55,4686,2235,2451
050,01,097,"Alabama","Mobile County",5,56,4802,2268,2534
050,01,097,"Alabama","Mobile County",5,57,5028,2388,2640
050,01,097,"Alabama","Mobile County",5,58,5207,2488,2719
050,01,097,"Alabama","Mobile County",5,59,5351,2586,2765
050,01,097,"Alabama","Mobile County",5,60,5323,2540,2783
050,01,097,"Alabama","Mobile County",5,61,5396,2516,2880
050,01,097,"Alabama","Mobile County",5,62,5417,2512,2905
050,01,097,"Alabama","Mobile County",5,63,5277,2429,2848
050,01,097,"Alabama","Mobile County",5,64,5212,2447,2765
050,01,097,"Alabama","Mobile County",5,65,5165,2422,2743
050,01,097,"Alabama","Mobile County",5,66,5110,2383,2727
050,01,097,"Alabama","Mobile County",5,67,4912,2260,2652
050,01,097,"Alabama","Mobile County",5,68,4680,2156,2524
050,01,097,"Alabama","Mobile County",5,69,4479,2056,2423
050,01,097,"Alabama","Mobile County",5,70,4292,1934,2358
050,01,097,"Alabama","Mobile County",5,71,4143,1871,2272
050,01,097,"Alabama","Mobile County",5,72,3961,1832,2129
050,01,097,"Alabama","Mobile County",5,73,3601,1605,1996
050,01,097,"Alabama","Mobile County",5,74,3513,1535,1978
050,01,097,"Alabama","Mobile County",5,75,3391,1518,1873
050,01,097,"Alabama","Mobile County",5,76,3613,1588,2025
050,01,097,"Alabama","Mobile County",5,77,2507,1095,1412
050,01,097,"Alabama","Mobile County",5,78,2450,1057,1393
050,01,097,"Alabama","Mobile County",5,79,2264,998,1266
050,01,097,"Alabama","Mobile County",5,80,2218,939,1279
050,01,097,"Alabama","Mobile County",5,81,1821,749,1072
050,01,097,"Alabama","Mobile County",5,82,1574,640,934
050,01,097,"Alabama","Mobile County",5,83,1427,527,900
050,01,097,"Alabama","Mobile County",5,84,1335,497,838
050,01,097,"Alabama","Mobile County",5,85,6763,2428,4335
050,01,099,"Alabama","Monroe County",1,0,174,89,85
050,01,099,"Alabama","Monroe County",1,1,185,103,82
050,01,099,"Alabama","Monroe County",1,2,197,112,85
050,01,099,"Alabama","Monroe County",1,3,217,115,102
050,01,099,"Alabama","Monroe County",1,4,199,98,101
050,01,099,"Alabama","Monroe County",1,5,205,99,106
050,01,099,"Alabama","Monroe County",1,6,208,109,99
050,01,099,"Alabama","Monroe County",1,7,218,110,108
050,01,099,"Alabama","Monroe County",1,8,223,116,107
050,01,099,"Alabama","Monroe County",1,9,236,125,111
050,01,099,"Alabama","Monroe County",1,10,233,124,109
050,01,099,"Alabama","Monroe County",1,11,252,129,123
050,01,099,"Alabama","Monroe County",1,12,266,135,131
050,01,099,"Alabama","Monroe County",1,13,268,142,126
050,01,099,"Alabama","Monroe County",1,14,262,140,122
050,01,099,"Alabama","Monroe County",1,15,282,152,130
050,01,099,"Alabama","Monroe County",1,16,270,138,132
050,01,099,"Alabama","Monroe County",1,17,268,132,136
050,01,099,"Alabama","Monroe County",1,18,234,119,115
050,01,099,"Alabama","Monroe County",1,19,214,118,96
050,01,099,"Alabama","Monroe County",1,20,241,127,114
050,01,099,"Alabama","Monroe County",1,21,236,122,114
050,01,099,"Alabama","Monroe County",1,22,246,125,121
050,01,099,"Alabama","Monroe County",1,23,253,113,140
050,01,099,"Alabama","Monroe County",1,24,223,115,108
050,01,099,"Alabama","Monroe County",1,25,214,118,96
050,01,099,"Alabama","Monroe County",1,26,240,117,123
050,01,099,"Alabama","Monroe County",1,27,237,110,127
050,01,099,"Alabama","Monroe County",1,28,234,116,118
050,01,099,"Alabama","Monroe County",1,29,238,107,131
050,01,099,"Alabama","Monroe County",1,30,210,101,109
050,01,099,"Alabama","Monroe County",1,31,192,91,101
050,01,099,"Alabama","Monroe County",1,32,185,88,97
050,01,099,"Alabama","Monroe County",1,33,193,96,97
050,01,099,"Alabama","Monroe County",1,34,184,81,103
050,01,099,"Alabama","Monroe County",1,35,205,84,121
050,01,099,"Alabama","Monroe County",1,36,203,91,112
050,01,099,"Alabama","Monroe County",1,37,207,93,114
050,01,099,"Alabama","Monroe County",1,38,210,101,109
050,01,099,"Alabama","Monroe County",1,39,234,114,120
050,01,099,"Alabama","Monroe County",1,40,224,95,129
050,01,099,"Alabama","Monroe County",1,41,220,96,124
050,01,099,"Alabama","Monroe County",1,42,221,92,129
050,01,099,"Alabama","Monroe County",1,43,223,108,115
050,01,099,"Alabama","Monroe County",1,44,221,108,113
050,01,099,"Alabama","Monroe County",1,45,228,104,124
050,01,099,"Alabama","Monroe County",1,46,246,102,144
050,01,099,"Alabama","Monroe County",1,47,264,119,145
050,01,099,"Alabama","Monroe County",1,48,269,139,130
050,01,099,"Alabama","Monroe County",1,49,273,133,140
050,01,099,"Alabama","Monroe County",1,50,245,128,117
050,01,099,"Alabama","Monroe County",1,51,234,108,126
050,01,099,"Alabama","Monroe County",1,52,253,103,150
050,01,099,"Alabama","Monroe County",1,53,266,114,152
050,01,099,"Alabama","Monroe County",1,54,269,131,138
050,01,099,"Alabama","Monroe County",1,55,293,155,138
050,01,099,"Alabama","Monroe County",1,56,300,153,147
050,01,099,"Alabama","Monroe County",1,57,290,144,146
050,01,099,"Alabama","Monroe County",1,58,304,142,162
050,01,099,"Alabama","Monroe County",1,59,290,140,150
050,01,099,"Alabama","Monroe County",1,60,311,142,169
050,01,099,"Alabama","Monroe County",1,61,323,143,180
050,01,099,"Alabama","Monroe County",1,62,299,150,149
050,01,099,"Alabama","Monroe County",1,63,287,145,142
050,01,099,"Alabama","Monroe County",1,64,302,147,155
050,01,099,"Alabama","Monroe County",1,65,302,142,160
050,01,099,"Alabama","Monroe County",1,66,301,141,160
050,01,099,"Alabama","Monroe County",1,67,275,121,154
050,01,099,"Alabama","Monroe County",1,68,265,113,152
050,01,099,"Alabama","Monroe County",1,69,231,103,128
050,01,099,"Alabama","Monroe County",1,70,223,106,117
050,01,099,"Alabama","Monroe County",1,71,225,108,117
050,01,099,"Alabama","Monroe County",1,72,225,117,108
050,01,099,"Alabama","Monroe County",1,73,209,105,104
050,01,099,"Alabama","Monroe County",1,74,168,75,93
050,01,099,"Alabama","Monroe County",1,75,166,82,84
050,01,099,"Alabama","Monroe County",1,76,181,81,100
050,01,099,"Alabama","Monroe County",1,77,168,62,106
050,01,099,"Alabama","Monroe County",1,78,151,70,81
050,01,099,"Alabama","Monroe County",1,79,116,55,61
050,01,099,"Alabama","Monroe County",1,80,109,42,67
050,01,099,"Alabama","Monroe County",1,81,108,47,61
050,01,099,"Alabama","Monroe County",1,82,75,32,43
050,01,099,"Alabama","Monroe County",1,83,83,32,51
050,01,099,"Alabama","Monroe County",1,84,83,30,53
050,01,099,"Alabama","Monroe County",1,85,456,146,310
050,01,099,"Alabama","Monroe County",2,0,171,87,84
050,01,099,"Alabama","Monroe County",2,1,184,101,83
050,01,099,"Alabama","Monroe County",2,2,196,111,85
050,01,099,"Alabama","Monroe County",2,3,210,112,98
050,01,099,"Alabama","Monroe County",2,4,203,102,101
050,01,099,"Alabama","Monroe County",2,5,204,100,104
050,01,099,"Alabama","Monroe County",2,6,210,108,102
050,01,099,"Alabama","Monroe County",2,7,218,112,106
050,01,099,"Alabama","Monroe County",2,8,222,114,108
050,01,099,"Alabama","Monroe County",2,9,231,122,109
050,01,099,"Alabama","Monroe County",2,10,234,123,111
050,01,099,"Alabama","Monroe County",2,11,245,127,118
050,01,099,"Alabama","Monroe County",2,12,263,134,129
050,01,099,"Alabama","Monroe County",2,13,266,139,127
050,01,099,"Alabama","Monroe County",2,14,262,140,122
050,01,099,"Alabama","Monroe County",2,15,274,147,127
050,01,099,"Alabama","Monroe County",2,16,273,142,131
050,01,099,"Alabama","Monroe County",2,17,264,132,132
050,01,099,"Alabama","Monroe County",2,18,232,118,114
050,01,099,"Alabama","Monroe County",2,19,213,115,98
050,01,099,"Alabama","Monroe County",2,20,236,124,112
050,01,099,"Alabama","Monroe County",2,21,239,124,115
050,01,099,"Alabama","Monroe County",2,22,251,127,124
050,01,099,"Alabama","Monroe County",2,23,253,117,136
050,01,099,"Alabama","Monroe County",2,24,230,114,116
050,01,099,"Alabama","Monroe County",2,25,216,116,100
050,01,099,"Alabama","Monroe County",2,26,234,116,118
050,01,099,"Alabama","Monroe County",2,27,240,113,127
050,01,099,"Alabama","Monroe County",2,28,232,113,119
050,01,099,"Alabama","Monroe County",2,29,234,106,128
050,01,099,"Alabama","Monroe County",2,30,218,103,115
050,01,099,"Alabama","Monroe County",2,31,198,95,103
050,01,099,"Alabama","Monroe County",2,32,182,86,96
050,01,099,"Alabama","Monroe County",2,33,188,93,95
050,01,099,"Alabama","Monroe County",2,34,185,83,102
050,01,099,"Alabama","Monroe County",2,35,199,83,116
050,01,099,"Alabama","Monroe County",2,36,204,89,115
050,01,099,"Alabama","Monroe County",2,37,209,93,116
050,01,099,"Alabama","Monroe County",2,38,211,100,111
050,01,099,"Alabama","Monroe County",2,39,227,111,116
050,01,099,"Alabama","Monroe County",2,40,225,100,125
050,01,099,"Alabama","Monroe County",2,41,217,93,124
050,01,099,"Alabama","Monroe County",2,42,217,92,125
050,01,099,"Alabama","Monroe County",2,43,224,105,119
050,01,099,"Alabama","Monroe County",2,44,218,106,112
050,01,099,"Alabama","Monroe County",2,45,229,105,124
050,01,099,"Alabama","Monroe County",2,46,240,101,139
050,01,099,"Alabama","Monroe County",2,47,259,114,145
050,01,099,"Alabama","Monroe County",2,48,269,135,134
050,01,099,"Alabama","Monroe County",2,49,272,135,137
050,01,099,"Alabama","Monroe County",2,50,250,129,121
050,01,099,"Alabama","Monroe County",2,51,233,111,122
050,01,099,"Alabama","Monroe County",2,52,245,103,142
050,01,099,"Alabama","Monroe County",2,53,262,111,151
050,01,099,"Alabama","Monroe County",2,54,266,126,140
050,01,099,"Alabama","Monroe County",2,55,289,151,138
050,01,099,"Alabama","Monroe County",2,56,297,152,145
050,01,099,"Alabama","Monroe County",2,57,293,147,146
050,01,099,"Alabama","Monroe County",2,58,294,141,153
050,01,099,"Alabama","Monroe County",2,59,295,142,153
050,01,099,"Alabama","Monroe County",2,60,305,141,164
050,01,099,"Alabama","Monroe County",2,61,317,142,175
050,01,099,"Alabama","Monroe County",2,62,306,149,157
050,01,099,"Alabama","Monroe County",2,63,290,146,144
050,01,099,"Alabama","Monroe County",2,64,296,146,150
050,01,099,"Alabama","Monroe County",2,65,300,142,158
050,01,099,"Alabama","Monroe County",2,66,302,141,161
050,01,099,"Alabama","Monroe County",2,67,279,125,154
050,01,099,"Alabama","Monroe County",2,68,266,113,153
050,01,099,"Alabama","Monroe County",2,69,237,106,131
050,01,099,"Alabama","Monroe County",2,70,224,104,120
050,01,099,"Alabama","Monroe County",2,71,225,108,117
050,01,099,"Alabama","Monroe County",2,72,221,115,106
050,01,099,"Alabama","Monroe County",2,73,221,111,110
050,01,099,"Alabama","Monroe County",2,74,166,77,89
050,01,099,"Alabama","Monroe County",2,75,168,81,87
050,01,099,"Alabama","Monroe County",2,76,175,80,95
050,01,099,"Alabama","Monroe County",2,77,173,66,107
050,01,099,"Alabama","Monroe County",2,78,150,67,83
050,01,099,"Alabama","Monroe County",2,79,120,55,65
050,01,099,"Alabama","Monroe County",2,80,106,43,63
050,01,099,"Alabama","Monroe County",2,81,105,45,60
050,01,099,"Alabama","Monroe County",2,82,83,36,47
050,01,099,"Alabama","Monroe County",2,83,76,29,47
050,01,099,"Alabama","Monroe County",2,84,82,29,53
050,01,099,"Alabama","Monroe County",2,85,458,146,312
050,01,099,"Alabama","Monroe County",3,0,211,103,108
050,01,099,"Alabama","Monroe County",3,1,174,90,84
050,01,099,"Alabama","Monroe County",3,2,189,103,86
050,01,099,"Alabama","Monroe County",3,3,195,118,77
050,01,099,"Alabama","Monroe County",3,4,207,112,95
050,01,099,"Alabama","Monroe County",3,5,206,104,102
050,01,099,"Alabama","Monroe County",3,6,214,101,113
050,01,099,"Alabama","Monroe County",3,7,212,105,107
050,01,099,"Alabama","Monroe County",3,8,225,113,112
050,01,099,"Alabama","Monroe County",3,9,219,109,110
050,01,099,"Alabama","Monroe County",3,10,229,121,108
050,01,099,"Alabama","Monroe County",3,11,246,130,116
050,01,099,"Alabama","Monroe County",3,12,243,128,115
050,01,099,"Alabama","Monroe County",3,13,248,127,121
050,01,099,"Alabama","Monroe County",3,14,259,135,124
050,01,099,"Alabama","Monroe County",3,15,254,138,116
050,01,099,"Alabama","Monroe County",3,16,282,154,128
050,01,099,"Alabama","Monroe County",3,17,270,144,126
050,01,099,"Alabama","Monroe County",3,18,227,122,105
050,01,099,"Alabama","Monroe County",3,19,201,104,97
050,01,099,"Alabama","Monroe County",3,20,216,110,106
050,01,099,"Alabama","Monroe County",3,21,244,125,119
050,01,099,"Alabama","Monroe County",3,22,253,125,128
050,01,099,"Alabama","Monroe County",3,23,248,126,122
050,01,099,"Alabama","Monroe County",3,24,230,108,122
050,01,099,"Alabama","Monroe County",3,25,235,119,116
050,01,099,"Alabama","Monroe County",3,26,222,117,105
050,01,099,"Alabama","Monroe County",3,27,233,115,118
050,01,099,"Alabama","Monroe County",3,28,234,106,128
050,01,099,"Alabama","Monroe County",3,29,238,121,117
050,01,099,"Alabama","Monroe County",3,30,236,102,134
050,01,099,"Alabama","Monroe County",3,31,223,111,112
050,01,099,"Alabama","Monroe County",3,32,200,95,105
050,01,099,"Alabama","Monroe County",3,33,182,83,99
050,01,099,"Alabama","Monroe County",3,34,184,93,91
050,01,099,"Alabama","Monroe County",3,35,173,75,98
050,01,099,"Alabama","Monroe County",3,36,197,82,115
050,01,099,"Alabama","Monroe County",3,37,198,84,114
050,01,099,"Alabama","Monroe County",3,38,215,100,115
050,01,099,"Alabama","Monroe County",3,39,207,97,110
050,01,099,"Alabama","Monroe County",3,40,225,109,116
050,01,099,"Alabama","Monroe County",3,41,228,101,127
050,01,099,"Alabama","Monroe County",3,42,225,100,125
050,01,099,"Alabama","Monroe County",3,43,216,92,124
050,01,099,"Alabama","Monroe County",3,44,220,101,119
050,01,099,"Alabama","Monroe County",3,45,224,114,110
050,01,099,"Alabama","Monroe County",3,46,220,102,118
050,01,099,"Alabama","Monroe County",3,47,239,99,140
050,01,099,"Alabama","Monroe County",3,48,250,112,138
050,01,099,"Alabama","Monroe County",3,49,274,139,135
050,01,099,"Alabama","Monroe County",3,50,267,128,139
050,01,099,"Alabama","Monroe County",3,51,251,132,119
050,01,099,"Alabama","Monroe County",3,52,234,112,122
050,01,099,"Alabama","Monroe County",3,53,249,105,144
050,01,099,"Alabama","Monroe County",3,54,262,113,149
050,01,099,"Alabama","Monroe County",3,55,269,127,142
050,01,099,"Alabama","Monroe County",3,56,281,145,136
050,01,099,"Alabama","Monroe County",3,57,297,156,141
050,01,099,"Alabama","Monroe County",3,58,294,147,147
050,01,099,"Alabama","Monroe County",3,59,289,141,148
050,01,099,"Alabama","Monroe County",3,60,288,141,147
050,01,099,"Alabama","Monroe County",3,61,295,135,160
050,01,099,"Alabama","Monroe County",3,62,308,143,165
050,01,099,"Alabama","Monroe County",3,63,310,146,164
050,01,099,"Alabama","Monroe County",3,64,270,137,133
050,01,099,"Alabama","Monroe County",3,65,291,140,151
050,01,099,"Alabama","Monroe County",3,66,306,144,162
050,01,099,"Alabama","Monroe County",3,67,299,138,161
050,01,099,"Alabama","Monroe County",3,68,274,123,151
050,01,099,"Alabama","Monroe County",3,69,258,112,146
050,01,099,"Alabama","Monroe County",3,70,223,97,126
050,01,099,"Alabama","Monroe County",3,71,213,99,114
050,01,099,"Alabama","Monroe County",3,72,221,107,114
050,01,099,"Alabama","Monroe County",3,73,216,112,104
050,01,099,"Alabama","Monroe County",3,74,204,100,104
050,01,099,"Alabama","Monroe County",3,75,159,73,86
050,01,099,"Alabama","Monroe County",3,76,156,73,83
050,01,099,"Alabama","Monroe County",3,77,165,75,90
050,01,099,"Alabama","Monroe County",3,78,165,66,99
050,01,099,"Alabama","Monroe County",3,79,145,61,84
050,01,099,"Alabama","Monroe County",3,80,111,51,60
050,01,099,"Alabama","Monroe County",3,81,98,40,58
050,01,099,"Alabama","Monroe County",3,82,97,40,57
050,01,099,"Alabama","Monroe County",3,83,77,35,42
050,01,099,"Alabama","Monroe County",3,84,70,25,45
050,01,099,"Alabama","Monroe County",3,85,438,142,296
050,01,099,"Alabama","Monroe County",4,0,229,115,114
050,01,099,"Alabama","Monroe County",4,1,203,98,105
050,01,099,"Alabama","Monroe County",4,2,190,101,89
050,01,099,"Alabama","Monroe County",4,3,199,110,89
050,01,099,"Alabama","Monroe County",4,4,200,114,86
050,01,099,"Alabama","Monroe County",4,5,228,127,101
050,01,099,"Alabama","Monroe County",4,6,206,101,105
050,01,099,"Alabama","Monroe County",4,7,213,99,114
050,01,099,"Alabama","Monroe County",4,8,216,106,110
050,01,099,"Alabama","Monroe County",4,9,217,109,108
050,01,099,"Alabama","Monroe County",4,10,221,112,109
050,01,099,"Alabama","Monroe County",4,11,229,119,110
050,01,099,"Alabama","Monroe County",4,12,239,124,115
050,01,099,"Alabama","Monroe County",4,13,241,126,115
050,01,099,"Alabama","Monroe County",4,14,255,130,125
050,01,099,"Alabama","Monroe County",4,15,259,132,127
050,01,099,"Alabama","Monroe County",4,16,260,138,122
050,01,099,"Alabama","Monroe County",4,17,277,154,123
050,01,099,"Alabama","Monroe County",4,18,232,124,108
050,01,099,"Alabama","Monroe County",4,19,192,103,89
050,01,099,"Alabama","Monroe County",4,20,210,105,105
050,01,099,"Alabama","Monroe County",4,21,222,112,110
050,01,099,"Alabama","Monroe County",4,22,254,128,126
050,01,099,"Alabama","Monroe County",4,23,258,123,135
050,01,099,"Alabama","Monroe County",4,24,237,123,114
050,01,099,"Alabama","Monroe County",4,25,231,107,124
050,01,099,"Alabama","Monroe County",4,26,213,108,105
050,01,099,"Alabama","Monroe County",4,27,216,115,101
050,01,099,"Alabama","Monroe County",4,28,239,114,125
050,01,099,"Alabama","Monroe County",4,29,240,106,134
050,01,099,"Alabama","Monroe County",4,30,233,121,112
050,01,099,"Alabama","Monroe County",4,31,241,106,135
050,01,099,"Alabama","Monroe County",4,32,211,102,109
050,01,099,"Alabama","Monroe County",4,33,215,101,114
050,01,099,"Alabama","Monroe County",4,34,166,75,91
050,01,099,"Alabama","Monroe County",4,35,190,97,93
050,01,099,"Alabama","Monroe County",4,36,173,72,101
050,01,099,"Alabama","Monroe County",4,37,199,82,117
050,01,099,"Alabama","Monroe County",4,38,199,82,117
050,01,099,"Alabama","Monroe County",4,39,207,95,112
050,01,099,"Alabama","Monroe County",4,40,194,89,105
050,01,099,"Alabama","Monroe County",4,41,222,107,115
050,01,099,"Alabama","Monroe County",4,42,222,94,128
050,01,099,"Alabama","Monroe County",4,43,223,100,123
050,01,099,"Alabama","Monroe County",4,44,224,96,128
050,01,099,"Alabama","Monroe County",4,45,225,102,123
050,01,099,"Alabama","Monroe County",4,46,226,117,109
050,01,099,"Alabama","Monroe County",4,47,217,100,117
050,01,099,"Alabama","Monroe County",4,48,237,100,137
050,01,099,"Alabama","Monroe County",4,49,253,113,140
050,01,099,"Alabama","Monroe County",4,50,265,131,134
050,01,099,"Alabama","Monroe County",4,51,260,125,135
050,01,099,"Alabama","Monroe County",4,52,243,124,119
050,01,099,"Alabama","Monroe County",4,53,230,109,121
050,01,099,"Alabama","Monroe County",4,54,249,109,140
050,01,099,"Alabama","Monroe County",4,55,262,111,151
050,01,099,"Alabama","Monroe County",4,56,262,120,142
050,01,099,"Alabama","Monroe County",4,57,285,147,138
050,01,099,"Alabama","Monroe County",4,58,299,152,147
050,01,099,"Alabama","Monroe County",4,59,278,138,140
050,01,099,"Alabama","Monroe County",4,60,281,132,149
050,01,099,"Alabama","Monroe County",4,61,278,135,143
050,01,099,"Alabama","Monroe County",4,62,291,132,159
050,01,099,"Alabama","Monroe County",4,63,299,139,160
050,01,099,"Alabama","Monroe County",4,64,307,151,156
050,01,099,"Alabama","Monroe County",4,65,256,134,122
050,01,099,"Alabama","Monroe County",4,66,293,142,151
050,01,099,"Alabama","Monroe County",4,67,295,139,156
050,01,099,"Alabama","Monroe County",4,68,291,133,158
050,01,099,"Alabama","Monroe County",4,69,267,122,145
050,01,099,"Alabama","Monroe County",4,70,247,102,145
050,01,099,"Alabama","Monroe County",4,71,217,94,123
050,01,099,"Alabama","Monroe County",4,72,211,98,113
050,01,099,"Alabama","Monroe County",4,73,218,104,114
050,01,099,"Alabama","Monroe County",4,74,211,109,102
050,01,099,"Alabama","Monroe County",4,75,196,98,98
050,01,099,"Alabama","Monroe County",4,76,146,62,84
050,01,099,"Alabama","Monroe County",4,77,148,69,79
050,01,099,"Alabama","Monroe County",4,78,160,74,86
050,01,099,"Alabama","Monroe County",4,79,153,60,93
050,01,099,"Alabama","Monroe County",4,80,133,54,79
050,01,099,"Alabama","Monroe County",4,81,102,46,56
050,01,099,"Alabama","Monroe County",4,82,87,31,56
050,01,099,"Alabama","Monroe County",4,83,90,38,52
050,01,099,"Alabama","Monroe County",4,84,70,28,42
050,01,099,"Alabama","Monroe County",4,85,429,147,282
050,01,099,"Alabama","Monroe County",5,0,227,115,112
050,01,099,"Alabama","Monroe County",5,1,233,112,121
050,01,099,"Alabama","Monroe County",5,2,198,97,101
050,01,099,"Alabama","Monroe County",5,3,192,105,87
050,01,099,"Alabama","Monroe County",5,4,208,112,96
050,01,099,"Alabama","Monroe County",5,5,197,110,87
050,01,099,"Alabama","Monroe County",5,6,221,123,98
050,01,099,"Alabama","Monroe County",5,7,211,105,106
050,01,099,"Alabama","Monroe County",5,8,211,99,112
050,01,099,"Alabama","Monroe County",5,9,215,106,109
050,01,099,"Alabama","Monroe County",5,10,215,105,110
050,01,099,"Alabama","Monroe County",5,11,226,113,113
050,01,099,"Alabama","Monroe County",5,12,236,118,118
050,01,099,"Alabama","Monroe County",5,13,239,129,110
050,01,099,"Alabama","Monroe County",5,14,253,137,116
050,01,099,"Alabama","Monroe County",5,15,262,138,124
050,01,099,"Alabama","Monroe County",5,16,257,136,121
050,01,099,"Alabama","Monroe County",5,17,253,134,119
050,01,099,"Alabama","Monroe County",5,18,236,139,97
050,01,099,"Alabama","Monroe County",5,19,187,101,86
050,01,099,"Alabama","Monroe County",5,20,192,96,96
050,01,099,"Alabama","Monroe County",5,21,216,111,105
050,01,099,"Alabama","Monroe County",5,22,225,110,115
050,01,099,"Alabama","Monroe County",5,23,245,123,122
050,01,099,"Alabama","Monroe County",5,24,241,123,118
050,01,099,"Alabama","Monroe County",5,25,224,109,115
050,01,099,"Alabama","Monroe County",5,26,223,93,130
050,01,099,"Alabama","Monroe County",5,27,219,114,105
050,01,099,"Alabama","Monroe County",5,28,218,115,103
050,01,099,"Alabama","Monroe County",5,29,240,117,123
050,01,099,"Alabama","Monroe County",5,30,227,106,121
050,01,099,"Alabama","Monroe County",5,31,236,126,110
050,01,099,"Alabama","Monroe County",5,32,240,103,137
050,01,099,"Alabama","Monroe County",5,33,214,98,116
050,01,099,"Alabama","Monroe County",5,34,204,99,105
050,01,099,"Alabama","Monroe County",5,35,166,75,91
050,01,099,"Alabama","Monroe County",5,36,195,99,96
050,01,099,"Alabama","Monroe County",5,37,172,70,102
050,01,099,"Alabama","Monroe County",5,38,187,76,111
050,01,099,"Alabama","Monroe County",5,39,200,81,119
050,01,099,"Alabama","Monroe County",5,40,203,94,109
050,01,099,"Alabama","Monroe County",5,41,193,88,105
050,01,099,"Alabama","Monroe County",5,42,215,103,112
050,01,099,"Alabama","Monroe County",5,43,218,94,124
050,01,099,"Alabama","Monroe County",5,44,223,103,120
050,01,099,"Alabama","Monroe County",5,45,222,97,125
050,01,099,"Alabama","Monroe County",5,46,218,98,120
050,01,099,"Alabama","Monroe County",5,47,228,114,114
050,01,099,"Alabama","Monroe County",5,48,214,99,115
050,01,099,"Alabama","Monroe County",5,49,244,104,140
050,01,099,"Alabama","Monroe County",5,50,253,114,139
050,01,099,"Alabama","Monroe County",5,51,255,131,124
050,01,099,"Alabama","Monroe County",5,52,259,117,142
050,01,099,"Alabama","Monroe County",5,53,241,125,116
050,01,099,"Alabama","Monroe County",5,54,225,106,119
050,01,099,"Alabama","Monroe County",5,55,253,113,140
050,01,099,"Alabama","Monroe County",5,56,258,106,152
050,01,099,"Alabama","Monroe County",5,57,257,121,136
050,01,099,"Alabama","Monroe County",5,58,290,146,144
050,01,099,"Alabama","Monroe County",5,59,291,149,142
050,01,099,"Alabama","Monroe County",5,60,279,143,136
050,01,099,"Alabama","Monroe County",5,61,277,126,151
050,01,099,"Alabama","Monroe County",5,62,277,135,142
050,01,099,"Alabama","Monroe County",5,63,283,125,158
050,01,099,"Alabama","Monroe County",5,64,296,137,159
050,01,099,"Alabama","Monroe County",5,65,295,145,150
050,01,099,"Alabama","Monroe County",5,66,246,130,116
050,01,099,"Alabama","Monroe County",5,67,284,140,144
050,01,099,"Alabama","Monroe County",5,68,290,135,155
050,01,099,"Alabama","Monroe County",5,69,285,132,153
050,01,099,"Alabama","Monroe County",5,70,264,121,143
050,01,099,"Alabama","Monroe County",5,71,235,98,137
050,01,099,"Alabama","Monroe County",5,72,215,93,122
050,01,099,"Alabama","Monroe County",5,73,203,94,109
050,01,099,"Alabama","Monroe County",5,74,209,98,111
050,01,099,"Alabama","Monroe County",5,75,208,108,100
050,01,099,"Alabama","Monroe County",5,76,179,87,92
050,01,099,"Alabama","Monroe County",5,77,137,58,79
050,01,099,"Alabama","Monroe County",5,78,145,69,76
050,01,099,"Alabama","Monroe County",5,79,150,65,85
050,01,099,"Alabama","Monroe County",5,80,144,57,87
050,01,099,"Alabama","Monroe County",5,81,122,50,72
050,01,099,"Alabama","Monroe County",5,82,95,40,55
050,01,099,"Alabama","Monroe County",5,83,83,31,52
050,01,099,"Alabama","Monroe County",5,84,82,31,51
050,01,099,"Alabama","Monroe County",5,85,425,153,272
050,01,101,"Alabama","Montgomery County",1,0,3116,1588,1528
050,01,101,"Alabama","Montgomery County",1,1,3128,1589,1539
050,01,101,"Alabama","Montgomery County",1,2,3134,1566,1568
050,01,101,"Alabama","Montgomery County",1,3,3135,1560,1575
050,01,101,"Alabama","Montgomery County",1,4,3116,1582,1534
050,01,101,"Alabama","Montgomery County",1,5,3148,1640,1508
050,01,101,"Alabama","Montgomery County",1,6,3049,1538,1511
050,01,101,"Alabama","Montgomery County",1,7,2992,1531,1461
050,01,101,"Alabama","Montgomery County",1,8,2972,1537,1435
050,01,101,"Alabama","Montgomery County",1,9,2977,1510,1467
050,01,101,"Alabama","Montgomery County",1,10,3042,1533,1509
050,01,101,"Alabama","Montgomery County",1,11,3140,1553,1587
050,01,101,"Alabama","Montgomery County",1,12,3215,1608,1607
050,01,101,"Alabama","Montgomery County",1,13,3118,1602,1516
050,01,101,"Alabama","Montgomery County",1,14,2947,1491,1456
050,01,101,"Alabama","Montgomery County",1,15,2915,1489,1426
050,01,101,"Alabama","Montgomery County",1,16,2968,1523,1445
050,01,101,"Alabama","Montgomery County",1,17,2954,1512,1442
050,01,101,"Alabama","Montgomery County",1,18,2992,1569,1423
050,01,101,"Alabama","Montgomery County",1,19,3197,1692,1505
050,01,101,"Alabama","Montgomery County",1,20,3143,1563,1580
050,01,101,"Alabama","Montgomery County",1,21,3153,1575,1578
050,01,101,"Alabama","Montgomery County",1,22,3066,1458,1608
050,01,101,"Alabama","Montgomery County",1,23,3116,1506,1610
050,01,101,"Alabama","Montgomery County",1,24,3070,1420,1650
050,01,101,"Alabama","Montgomery County",1,25,3072,1451,1621
050,01,101,"Alabama","Montgomery County",1,26,3114,1512,1602
050,01,101,"Alabama","Montgomery County",1,27,3268,1584,1684
050,01,101,"Alabama","Montgomery County",1,28,3376,1620,1756
050,01,101,"Alabama","Montgomery County",1,29,3391,1609,1782
050,01,101,"Alabama","Montgomery County",1,30,3449,1634,1815
050,01,101,"Alabama","Montgomery County",1,31,3307,1554,1753
050,01,101,"Alabama","Montgomery County",1,32,3149,1467,1682
050,01,101,"Alabama","Montgomery County",1,33,3121,1489,1632
050,01,101,"Alabama","Montgomery County",1,34,3054,1454,1600
050,01,101,"Alabama","Montgomery County",1,35,3038,1386,1652
050,01,101,"Alabama","Montgomery County",1,36,3066,1466,1600
050,01,101,"Alabama","Montgomery County",1,37,2943,1390,1553
050,01,101,"Alabama","Montgomery County",1,38,3064,1445,1619
050,01,101,"Alabama","Montgomery County",1,39,3016,1406,1610
050,01,101,"Alabama","Montgomery County",1,40,2846,1311,1535
050,01,101,"Alabama","Montgomery County",1,41,2814,1321,1493
050,01,101,"Alabama","Montgomery County",1,42,2730,1270,1460
050,01,101,"Alabama","Montgomery County",1,43,2630,1227,1403
050,01,101,"Alabama","Montgomery County",1,44,2576,1193,1383
050,01,101,"Alabama","Montgomery County",1,45,2621,1192,1429
050,01,101,"Alabama","Montgomery County",1,46,2614,1186,1428
050,01,101,"Alabama","Montgomery County",1,47,2754,1286,1468
050,01,101,"Alabama","Montgomery County",1,48,2785,1306,1479
050,01,101,"Alabama","Montgomery County",1,49,2943,1386,1557
050,01,101,"Alabama","Montgomery County",1,50,2789,1267,1522
050,01,101,"Alabama","Montgomery County",1,51,2655,1233,1422
050,01,101,"Alabama","Montgomery County",1,52,2591,1260,1331
050,01,101,"Alabama","Montgomery County",1,53,2540,1225,1315
050,01,101,"Alabama","Montgomery County",1,54,2758,1322,1436
050,01,101,"Alabama","Montgomery County",1,55,2846,1315,1531
050,01,101,"Alabama","Montgomery County",1,56,2907,1320,1587
050,01,101,"Alabama","Montgomery County",1,57,3010,1414,1596
050,01,101,"Alabama","Montgomery County",1,58,2938,1353,1585
050,01,101,"Alabama","Montgomery County",1,59,2866,1311,1555
050,01,101,"Alabama","Montgomery County",1,60,2893,1320,1573
050,01,101,"Alabama","Montgomery County",1,61,2813,1256,1557
050,01,101,"Alabama","Montgomery County",1,62,2863,1332,1531
050,01,101,"Alabama","Montgomery County",1,63,2795,1248,1547
050,01,101,"Alabama","Montgomery County",1,64,2733,1201,1532
050,01,101,"Alabama","Montgomery County",1,65,2659,1171,1488
050,01,101,"Alabama","Montgomery County",1,66,2544,1087,1457
050,01,101,"Alabama","Montgomery County",1,67,2515,1090,1425
050,01,101,"Alabama","Montgomery County",1,68,2382,1031,1351
050,01,101,"Alabama","Montgomery County",1,69,2189,956,1233
050,01,101,"Alabama","Montgomery County",1,70,2123,918,1205
050,01,101,"Alabama","Montgomery County",1,71,2017,907,1110
050,01,101,"Alabama","Montgomery County",1,72,1950,892,1058
050,01,101,"Alabama","Montgomery County",1,73,1849,847,1002
050,01,101,"Alabama","Montgomery County",1,74,1367,613,754
050,01,101,"Alabama","Montgomery County",1,75,1368,569,799
050,01,101,"Alabama","Montgomery County",1,76,1334,559,775
050,01,101,"Alabama","Montgomery County",1,77,1281,544,737
050,01,101,"Alabama","Montgomery County",1,78,1109,464,645
050,01,101,"Alabama","Montgomery County",1,79,1024,416,608
050,01,101,"Alabama","Montgomery County",1,80,912,362,550
050,01,101,"Alabama","Montgomery County",1,81,862,360,502
050,01,101,"Alabama","Montgomery County",1,82,774,300,474
050,01,101,"Alabama","Montgomery County",1,83,722,280,442
050,01,101,"Alabama","Montgomery County",1,84,678,223,455
050,01,101,"Alabama","Montgomery County",1,85,3752,1279,2473
050,01,101,"Alabama","Montgomery County",2,0,3106,1582,1524
050,01,101,"Alabama","Montgomery County",2,1,3128,1585,1543
050,01,101,"Alabama","Montgomery County",2,2,3143,1578,1565
050,01,101,"Alabama","Montgomery County",2,3,3115,1552,1563
050,01,101,"Alabama","Montgomery County",2,4,3109,1568,1541
050,01,101,"Alabama","Montgomery County",2,5,3134,1623,1511
050,01,101,"Alabama","Montgomery County",2,6,3067,1562,1505
050,01,101,"Alabama","Montgomery County",2,7,2997,1532,1465
050,01,101,"Alabama","Montgomery County",2,8,2959,1531,1428
050,01,101,"Alabama","Montgomery County",2,9,2960,1514,1446
050,01,101,"Alabama","Montgomery County",2,10,3012,1518,1494
050,01,101,"Alabama","Montgomery County",2,11,3088,1535,1553
050,01,101,"Alabama","Montgomery County",2,12,3206,1603,1603
050,01,101,"Alabama","Montgomery County",2,13,3130,1595,1535
050,01,101,"Alabama","Montgomery County",2,14,2986,1516,1470
050,01,101,"Alabama","Montgomery County",2,15,2918,1490,1428
050,01,101,"Alabama","Montgomery County",2,16,2964,1525,1439
050,01,101,"Alabama","Montgomery County",2,17,2943,1508,1435
050,01,101,"Alabama","Montgomery County",2,18,3008,1572,1436
050,01,101,"Alabama","Montgomery County",2,19,3237,1706,1531
050,01,101,"Alabama","Montgomery County",2,20,3225,1601,1624
050,01,101,"Alabama","Montgomery County",2,21,3177,1579,1598
050,01,101,"Alabama","Montgomery County",2,22,3085,1473,1612
050,01,101,"Alabama","Montgomery County",2,23,3112,1502,1610
050,01,101,"Alabama","Montgomery County",2,24,3025,1398,1627
050,01,101,"Alabama","Montgomery County",2,25,3053,1445,1608
050,01,101,"Alabama","Montgomery County",2,26,3092,1488,1604
050,01,101,"Alabama","Montgomery County",2,27,3207,1553,1654
050,01,101,"Alabama","Montgomery County",2,28,3326,1599,1727
050,01,101,"Alabama","Montgomery County",2,29,3351,1587,1764
050,01,101,"Alabama","Montgomery County",2,30,3425,1611,1814
050,01,101,"Alabama","Montgomery County",2,31,3308,1552,1756
050,01,101,"Alabama","Montgomery County",2,32,3147,1455,1692
050,01,101,"Alabama","Montgomery County",2,33,3114,1479,1635
050,01,101,"Alabama","Montgomery County",2,34,3041,1439,1602
050,01,101,"Alabama","Montgomery County",2,35,3042,1397,1645
050,01,101,"Alabama","Montgomery County",2,36,3016,1426,1590
050,01,101,"Alabama","Montgomery County",2,37,2924,1376,1548
050,01,101,"Alabama","Montgomery County",2,38,3022,1421,1601
050,01,101,"Alabama","Montgomery County",2,39,2976,1387,1589
050,01,101,"Alabama","Montgomery County",2,40,2889,1330,1559
050,01,101,"Alabama","Montgomery County",2,41,2813,1316,1497
050,01,101,"Alabama","Montgomery County",2,42,2704,1252,1452
050,01,101,"Alabama","Montgomery County",2,43,2659,1236,1423
050,01,101,"Alabama","Montgomery County",2,44,2543,1171,1372
050,01,101,"Alabama","Montgomery County",2,45,2588,1169,1419
050,01,101,"Alabama","Montgomery County",2,46,2605,1182,1423
050,01,101,"Alabama","Montgomery County",2,47,2694,1242,1452
050,01,101,"Alabama","Montgomery County",2,48,2768,1289,1479
050,01,101,"Alabama","Montgomery County",2,49,2901,1365,1536
050,01,101,"Alabama","Montgomery County",2,50,2816,1287,1529
050,01,101,"Alabama","Montgomery County",2,51,2656,1227,1429
050,01,101,"Alabama","Montgomery County",2,52,2602,1247,1355
050,01,101,"Alabama","Montgomery County",2,53,2523,1214,1309
050,01,101,"Alabama","Montgomery County",2,54,2700,1299,1401
050,01,101,"Alabama","Montgomery County",2,55,2794,1298,1496
050,01,101,"Alabama","Montgomery County",2,56,2883,1312,1571
050,01,101,"Alabama","Montgomery County",2,57,2983,1388,1595
050,01,101,"Alabama","Montgomery County",2,58,2938,1362,1576
050,01,101,"Alabama","Montgomery County",2,59,2866,1306,1560
050,01,101,"Alabama","Montgomery County",2,60,2880,1318,1562
050,01,101,"Alabama","Montgomery County",2,61,2810,1255,1555
050,01,101,"Alabama","Montgomery County",2,62,2827,1303,1524
050,01,101,"Alabama","Montgomery County",2,63,2796,1252,1544
050,01,101,"Alabama","Montgomery County",2,64,2715,1194,1521
050,01,101,"Alabama","Montgomery County",2,65,2653,1167,1486
050,01,101,"Alabama","Montgomery County",2,66,2566,1105,1461
050,01,101,"Alabama","Montgomery County",2,67,2486,1073,1413
050,01,101,"Alabama","Montgomery County",2,68,2382,1032,1350
050,01,101,"Alabama","Montgomery County",2,69,2239,976,1263
050,01,101,"Alabama","Montgomery County",2,70,2120,919,1201
050,01,101,"Alabama","Montgomery County",2,71,2026,899,1127
050,01,101,"Alabama","Montgomery County",2,72,1924,877,1047
050,01,101,"Alabama","Montgomery County",2,73,1931,881,1050
050,01,101,"Alabama","Montgomery County",2,74,1393,622,771
050,01,101,"Alabama","Montgomery County",2,75,1350,568,782
050,01,101,"Alabama","Montgomery County",2,76,1321,550,771
050,01,101,"Alabama","Montgomery County",2,77,1306,551,755
050,01,101,"Alabama","Montgomery County",2,78,1117,467,650
050,01,101,"Alabama","Montgomery County",2,79,1034,423,611
050,01,101,"Alabama","Montgomery County",2,80,928,370,558
050,01,101,"Alabama","Montgomery County",2,81,858,365,493
050,01,101,"Alabama","Montgomery County",2,82,774,303,471
050,01,101,"Alabama","Montgomery County",2,83,714,269,445
050,01,101,"Alabama","Montgomery County",2,84,671,228,443
050,01,101,"Alabama","Montgomery County",2,85,3718,1255,2463
050,01,101,"Alabama","Montgomery County",3,0,3048,1524,1524
050,01,101,"Alabama","Montgomery County",3,1,2998,1529,1469
050,01,101,"Alabama","Montgomery County",3,2,3129,1579,1550
050,01,101,"Alabama","Montgomery County",3,3,3164,1604,1560
050,01,101,"Alabama","Montgomery County",3,4,3144,1595,1549
050,01,101,"Alabama","Montgomery County",3,5,3117,1583,1534
050,01,101,"Alabama","Montgomery County",3,6,3107,1611,1496
050,01,101,"Alabama","Montgomery County",3,7,3034,1553,1481
050,01,101,"Alabama","Montgomery County",3,8,2976,1497,1479
050,01,101,"Alabama","Montgomery County",3,9,2920,1488,1432
050,01,101,"Alabama","Montgomery County",3,10,2941,1506,1435
050,01,101,"Alabama","Montgomery County",3,11,2989,1501,1488
050,01,101,"Alabama","Montgomery County",3,12,3052,1515,1537
050,01,101,"Alabama","Montgomery County",3,13,3160,1573,1587
050,01,101,"Alabama","Montgomery County",3,14,3070,1582,1488
050,01,101,"Alabama","Montgomery County",3,15,3003,1535,1468
050,01,101,"Alabama","Montgomery County",3,16,2948,1503,1445
050,01,101,"Alabama","Montgomery County",3,17,2968,1521,1447
050,01,101,"Alabama","Montgomery County",3,18,3008,1562,1446
050,01,101,"Alabama","Montgomery County",3,19,3225,1677,1548
050,01,101,"Alabama","Montgomery County",3,20,3228,1599,1629
050,01,101,"Alabama","Montgomery County",3,21,3294,1643,1651
050,01,101,"Alabama","Montgomery County",3,22,3125,1501,1624
050,01,101,"Alabama","Montgomery County",3,23,3136,1489,1647
050,01,101,"Alabama","Montgomery County",3,24,3004,1409,1595
050,01,101,"Alabama","Montgomery County",3,25,2980,1384,1596
050,01,101,"Alabama","Montgomery County",3,26,3016,1429,1587
050,01,101,"Alabama","Montgomery County",3,27,2987,1432,1555
050,01,101,"Alabama","Montgomery County",3,28,3154,1548,1606
050,01,101,"Alabama","Montgomery County",3,29,3200,1514,1686
050,01,101,"Alabama","Montgomery County",3,30,3352,1583,1769
050,01,101,"Alabama","Montgomery County",3,31,3420,1608,1812
050,01,101,"Alabama","Montgomery County",3,32,3205,1453,1752
050,01,101,"Alabama","Montgomery County",3,33,3111,1440,1671
050,01,101,"Alabama","Montgomery County",3,34,2995,1414,1581
050,01,101,"Alabama","Montgomery County",3,35,2980,1411,1569
050,01,101,"Alabama","Montgomery County",3,36,3089,1437,1652
050,01,101,"Alabama","Montgomery County",3,37,2816,1280,1536
050,01,101,"Alabama","Montgomery County",3,38,2847,1332,1515
050,01,101,"Alabama","Montgomery County",3,39,2955,1368,1587
050,01,101,"Alabama","Montgomery County",3,40,2892,1335,1557
050,01,101,"Alabama","Montgomery County",3,41,2933,1377,1556
050,01,101,"Alabama","Montgomery County",3,42,2707,1251,1456
050,01,101,"Alabama","Montgomery County",3,43,2664,1247,1417
050,01,101,"Alabama","Montgomery County",3,44,2646,1211,1435
050,01,101,"Alabama","Montgomery County",3,45,2447,1077,1370
050,01,101,"Alabama","Montgomery County",3,46,2552,1170,1382
050,01,101,"Alabama","Montgomery County",3,47,2557,1130,1427
050,01,101,"Alabama","Montgomery County",3,48,2632,1210,1422
050,01,101,"Alabama","Montgomery County",3,49,2719,1259,1460
050,01,101,"Alabama","Montgomery County",3,50,2842,1307,1535
050,01,101,"Alabama","Montgomery County",3,51,2838,1301,1537
050,01,101,"Alabama","Montgomery County",3,52,2592,1190,1402
050,01,101,"Alabama","Montgomery County",3,53,2548,1204,1344
050,01,101,"Alabama","Montgomery County",3,54,2570,1266,1304
050,01,101,"Alabama","Montgomery County",3,55,2634,1241,1393
050,01,101,"Alabama","Montgomery County",3,56,2755,1256,1499
050,01,101,"Alabama","Montgomery County",3,57,2849,1299,1550
050,01,101,"Alabama","Montgomery County",3,58,2939,1384,1555
050,01,101,"Alabama","Montgomery County",3,59,2821,1276,1545
050,01,101,"Alabama","Montgomery County",3,60,2820,1289,1531
050,01,101,"Alabama","Montgomery County",3,61,2831,1277,1554
050,01,101,"Alabama","Montgomery County",3,62,2781,1241,1540
050,01,101,"Alabama","Montgomery County",3,63,2715,1244,1471
050,01,101,"Alabama","Montgomery County",3,64,2694,1198,1496
050,01,101,"Alabama","Montgomery County",3,65,2633,1151,1482
050,01,101,"Alabama","Montgomery County",3,66,2601,1138,1463
050,01,101,"Alabama","Montgomery County",3,67,2456,1033,1423
050,01,101,"Alabama","Montgomery County",3,68,2421,1041,1380
050,01,101,"Alabama","Montgomery County",3,69,2301,989,1312
050,01,101,"Alabama","Montgomery County",3,70,2137,935,1202
050,01,101,"Alabama","Montgomery County",3,71,2078,883,1195
050,01,101,"Alabama","Montgomery County",3,72,1960,866,1094
050,01,101,"Alabama","Montgomery County",3,73,1862,833,1029
050,01,101,"Alabama","Montgomery County",3,74,1849,840,1009
050,01,101,"Alabama","Montgomery County",3,75,1301,570,731
050,01,101,"Alabama","Montgomery County",3,76,1294,551,743
050,01,101,"Alabama","Montgomery County",3,77,1257,517,740
050,01,101,"Alabama","Montgomery County",3,78,1249,514,735
050,01,101,"Alabama","Montgomery County",3,79,1044,422,622
050,01,101,"Alabama","Montgomery County",3,80,959,386,573
050,01,101,"Alabama","Montgomery County",3,81,886,359,527
050,01,101,"Alabama","Montgomery County",3,82,779,313,466
050,01,101,"Alabama","Montgomery County",3,83,700,273,427
050,01,101,"Alabama","Montgomery County",3,84,632,228,404
050,01,101,"Alabama","Montgomery County",3,85,3663,1228,2435
050,01,101,"Alabama","Montgomery County",4,0,2958,1507,1451
050,01,101,"Alabama","Montgomery County",4,1,3032,1515,1517
050,01,101,"Alabama","Montgomery County",4,2,2995,1521,1474
050,01,101,"Alabama","Montgomery County",4,3,3082,1579,1503
050,01,101,"Alabama","Montgomery County",4,4,3171,1592,1579
050,01,101,"Alabama","Montgomery County",4,5,3129,1578,1551
050,01,101,"Alabama","Montgomery County",4,6,3092,1581,1511
050,01,101,"Alabama","Montgomery County",4,7,3098,1607,1491
050,01,101,"Alabama","Montgomery County",4,8,2995,1516,1479
050,01,101,"Alabama","Montgomery County",4,9,2928,1460,1468
050,01,101,"Alabama","Montgomery County",4,10,2903,1490,1413
050,01,101,"Alabama","Montgomery County",4,11,2906,1494,1412
050,01,101,"Alabama","Montgomery County",4,12,2999,1506,1493
050,01,101,"Alabama","Montgomery County",4,13,3030,1518,1512
050,01,101,"Alabama","Montgomery County",4,14,3170,1576,1594
050,01,101,"Alabama","Montgomery County",4,15,3071,1576,1495
050,01,101,"Alabama","Montgomery County",4,16,3068,1580,1488
050,01,101,"Alabama","Montgomery County",4,17,2946,1499,1447
050,01,101,"Alabama","Montgomery County",4,18,3054,1617,1437
050,01,101,"Alabama","Montgomery County",4,19,3160,1665,1495
050,01,101,"Alabama","Montgomery County",4,20,3126,1543,1583
050,01,101,"Alabama","Montgomery County",4,21,3237,1607,1630
050,01,101,"Alabama","Montgomery County",4,22,3122,1518,1604
050,01,101,"Alabama","Montgomery County",4,23,3117,1498,1619
050,01,101,"Alabama","Montgomery County",4,24,3006,1387,1619
050,01,101,"Alabama","Montgomery County",4,25,2981,1434,1547
050,01,101,"Alabama","Montgomery County",4,26,2953,1359,1594
050,01,101,"Alabama","Montgomery County",4,27,2948,1394,1554
050,01,101,"Alabama","Montgomery County",4,28,3014,1456,1558
050,01,101,"Alabama","Montgomery County",4,29,3085,1500,1585
050,01,101,"Alabama","Montgomery County",4,30,3264,1566,1698
050,01,101,"Alabama","Montgomery County",4,31,3323,1581,1742
050,01,101,"Alabama","Montgomery County",4,32,3318,1530,1788
050,01,101,"Alabama","Montgomery County",4,33,3251,1503,1748
050,01,101,"Alabama","Montgomery County",4,34,3109,1452,1657
050,01,101,"Alabama","Montgomery County",4,35,3005,1389,1616
050,01,101,"Alabama","Montgomery County",4,36,3021,1467,1554
050,01,101,"Alabama","Montgomery County",4,37,2932,1317,1615
050,01,101,"Alabama","Montgomery County",4,38,2744,1240,1504
050,01,101,"Alabama","Montgomery County",4,39,2785,1271,1514
050,01,101,"Alabama","Montgomery County",4,40,2888,1310,1578
050,01,101,"Alabama","Montgomery County",4,41,2973,1415,1558
050,01,101,"Alabama","Montgomery County",4,42,2868,1329,1539
050,01,101,"Alabama","Montgomery County",4,43,2687,1237,1450
050,01,101,"Alabama","Montgomery County",4,44,2690,1262,1428
050,01,101,"Alabama","Montgomery County",4,45,2528,1165,1363
050,01,101,"Alabama","Montgomery County",4,46,2497,1128,1369
050,01,101,"Alabama","Montgomery County",4,47,2477,1129,1348
050,01,101,"Alabama","Montgomery County",4,48,2488,1075,1413
050,01,101,"Alabama","Montgomery County",4,49,2620,1205,1415
050,01,101,"Alabama","Montgomery County",4,50,2670,1242,1428
050,01,101,"Alabama","Montgomery County",4,51,2859,1344,1515
050,01,101,"Alabama","Montgomery County",4,52,2820,1292,1528
050,01,101,"Alabama","Montgomery County",4,53,2551,1154,1397
050,01,101,"Alabama","Montgomery County",4,54,2580,1236,1344
050,01,101,"Alabama","Montgomery County",4,55,2515,1237,1278
050,01,101,"Alabama","Montgomery County",4,56,2596,1220,1376
050,01,101,"Alabama","Montgomery County",4,57,2776,1251,1525
050,01,101,"Alabama","Montgomery County",4,58,2815,1300,1515
050,01,101,"Alabama","Montgomery County",4,59,2870,1321,1549
050,01,101,"Alabama","Montgomery County",4,60,2785,1253,1532
050,01,101,"Alabama","Montgomery County",4,61,2754,1262,1492
050,01,101,"Alabama","Montgomery County",4,62,2788,1278,1510
050,01,101,"Alabama","Montgomery County",4,63,2707,1197,1510
050,01,101,"Alabama","Montgomery County",4,64,2654,1205,1449
050,01,101,"Alabama","Montgomery County",4,65,2618,1157,1461
050,01,101,"Alabama","Montgomery County",4,66,2552,1110,1442
050,01,101,"Alabama","Montgomery County",4,67,2519,1088,1431
050,01,101,"Alabama","Montgomery County",4,68,2385,996,1389
050,01,101,"Alabama","Montgomery County",4,69,2344,1005,1339
050,01,101,"Alabama","Montgomery County",4,70,2210,946,1264
050,01,101,"Alabama","Montgomery County",4,71,2087,882,1205
050,01,101,"Alabama","Montgomery County",4,72,1992,847,1145
050,01,101,"Alabama","Montgomery County",4,73,1921,843,1078
050,01,101,"Alabama","Montgomery County",4,74,1821,814,1007
050,01,101,"Alabama","Montgomery County",4,75,1762,792,970
050,01,101,"Alabama","Montgomery County",4,76,1255,548,707
050,01,101,"Alabama","Montgomery County",4,77,1231,521,710
050,01,101,"Alabama","Montgomery County",4,78,1200,484,716
050,01,101,"Alabama","Montgomery County",4,79,1176,474,702
050,01,101,"Alabama","Montgomery County",4,80,961,378,583
050,01,101,"Alabama","Montgomery County",4,81,920,381,539
050,01,101,"Alabama","Montgomery County",4,82,808,313,495
050,01,101,"Alabama","Montgomery County",4,83,715,293,422
050,01,101,"Alabama","Montgomery County",4,84,636,240,396
050,01,101,"Alabama","Montgomery County",4,85,3604,1220,2384
050,01,101,"Alabama","Montgomery County",5,0,2977,1515,1462
050,01,101,"Alabama","Montgomery County",5,1,2961,1520,1441
050,01,101,"Alabama","Montgomery County",5,2,2999,1506,1493
050,01,101,"Alabama","Montgomery County",5,3,2997,1525,1472
050,01,101,"Alabama","Montgomery County",5,4,3052,1556,1496
050,01,101,"Alabama","Montgomery County",5,5,3162,1580,1582
050,01,101,"Alabama","Montgomery County",5,6,3105,1553,1552
050,01,101,"Alabama","Montgomery County",5,7,3085,1593,1492
050,01,101,"Alabama","Montgomery County",5,8,3087,1611,1476
050,01,101,"Alabama","Montgomery County",5,9,2979,1482,1497
050,01,101,"Alabama","Montgomery County",5,10,2851,1428,1423
050,01,101,"Alabama","Montgomery County",5,11,2886,1489,1397
050,01,101,"Alabama","Montgomery County",5,12,2887,1478,1409
050,01,101,"Alabama","Montgomery County",5,13,2951,1490,1461
050,01,101,"Alabama","Montgomery County",5,14,2990,1500,1490
050,01,101,"Alabama","Montgomery County",5,15,3135,1548,1587
050,01,101,"Alabama","Montgomery County",5,16,3076,1588,1488
050,01,101,"Alabama","Montgomery County",5,17,3067,1575,1492
050,01,101,"Alabama","Montgomery County",5,18,3018,1580,1438
050,01,101,"Alabama","Montgomery County",5,19,3205,1716,1489
050,01,101,"Alabama","Montgomery County",5,20,3111,1544,1567
050,01,101,"Alabama","Montgomery County",5,21,3154,1583,1571
050,01,101,"Alabama","Montgomery County",5,22,3113,1509,1604
050,01,101,"Alabama","Montgomery County",5,23,3058,1492,1566
050,01,101,"Alabama","Montgomery County",5,24,2899,1354,1545
050,01,101,"Alabama","Montgomery County",5,25,2915,1371,1544
050,01,101,"Alabama","Montgomery County",5,26,2918,1371,1547
050,01,101,"Alabama","Montgomery County",5,27,2815,1287,1528
050,01,101,"Alabama","Montgomery County",5,28,2920,1373,1547
050,01,101,"Alabama","Montgomery County",5,29,2899,1369,1530
050,01,101,"Alabama","Montgomery County",5,30,3047,1494,1553
050,01,101,"Alabama","Montgomery County",5,31,3188,1523,1665
050,01,101,"Alabama","Montgomery County",5,32,3210,1499,1711
050,01,101,"Alabama","Montgomery County",5,33,3295,1542,1753
050,01,101,"Alabama","Montgomery County",5,34,3195,1495,1700
050,01,101,"Alabama","Montgomery County",5,35,3081,1425,1656
050,01,101,"Alabama","Montgomery County",5,36,3047,1428,1619
050,01,101,"Alabama","Montgomery County",5,37,2893,1345,1548
050,01,101,"Alabama","Montgomery County",5,38,2850,1250,1600
050,01,101,"Alabama","Montgomery County",5,39,2683,1210,1473
050,01,101,"Alabama","Montgomery County",5,40,2734,1246,1488
050,01,101,"Alabama","Montgomery County",5,41,2895,1339,1556
050,01,101,"Alabama","Montgomery County",5,42,2944,1373,1571
050,01,101,"Alabama","Montgomery County",5,43,2858,1337,1521
050,01,101,"Alabama","Montgomery County",5,44,2669,1219,1450
050,01,101,"Alabama","Montgomery County",5,45,2575,1178,1397
050,01,101,"Alabama","Montgomery County",5,46,2543,1185,1358
050,01,101,"Alabama","Montgomery County",5,47,2430,1094,1336
050,01,101,"Alabama","Montgomery County",5,48,2444,1080,1364
050,01,101,"Alabama","Montgomery County",5,49,2443,1066,1377
050,01,101,"Alabama","Montgomery County",5,50,2590,1166,1424
050,01,101,"Alabama","Montgomery County",5,51,2685,1263,1422
050,01,101,"Alabama","Montgomery County",5,52,2815,1315,1500
050,01,101,"Alabama","Montgomery County",5,53,2741,1240,1501
050,01,101,"Alabama","Montgomery County",5,54,2570,1190,1380
050,01,101,"Alabama","Montgomery County",5,55,2487,1167,1320
050,01,101,"Alabama","Montgomery County",5,56,2443,1198,1245
050,01,101,"Alabama","Montgomery County",5,57,2595,1213,1382
050,01,101,"Alabama","Montgomery County",5,58,2707,1223,1484
050,01,101,"Alabama","Montgomery County",5,59,2721,1239,1482
050,01,101,"Alabama","Montgomery County",5,60,2801,1294,1507
050,01,101,"Alabama","Montgomery County",5,61,2710,1209,1501
050,01,101,"Alabama","Montgomery County",5,62,2766,1287,1479
050,01,101,"Alabama","Montgomery County",5,63,2729,1232,1497
050,01,101,"Alabama","Montgomery County",5,64,2658,1162,1496
050,01,101,"Alabama","Montgomery County",5,65,2593,1177,1416
050,01,101,"Alabama","Montgomery County",5,66,2570,1133,1437
050,01,101,"Alabama","Montgomery County",5,67,2511,1086,1425
050,01,101,"Alabama","Montgomery County",5,68,2463,1065,1398
050,01,101,"Alabama","Montgomery County",5,69,2318,960,1358
050,01,101,"Alabama","Montgomery County",5,70,2290,980,1310
050,01,101,"Alabama","Montgomery County",5,71,2179,925,1254
050,01,101,"Alabama","Montgomery County",5,72,2008,847,1161
050,01,101,"Alabama","Montgomery County",5,73,1959,826,1133
050,01,101,"Alabama","Montgomery County",5,74,1881,823,1058
050,01,101,"Alabama","Montgomery County",5,75,1746,765,981
050,01,101,"Alabama","Montgomery County",5,76,1716,778,938
050,01,101,"Alabama","Montgomery County",5,77,1194,523,671
050,01,101,"Alabama","Montgomery County",5,78,1176,492,684
050,01,101,"Alabama","Montgomery County",5,79,1141,447,694
050,01,101,"Alabama","Montgomery County",5,80,1098,434,664
050,01,101,"Alabama","Montgomery County",5,81,936,377,559
050,01,101,"Alabama","Montgomery County",5,82,835,330,505
050,01,101,"Alabama","Montgomery County",5,83,750,291,459
050,01,101,"Alabama","Montgomery County",5,84,665,254,411
050,01,101,"Alabama","Montgomery County",5,85,3637,1265,2372
050,01,103,"Alabama","Morgan County",1,0,1454,745,709
050,01,103,"Alabama","Morgan County",1,1,1502,764,738
050,01,103,"Alabama","Morgan County",1,2,1525,736,789
050,01,103,"Alabama","Morgan County",1,3,1498,756,742
050,01,103,"Alabama","Morgan County",1,4,1533,806,727
050,01,103,"Alabama","Morgan County",1,5,1501,762,739
050,01,103,"Alabama","Morgan County",1,6,1512,781,731
050,01,103,"Alabama","Morgan County",1,7,1476,749,727
050,01,103,"Alabama","Morgan County",1,8,1533,776,757
050,01,103,"Alabama","Morgan County",1,9,1599,824,775
050,01,103,"Alabama","Morgan County",1,10,1680,877,803
050,01,103,"Alabama","Morgan County",1,11,1766,934,832
050,01,103,"Alabama","Morgan County",1,12,1776,910,866
050,01,103,"Alabama","Morgan County",1,13,1716,876,840
050,01,103,"Alabama","Morgan County",1,14,1674,892,782
050,01,103,"Alabama","Morgan County",1,15,1702,867,835
050,01,103,"Alabama","Morgan County",1,16,1722,880,842
050,01,103,"Alabama","Morgan County",1,17,1707,874,833
050,01,103,"Alabama","Morgan County",1,18,1483,784,699
050,01,103,"Alabama","Morgan County",1,19,1212,637,575
050,01,103,"Alabama","Morgan County",1,20,1278,646,632
050,01,103,"Alabama","Morgan County",1,21,1386,719,667
050,01,103,"Alabama","Morgan County",1,22,1417,734,683
050,01,103,"Alabama","Morgan County",1,23,1403,713,690
050,01,103,"Alabama","Morgan County",1,24,1437,744,693
050,01,103,"Alabama","Morgan County",1,25,1436,701,735
050,01,103,"Alabama","Morgan County",1,26,1479,735,744
050,01,103,"Alabama","Morgan County",1,27,1463,734,729
050,01,103,"Alabama","Morgan County",1,28,1558,786,772
050,01,103,"Alabama","Morgan County",1,29,1560,805,755
050,01,103,"Alabama","Morgan County",1,30,1576,802,774
050,01,103,"Alabama","Morgan County",1,31,1503,745,758
050,01,103,"Alabama","Morgan County",1,32,1472,765,707
050,01,103,"Alabama","Morgan County",1,33,1392,717,675
050,01,103,"Alabama","Morgan County",1,34,1464,732,732
050,01,103,"Alabama","Morgan County",1,35,1550,809,741
050,01,103,"Alabama","Morgan County",1,36,1449,728,721
050,01,103,"Alabama","Morgan County",1,37,1511,759,752
050,01,103,"Alabama","Morgan County",1,38,1567,800,767
050,01,103,"Alabama","Morgan County",1,39,1578,810,768
050,01,103,"Alabama","Morgan County",1,40,1538,792,746
050,01,103,"Alabama","Morgan County",1,41,1544,763,781
050,01,103,"Alabama","Morgan County",1,42,1581,788,793
050,01,103,"Alabama","Morgan County",1,43,1533,769,764
050,01,103,"Alabama","Morgan County",1,44,1410,721,689
050,01,103,"Alabama","Morgan County",1,45,1437,756,681
050,01,103,"Alabama","Morgan County",1,46,1483,781,702
050,01,103,"Alabama","Morgan County",1,47,1572,814,758
050,01,103,"Alabama","Morgan County",1,48,1634,835,799
050,01,103,"Alabama","Morgan County",1,49,1715,880,835
050,01,103,"Alabama","Morgan County",1,50,1571,779,792
050,01,103,"Alabama","Morgan County",1,51,1634,810,824
050,01,103,"Alabama","Morgan County",1,52,1597,781,816
050,01,103,"Alabama","Morgan County",1,53,1687,815,872
050,01,103,"Alabama","Morgan County",1,54,1727,843,884
050,01,103,"Alabama","Morgan County",1,55,1851,947,904
050,01,103,"Alabama","Morgan County",1,56,1846,937,909
050,01,103,"Alabama","Morgan County",1,57,1745,868,877
050,01,103,"Alabama","Morgan County",1,58,1756,886,870
050,01,103,"Alabama","Morgan County",1,59,1735,887,848
050,01,103,"Alabama","Morgan County",1,60,1708,882,826
050,01,103,"Alabama","Morgan County",1,61,1677,824,853
050,01,103,"Alabama","Morgan County",1,62,1655,810,845
050,01,103,"Alabama","Morgan County",1,63,1621,788,833
050,01,103,"Alabama","Morgan County",1,64,1548,754,794
050,01,103,"Alabama","Morgan County",1,65,1496,698,798
050,01,103,"Alabama","Morgan County",1,66,1483,685,798
050,01,103,"Alabama","Morgan County",1,67,1422,658,764
050,01,103,"Alabama","Morgan County",1,68,1367,636,731
050,01,103,"Alabama","Morgan County",1,69,1254,584,670
050,01,103,"Alabama","Morgan County",1,70,1237,545,692
050,01,103,"Alabama","Morgan County",1,71,1239,571,668
050,01,103,"Alabama","Morgan County",1,72,1188,523,665
050,01,103,"Alabama","Morgan County",1,73,1212,537,675
050,01,103,"Alabama","Morgan County",1,74,900,398,502
050,01,103,"Alabama","Morgan County",1,75,892,411,481
050,01,103,"Alabama","Morgan County",1,76,884,405,479
050,01,103,"Alabama","Morgan County",1,77,882,399,483
050,01,103,"Alabama","Morgan County",1,78,748,346,402
050,01,103,"Alabama","Morgan County",1,79,691,303,388
050,01,103,"Alabama","Morgan County",1,80,632,269,363
050,01,103,"Alabama","Morgan County",1,81,587,252,335
050,01,103,"Alabama","Morgan County",1,82,529,225,304
050,01,103,"Alabama","Morgan County",1,83,437,170,267
050,01,103,"Alabama","Morgan County",1,84,410,160,250
050,01,103,"Alabama","Morgan County",1,85,2079,756,1323
050,01,103,"Alabama","Morgan County",2,0,1434,734,700
050,01,103,"Alabama","Morgan County",2,1,1495,762,733
050,01,103,"Alabama","Morgan County",2,2,1519,745,774
050,01,103,"Alabama","Morgan County",2,3,1503,756,747
050,01,103,"Alabama","Morgan County",2,4,1533,796,737
050,01,103,"Alabama","Morgan County",2,5,1516,774,742
050,01,103,"Alabama","Morgan County",2,6,1511,776,735
050,01,103,"Alabama","Morgan County",2,7,1488,760,728
050,01,103,"Alabama","Morgan County",2,8,1516,765,751
050,01,103,"Alabama","Morgan County",2,9,1584,811,773
050,01,103,"Alabama","Morgan County",2,10,1665,865,800
050,01,103,"Alabama","Morgan County",2,11,1741,916,825
050,01,103,"Alabama","Morgan County",2,12,1785,919,866
050,01,103,"Alabama","Morgan County",2,13,1723,884,839
050,01,103,"Alabama","Morgan County",2,14,1684,889,795
050,01,103,"Alabama","Morgan County",2,15,1701,875,826
050,01,103,"Alabama","Morgan County",2,16,1727,883,844
050,01,103,"Alabama","Morgan County",2,17,1713,877,836
050,01,103,"Alabama","Morgan County",2,18,1471,775,696
050,01,103,"Alabama","Morgan County",2,19,1230,647,583
050,01,103,"Alabama","Morgan County",2,20,1294,654,640
050,01,103,"Alabama","Morgan County",2,21,1379,711,668
050,01,103,"Alabama","Morgan County",2,22,1417,725,692
050,01,103,"Alabama","Morgan County",2,23,1405,712,693
050,01,103,"Alabama","Morgan County",2,24,1426,731,695
050,01,103,"Alabama","Morgan County",2,25,1428,703,725
050,01,103,"Alabama","Morgan County",2,26,1465,723,742
050,01,103,"Alabama","Morgan County",2,27,1455,727,728
050,01,103,"Alabama","Morgan County",2,28,1530,770,760
050,01,103,"Alabama","Morgan County",2,29,1556,797,759
050,01,103,"Alabama","Morgan County",2,30,1576,801,775
050,01,103,"Alabama","Morgan County",2,31,1503,746,757
050,01,103,"Alabama","Morgan County",2,32,1474,755,719
050,01,103,"Alabama","Morgan County",2,33,1391,710,681
050,01,103,"Alabama","Morgan County",2,34,1449,729,720
050,01,103,"Alabama","Morgan County",2,35,1534,792,742
050,01,103,"Alabama","Morgan County",2,36,1448,726,722
050,01,103,"Alabama","Morgan County",2,37,1502,753,749
050,01,103,"Alabama","Morgan County",2,38,1563,794,769
050,01,103,"Alabama","Morgan County",2,39,1561,797,764
050,01,103,"Alabama","Morgan County",2,40,1557,796,761
050,01,103,"Alabama","Morgan County",2,41,1538,765,773
050,01,103,"Alabama","Morgan County",2,42,1570,778,792
050,01,103,"Alabama","Morgan County",2,43,1553,778,775
050,01,103,"Alabama","Morgan County",2,44,1420,720,700
050,01,103,"Alabama","Morgan County",2,45,1431,744,687
050,01,103,"Alabama","Morgan County",2,46,1462,768,694
050,01,103,"Alabama","Morgan County",2,47,1542,801,741
050,01,103,"Alabama","Morgan County",2,48,1609,821,788
050,01,103,"Alabama","Morgan County",2,49,1704,876,828
050,01,103,"Alabama","Morgan County",2,50,1595,794,801
050,01,103,"Alabama","Morgan County",2,51,1609,795,814
050,01,103,"Alabama","Morgan County",2,52,1604,785,819
050,01,103,"Alabama","Morgan County",2,53,1656,799,857
050,01,103,"Alabama","Morgan County",2,54,1705,830,875
050,01,103,"Alabama","Morgan County",2,55,1813,918,895
050,01,103,"Alabama","Morgan County",2,56,1848,939,909
050,01,103,"Alabama","Morgan County",2,57,1765,881,884
050,01,103,"Alabama","Morgan County",2,58,1743,876,867
050,01,103,"Alabama","Morgan County",2,59,1750,891,859
050,01,103,"Alabama","Morgan County",2,60,1703,877,826
050,01,103,"Alabama","Morgan County",2,61,1673,833,840
050,01,103,"Alabama","Morgan County",2,62,1647,803,844
050,01,103,"Alabama","Morgan County",2,63,1642,800,842
050,01,103,"Alabama","Morgan County",2,64,1556,758,798
050,01,103,"Alabama","Morgan County",2,65,1504,709,795
050,01,103,"Alabama","Morgan County",2,66,1483,685,798
050,01,103,"Alabama","Morgan County",2,67,1427,660,767
050,01,103,"Alabama","Morgan County",2,68,1360,630,730
050,01,103,"Alabama","Morgan County",2,69,1287,597,690
050,01,103,"Alabama","Morgan County",2,70,1225,544,681
050,01,103,"Alabama","Morgan County",2,71,1235,562,673
050,01,103,"Alabama","Morgan County",2,72,1180,524,656
050,01,103,"Alabama","Morgan County",2,73,1257,554,703
050,01,103,"Alabama","Morgan County",2,74,910,404,506
050,01,103,"Alabama","Morgan County",2,75,890,408,482
050,01,103,"Alabama","Morgan County",2,76,869,396,473
050,01,103,"Alabama","Morgan County",2,77,893,406,487
050,01,103,"Alabama","Morgan County",2,78,757,343,414
050,01,103,"Alabama","Morgan County",2,79,693,306,387
050,01,103,"Alabama","Morgan County",2,80,633,269,364
050,01,103,"Alabama","Morgan County",2,81,589,251,338
050,01,103,"Alabama","Morgan County",2,82,544,233,311
050,01,103,"Alabama","Morgan County",2,83,451,176,275
050,01,103,"Alabama","Morgan County",2,84,403,157,246
050,01,103,"Alabama","Morgan County",2,85,2108,769,1339
050,01,103,"Alabama","Morgan County",3,0,1415,720,695
050,01,103,"Alabama","Morgan County",3,1,1480,763,717
050,01,103,"Alabama","Morgan County",3,2,1533,775,758
050,01,103,"Alabama","Morgan County",3,3,1533,752,781
050,01,103,"Alabama","Morgan County",3,4,1529,773,756
050,01,103,"Alabama","Morgan County",3,5,1558,788,770
050,01,103,"Alabama","Morgan County",3,6,1529,777,752
050,01,103,"Alabama","Morgan County",3,7,1534,794,740
050,01,103,"Alabama","Morgan County",3,8,1535,787,748
050,01,103,"Alabama","Morgan County",3,9,1541,777,764
050,01,103,"Alabama","Morgan County",3,10,1603,816,787
050,01,103,"Alabama","Morgan County",3,11,1666,853,813
050,01,103,"Alabama","Morgan County",3,12,1755,917,838
050,01,103,"Alabama","Morgan County",3,13,1811,924,887
050,01,103,"Alabama","Morgan County",3,14,1705,876,829
050,01,103,"Alabama","Morgan County",3,15,1712,910,802
050,01,103,"Alabama","Morgan County",3,16,1730,904,826
050,01,103,"Alabama","Morgan County",3,17,1721,866,855
050,01,103,"Alabama","Morgan County",3,18,1522,797,725
050,01,103,"Alabama","Morgan County",3,19,1236,644,592
050,01,103,"Alabama","Morgan County",3,20,1322,676,646
050,01,103,"Alabama","Morgan County",3,21,1393,728,665
050,01,103,"Alabama","Morgan County",3,22,1432,726,706
050,01,103,"Alabama","Morgan County",3,23,1468,767,701
050,01,103,"Alabama","Morgan County",3,24,1415,724,691
050,01,103,"Alabama","Morgan County",3,25,1400,705,695
050,01,103,"Alabama","Morgan County",3,26,1467,739,728
050,01,103,"Alabama","Morgan County",3,27,1500,724,776
050,01,103,"Alabama","Morgan County",3,28,1460,740,720
050,01,103,"Alabama","Morgan County",3,29,1550,771,779
050,01,103,"Alabama","Morgan County",3,30,1552,814,738
050,01,103,"Alabama","Morgan County",3,31,1549,784,765
050,01,103,"Alabama","Morgan County",3,32,1571,773,798
050,01,103,"Alabama","Morgan County",3,33,1441,720,721
050,01,103,"Alabama","Morgan County",3,34,1415,731,684
050,01,103,"Alabama","Morgan County",3,35,1476,750,726
050,01,103,"Alabama","Morgan County",3,36,1480,730,750
050,01,103,"Alabama","Morgan County",3,37,1470,735,735
050,01,103,"Alabama","Morgan County",3,38,1548,776,772
050,01,103,"Alabama","Morgan County",3,39,1551,769,782
050,01,103,"Alabama","Morgan County",3,40,1544,792,752
050,01,103,"Alabama","Morgan County",3,41,1576,799,777
050,01,103,"Alabama","Morgan County",3,42,1538,769,769
050,01,103,"Alabama","Morgan County",3,43,1567,778,789
050,01,103,"Alabama","Morgan County",3,44,1529,772,757
050,01,103,"Alabama","Morgan County",3,45,1422,706,716
050,01,103,"Alabama","Morgan County",3,46,1404,729,675
050,01,103,"Alabama","Morgan County",3,47,1423,748,675
050,01,103,"Alabama","Morgan County",3,48,1548,797,751
050,01,103,"Alabama","Morgan County",3,49,1624,839,785
050,01,103,"Alabama","Morgan County",3,50,1674,848,826
050,01,103,"Alabama","Morgan County",3,51,1579,779,800
050,01,103,"Alabama","Morgan County",3,52,1604,795,809
050,01,103,"Alabama","Morgan County",3,53,1575,759,816
050,01,103,"Alabama","Morgan County",3,54,1666,813,853
050,01,103,"Alabama","Morgan County",3,55,1703,825,878
050,01,103,"Alabama","Morgan County",3,56,1774,886,888
050,01,103,"Alabama","Morgan County",3,57,1840,945,895
050,01,103,"Alabama","Morgan County",3,58,1755,877,878
050,01,103,"Alabama","Morgan County",3,59,1719,858,861
050,01,103,"Alabama","Morgan County",3,60,1711,869,842
050,01,103,"Alabama","Morgan County",3,61,1667,859,808
050,01,103,"Alabama","Morgan County",3,62,1638,811,827
050,01,103,"Alabama","Morgan County",3,63,1610,787,823
050,01,103,"Alabama","Morgan County",3,64,1594,768,826
050,01,103,"Alabama","Morgan County",3,65,1529,735,794
050,01,103,"Alabama","Morgan County",3,66,1463,681,782
050,01,103,"Alabama","Morgan County",3,67,1450,672,778
050,01,103,"Alabama","Morgan County",3,68,1392,638,754
050,01,103,"Alabama","Morgan County",3,69,1326,610,716
050,01,103,"Alabama","Morgan County",3,70,1228,564,664
050,01,103,"Alabama","Morgan County",3,71,1174,527,647
050,01,103,"Alabama","Morgan County",3,72,1188,524,664
050,01,103,"Alabama","Morgan County",3,73,1137,488,649
050,01,103,"Alabama","Morgan County",3,74,1212,530,682
050,01,103,"Alabama","Morgan County",3,75,880,386,494
050,01,103,"Alabama","Morgan County",3,76,860,382,478
050,01,103,"Alabama","Morgan County",3,77,819,367,452
050,01,103,"Alabama","Morgan County",3,78,851,375,476
050,01,103,"Alabama","Morgan County",3,79,717,319,398
050,01,103,"Alabama","Morgan County",3,80,651,280,371
050,01,103,"Alabama","Morgan County",3,81,585,242,343
050,01,103,"Alabama","Morgan County",3,82,537,236,301
050,01,103,"Alabama","Morgan County",3,83,476,199,277
050,01,103,"Alabama","Morgan County",3,84,419,169,250
050,01,103,"Alabama","Morgan County",3,85,2089,766,1323
050,01,103,"Alabama","Morgan County",4,0,1429,720,709
050,01,103,"Alabama","Morgan County",4,1,1450,743,707
050,01,103,"Alabama","Morgan County",4,2,1500,763,737
050,01,103,"Alabama","Morgan County",4,3,1525,776,749
050,01,103,"Alabama","Morgan County",4,4,1559,764,795
050,01,103,"Alabama","Morgan County",4,5,1558,782,776
050,01,103,"Alabama","Morgan County",4,6,1579,803,776
050,01,103,"Alabama","Morgan County",4,7,1553,784,769
050,01,103,"Alabama","Morgan County",4,8,1602,833,769
050,01,103,"Alabama","Morgan County",4,9,1559,814,745
050,01,103,"Alabama","Morgan County",4,10,1580,781,799
050,01,103,"Alabama","Morgan County",4,11,1652,846,806
050,01,103,"Alabama","Morgan County",4,12,1680,870,810
050,01,103,"Alabama","Morgan County",4,13,1748,908,840
050,01,103,"Alabama","Morgan County",4,14,1821,937,884
050,01,103,"Alabama","Morgan County",4,15,1732,879,853
050,01,103,"Alabama","Morgan County",4,16,1709,889,820
050,01,103,"Alabama","Morgan County",4,17,1727,902,825
050,01,103,"Alabama","Morgan County",4,18,1472,779,693
050,01,103,"Alabama","Morgan County",4,19,1262,678,584
050,01,103,"Alabama","Morgan County",4,20,1284,666,618
050,01,103,"Alabama","Morgan County",4,21,1432,744,688
050,01,103,"Alabama","Morgan County",4,22,1450,754,696
050,01,103,"Alabama","Morgan County",4,23,1493,758,735
050,01,103,"Alabama","Morgan County",4,24,1507,777,730
050,01,103,"Alabama","Morgan County",4,25,1434,730,704
050,01,103,"Alabama","Morgan County",4,26,1472,746,726
050,01,103,"Alabama","Morgan County",4,27,1513,764,749
050,01,103,"Alabama","Morgan County",4,28,1512,741,771
050,01,103,"Alabama","Morgan County",4,29,1479,742,737
050,01,103,"Alabama","Morgan County",4,30,1575,817,758
050,01,103,"Alabama","Morgan County",4,31,1566,821,745
050,01,103,"Alabama","Morgan County",4,32,1627,843,784
050,01,103,"Alabama","Morgan County",4,33,1559,750,809
050,01,103,"Alabama","Morgan County",4,34,1453,730,723
050,01,103,"Alabama","Morgan County",4,35,1456,775,681
050,01,103,"Alabama","Morgan County",4,36,1417,690,727
050,01,103,"Alabama","Morgan County",4,37,1554,785,769
050,01,103,"Alabama","Morgan County",4,38,1534,792,742
050,01,103,"Alabama","Morgan County",4,39,1545,768,777
050,01,103,"Alabama","Morgan County",4,40,1551,771,780
050,01,103,"Alabama","Morgan County",4,41,1565,793,772
050,01,103,"Alabama","Morgan County",4,42,1584,804,780
050,01,103,"Alabama","Morgan County",4,43,1576,793,783
050,01,103,"Alabama","Morgan County",4,44,1567,790,777
050,01,103,"Alabama","Morgan County",4,45,1532,770,762
050,01,103,"Alabama","Morgan County",4,46,1439,726,713
050,01,103,"Alabama","Morgan County",4,47,1424,740,684
050,01,103,"Alabama","Morgan County",4,48,1428,752,676
050,01,103,"Alabama","Morgan County",4,49,1575,826,749
050,01,103,"Alabama","Morgan County",4,50,1571,796,775
050,01,103,"Alabama","Morgan County",4,51,1693,860,833
050,01,103,"Alabama","Morgan County",4,52,1589,788,801
050,01,103,"Alabama","Morgan County",4,53,1598,784,814
050,01,103,"Alabama","Morgan County",4,54,1581,765,816
050,01,103,"Alabama","Morgan County",4,55,1664,810,854
050,01,103,"Alabama","Morgan County",4,56,1685,805,880
050,01,103,"Alabama","Morgan County",4,57,1764,866,898
050,01,103,"Alabama","Morgan County",4,58,1848,940,908
050,01,103,"Alabama","Morgan County",4,59,1742,859,883
050,01,103,"Alabama","Morgan County",4,60,1711,849,862
050,01,103,"Alabama","Morgan County",4,61,1673,842,831
050,01,103,"Alabama","Morgan County",4,62,1640,831,809
050,01,103,"Alabama","Morgan County",4,63,1598,783,815
050,01,103,"Alabama","Morgan County",4,64,1575,774,801
050,01,103,"Alabama","Morgan County",4,65,1585,753,832
050,01,103,"Alabama","Morgan County",4,66,1515,722,793
050,01,103,"Alabama","Morgan County",4,67,1437,677,760
050,01,103,"Alabama","Morgan County",4,68,1430,656,774
050,01,103,"Alabama","Morgan County",4,69,1376,644,732
050,01,103,"Alabama","Morgan County",4,70,1298,595,703
050,01,103,"Alabama","Morgan County",4,71,1195,551,644
050,01,103,"Alabama","Morgan County",4,72,1135,499,636
050,01,103,"Alabama","Morgan County",4,73,1140,497,643
050,01,103,"Alabama","Morgan County",4,74,1086,466,620
050,01,103,"Alabama","Morgan County",4,75,1169,503,666
050,01,103,"Alabama","Morgan County",4,76,842,369,473
050,01,103,"Alabama","Morgan County",4,77,816,364,452
050,01,103,"Alabama","Morgan County",4,78,788,342,446
050,01,103,"Alabama","Morgan County",4,79,798,347,451
050,01,103,"Alabama","Morgan County",4,80,665,295,370
050,01,103,"Alabama","Morgan County",4,81,608,258,350
050,01,103,"Alabama","Morgan County",4,82,539,228,311
050,01,103,"Alabama","Morgan County",4,83,486,210,276
050,01,103,"Alabama","Morgan County",4,84,443,185,258
050,01,103,"Alabama","Morgan County",4,85,2148,795,1353
050,01,103,"Alabama","Morgan County",5,0,1456,731,725
050,01,103,"Alabama","Morgan County",5,1,1459,716,743
050,01,103,"Alabama","Morgan County",5,2,1481,740,741
050,01,103,"Alabama","Morgan County",5,3,1542,771,771
050,01,103,"Alabama","Morgan County",5,4,1523,787,736
050,01,103,"Alabama","Morgan County",5,5,1569,768,801
050,01,103,"Alabama","Morgan County",5,6,1577,786,791
050,01,103,"Alabama","Morgan County",5,7,1618,818,800
050,01,103,"Alabama","Morgan County",5,8,1577,811,766
050,01,103,"Alabama","Morgan County",5,9,1600,837,763
050,01,103,"Alabama","Morgan County",5,10,1566,799,767
050,01,103,"Alabama","Morgan County",5,11,1633,813,820
050,01,103,"Alabama","Morgan County",5,12,1666,860,806
050,01,103,"Alabama","Morgan County",5,13,1717,894,823
050,01,103,"Alabama","Morgan County",5,14,1758,925,833
050,01,103,"Alabama","Morgan County",5,15,1846,950,896
050,01,103,"Alabama","Morgan County",5,16,1736,890,846
050,01,103,"Alabama","Morgan County",5,17,1710,881,829
050,01,103,"Alabama","Morgan County",5,18,1500,806,694
050,01,103,"Alabama","Morgan County",5,19,1252,678,574
050,01,103,"Alabama","Morgan County",5,20,1379,725,654
050,01,103,"Alabama","Morgan County",5,21,1413,751,662
050,01,103,"Alabama","Morgan County",5,22,1490,762,728
050,01,103,"Alabama","Morgan County",5,23,1533,785,748
050,01,103,"Alabama","Morgan County",5,24,1504,766,738
050,01,103,"Alabama","Morgan County",5,25,1512,783,729
050,01,103,"Alabama","Morgan County",5,26,1434,738,696
050,01,103,"Alabama","Morgan County",5,27,1469,749,720
050,01,103,"Alabama","Morgan County",5,28,1477,720,757
050,01,103,"Alabama","Morgan County",5,29,1519,742,777
050,01,103,"Alabama","Morgan County",5,30,1531,779,752
050,01,103,"Alabama","Morgan County",5,31,1537,797,740
050,01,103,"Alabama","Morgan County",5,32,1659,879,780
050,01,103,"Alabama","Morgan County",5,33,1598,808,790
050,01,103,"Alabama","Morgan County",5,34,1577,749,828
050,01,103,"Alabama","Morgan County",5,35,1504,776,728
050,01,103,"Alabama","Morgan County",5,36,1437,749,688
050,01,103,"Alabama","Morgan County",5,37,1459,728,731
050,01,103,"Alabama","Morgan County",5,38,1577,806,771
050,01,103,"Alabama","Morgan County",5,39,1543,794,749
050,01,103,"Alabama","Morgan County",5,40,1537,767,770
050,01,103,"Alabama","Morgan County",5,41,1557,774,783
050,01,103,"Alabama","Morgan County",5,42,1578,800,778
050,01,103,"Alabama","Morgan County",5,43,1609,823,786
050,01,103,"Alabama","Morgan County",5,44,1598,809,789
050,01,103,"Alabama","Morgan County",5,45,1565,794,771
050,01,103,"Alabama","Morgan County",5,46,1551,776,775
050,01,103,"Alabama","Morgan County",5,47,1438,722,716
050,01,103,"Alabama","Morgan County",5,48,1401,715,686
050,01,103,"Alabama","Morgan County",5,49,1468,793,675
050,01,103,"Alabama","Morgan County",5,50,1539,789,750
050,01,103,"Alabama","Morgan County",5,51,1619,835,784
050,01,103,"Alabama","Morgan County",5,52,1714,872,842
050,01,103,"Alabama","Morgan County",5,53,1604,774,830
050,01,103,"Alabama","Morgan County",5,54,1595,780,815
050,01,103,"Alabama","Morgan County",5,55,1578,764,814
050,01,103,"Alabama","Morgan County",5,56,1674,808,866
050,01,103,"Alabama","Morgan County",5,57,1694,802,892
050,01,103,"Alabama","Morgan County",5,58,1747,855,892
050,01,103,"Alabama","Morgan County",5,59,1845,951,894
050,01,103,"Alabama","Morgan County",5,60,1733,858,875
050,01,103,"Alabama","Morgan County",5,61,1665,824,841
050,01,103,"Alabama","Morgan County",5,62,1654,828,826
050,01,103,"Alabama","Morgan County",5,63,1631,828,803
050,01,103,"Alabama","Morgan County",5,64,1561,763,798
050,01,103,"Alabama","Morgan County",5,65,1553,756,797
050,01,103,"Alabama","Morgan County",5,66,1552,723,829
050,01,103,"Alabama","Morgan County",5,67,1500,717,783
050,01,103,"Alabama","Morgan County",5,68,1396,644,752
050,01,103,"Alabama","Morgan County",5,69,1406,652,754
050,01,103,"Alabama","Morgan County",5,70,1340,626,714
050,01,103,"Alabama","Morgan County",5,71,1265,586,679
050,01,103,"Alabama","Morgan County",5,72,1164,529,635
050,01,103,"Alabama","Morgan County",5,73,1108,487,621
050,01,103,"Alabama","Morgan County",5,74,1112,486,626
050,01,103,"Alabama","Morgan County",5,75,1046,443,603
050,01,103,"Alabama","Morgan County",5,76,1130,485,645
050,01,103,"Alabama","Morgan County",5,77,809,351,458
050,01,103,"Alabama","Morgan County",5,78,768,334,434
050,01,103,"Alabama","Morgan County",5,79,750,314,436
050,01,103,"Alabama","Morgan County",5,80,740,323,417
050,01,103,"Alabama","Morgan County",5,81,625,269,356
050,01,103,"Alabama","Morgan County",5,82,564,241,323
050,01,103,"Alabama","Morgan County",5,83,493,203,290
050,01,103,"Alabama","Morgan County",5,84,455,200,255
050,01,103,"Alabama","Morgan County",5,85,2264,866,1398
050,01,105,"Alabama","Perry County",1,0,85,43,42
050,01,105,"Alabama","Perry County",1,1,90,47,43
050,01,105,"Alabama","Perry County",1,2,94,47,47
050,01,105,"Alabama","Perry County",1,3,92,51,41
050,01,105,"Alabama","Perry County",1,4,104,56,48
050,01,105,"Alabama","Perry County",1,5,99,53,46
050,01,105,"Alabama","Perry County",1,6,86,43,43
050,01,105,"Alabama","Perry County",1,7,107,50,57
050,01,105,"Alabama","Perry County",1,8,89,41,48
050,01,105,"Alabama","Perry County",1,9,97,53,44
050,01,105,"Alabama","Perry County",1,10,108,54,54
050,01,105,"Alabama","Perry County",1,11,103,55,48
050,01,105,"Alabama","Perry County",1,12,113,57,56
050,01,105,"Alabama","Perry County",1,13,102,53,49
050,01,105,"Alabama","Perry County",1,14,99,51,48
050,01,105,"Alabama","Perry County",1,15,101,50,51
050,01,105,"Alabama","Perry County",1,16,115,57,58
050,01,105,"Alabama","Perry County",1,17,115,52,63
050,01,105,"Alabama","Perry County",1,18,164,93,71
050,01,105,"Alabama","Perry County",1,19,245,141,104
050,01,105,"Alabama","Perry County",1,20,217,105,112
050,01,105,"Alabama","Perry County",1,21,119,57,62
050,01,105,"Alabama","Perry County",1,22,105,50,55
050,01,105,"Alabama","Perry County",1,23,109,56,53
050,01,105,"Alabama","Perry County",1,24,100,48,52
050,01,105,"Alabama","Perry County",1,25,106,54,52
050,01,105,"Alabama","Perry County",1,26,104,50,54
050,01,105,"Alabama","Perry County",1,27,106,47,59
050,01,105,"Alabama","Perry County",1,28,100,49,51
050,01,105,"Alabama","Perry County",1,29,100,44,56
050,01,105,"Alabama","Perry County",1,30,88,37,51
050,01,105,"Alabama","Perry County",1,31,78,32,46
050,01,105,"Alabama","Perry County",1,32,78,33,45
050,01,105,"Alabama","Perry County",1,33,87,46,41
050,01,105,"Alabama","Perry County",1,34,86,49,37
050,01,105,"Alabama","Perry County",1,35,84,42,42
050,01,105,"Alabama","Perry County",1,36,85,40,45
050,01,105,"Alabama","Perry County",1,37,85,42,43
050,01,105,"Alabama","Perry County",1,38,80,30,50
050,01,105,"Alabama","Perry County",1,39,98,41,57
050,01,105,"Alabama","Perry County",1,40,104,42,62
050,01,105,"Alabama","Perry County",1,41,80,35,45
050,01,105,"Alabama","Perry County",1,42,94,39,55
050,01,105,"Alabama","Perry County",1,43,89,34,55
050,01,105,"Alabama","Perry County",1,44,89,37,52
050,01,105,"Alabama","Perry County",1,45,82,39,43
050,01,105,"Alabama","Perry County",1,46,95,41,54
050,01,105,"Alabama","Perry County",1,47,103,48,55
050,01,105,"Alabama","Perry County",1,48,99,43,56
050,01,105,"Alabama","Perry County",1,49,105,49,56
050,01,105,"Alabama","Perry County",1,50,104,55,49
050,01,105,"Alabama","Perry County",1,51,99,48,51
050,01,105,"Alabama","Perry County",1,52,96,54,42
050,01,105,"Alabama","Perry County",1,53,84,38,46
050,01,105,"Alabama","Perry County",1,54,89,43,46
050,01,105,"Alabama","Perry County",1,55,104,46,58
050,01,105,"Alabama","Perry County",1,56,108,48,60
050,01,105,"Alabama","Perry County",1,57,101,49,52
050,01,105,"Alabama","Perry County",1,58,113,47,66
050,01,105,"Alabama","Perry County",1,59,112,46,66
050,01,105,"Alabama","Perry County",1,60,113,54,59
050,01,105,"Alabama","Perry County",1,61,120,54,66
050,01,105,"Alabama","Perry County",1,62,135,65,70
050,01,105,"Alabama","Perry County",1,63,119,56,63
050,01,105,"Alabama","Perry County",1,64,115,57,58
050,01,105,"Alabama","Perry County",1,65,128,57,71
050,01,105,"Alabama","Perry County",1,66,115,46,69
050,01,105,"Alabama","Perry County",1,67,97,38,59
050,01,105,"Alabama","Perry County",1,68,95,41,54
050,01,105,"Alabama","Perry County",1,69,90,38,52
050,01,105,"Alabama","Perry County",1,70,96,39,57
050,01,105,"Alabama","Perry County",1,71,86,37,49
050,01,105,"Alabama","Perry County",1,72,90,42,48
050,01,105,"Alabama","Perry County",1,73,80,38,42
050,01,105,"Alabama","Perry County",1,74,75,33,42
050,01,105,"Alabama","Perry County",1,75,81,29,52
050,01,105,"Alabama","Perry County",1,76,79,29,50
050,01,105,"Alabama","Perry County",1,77,67,25,42
050,01,105,"Alabama","Perry County",1,78,60,23,37
050,01,105,"Alabama","Perry County",1,79,56,25,31
050,01,105,"Alabama","Perry County",1,80,66,30,36
050,01,105,"Alabama","Perry County",1,81,58,24,34
050,01,105,"Alabama","Perry County",1,82,52,23,29
050,01,105,"Alabama","Perry County",1,83,38,18,20
050,01,105,"Alabama","Perry County",1,84,31,7,24
050,01,105,"Alabama","Perry County",1,85,198,61,137
050,01,105,"Alabama","Perry County",2,0,94,49,45
050,01,105,"Alabama","Perry County",2,1,87,45,42
050,01,105,"Alabama","Perry County",2,2,92,47,45
050,01,105,"Alabama","Perry County",2,3,92,50,42
050,01,105,"Alabama","Perry County",2,4,101,54,47
050,01,105,"Alabama","Perry County",2,5,100,53,47
050,01,105,"Alabama","Perry County",2,6,89,45,44
050,01,105,"Alabama","Perry County",2,7,101,48,53
050,01,105,"Alabama","Perry County",2,8,92,43,49
050,01,105,"Alabama","Perry County",2,9,96,50,46
050,01,105,"Alabama","Perry County",2,10,102,53,49
050,01,105,"Alabama","Perry County",2,11,101,53,48
050,01,105,"Alabama","Perry County",2,12,109,56,53
050,01,105,"Alabama","Perry County",2,13,105,54,51
050,01,105,"Alabama","Perry County",2,14,100,51,49
050,01,105,"Alabama","Perry County",2,15,100,50,50
050,01,105,"Alabama","Perry County",2,16,110,54,56
050,01,105,"Alabama","Perry County",2,17,114,53,61
050,01,105,"Alabama","Perry County",2,18,162,90,72
050,01,105,"Alabama","Perry County",2,19,241,138,103
050,01,105,"Alabama","Perry County",2,20,213,103,110
050,01,105,"Alabama","Perry County",2,21,119,58,61
050,01,105,"Alabama","Perry County",2,22,106,48,58
050,01,105,"Alabama","Perry County",2,23,105,54,51
050,01,105,"Alabama","Perry County",2,24,97,47,50
050,01,105,"Alabama","Perry County",2,25,103,52,51
050,01,105,"Alabama","Perry County",2,26,104,51,53
050,01,105,"Alabama","Perry County",2,27,104,47,57
050,01,105,"Alabama","Perry County",2,28,99,48,51
050,01,105,"Alabama","Perry County",2,29,99,45,54
050,01,105,"Alabama","Perry County",2,30,90,38,52
050,01,105,"Alabama","Perry County",2,31,79,32,47
050,01,105,"Alabama","Perry County",2,32,77,32,45
050,01,105,"Alabama","Perry County",2,33,83,43,40
050,01,105,"Alabama","Perry County",2,34,87,49,38
050,01,105,"Alabama","Perry County",2,35,84,44,40
050,01,105,"Alabama","Perry County",2,36,86,42,44
050,01,105,"Alabama","Perry County",2,37,84,41,43
050,01,105,"Alabama","Perry County",2,38,80,32,48
050,01,105,"Alabama","Perry County",2,39,94,38,56
050,01,105,"Alabama","Perry County",2,40,103,42,61
050,01,105,"Alabama","Perry County",2,41,87,37,50
050,01,105,"Alabama","Perry County",2,42,88,38,50
050,01,105,"Alabama","Perry County",2,43,91,35,56
050,01,105,"Alabama","Perry County",2,44,88,36,52
050,01,105,"Alabama","Perry County",2,45,84,38,46
050,01,105,"Alabama","Perry County",2,46,91,40,51
050,01,105,"Alabama","Perry County",2,47,100,46,54
050,01,105,"Alabama","Perry County",2,48,101,45,56
050,01,105,"Alabama","Perry County",2,49,102,47,55
050,01,105,"Alabama","Perry County",2,50,103,53,50
050,01,105,"Alabama","Perry County",2,51,100,49,51
050,01,105,"Alabama","Perry County",2,52,96,52,44
050,01,105,"Alabama","Perry County",2,53,84,42,42
050,01,105,"Alabama","Perry County",2,54,86,41,45
050,01,105,"Alabama","Perry County",2,55,101,46,55
050,01,105,"Alabama","Perry County",2,56,107,48,59
050,01,105,"Alabama","Perry County",2,57,103,50,53
050,01,105,"Alabama","Perry County",2,58,111,47,64
050,01,105,"Alabama","Perry County",2,59,110,46,64
050,01,105,"Alabama","Perry County",2,60,113,52,61
050,01,105,"Alabama","Perry County",2,61,120,55,65
050,01,105,"Alabama","Perry County",2,62,126,61,65
050,01,105,"Alabama","Perry County",2,63,124,58,66
050,01,105,"Alabama","Perry County",2,64,115,57,58
050,01,105,"Alabama","Perry County",2,65,123,58,65
050,01,105,"Alabama","Perry County",2,66,117,48,69
050,01,105,"Alabama","Perry County",2,67,100,40,60
050,01,105,"Alabama","Perry County",2,68,97,41,56
050,01,105,"Alabama","Perry County",2,69,91,38,53
050,01,105,"Alabama","Perry County",2,70,97,40,57
050,01,105,"Alabama","Perry County",2,71,88,37,51
050,01,105,"Alabama","Perry County",2,72,87,40,47
050,01,105,"Alabama","Perry County",2,73,84,40,44
050,01,105,"Alabama","Perry County",2,74,73,33,40
050,01,105,"Alabama","Perry County",2,75,79,29,50
050,01,105,"Alabama","Perry County",2,76,77,28,49
050,01,105,"Alabama","Perry County",2,77,72,26,46
050,01,105,"Alabama","Perry County",2,78,60,22,38
050,01,105,"Alabama","Perry County",2,79,53,24,29
050,01,105,"Alabama","Perry County",2,80,64,29,35
050,01,105,"Alabama","Perry County",2,81,57,24,33
050,01,105,"Alabama","Perry County",2,82,53,23,30
050,01,105,"Alabama","Perry County",2,83,38,18,20
050,01,105,"Alabama","Perry County",2,84,34,10,24
050,01,105,"Alabama","Perry County",2,85,199,61,138
050,01,105,"Alabama","Perry County",3,0,96,53,43
050,01,105,"Alabama","Perry County",3,1,100,54,46
050,01,105,"Alabama","Perry County",3,2,84,42,42
050,01,105,"Alabama","Perry County",3,3,92,48,44
050,01,105,"Alabama","Perry County",3,4,94,53,41
050,01,105,"Alabama","Perry County",3,5,101,51,50
050,01,105,"Alabama","Perry County",3,6,93,51,42
050,01,105,"Alabama","Perry County",3,7,82,39,43
050,01,105,"Alabama","Perry County",3,8,103,49,54
050,01,105,"Alabama","Perry County",3,9,86,38,48
050,01,105,"Alabama","Perry County",3,10,98,54,44
050,01,105,"Alabama","Perry County",3,11,96,51,45
050,01,105,"Alabama","Perry County",3,12,107,57,50
050,01,105,"Alabama","Perry County",3,13,110,57,53
050,01,105,"Alabama","Perry County",3,14,102,53,49
050,01,105,"Alabama","Perry County",3,15,96,50,46
050,01,105,"Alabama","Perry County",3,16,94,44,50
050,01,105,"Alabama","Perry County",3,17,112,54,58
050,01,105,"Alabama","Perry County",3,18,151,82,69
050,01,105,"Alabama","Perry County",3,19,243,138,105
050,01,105,"Alabama","Perry County",3,20,210,102,108
050,01,105,"Alabama","Perry County",3,21,124,56,68
050,01,105,"Alabama","Perry County",3,22,103,44,59
050,01,105,"Alabama","Perry County",3,23,99,48,51
050,01,105,"Alabama","Perry County",3,24,97,50,47
050,01,105,"Alabama","Perry County",3,25,96,48,48
050,01,105,"Alabama","Perry County",3,26,108,51,57
050,01,105,"Alabama","Perry County",3,27,97,50,47
050,01,105,"Alabama","Perry County",3,28,103,44,59
050,01,105,"Alabama","Perry County",3,29,93,43,50
050,01,105,"Alabama","Perry County",3,30,95,47,48
050,01,105,"Alabama","Perry County",3,31,82,36,46
050,01,105,"Alabama","Perry County",3,32,76,30,46
050,01,105,"Alabama","Perry County",3,33,83,37,46
050,01,105,"Alabama","Perry County",3,34,86,44,42
050,01,105,"Alabama","Perry County",3,35,85,50,35
050,01,105,"Alabama","Perry County",3,36,83,45,38
050,01,105,"Alabama","Perry County",3,37,86,40,46
050,01,105,"Alabama","Perry County",3,38,79,34,45
050,01,105,"Alabama","Perry County",3,39,85,37,48
050,01,105,"Alabama","Perry County",3,40,92,39,53
050,01,105,"Alabama","Perry County",3,41,98,42,56
050,01,105,"Alabama","Perry County",3,42,87,37,50
050,01,105,"Alabama","Perry County",3,43,93,42,51
050,01,105,"Alabama","Perry County",3,44,90,33,57
050,01,105,"Alabama","Perry County",3,45,83,33,50
050,01,105,"Alabama","Perry County",3,46,81,37,44
050,01,105,"Alabama","Perry County",3,47,83,34,49
050,01,105,"Alabama","Perry County",3,48,102,46,56
050,01,105,"Alabama","Perry County",3,49,99,44,55
050,01,105,"Alabama","Perry County",3,50,98,42,56
050,01,105,"Alabama","Perry County",3,51,97,48,49
050,01,105,"Alabama","Perry County",3,52,101,51,50
050,01,105,"Alabama","Perry County",3,53,95,52,43
050,01,105,"Alabama","Perry County",3,54,85,38,47
050,01,105,"Alabama","Perry County",3,55,92,42,50
050,01,105,"Alabama","Perry County",3,56,102,46,56
050,01,105,"Alabama","Perry County",3,57,106,47,59
050,01,105,"Alabama","Perry County",3,58,101,44,57
050,01,105,"Alabama","Perry County",3,59,111,47,64
050,01,105,"Alabama","Perry County",3,60,110,47,63
050,01,105,"Alabama","Perry County",3,61,117,51,66
050,01,105,"Alabama","Perry County",3,62,118,56,62
050,01,105,"Alabama","Perry County",3,63,124,58,66
050,01,105,"Alabama","Perry County",3,64,118,56,62
050,01,105,"Alabama","Perry County",3,65,110,57,53
050,01,105,"Alabama","Perry County",3,66,120,53,67
050,01,105,"Alabama","Perry County",3,67,109,47,62
050,01,105,"Alabama","Perry County",3,68,103,41,62
050,01,105,"Alabama","Perry County",3,69,92,40,52
050,01,105,"Alabama","Perry County",3,70,84,36,48
050,01,105,"Alabama","Perry County",3,71,90,36,54
050,01,105,"Alabama","Perry County",3,72,84,36,48
050,01,105,"Alabama","Perry County",3,73,74,33,41
050,01,105,"Alabama","Perry County",3,74,88,41,47
050,01,105,"Alabama","Perry County",3,75,71,35,36
050,01,105,"Alabama","Perry County",3,76,74,27,47
050,01,105,"Alabama","Perry County",3,77,77,25,52
050,01,105,"Alabama","Perry County",3,78,66,22,44
050,01,105,"Alabama","Perry County",3,79,54,22,32
050,01,105,"Alabama","Perry County",3,80,53,21,32
050,01,105,"Alabama","Perry County",3,81,58,27,31
050,01,105,"Alabama","Perry County",3,82,53,24,29
050,01,105,"Alabama","Perry County",3,83,44,21,23
050,01,105,"Alabama","Perry County",3,84,34,16,18
050,01,105,"Alabama","Perry County",3,85,197,54,143
050,01,105,"Alabama","Perry County",4,0,88,45,43
050,01,105,"Alabama","Perry County",4,1,94,50,44
050,01,105,"Alabama","Perry County",4,2,97,55,42
050,01,105,"Alabama","Perry County",4,3,86,40,46
050,01,105,"Alabama","Perry County",4,4,89,47,42
050,01,105,"Alabama","Perry County",4,5,89,53,36
050,01,105,"Alabama","Perry County",4,6,96,52,44
050,01,105,"Alabama","Perry County",4,7,91,48,43
050,01,105,"Alabama","Perry County",4,8,81,37,44
050,01,105,"Alabama","Perry County",4,9,97,44,53
050,01,105,"Alabama","Perry County",4,10,89,38,51
050,01,105,"Alabama","Perry County",4,11,93,50,43
050,01,105,"Alabama","Perry County",4,12,95,51,44
050,01,105,"Alabama","Perry County",4,13,103,56,47
050,01,105,"Alabama","Perry County",4,14,112,57,55
050,01,105,"Alabama","Perry County",4,15,103,53,50
050,01,105,"Alabama","Perry County",4,16,99,53,46
050,01,105,"Alabama","Perry County",4,17,91,42,49
050,01,105,"Alabama","Perry County",4,18,125,66,59
050,01,105,"Alabama","Perry County",4,19,146,81,65
050,01,105,"Alabama","Perry County",4,20,146,73,73
050,01,105,"Alabama","Perry County",4,21,112,53,59
050,01,105,"Alabama","Perry County",4,22,107,46,61
050,01,105,"Alabama","Perry County",4,23,91,44,47
050,01,105,"Alabama","Perry County",4,24,86,38,48
050,01,105,"Alabama","Perry County",4,25,91,50,41
050,01,105,"Alabama","Perry County",4,26,94,47,47
050,01,105,"Alabama","Perry County",4,27,102,52,50
050,01,105,"Alabama","Perry County",4,28,87,47,40
050,01,105,"Alabama","Perry County",4,29,106,48,58
050,01,105,"Alabama","Perry County",4,30,95,44,51
050,01,105,"Alabama","Perry County",4,31,84,37,47
050,01,105,"Alabama","Perry County",4,32,76,36,40
050,01,105,"Alabama","Perry County",4,33,70,26,44
050,01,105,"Alabama","Perry County",4,34,81,33,48
050,01,105,"Alabama","Perry County",4,35,81,45,36
050,01,105,"Alabama","Perry County",4,36,79,45,34
050,01,105,"Alabama","Perry County",4,37,79,37,42
050,01,105,"Alabama","Perry County",4,38,82,38,44
050,01,105,"Alabama","Perry County",4,39,74,33,41
050,01,105,"Alabama","Perry County",4,40,84,36,48
050,01,105,"Alabama","Perry County",4,41,92,39,53
050,01,105,"Alabama","Perry County",4,42,92,38,54
050,01,105,"Alabama","Perry County",4,43,80,34,46
050,01,105,"Alabama","Perry County",4,44,85,38,47
050,01,105,"Alabama","Perry County",4,45,94,35,59
050,01,105,"Alabama","Perry County",4,46,81,32,49
050,01,105,"Alabama","Perry County",4,47,85,42,43
050,01,105,"Alabama","Perry County",4,48,83,36,47
050,01,105,"Alabama","Perry County",4,49,98,44,54
050,01,105,"Alabama","Perry County",4,50,96,43,53
050,01,105,"Alabama","Perry County",4,51,95,37,58
050,01,105,"Alabama","Perry County",4,52,101,49,52
050,01,105,"Alabama","Perry County",4,53,97,47,50
050,01,105,"Alabama","Perry County",4,54,93,47,46
050,01,105,"Alabama","Perry County",4,55,86,41,45
050,01,105,"Alabama","Perry County",4,56,84,39,45
050,01,105,"Alabama","Perry County",4,57,101,50,51
050,01,105,"Alabama","Perry County",4,58,100,39,61
050,01,105,"Alabama","Perry County",4,59,102,45,57
050,01,105,"Alabama","Perry County",4,60,107,46,61
050,01,105,"Alabama","Perry County",4,61,103,40,63
050,01,105,"Alabama","Perry County",4,62,117,51,66
050,01,105,"Alabama","Perry County",4,63,116,56,60
050,01,105,"Alabama","Perry County",4,64,114,54,60
050,01,105,"Alabama","Perry County",4,65,113,55,58
050,01,105,"Alabama","Perry County",4,66,115,59,56
050,01,105,"Alabama","Perry County",4,67,109,51,58
050,01,105,"Alabama","Perry County",4,68,109,47,62
050,01,105,"Alabama","Perry County",4,69,93,37,56
050,01,105,"Alabama","Perry County",4,70,92,41,51
050,01,105,"Alabama","Perry County",4,71,81,34,47
050,01,105,"Alabama","Perry County",4,72,90,36,54
050,01,105,"Alabama","Perry County",4,73,71,31,40
050,01,105,"Alabama","Perry County",4,74,72,31,41
050,01,105,"Alabama","Perry County",4,75,82,41,41
050,01,105,"Alabama","Perry County",4,76,66,33,33
050,01,105,"Alabama","Perry County",4,77,72,25,47
050,01,105,"Alabama","Perry County",4,78,73,23,50
050,01,105,"Alabama","Perry County",4,79,59,21,38
050,01,105,"Alabama","Perry County",4,80,57,20,37
050,01,105,"Alabama","Perry County",4,81,46,19,27
050,01,105,"Alabama","Perry County",4,82,55,29,26
050,01,105,"Alabama","Perry County",4,83,46,21,25
050,01,105,"Alabama","Perry County",4,84,41,21,20
050,01,105,"Alabama","Perry County",4,85,189,52,137
050,01,105,"Alabama","Perry County",5,0,86,43,43
050,01,105,"Alabama","Perry County",5,1,91,45,46
050,01,105,"Alabama","Perry County",5,2,89,50,39
050,01,105,"Alabama","Perry County",5,3,103,57,46
050,01,105,"Alabama","Perry County",5,4,85,42,43
050,01,105,"Alabama","Perry County",5,5,86,47,39
050,01,105,"Alabama","Perry County",5,6,90,52,38
050,01,105,"Alabama","Perry County",5,7,92,49,43
050,01,105,"Alabama","Perry County",5,8,90,45,45
050,01,105,"Alabama","Perry County",5,9,74,38,36
050,01,105,"Alabama","Perry County",5,10,89,38,51
050,01,105,"Alabama","Perry County",5,11,88,40,48
050,01,105,"Alabama","Perry County",5,12,97,52,45
050,01,105,"Alabama","Perry County",5,13,94,50,44
050,01,105,"Alabama","Perry County",5,14,101,56,45
050,01,105,"Alabama","Perry County",5,15,113,56,57
050,01,105,"Alabama","Perry County",5,16,95,48,47
050,01,105,"Alabama","Perry County",5,17,94,48,46
050,01,105,"Alabama","Perry County",5,18,109,57,52
050,01,105,"Alabama","Perry County",5,19,155,85,70
050,01,105,"Alabama","Perry County",5,20,132,67,65
050,01,105,"Alabama","Perry County",5,21,100,51,49
050,01,105,"Alabama","Perry County",5,22,112,51,61
050,01,105,"Alabama","Perry County",5,23,98,39,59
050,01,105,"Alabama","Perry County",5,24,89,44,45
050,01,105,"Alabama","Perry County",5,25,82,34,48
050,01,105,"Alabama","Perry County",5,26,88,45,43
050,01,105,"Alabama","Perry County",5,27,81,41,40
050,01,105,"Alabama","Perry County",5,28,96,45,51
050,01,105,"Alabama","Perry County",5,29,86,46,40
050,01,105,"Alabama","Perry County",5,30,107,48,59
050,01,105,"Alabama","Perry County",5,31,99,52,47
050,01,105,"Alabama","Perry County",5,32,83,35,48
050,01,105,"Alabama","Perry County",5,33,71,34,37
050,01,105,"Alabama","Perry County",5,34,69,24,45
050,01,105,"Alabama","Perry County",5,35,76,28,48
050,01,105,"Alabama","Perry County",5,36,75,40,35
050,01,105,"Alabama","Perry County",5,37,80,49,31
050,01,105,"Alabama","Perry County",5,38,77,38,39
050,01,105,"Alabama","Perry County",5,39,85,41,44
050,01,105,"Alabama","Perry County",5,40,77,34,43
050,01,105,"Alabama","Perry County",5,41,79,33,46
050,01,105,"Alabama","Perry County",5,42,92,39,53
050,01,105,"Alabama","Perry County",5,43,89,38,51
050,01,105,"Alabama","Perry County",5,44,81,35,46
050,01,105,"Alabama","Perry County",5,45,84,38,46
050,01,105,"Alabama","Perry County",5,46,96,37,59
050,01,105,"Alabama","Perry County",5,47,86,32,54
050,01,105,"Alabama","Perry County",5,48,85,41,44
050,01,105,"Alabama","Perry County",5,49,83,37,46
050,01,105,"Alabama","Perry County",5,50,98,44,54
050,01,105,"Alabama","Perry County",5,51,94,41,53
050,01,105,"Alabama","Perry County",5,52,93,39,54
050,01,105,"Alabama","Perry County",5,53,101,51,50
050,01,105,"Alabama","Perry County",5,54,95,46,49
050,01,105,"Alabama","Perry County",5,55,95,49,46
050,01,105,"Alabama","Perry County",5,56,79,40,39
050,01,105,"Alabama","Perry County",5,57,88,43,45
050,01,105,"Alabama","Perry County",5,58,97,45,52
050,01,105,"Alabama","Perry County",5,59,95,38,57
050,01,105,"Alabama","Perry County",5,60,97,44,53
050,01,105,"Alabama","Perry County",5,61,99,39,60
050,01,105,"Alabama","Perry County",5,62,103,42,61
050,01,105,"Alabama","Perry County",5,63,112,45,67
050,01,105,"Alabama","Perry County",5,64,111,52,59
050,01,105,"Alabama","Perry County",5,65,110,51,59
050,01,105,"Alabama","Perry County",5,66,109,52,57
050,01,105,"Alabama","Perry County",5,67,106,55,51
050,01,105,"Alabama","Perry County",5,68,110,48,62
050,01,105,"Alabama","Perry County",5,69,100,45,55
050,01,105,"Alabama","Perry County",5,70,92,37,55
050,01,105,"Alabama","Perry County",5,71,87,39,48
050,01,105,"Alabama","Perry County",5,72,76,32,44
050,01,105,"Alabama","Perry County",5,73,83,35,48
050,01,105,"Alabama","Perry County",5,74,70,29,41
050,01,105,"Alabama","Perry County",5,75,65,31,34
050,01,105,"Alabama","Perry County",5,76,73,36,37
050,01,105,"Alabama","Perry County",5,77,64,31,33
050,01,105,"Alabama","Perry County",5,78,67,22,45
050,01,105,"Alabama","Perry County",5,79,66,20,46
050,01,105,"Alabama","Perry County",5,80,61,18,43
050,01,105,"Alabama","Perry County",5,81,52,18,34
050,01,105,"Alabama","Perry County",5,82,46,20,26
050,01,105,"Alabama","Perry County",5,83,47,25,22
050,01,105,"Alabama","Perry County",5,84,45,21,24
050,01,105,"Alabama","Perry County",5,85,193,55,138
050,01,107,"Alabama","Pickens County",1,0,201,103,98
050,01,107,"Alabama","Pickens County",1,1,225,115,110
050,01,107,"Alabama","Pickens County",1,2,188,109,79
050,01,107,"Alabama","Pickens County",1,3,191,96,95
050,01,107,"Alabama","Pickens County",1,4,202,110,92
050,01,107,"Alabama","Pickens County",1,5,196,100,96
050,01,107,"Alabama","Pickens County",1,6,197,104,93
050,01,107,"Alabama","Pickens County",1,7,184,97,87
050,01,107,"Alabama","Pickens County",1,8,202,106,96
050,01,107,"Alabama","Pickens County",1,9,197,102,95
050,01,107,"Alabama","Pickens County",1,10,219,112,107
050,01,107,"Alabama","Pickens County",1,11,225,102,123
050,01,107,"Alabama","Pickens County",1,12,221,108,113
050,01,107,"Alabama","Pickens County",1,13,210,117,93
050,01,107,"Alabama","Pickens County",1,14,201,117,84
050,01,107,"Alabama","Pickens County",1,15,220,124,96
050,01,107,"Alabama","Pickens County",1,16,214,114,100
050,01,107,"Alabama","Pickens County",1,17,241,135,106
050,01,107,"Alabama","Pickens County",1,18,219,116,103
050,01,107,"Alabama","Pickens County",1,19,240,155,85
050,01,107,"Alabama","Pickens County",1,20,200,86,114
050,01,107,"Alabama","Pickens County",1,21,255,162,93
050,01,107,"Alabama","Pickens County",1,22,233,131,102
050,01,107,"Alabama","Pickens County",1,23,193,98,95
050,01,107,"Alabama","Pickens County",1,24,283,188,95
050,01,107,"Alabama","Pickens County",1,25,270,128,142
050,01,107,"Alabama","Pickens County",1,26,265,161,104
050,01,107,"Alabama","Pickens County",1,27,257,134,123
050,01,107,"Alabama","Pickens County",1,28,198,99,99
050,01,107,"Alabama","Pickens County",1,29,247,114,133
050,01,107,"Alabama","Pickens County",1,30,218,96,122
050,01,107,"Alabama","Pickens County",1,31,283,158,125
050,01,107,"Alabama","Pickens County",1,32,198,91,107
050,01,107,"Alabama","Pickens County",1,33,269,136,133
050,01,107,"Alabama","Pickens County",1,34,305,193,112
050,01,107,"Alabama","Pickens County",1,35,272,160,112
050,01,107,"Alabama","Pickens County",1,36,287,124,163
050,01,107,"Alabama","Pickens County",1,37,238,129,109
050,01,107,"Alabama","Pickens County",1,38,197,91,106
050,01,107,"Alabama","Pickens County",1,39,246,142,104
050,01,107,"Alabama","Pickens County",1,40,224,115,109
050,01,107,"Alabama","Pickens County",1,41,275,140,135
050,01,107,"Alabama","Pickens County",1,42,180,82,98
050,01,107,"Alabama","Pickens County",1,43,209,108,101
050,01,107,"Alabama","Pickens County",1,44,190,80,110
050,01,107,"Alabama","Pickens County",1,45,239,112,127
050,01,107,"Alabama","Pickens County",1,46,226,133,93
050,01,107,"Alabama","Pickens County",1,47,305,151,154
050,01,107,"Alabama","Pickens County",1,48,244,106,138
050,01,107,"Alabama","Pickens County",1,49,241,115,126
050,01,107,"Alabama","Pickens County",1,50,203,88,115
050,01,107,"Alabama","Pickens County",1,51,228,94,134
050,01,107,"Alabama","Pickens County",1,52,290,133,157
050,01,107,"Alabama","Pickens County",1,53,256,127,129
050,01,107,"Alabama","Pickens County",1,54,257,129,128
050,01,107,"Alabama","Pickens County",1,55,266,121,145
050,01,107,"Alabama","Pickens County",1,56,316,164,152
050,01,107,"Alabama","Pickens County",1,57,270,135,135
050,01,107,"Alabama","Pickens County",1,58,273,139,134
050,01,107,"Alabama","Pickens County",1,59,332,180,152
050,01,107,"Alabama","Pickens County",1,60,280,142,138
050,01,107,"Alabama","Pickens County",1,61,267,130,137
050,01,107,"Alabama","Pickens County",1,62,276,137,139
050,01,107,"Alabama","Pickens County",1,63,251,121,130
050,01,107,"Alabama","Pickens County",1,64,244,114,130
050,01,107,"Alabama","Pickens County",1,65,254,125,129
050,01,107,"Alabama","Pickens County",1,66,254,109,145
050,01,107,"Alabama","Pickens County",1,67,251,139,112
050,01,107,"Alabama","Pickens County",1,68,226,114,112
050,01,107,"Alabama","Pickens County",1,69,208,102,106
050,01,107,"Alabama","Pickens County",1,70,229,104,125
050,01,107,"Alabama","Pickens County",1,71,213,106,107
050,01,107,"Alabama","Pickens County",1,72,191,84,107
050,01,107,"Alabama","Pickens County",1,73,186,88,98
050,01,107,"Alabama","Pickens County",1,74,148,64,84
050,01,107,"Alabama","Pickens County",1,75,146,66,80
050,01,107,"Alabama","Pickens County",1,76,149,60,89
050,01,107,"Alabama","Pickens County",1,77,143,57,86
050,01,107,"Alabama","Pickens County",1,78,123,52,71
050,01,107,"Alabama","Pickens County",1,79,122,65,57
050,01,107,"Alabama","Pickens County",1,80,106,46,60
050,01,107,"Alabama","Pickens County",1,81,113,50,63
050,01,107,"Alabama","Pickens County",1,82,95,41,54
050,01,107,"Alabama","Pickens County",1,83,74,31,43
050,01,107,"Alabama","Pickens County",1,84,85,37,48
050,01,107,"Alabama","Pickens County",1,85,365,133,232
050,01,107,"Alabama","Pickens County",2,0,186,101,85
050,01,107,"Alabama","Pickens County",2,1,218,112,106
050,01,107,"Alabama","Pickens County",2,2,196,109,87
050,01,107,"Alabama","Pickens County",2,3,190,99,91
050,01,107,"Alabama","Pickens County",2,4,199,106,93
050,01,107,"Alabama","Pickens County",2,5,195,101,94
050,01,107,"Alabama","Pickens County",2,6,194,101,93
050,01,107,"Alabama","Pickens County",2,7,189,100,89
050,01,107,"Alabama","Pickens County",2,8,198,104,94
050,01,107,"Alabama","Pickens County",2,9,198,103,95
050,01,107,"Alabama","Pickens County",2,10,212,108,104
050,01,107,"Alabama","Pickens County",2,11,223,105,118
050,01,107,"Alabama","Pickens County",2,12,222,107,115
050,01,107,"Alabama","Pickens County",2,13,213,115,98
050,01,107,"Alabama","Pickens County",2,14,204,117,87
050,01,107,"Alabama","Pickens County",2,15,215,122,93
050,01,107,"Alabama","Pickens County",2,16,214,115,99
050,01,107,"Alabama","Pickens County",2,17,237,132,105
050,01,107,"Alabama","Pickens County",2,18,208,112,96
050,01,107,"Alabama","Pickens County",2,19,238,154,84
050,01,107,"Alabama","Pickens County",2,20,200,88,112
050,01,107,"Alabama","Pickens County",2,21,255,159,96
050,01,107,"Alabama","Pickens County",2,22,229,129,100
050,01,107,"Alabama","Pickens County",2,23,196,98,98
050,01,107,"Alabama","Pickens County",2,24,277,183,94
050,01,107,"Alabama","Pickens County",2,25,264,127,137
050,01,107,"Alabama","Pickens County",2,26,256,153,103
050,01,107,"Alabama","Pickens County",2,27,253,133,120
050,01,107,"Alabama","Pickens County",2,28,199,99,100
050,01,107,"Alabama","Pickens County",2,29,238,108,130
050,01,107,"Alabama","Pickens County",2,30,220,101,119
050,01,107,"Alabama","Pickens County",2,31,281,153,128
050,01,107,"Alabama","Pickens County",2,32,198,92,106
050,01,107,"Alabama","Pickens County",2,33,267,134,133
050,01,107,"Alabama","Pickens County",2,34,296,184,112
050,01,107,"Alabama","Pickens County",2,35,262,153,109
050,01,107,"Alabama","Pickens County",2,36,281,123,158
050,01,107,"Alabama","Pickens County",2,37,241,131,110
050,01,107,"Alabama","Pickens County",2,38,199,90,109
050,01,107,"Alabama","Pickens County",2,39,243,139,104
050,01,107,"Alabama","Pickens County",2,40,221,113,108
050,01,107,"Alabama","Pickens County",2,41,275,139,136
050,01,107,"Alabama","Pickens County",2,42,180,84,96
050,01,107,"Alabama","Pickens County",2,43,208,106,102
050,01,107,"Alabama","Pickens County",2,44,186,78,108
050,01,107,"Alabama","Pickens County",2,45,237,111,126
050,01,107,"Alabama","Pickens County",2,46,221,126,95
050,01,107,"Alabama","Pickens County",2,47,292,145,147
050,01,107,"Alabama","Pickens County",2,48,237,105,132
050,01,107,"Alabama","Pickens County",2,49,240,116,124
050,01,107,"Alabama","Pickens County",2,50,208,90,118
050,01,107,"Alabama","Pickens County",2,51,225,91,134
050,01,107,"Alabama","Pickens County",2,52,278,128,150
050,01,107,"Alabama","Pickens County",2,53,250,123,127
050,01,107,"Alabama","Pickens County",2,54,255,128,127
050,01,107,"Alabama","Pickens County",2,55,266,123,143
050,01,107,"Alabama","Pickens County",2,56,310,160,150
050,01,107,"Alabama","Pickens County",2,57,275,134,141
050,01,107,"Alabama","Pickens County",2,58,274,139,135
050,01,107,"Alabama","Pickens County",2,59,324,176,148
050,01,107,"Alabama","Pickens County",2,60,280,139,141
050,01,107,"Alabama","Pickens County",2,61,266,128,138
050,01,107,"Alabama","Pickens County",2,62,273,135,138
050,01,107,"Alabama","Pickens County",2,63,257,126,131
050,01,107,"Alabama","Pickens County",2,64,245,115,130
050,01,107,"Alabama","Pickens County",2,65,254,123,131
050,01,107,"Alabama","Pickens County",2,66,254,113,141
050,01,107,"Alabama","Pickens County",2,67,254,134,120
050,01,107,"Alabama","Pickens County",2,68,223,112,111
050,01,107,"Alabama","Pickens County",2,69,209,101,108
050,01,107,"Alabama","Pickens County",2,70,226,103,123
050,01,107,"Alabama","Pickens County",2,71,207,103,104
050,01,107,"Alabama","Pickens County",2,72,191,86,105
050,01,107,"Alabama","Pickens County",2,73,195,90,105
050,01,107,"Alabama","Pickens County",2,74,145,65,80
050,01,107,"Alabama","Pickens County",2,75,143,65,78
050,01,107,"Alabama","Pickens County",2,76,144,59,85
050,01,107,"Alabama","Pickens County",2,77,146,58,88
050,01,107,"Alabama","Pickens County",2,78,122,52,70
050,01,107,"Alabama","Pickens County",2,79,123,63,60
050,01,107,"Alabama","Pickens County",2,80,110,49,61
050,01,107,"Alabama","Pickens County",2,81,109,49,60
050,01,107,"Alabama","Pickens County",2,82,100,43,57
050,01,107,"Alabama","Pickens County",2,83,75,31,44
050,01,107,"Alabama","Pickens County",2,84,80,36,44
050,01,107,"Alabama","Pickens County",2,85,372,139,233
050,01,107,"Alabama","Pickens County",3,0,165,89,76
050,01,107,"Alabama","Pickens County",3,1,178,93,85
050,01,107,"Alabama","Pickens County",3,2,211,104,107
050,01,107,"Alabama","Pickens County",3,3,192,107,85
050,01,107,"Alabama","Pickens County",3,4,193,106,87
050,01,107,"Alabama","Pickens County",3,5,192,96,96
050,01,107,"Alabama","Pickens County",3,6,195,103,92
050,01,107,"Alabama","Pickens County",3,7,198,107,91
050,01,107,"Alabama","Pickens County",3,8,185,98,87
050,01,107,"Alabama","Pickens County",3,9,199,105,94
050,01,107,"Alabama","Pickens County",3,10,197,103,94
050,01,107,"Alabama","Pickens County",3,11,206,103,103
050,01,107,"Alabama","Pickens County",3,12,217,101,116
050,01,107,"Alabama","Pickens County",3,13,226,107,119
050,01,107,"Alabama","Pickens County",3,14,208,108,100
050,01,107,"Alabama","Pickens County",3,15,201,112,89
050,01,107,"Alabama","Pickens County",3,16,210,118,92
050,01,107,"Alabama","Pickens County",3,17,227,128,99
050,01,107,"Alabama","Pickens County",3,18,186,99,87
050,01,107,"Alabama","Pickens County",3,19,228,150,78
050,01,107,"Alabama","Pickens County",3,20,194,95,99
050,01,107,"Alabama","Pickens County",3,21,245,151,94
050,01,107,"Alabama","Pickens County",3,22,215,119,96
050,01,107,"Alabama","Pickens County",3,23,200,97,103
050,01,107,"Alabama","Pickens County",3,24,283,179,104
050,01,107,"Alabama","Pickens County",3,25,249,127,122
050,01,107,"Alabama","Pickens County",3,26,245,146,99
050,01,107,"Alabama","Pickens County",3,27,249,130,119
050,01,107,"Alabama","Pickens County",3,28,210,109,101
050,01,107,"Alabama","Pickens County",3,29,207,95,112
050,01,107,"Alabama","Pickens County",3,30,207,109,98
050,01,107,"Alabama","Pickens County",3,31,295,156,139
050,01,107,"Alabama","Pickens County",3,32,198,92,106
050,01,107,"Alabama","Pickens County",3,33,258,124,134
050,01,107,"Alabama","Pickens County",3,34,303,191,112
050,01,107,"Alabama","Pickens County",3,35,229,129,100
050,01,107,"Alabama","Pickens County",3,36,270,126,144
050,01,107,"Alabama","Pickens County",3,37,248,138,110
050,01,107,"Alabama","Pickens County",3,38,205,94,111
050,01,107,"Alabama","Pickens County",3,39,249,134,115
050,01,107,"Alabama","Pickens County",3,40,224,112,112
050,01,107,"Alabama","Pickens County",3,41,284,139,145
050,01,107,"Alabama","Pickens County",3,42,195,96,99
050,01,107,"Alabama","Pickens County",3,43,214,113,101
050,01,107,"Alabama","Pickens County",3,44,185,75,110
050,01,107,"Alabama","Pickens County",3,45,236,113,123
050,01,107,"Alabama","Pickens County",3,46,212,109,103
050,01,107,"Alabama","Pickens County",3,47,265,128,137
050,01,107,"Alabama","Pickens County",3,48,220,109,111
050,01,107,"Alabama","Pickens County",3,49,237,123,114
050,01,107,"Alabama","Pickens County",3,50,219,97,122
050,01,107,"Alabama","Pickens County",3,51,240,96,144
050,01,107,"Alabama","Pickens County",3,52,262,119,143
050,01,107,"Alabama","Pickens County",3,53,218,109,109
050,01,107,"Alabama","Pickens County",3,54,253,126,127
050,01,107,"Alabama","Pickens County",3,55,258,124,134
050,01,107,"Alabama","Pickens County",3,56,282,146,136
050,01,107,"Alabama","Pickens County",3,57,272,124,148
050,01,107,"Alabama","Pickens County",3,58,276,134,142
050,01,107,"Alabama","Pickens County",3,59,297,169,128
050,01,107,"Alabama","Pickens County",3,60,280,134,146
050,01,107,"Alabama","Pickens County",3,61,276,138,138
050,01,107,"Alabama","Pickens County",3,62,261,123,138
050,01,107,"Alabama","Pickens County",3,63,262,131,131
050,01,107,"Alabama","Pickens County",3,64,242,115,127
050,01,107,"Alabama","Pickens County",3,65,244,112,132
050,01,107,"Alabama","Pickens County",3,66,250,119,131
050,01,107,"Alabama","Pickens County",3,67,257,122,135
050,01,107,"Alabama","Pickens County",3,68,231,110,121
050,01,107,"Alabama","Pickens County",3,69,218,107,111
050,01,107,"Alabama","Pickens County",3,70,211,93,118
050,01,107,"Alabama","Pickens County",3,71,199,98,101
050,01,107,"Alabama","Pickens County",3,72,193,98,95
050,01,107,"Alabama","Pickens County",3,73,182,79,103
050,01,107,"Alabama","Pickens County",3,74,184,84,100
050,01,107,"Alabama","Pickens County",3,75,138,62,76
050,01,107,"Alabama","Pickens County",3,76,136,61,75
050,01,107,"Alabama","Pickens County",3,77,129,49,80
050,01,107,"Alabama","Pickens County",3,78,140,56,84
050,01,107,"Alabama","Pickens County",3,79,120,54,66
050,01,107,"Alabama","Pickens County",3,80,117,54,63
050,01,107,"Alabama","Pickens County",3,81,92,41,51
050,01,107,"Alabama","Pickens County",3,82,104,48,56
050,01,107,"Alabama","Pickens County",3,83,91,40,51
050,01,107,"Alabama","Pickens County",3,84,69,29,40
050,01,107,"Alabama","Pickens County",3,85,370,145,225
050,01,107,"Alabama","Pickens County",4,0,176,98,78
050,01,107,"Alabama","Pickens County",4,1,179,101,78
050,01,107,"Alabama","Pickens County",4,2,176,92,84
050,01,107,"Alabama","Pickens County",4,3,192,94,98
050,01,107,"Alabama","Pickens County",4,4,190,109,81
050,01,107,"Alabama","Pickens County",4,5,192,108,84
050,01,107,"Alabama","Pickens County",4,6,198,100,98
050,01,107,"Alabama","Pickens County",4,7,196,102,94
050,01,107,"Alabama","Pickens County",4,8,189,95,94
050,01,107,"Alabama","Pickens County",4,9,189,104,85
050,01,107,"Alabama","Pickens County",4,10,202,106,96
050,01,107,"Alabama","Pickens County",4,11,195,102,93
050,01,107,"Alabama","Pickens County",4,12,210,108,102
050,01,107,"Alabama","Pickens County",4,13,221,103,118
050,01,107,"Alabama","Pickens County",4,14,221,103,118
050,01,107,"Alabama","Pickens County",4,15,207,104,103
050,01,107,"Alabama","Pickens County",4,16,198,111,87
050,01,107,"Alabama","Pickens County",4,17,231,139,92
050,01,107,"Alabama","Pickens County",4,18,178,98,80
050,01,107,"Alabama","Pickens County",4,19,224,153,71
050,01,107,"Alabama","Pickens County",4,20,192,97,95
050,01,107,"Alabama","Pickens County",4,21,263,178,85
050,01,107,"Alabama","Pickens County",4,22,220,126,94
050,01,107,"Alabama","Pickens County",4,23,197,93,104
050,01,107,"Alabama","Pickens County",4,24,306,204,102
050,01,107,"Alabama","Pickens County",4,25,276,139,137
050,01,107,"Alabama","Pickens County",4,26,239,154,85
050,01,107,"Alabama","Pickens County",4,27,236,120,116
050,01,107,"Alabama","Pickens County",4,28,188,88,100
050,01,107,"Alabama","Pickens County",4,29,233,102,131
050,01,107,"Alabama","Pickens County",4,30,184,94,90
050,01,107,"Alabama","Pickens County",4,31,293,170,123
050,01,107,"Alabama","Pickens County",4,32,226,108,118
050,01,107,"Alabama","Pickens County",4,33,283,146,137
050,01,107,"Alabama","Pickens County",4,34,311,203,108
050,01,107,"Alabama","Pickens County",4,35,254,149,105
050,01,107,"Alabama","Pickens County",4,36,264,114,150
050,01,107,"Alabama","Pickens County",4,37,262,150,112
050,01,107,"Alabama","Pickens County",4,38,220,106,114
050,01,107,"Alabama","Pickens County",4,39,257,146,111
050,01,107,"Alabama","Pickens County",4,40,230,113,117
050,01,107,"Alabama","Pickens County",4,41,307,155,152
050,01,107,"Alabama","Pickens County",4,42,203,90,113
050,01,107,"Alabama","Pickens County",4,43,234,130,104
050,01,107,"Alabama","Pickens County",4,44,194,84,110
050,01,107,"Alabama","Pickens County",4,45,260,127,133
050,01,107,"Alabama","Pickens County",4,46,220,123,97
050,01,107,"Alabama","Pickens County",4,47,277,125,152
050,01,107,"Alabama","Pickens County",4,48,197,87,110
050,01,107,"Alabama","Pickens County",4,49,228,133,95
050,01,107,"Alabama","Pickens County",4,50,218,108,110
050,01,107,"Alabama","Pickens County",4,51,248,95,153
050,01,107,"Alabama","Pickens County",4,52,284,127,157
050,01,107,"Alabama","Pickens County",4,53,199,94,105
050,01,107,"Alabama","Pickens County",4,54,211,104,107
050,01,107,"Alabama","Pickens County",4,55,254,123,131
050,01,107,"Alabama","Pickens County",4,56,284,158,126
050,01,107,"Alabama","Pickens County",4,57,256,118,138
050,01,107,"Alabama","Pickens County",4,58,268,121,147
050,01,107,"Alabama","Pickens County",4,59,314,175,139
050,01,107,"Alabama","Pickens County",4,60,257,131,126
050,01,107,"Alabama","Pickens County",4,61,276,132,144
050,01,107,"Alabama","Pickens County",4,62,273,140,133
050,01,107,"Alabama","Pickens County",4,63,256,120,136
050,01,107,"Alabama","Pickens County",4,64,256,127,129
050,01,107,"Alabama","Pickens County",4,65,240,116,124
050,01,107,"Alabama","Pickens County",4,66,227,102,125
050,01,107,"Alabama","Pickens County",4,67,261,135,126
050,01,107,"Alabama","Pickens County",4,68,236,105,131
050,01,107,"Alabama","Pickens County",4,69,227,105,122
050,01,107,"Alabama","Pickens County",4,70,231,103,128
050,01,107,"Alabama","Pickens County",4,71,186,88,98
050,01,107,"Alabama","Pickens County",4,72,185,92,93
050,01,107,"Alabama","Pickens County",4,73,187,95,92
050,01,107,"Alabama","Pickens County",4,74,173,71,102
050,01,107,"Alabama","Pickens County",4,75,172,79,93
050,01,107,"Alabama","Pickens County",4,76,138,62,76
050,01,107,"Alabama","Pickens County",4,77,123,55,68
050,01,107,"Alabama","Pickens County",4,78,126,45,81
050,01,107,"Alabama","Pickens County",4,79,130,56,74
050,01,107,"Alabama","Pickens County",4,80,109,45,64
050,01,107,"Alabama","Pickens County",4,81,105,53,52
050,01,107,"Alabama","Pickens County",4,82,82,36,46
050,01,107,"Alabama","Pickens County",4,83,92,41,51
050,01,107,"Alabama","Pickens County",4,84,80,35,45
050,01,107,"Alabama","Pickens County",4,85,367,147,220
050,01,107,"Alabama","Pickens County",5,0,182,101,81
050,01,107,"Alabama","Pickens County",5,1,171,98,73
050,01,107,"Alabama","Pickens County",5,2,179,102,77
050,01,107,"Alabama","Pickens County",5,3,174,90,84
050,01,107,"Alabama","Pickens County",5,4,190,95,95
050,01,107,"Alabama","Pickens County",5,5,192,108,84
050,01,107,"Alabama","Pickens County",5,6,180,97,83
050,01,107,"Alabama","Pickens County",5,7,193,98,95
050,01,107,"Alabama","Pickens County",5,8,203,110,93
050,01,107,"Alabama","Pickens County",5,9,189,101,88
050,01,107,"Alabama","Pickens County",5,10,194,105,89
050,01,107,"Alabama","Pickens County",5,11,196,105,91
050,01,107,"Alabama","Pickens County",5,12,208,111,97
050,01,107,"Alabama","Pickens County",5,13,216,109,107
050,01,107,"Alabama","Pickens County",5,14,217,101,116
050,01,107,"Alabama","Pickens County",5,15,223,107,116
050,01,107,"Alabama","Pickens County",5,16,204,101,103
050,01,107,"Alabama","Pickens County",5,17,223,137,86
050,01,107,"Alabama","Pickens County",5,18,179,103,76
050,01,107,"Alabama","Pickens County",5,19,220,151,69
050,01,107,"Alabama","Pickens County",5,20,183,83,100
050,01,107,"Alabama","Pickens County",5,21,270,183,87
050,01,107,"Alabama","Pickens County",5,22,224,137,87
050,01,107,"Alabama","Pickens County",5,23,187,88,99
050,01,107,"Alabama","Pickens County",5,24,306,203,103
050,01,107,"Alabama","Pickens County",5,25,290,148,142
050,01,107,"Alabama","Pickens County",5,26,249,160,89
050,01,107,"Alabama","Pickens County",5,27,239,133,106
050,01,107,"Alabama","Pickens County",5,28,159,74,85
050,01,107,"Alabama","Pickens County",5,29,229,90,139
050,01,107,"Alabama","Pickens County",5,30,202,92,110
050,01,107,"Alabama","Pickens County",5,31,268,162,106
050,01,107,"Alabama","Pickens County",5,32,210,106,104
050,01,107,"Alabama","Pickens County",5,33,318,163,155
050,01,107,"Alabama","Pickens County",5,34,338,214,124
050,01,107,"Alabama","Pickens County",5,35,232,139,93
050,01,107,"Alabama","Pickens County",5,36,277,120,157
050,01,107,"Alabama","Pickens County",5,37,227,130,97
050,01,107,"Alabama","Pickens County",5,38,213,106,107
050,01,107,"Alabama","Pickens County",5,39,272,161,111
050,01,107,"Alabama","Pickens County",5,40,223,112,111
050,01,107,"Alabama","Pickens County",5,41,310,151,159
050,01,107,"Alabama","Pickens County",5,42,198,92,106
050,01,107,"Alabama","Pickens County",5,43,247,128,119
050,01,107,"Alabama","Pickens County",5,44,216,97,119
050,01,107,"Alabama","Pickens County",5,45,269,136,133
050,01,107,"Alabama","Pickens County",5,46,227,125,102
050,01,107,"Alabama","Pickens County",5,47,292,136,156
050,01,107,"Alabama","Pickens County",5,48,186,70,116
050,01,107,"Alabama","Pickens County",5,49,205,113,92
050,01,107,"Alabama","Pickens County",5,50,198,108,90
050,01,107,"Alabama","Pickens County",5,51,249,104,145
050,01,107,"Alabama","Pickens County",5,52,290,128,162
050,01,107,"Alabama","Pickens County",5,53,224,102,122
050,01,107,"Alabama","Pickens County",5,54,197,93,104
050,01,107,"Alabama","Pickens County",5,55,206,105,101
050,01,107,"Alabama","Pickens County",5,56,286,160,126
050,01,107,"Alabama","Pickens County",5,57,247,123,124
050,01,107,"Alabama","Pickens County",5,58,254,119,135
050,01,107,"Alabama","Pickens County",5,59,310,166,144
050,01,107,"Alabama","Pickens County",5,60,270,126,144
050,01,107,"Alabama","Pickens County",5,61,253,127,126
050,01,107,"Alabama","Pickens County",5,62,281,139,142
050,01,107,"Alabama","Pickens County",5,63,264,133,131
050,01,107,"Alabama","Pickens County",5,64,251,117,134
050,01,107,"Alabama","Pickens County",5,65,254,125,129
050,01,107,"Alabama","Pickens County",5,66,234,112,122
050,01,107,"Alabama","Pickens County",5,67,239,118,121
050,01,107,"Alabama","Pickens County",5,68,238,111,127
050,01,107,"Alabama","Pickens County",5,69,232,100,132
050,01,107,"Alabama","Pickens County",5,70,239,102,137
050,01,107,"Alabama","Pickens County",5,71,203,98,105
050,01,107,"Alabama","Pickens County",5,72,177,85,92
050,01,107,"Alabama","Pickens County",5,73,178,89,89
050,01,107,"Alabama","Pickens County",5,74,173,86,87
050,01,107,"Alabama","Pickens County",5,75,160,67,93
050,01,107,"Alabama","Pickens County",5,76,168,76,92
050,01,107,"Alabama","Pickens County",5,77,125,54,71
050,01,107,"Alabama","Pickens County",5,78,116,49,67
050,01,107,"Alabama","Pickens County",5,79,113,44,69
050,01,107,"Alabama","Pickens County",5,80,124,49,75
050,01,107,"Alabama","Pickens County",5,81,98,43,55
050,01,107,"Alabama","Pickens County",5,82,96,46,50
050,01,107,"Alabama","Pickens County",5,83,72,29,43
050,01,107,"Alabama","Pickens County",5,84,83,36,47
050,01,107,"Alabama","Pickens County",5,85,387,161,226
050,01,109,"Alabama","Pike County",1,0,347,174,173
050,01,109,"Alabama","Pike County",1,1,340,169,171
050,01,109,"Alabama","Pike County",1,2,344,172,172
050,01,109,"Alabama","Pike County",1,3,344,182,162
050,01,109,"Alabama","Pike County",1,4,377,207,170
050,01,109,"Alabama","Pike County",1,5,342,181,161
050,01,109,"Alabama","Pike County",1,6,356,187,169
050,01,109,"Alabama","Pike County",1,7,354,184,170
050,01,109,"Alabama","Pike County",1,8,356,191,165
050,01,109,"Alabama","Pike County",1,9,357,191,166
050,01,109,"Alabama","Pike County",1,10,341,167,174
050,01,109,"Alabama","Pike County",1,11,362,191,171
050,01,109,"Alabama","Pike County",1,12,362,196,166
050,01,109,"Alabama","Pike County",1,13,354,174,180
050,01,109,"Alabama","Pike County",1,14,358,180,178
050,01,109,"Alabama","Pike County",1,15,345,184,161
050,01,109,"Alabama","Pike County",1,16,333,179,154
050,01,109,"Alabama","Pike County",1,17,358,189,169
050,01,109,"Alabama","Pike County",1,18,724,301,423
050,01,109,"Alabama","Pike County",1,19,1136,456,680
050,01,109,"Alabama","Pike County",1,20,1290,616,674
050,01,109,"Alabama","Pike County",1,21,1291,487,804
050,01,109,"Alabama","Pike County",1,22,1239,640,599
050,01,109,"Alabama","Pike County",1,23,962,500,462
050,01,109,"Alabama","Pike County",1,24,704,421,283
050,01,109,"Alabama","Pike County",1,25,602,358,244
050,01,109,"Alabama","Pike County",1,26,443,243,200
050,01,109,"Alabama","Pike County",1,27,417,230,187
050,01,109,"Alabama","Pike County",1,28,451,245,206
050,01,109,"Alabama","Pike County",1,29,425,222,203
050,01,109,"Alabama","Pike County",1,30,360,177,183
050,01,109,"Alabama","Pike County",1,31,364,190,174
050,01,109,"Alabama","Pike County",1,32,303,147,156
050,01,109,"Alabama","Pike County",1,33,284,140,144
050,01,109,"Alabama","Pike County",1,34,308,150,158
050,01,109,"Alabama","Pike County",1,35,339,160,179
050,01,109,"Alabama","Pike County",1,36,345,174,171
050,01,109,"Alabama","Pike County",1,37,370,174,196
050,01,109,"Alabama","Pike County",1,38,343,152,191
050,01,109,"Alabama","Pike County",1,39,336,175,161
050,01,109,"Alabama","Pike County",1,40,340,158,182
050,01,109,"Alabama","Pike County",1,41,305,132,173
050,01,109,"Alabama","Pike County",1,42,303,131,172
050,01,109,"Alabama","Pike County",1,43,313,155,158
050,01,109,"Alabama","Pike County",1,44,325,147,178
050,01,109,"Alabama","Pike County",1,45,322,141,181
050,01,109,"Alabama","Pike County",1,46,291,143,148
050,01,109,"Alabama","Pike County",1,47,315,162,153
050,01,109,"Alabama","Pike County",1,48,370,175,195
050,01,109,"Alabama","Pike County",1,49,359,177,182
050,01,109,"Alabama","Pike County",1,50,357,161,196
050,01,109,"Alabama","Pike County",1,51,354,150,204
050,01,109,"Alabama","Pike County",1,52,330,154,176
050,01,109,"Alabama","Pike County",1,53,323,148,175
050,01,109,"Alabama","Pike County",1,54,324,152,172
050,01,109,"Alabama","Pike County",1,55,327,159,168
050,01,109,"Alabama","Pike County",1,56,374,169,205
050,01,109,"Alabama","Pike County",1,57,361,164,197
050,01,109,"Alabama","Pike County",1,58,387,179,208
050,01,109,"Alabama","Pike County",1,59,380,189,191
050,01,109,"Alabama","Pike County",1,60,372,169,203
050,01,109,"Alabama","Pike County",1,61,363,168,195
050,01,109,"Alabama","Pike County",1,62,372,177,195
050,01,109,"Alabama","Pike County",1,63,383,191,192
050,01,109,"Alabama","Pike County",1,64,385,179,206
050,01,109,"Alabama","Pike County",1,65,349,150,199
050,01,109,"Alabama","Pike County",1,66,303,148,155
050,01,109,"Alabama","Pike County",1,67,290,139,151
050,01,109,"Alabama","Pike County",1,68,286,128,158
050,01,109,"Alabama","Pike County",1,69,272,118,154
050,01,109,"Alabama","Pike County",1,70,305,152,153
050,01,109,"Alabama","Pike County",1,71,275,133,142
050,01,109,"Alabama","Pike County",1,72,285,133,152
050,01,109,"Alabama","Pike County",1,73,285,145,140
050,01,109,"Alabama","Pike County",1,74,226,98,128
050,01,109,"Alabama","Pike County",1,75,230,101,129
050,01,109,"Alabama","Pike County",1,76,213,96,117
050,01,109,"Alabama","Pike County",1,77,188,82,106
050,01,109,"Alabama","Pike County",1,78,170,80,90
050,01,109,"Alabama","Pike County",1,79,163,74,89
050,01,109,"Alabama","Pike County",1,80,137,60,77
050,01,109,"Alabama","Pike County",1,81,138,57,81
050,01,109,"Alabama","Pike County",1,82,148,60,88
050,01,109,"Alabama","Pike County",1,83,122,52,70
050,01,109,"Alabama","Pike County",1,84,101,45,56
050,01,109,"Alabama","Pike County",1,85,515,157,358
050,01,109,"Alabama","Pike County",2,0,349,177,172
050,01,109,"Alabama","Pike County",2,1,339,169,170
050,01,109,"Alabama","Pike County",2,2,343,171,172
050,01,109,"Alabama","Pike County",2,3,343,179,164
050,01,109,"Alabama","Pike County",2,4,368,199,169
050,01,109,"Alabama","Pike County",2,5,353,189,164
050,01,109,"Alabama","Pike County",2,6,353,188,165
050,01,109,"Alabama","Pike County",2,7,354,184,170
050,01,109,"Alabama","Pike County",2,8,354,187,167
050,01,109,"Alabama","Pike County",2,9,359,190,169
050,01,109,"Alabama","Pike County",2,10,344,172,172
050,01,109,"Alabama","Pike County",2,11,355,184,171
050,01,109,"Alabama","Pike County",2,12,364,195,169
050,01,109,"Alabama","Pike County",2,13,357,180,177
050,01,109,"Alabama","Pike County",2,14,355,177,178
050,01,109,"Alabama","Pike County",2,15,346,181,165
050,01,109,"Alabama","Pike County",2,16,337,180,157
050,01,109,"Alabama","Pike County",2,17,352,185,167
050,01,109,"Alabama","Pike County",2,18,710,296,414
050,01,109,"Alabama","Pike County",2,19,1109,443,666
050,01,109,"Alabama","Pike County",2,20,1279,614,665
050,01,109,"Alabama","Pike County",2,21,1272,477,795
050,01,109,"Alabama","Pike County",2,22,1217,625,592
050,01,109,"Alabama","Pike County",2,23,970,499,471
050,01,109,"Alabama","Pike County",2,24,688,413,275
050,01,109,"Alabama","Pike County",2,25,598,350,248
050,01,109,"Alabama","Pike County",2,26,450,246,204
050,01,109,"Alabama","Pike County",2,27,419,230,189
050,01,109,"Alabama","Pike County",2,28,448,243,205
050,01,109,"Alabama","Pike County",2,29,425,225,200
050,01,109,"Alabama","Pike County",2,30,380,189,191
050,01,109,"Alabama","Pike County",2,31,363,187,176
050,01,109,"Alabama","Pike County",2,32,316,157,159
050,01,109,"Alabama","Pike County",2,33,287,140,147
050,01,109,"Alabama","Pike County",2,34,302,147,155
050,01,109,"Alabama","Pike County",2,35,335,159,176
050,01,109,"Alabama","Pike County",2,36,341,170,171
050,01,109,"Alabama","Pike County",2,37,361,171,190
050,01,109,"Alabama","Pike County",2,38,349,158,191
050,01,109,"Alabama","Pike County",2,39,339,170,169
050,01,109,"Alabama","Pike County",2,40,338,162,176
050,01,109,"Alabama","Pike County",2,41,310,137,173
050,01,109,"Alabama","Pike County",2,42,299,130,169
050,01,109,"Alabama","Pike County",2,43,309,149,160
050,01,109,"Alabama","Pike County",2,44,317,145,172
050,01,109,"Alabama","Pike County",2,45,320,141,179
050,01,109,"Alabama","Pike County",2,46,296,142,154
050,01,109,"Alabama","Pike County",2,47,309,157,152
050,01,109,"Alabama","Pike County",2,48,355,172,183
050,01,109,"Alabama","Pike County",2,49,368,179,189
050,01,109,"Alabama","Pike County",2,50,355,163,192
050,01,109,"Alabama","Pike County",2,51,351,152,199
050,01,109,"Alabama","Pike County",2,52,335,151,184
050,01,109,"Alabama","Pike County",2,53,323,148,175
050,01,109,"Alabama","Pike County",2,54,324,152,172
050,01,109,"Alabama","Pike County",2,55,327,159,168
050,01,109,"Alabama","Pike County",2,56,362,167,195
050,01,109,"Alabama","Pike County",2,57,362,163,199
050,01,109,"Alabama","Pike County",2,58,381,175,206
050,01,109,"Alabama","Pike County",2,59,383,188,195
050,01,109,"Alabama","Pike County",2,60,372,173,199
050,01,109,"Alabama","Pike County",2,61,364,168,196
050,01,109,"Alabama","Pike County",2,62,367,173,194
050,01,109,"Alabama","Pike County",2,63,383,189,194
050,01,109,"Alabama","Pike County",2,64,383,183,200
050,01,109,"Alabama","Pike County",2,65,358,158,200
050,01,109,"Alabama","Pike County",2,66,314,147,167
050,01,109,"Alabama","Pike County",2,67,294,142,152
050,01,109,"Alabama","Pike County",2,68,280,128,152
050,01,109,"Alabama","Pike County",2,69,273,119,154
050,01,109,"Alabama","Pike County",2,70,295,143,152
050,01,109,"Alabama","Pike County",2,71,283,137,146
050,01,109,"Alabama","Pike County",2,72,275,129,146
050,01,109,"Alabama","Pike County",2,73,294,146,148
050,01,109,"Alabama","Pike County",2,74,222,99,123
050,01,109,"Alabama","Pike County",2,75,229,101,128
050,01,109,"Alabama","Pike County",2,76,215,96,119
050,01,109,"Alabama","Pike County",2,77,198,86,112
050,01,109,"Alabama","Pike County",2,78,172,79,93
050,01,109,"Alabama","Pike County",2,79,164,76,88
050,01,109,"Alabama","Pike County",2,80,139,60,79
050,01,109,"Alabama","Pike County",2,81,132,56,76
050,01,109,"Alabama","Pike County",2,82,143,59,84
050,01,109,"Alabama","Pike County",2,83,123,52,71
050,01,109,"Alabama","Pike County",2,84,106,47,59
050,01,109,"Alabama","Pike County",2,85,515,160,355
050,01,109,"Alabama","Pike County",3,0,351,176,175
050,01,109,"Alabama","Pike County",3,1,361,185,176
050,01,109,"Alabama","Pike County",3,2,334,164,170
050,01,109,"Alabama","Pike County",3,3,341,166,175
050,01,109,"Alabama","Pike County",3,4,349,190,159
050,01,109,"Alabama","Pike County",3,5,353,191,162
050,01,109,"Alabama","Pike County",3,6,362,188,174
050,01,109,"Alabama","Pike County",3,7,347,188,159
050,01,109,"Alabama","Pike County",3,8,344,174,170
050,01,109,"Alabama","Pike County",3,9,365,186,179
050,01,109,"Alabama","Pike County",3,10,367,189,178
050,01,109,"Alabama","Pike County",3,11,338,180,158
050,01,109,"Alabama","Pike County",3,12,345,176,169
050,01,109,"Alabama","Pike County",3,13,355,193,162
050,01,109,"Alabama","Pike County",3,14,364,183,181
050,01,109,"Alabama","Pike County",3,15,348,173,175
050,01,109,"Alabama","Pike County",3,16,352,185,167
050,01,109,"Alabama","Pike County",3,17,347,183,164
050,01,109,"Alabama","Pike County",3,18,692,293,399
050,01,109,"Alabama","Pike County",3,19,1077,439,638
050,01,109,"Alabama","Pike County",3,20,1238,606,632
050,01,109,"Alabama","Pike County",3,21,1268,464,804
050,01,109,"Alabama","Pike County",3,22,1192,619,573
050,01,109,"Alabama","Pike County",3,23,997,494,503
050,01,109,"Alabama","Pike County",3,24,650,386,264
050,01,109,"Alabama","Pike County",3,25,574,339,235
050,01,109,"Alabama","Pike County",3,26,450,242,208
050,01,109,"Alabama","Pike County",3,27,402,212,190
050,01,109,"Alabama","Pike County",3,28,395,211,184
050,01,109,"Alabama","Pike County",3,29,416,225,191
050,01,109,"Alabama","Pike County",3,30,415,211,204
050,01,109,"Alabama","Pike County",3,31,380,196,184
050,01,109,"Alabama","Pike County",3,32,350,178,172
050,01,109,"Alabama","Pike County",3,33,319,156,163
050,01,109,"Alabama","Pike County",3,34,289,141,148
050,01,109,"Alabama","Pike County",3,35,306,149,157
050,01,109,"Alabama","Pike County",3,36,328,153,175
050,01,109,"Alabama","Pike County",3,37,331,157,174
050,01,109,"Alabama","Pike County",3,38,363,174,189
050,01,109,"Alabama","Pike County",3,39,356,158,198
050,01,109,"Alabama","Pike County",3,40,348,171,177
050,01,109,"Alabama","Pike County",3,41,346,167,179
050,01,109,"Alabama","Pike County",3,42,309,141,168
050,01,109,"Alabama","Pike County",3,43,303,131,172
050,01,109,"Alabama","Pike County",3,44,309,149,160
050,01,109,"Alabama","Pike County",3,45,311,142,169
050,01,109,"Alabama","Pike County",3,46,317,141,176
050,01,109,"Alabama","Pike County",3,47,293,143,150
050,01,109,"Alabama","Pike County",3,48,310,153,157
050,01,109,"Alabama","Pike County",3,49,352,169,183
050,01,109,"Alabama","Pike County",3,50,370,185,185
050,01,109,"Alabama","Pike County",3,51,348,158,190
050,01,109,"Alabama","Pike County",3,52,355,157,198
050,01,109,"Alabama","Pike County",3,53,331,150,181
050,01,109,"Alabama","Pike County",3,54,337,156,181
050,01,109,"Alabama","Pike County",3,55,324,153,171
050,01,109,"Alabama","Pike County",3,56,339,162,177
050,01,109,"Alabama","Pike County",3,57,363,167,196
050,01,109,"Alabama","Pike County",3,58,366,160,206
050,01,109,"Alabama","Pike County",3,59,381,174,207
050,01,109,"Alabama","Pike County",3,60,375,181,194
050,01,109,"Alabama","Pike County",3,61,370,173,197
050,01,109,"Alabama","Pike County",3,62,356,156,200
050,01,109,"Alabama","Pike County",3,63,363,175,188
050,01,109,"Alabama","Pike County",3,64,363,175,188
050,01,109,"Alabama","Pike County",3,65,377,180,197
050,01,109,"Alabama","Pike County",3,66,348,155,193
050,01,109,"Alabama","Pike County",3,67,307,144,163
050,01,109,"Alabama","Pike County",3,68,285,139,146
050,01,109,"Alabama","Pike County",3,69,274,120,154
050,01,109,"Alabama","Pike County",3,70,268,119,149
050,01,109,"Alabama","Pike County",3,71,288,137,151
050,01,109,"Alabama","Pike County",3,72,265,125,140
050,01,109,"Alabama","Pike County",3,73,264,124,140
050,01,109,"Alabama","Pike County",3,74,282,138,144
050,01,109,"Alabama","Pike County",3,75,218,97,121
050,01,109,"Alabama","Pike County",3,76,214,93,121
050,01,109,"Alabama","Pike County",3,77,205,92,113
050,01,109,"Alabama","Pike County",3,78,182,76,106
050,01,109,"Alabama","Pike County",3,79,161,71,90
050,01,109,"Alabama","Pike County",3,80,157,68,89
050,01,109,"Alabama","Pike County",3,81,118,52,66
050,01,109,"Alabama","Pike County",3,82,131,58,73
050,01,109,"Alabama","Pike County",3,83,130,51,79
050,01,109,"Alabama","Pike County",3,84,111,44,67
050,01,109,"Alabama","Pike County",3,85,511,159,352
050,01,109,"Alabama","Pike County",4,0,357,182,175
050,01,109,"Alabama","Pike County",4,1,335,163,172
050,01,109,"Alabama","Pike County",4,2,360,182,178
050,01,109,"Alabama","Pike County",4,3,337,162,175
050,01,109,"Alabama","Pike County",4,4,348,177,171
050,01,109,"Alabama","Pike County",4,5,344,190,154
050,01,109,"Alabama","Pike County",4,6,365,199,166
050,01,109,"Alabama","Pike County",4,7,374,189,185
050,01,109,"Alabama","Pike County",4,8,353,192,161
050,01,109,"Alabama","Pike County",4,9,350,182,168
050,01,109,"Alabama","Pike County",4,10,358,191,167
050,01,109,"Alabama","Pike County",4,11,366,178,188
050,01,109,"Alabama","Pike County",4,12,338,178,160
050,01,109,"Alabama","Pike County",4,13,356,177,179
050,01,109,"Alabama","Pike County",4,14,351,189,162
050,01,109,"Alabama","Pike County",4,15,373,186,187
050,01,109,"Alabama","Pike County",4,16,356,171,185
050,01,109,"Alabama","Pike County",4,17,366,196,170
050,01,109,"Alabama","Pike County",4,18,717,307,410
050,01,109,"Alabama","Pike County",4,19,1108,452,656
050,01,109,"Alabama","Pike County",4,20,1267,626,641
050,01,109,"Alabama","Pike County",4,21,1255,467,788
050,01,109,"Alabama","Pike County",4,22,1213,601,612
050,01,109,"Alabama","Pike County",4,23,991,502,489
050,01,109,"Alabama","Pike County",4,24,684,378,306
050,01,109,"Alabama","Pike County",4,25,544,302,242
050,01,109,"Alabama","Pike County",4,26,433,235,198
050,01,109,"Alabama","Pike County",4,27,403,215,188
050,01,109,"Alabama","Pike County",4,28,394,201,193
050,01,109,"Alabama","Pike County",4,29,378,202,176
050,01,109,"Alabama","Pike County",4,30,418,217,201
050,01,109,"Alabama","Pike County",4,31,403,210,193
050,01,109,"Alabama","Pike County",4,32,368,190,178
050,01,109,"Alabama","Pike County",4,33,354,176,178
050,01,109,"Alabama","Pike County",4,34,315,154,161
050,01,109,"Alabama","Pike County",4,35,294,135,159
050,01,109,"Alabama","Pike County",4,36,304,154,150
050,01,109,"Alabama","Pike County",4,37,332,157,175
050,01,109,"Alabama","Pike County",4,38,345,166,179
050,01,109,"Alabama","Pike County",4,39,368,174,194
050,01,109,"Alabama","Pike County",4,40,346,150,196
050,01,109,"Alabama","Pike County",4,41,352,168,184
050,01,109,"Alabama","Pike County",4,42,351,170,181
050,01,109,"Alabama","Pike County",4,43,312,138,174
050,01,109,"Alabama","Pike County",4,44,305,134,171
050,01,109,"Alabama","Pike County",4,45,308,146,162
050,01,109,"Alabama","Pike County",4,46,298,143,155
050,01,109,"Alabama","Pike County",4,47,330,147,183
050,01,109,"Alabama","Pike County",4,48,293,143,150
050,01,109,"Alabama","Pike County",4,49,318,159,159
050,01,109,"Alabama","Pike County",4,50,357,171,186
050,01,109,"Alabama","Pike County",4,51,369,184,185
050,01,109,"Alabama","Pike County",4,52,368,173,195
050,01,109,"Alabama","Pike County",4,53,355,158,197
050,01,109,"Alabama","Pike County",4,54,338,154,184
050,01,109,"Alabama","Pike County",4,55,330,152,178
050,01,109,"Alabama","Pike County",4,56,319,150,169
050,01,109,"Alabama","Pike County",4,57,333,161,172
050,01,109,"Alabama","Pike County",4,58,369,167,202
050,01,109,"Alabama","Pike County",4,59,362,161,201
050,01,109,"Alabama","Pike County",4,60,378,175,203
050,01,109,"Alabama","Pike County",4,61,384,187,197
050,01,109,"Alabama","Pike County",4,62,368,168,200
050,01,109,"Alabama","Pike County",4,63,351,155,196
050,01,109,"Alabama","Pike County",4,64,362,180,182
050,01,109,"Alabama","Pike County",4,65,347,163,184
050,01,109,"Alabama","Pike County",4,66,369,177,192
050,01,109,"Alabama","Pike County",4,67,350,158,192
050,01,109,"Alabama","Pike County",4,68,297,140,157
050,01,109,"Alabama","Pike County",4,69,285,136,149
050,01,109,"Alabama","Pike County",4,70,264,126,138
050,01,109,"Alabama","Pike County",4,71,260,112,148
050,01,109,"Alabama","Pike County",4,72,276,129,147
050,01,109,"Alabama","Pike County",4,73,270,126,144
050,01,109,"Alabama","Pike County",4,74,254,118,136
050,01,109,"Alabama","Pike County",4,75,275,135,140
050,01,109,"Alabama","Pike County",4,76,207,92,115
050,01,109,"Alabama","Pike County",4,77,207,93,114
050,01,109,"Alabama","Pike County",4,78,186,82,104
050,01,109,"Alabama","Pike County",4,79,176,71,105
050,01,109,"Alabama","Pike County",4,80,147,64,83
050,01,109,"Alabama","Pike County",4,81,136,65,71
050,01,109,"Alabama","Pike County",4,82,117,52,65
050,01,109,"Alabama","Pike County",4,83,120,49,71
050,01,109,"Alabama","Pike County",4,84,119,47,72
050,01,109,"Alabama","Pike County",4,85,515,162,353
050,01,109,"Alabama","Pike County",5,0,359,183,176
050,01,109,"Alabama","Pike County",5,1,328,162,166
050,01,109,"Alabama","Pike County",5,2,342,162,180
050,01,109,"Alabama","Pike County",5,3,384,192,192
050,01,109,"Alabama","Pike County",5,4,358,173,185
050,01,109,"Alabama","Pike County",5,5,351,180,171
050,01,109,"Alabama","Pike County",5,6,357,195,162
050,01,109,"Alabama","Pike County",5,7,372,200,172
050,01,109,"Alabama","Pike County",5,8,379,194,185
050,01,109,"Alabama","Pike County",5,9,364,189,175
050,01,109,"Alabama","Pike County",5,10,350,181,169
050,01,109,"Alabama","Pike County",5,11,356,189,167
050,01,109,"Alabama","Pike County",5,12,376,185,191
050,01,109,"Alabama","Pike County",5,13,345,177,168
050,01,109,"Alabama","Pike County",5,14,359,181,178
050,01,109,"Alabama","Pike County",5,15,352,190,162
050,01,109,"Alabama","Pike County",5,16,378,190,188
050,01,109,"Alabama","Pike County",5,17,362,170,192
050,01,109,"Alabama","Pike County",5,18,716,302,414
050,01,109,"Alabama","Pike County",5,19,1096,448,648
050,01,109,"Alabama","Pike County",5,20,1242,618,624
050,01,109,"Alabama","Pike County",5,21,1235,469,766
050,01,109,"Alabama","Pike County",5,22,1181,596,585
050,01,109,"Alabama","Pike County",5,23,978,488,490
050,01,109,"Alabama","Pike County",5,24,694,402,292
050,01,109,"Alabama","Pike County",5,25,585,306,279
050,01,109,"Alabama","Pike County",5,26,379,188,191
050,01,109,"Alabama","Pike County",5,27,402,213,189
050,01,109,"Alabama","Pike County",5,28,424,223,201
050,01,109,"Alabama","Pike County",5,29,389,196,193
050,01,109,"Alabama","Pike County",5,30,388,194,194
050,01,109,"Alabama","Pike County",5,31,415,223,192
050,01,109,"Alabama","Pike County",5,32,390,194,196
050,01,109,"Alabama","Pike County",5,33,381,197,184
050,01,109,"Alabama","Pike County",5,34,360,179,181
050,01,109,"Alabama","Pike County",5,35,313,149,164
050,01,109,"Alabama","Pike County",5,36,313,144,169
050,01,109,"Alabama","Pike County",5,37,311,154,157
050,01,109,"Alabama","Pike County",5,38,328,152,176
050,01,109,"Alabama","Pike County",5,39,342,156,186
050,01,109,"Alabama","Pike County",5,40,365,179,186
050,01,109,"Alabama","Pike County",5,41,357,158,199
050,01,109,"Alabama","Pike County",5,42,359,173,186
050,01,109,"Alabama","Pike County",5,43,359,170,189
050,01,109,"Alabama","Pike County",5,44,318,141,177
050,01,109,"Alabama","Pike County",5,45,303,130,173
050,01,109,"Alabama","Pike County",5,46,299,139,160
050,01,109,"Alabama","Pike County",5,47,297,142,155
050,01,109,"Alabama","Pike County",5,48,329,149,180
050,01,109,"Alabama","Pike County",5,49,292,147,145
050,01,109,"Alabama","Pike County",5,50,324,154,170
050,01,109,"Alabama","Pike County",5,51,365,175,190
050,01,109,"Alabama","Pike County",5,52,370,182,188
050,01,109,"Alabama","Pike County",5,53,375,176,199
050,01,109,"Alabama","Pike County",5,54,350,159,191
050,01,109,"Alabama","Pike County",5,55,327,150,177
050,01,109,"Alabama","Pike County",5,56,334,156,178
050,01,109,"Alabama","Pike County",5,57,316,145,171
050,01,109,"Alabama","Pike County",5,58,333,156,177
050,01,109,"Alabama","Pike County",5,59,366,165,201
050,01,109,"Alabama","Pike County",5,60,353,154,199
050,01,109,"Alabama","Pike County",5,61,377,185,192
050,01,109,"Alabama","Pike County",5,62,362,174,188
050,01,109,"Alabama","Pike County",5,63,359,162,197
050,01,109,"Alabama","Pike County",5,64,340,151,189
050,01,109,"Alabama","Pike County",5,65,360,176,184
050,01,109,"Alabama","Pike County",5,66,338,160,178
050,01,109,"Alabama","Pike County",5,67,363,177,186
050,01,109,"Alabama","Pike County",5,68,336,153,183
050,01,109,"Alabama","Pike County",5,69,289,133,156
050,01,109,"Alabama","Pike County",5,70,274,136,138
050,01,109,"Alabama","Pike County",5,71,262,122,140
050,01,109,"Alabama","Pike County",5,72,253,106,147
050,01,109,"Alabama","Pike County",5,73,278,132,146
050,01,109,"Alabama","Pike County",5,74,252,114,138
050,01,109,"Alabama","Pike County",5,75,241,115,126
050,01,109,"Alabama","Pike County",5,76,259,129,130
050,01,109,"Alabama","Pike County",5,77,204,90,114
050,01,109,"Alabama","Pike County",5,78,190,83,107
050,01,109,"Alabama","Pike County",5,79,181,80,101
050,01,109,"Alabama","Pike County",5,80,167,63,104
050,01,109,"Alabama","Pike County",5,81,134,59,75
050,01,109,"Alabama","Pike County",5,82,134,65,69
050,01,109,"Alabama","Pike County",5,83,108,45,63
050,01,109,"Alabama","Pike County",5,84,111,47,64
050,01,109,"Alabama","Pike County",5,85,540,172,368
050,01,111,"Alabama","Randolph County",1,0,235,121,114
050,01,111,"Alabama","Randolph County",1,1,231,116,115
050,01,111,"Alabama","Randolph County",1,2,230,119,111
050,01,111,"Alabama","Randolph County",1,3,245,119,126
050,01,111,"Alabama","Randolph County",1,4,253,127,126
050,01,111,"Alabama","Randolph County",1,5,274,130,144
050,01,111,"Alabama","Randolph County",1,6,275,141,134
050,01,111,"Alabama","Randolph County",1,7,261,140,121
050,01,111,"Alabama","Randolph County",1,8,244,109,135
050,01,111,"Alabama","Randolph County",1,9,229,106,123
050,01,111,"Alabama","Randolph County",1,10,262,144,118
050,01,111,"Alabama","Randolph County",1,11,280,149,131
050,01,111,"Alabama","Randolph County",1,12,266,140,126
050,01,111,"Alabama","Randolph County",1,13,275,132,143
050,01,111,"Alabama","Randolph County",1,14,276,140,136
050,01,111,"Alabama","Randolph County",1,15,279,138,141
050,01,111,"Alabama","Randolph County",1,16,261,141,120
050,01,111,"Alabama","Randolph County",1,17,263,142,121
050,01,111,"Alabama","Randolph County",1,18,282,152,130
050,01,111,"Alabama","Randolph County",1,19,305,163,142
050,01,111,"Alabama","Randolph County",1,20,271,142,129
050,01,111,"Alabama","Randolph County",1,21,241,126,115
050,01,111,"Alabama","Randolph County",1,22,236,119,117
050,01,111,"Alabama","Randolph County",1,23,235,110,125
050,01,111,"Alabama","Randolph County",1,24,250,122,128
050,01,111,"Alabama","Randolph County",1,25,249,131,118
050,01,111,"Alabama","Randolph County",1,26,253,134,119
050,01,111,"Alabama","Randolph County",1,27,267,134,133
050,01,111,"Alabama","Randolph County",1,28,244,112,132
050,01,111,"Alabama","Randolph County",1,29,245,120,125
050,01,111,"Alabama","Randolph County",1,30,246,110,136
050,01,111,"Alabama","Randolph County",1,31,236,102,134
050,01,111,"Alabama","Randolph County",1,32,224,110,114
050,01,111,"Alabama","Randolph County",1,33,224,106,118
050,01,111,"Alabama","Randolph County",1,34,195,99,96
050,01,111,"Alabama","Randolph County",1,35,210,100,110
050,01,111,"Alabama","Randolph County",1,36,207,91,116
050,01,111,"Alabama","Randolph County",1,37,231,105,126
050,01,111,"Alabama","Randolph County",1,38,238,121,117
050,01,111,"Alabama","Randolph County",1,39,265,131,134
050,01,111,"Alabama","Randolph County",1,40,230,117,113
050,01,111,"Alabama","Randolph County",1,41,236,117,119
050,01,111,"Alabama","Randolph County",1,42,233,111,122
050,01,111,"Alabama","Randolph County",1,43,254,130,124
050,01,111,"Alabama","Randolph County",1,44,235,120,115
050,01,111,"Alabama","Randolph County",1,45,239,113,126
050,01,111,"Alabama","Randolph County",1,46,258,128,130
050,01,111,"Alabama","Randolph County",1,47,263,138,125
050,01,111,"Alabama","Randolph County",1,48,300,148,152
050,01,111,"Alabama","Randolph County",1,49,325,150,175
050,01,111,"Alabama","Randolph County",1,50,285,134,151
050,01,111,"Alabama","Randolph County",1,51,300,140,160
050,01,111,"Alabama","Randolph County",1,52,313,168,145
050,01,111,"Alabama","Randolph County",1,53,312,163,149
050,01,111,"Alabama","Randolph County",1,54,311,152,159
050,01,111,"Alabama","Randolph County",1,55,306,152,154
050,01,111,"Alabama","Randolph County",1,56,346,164,182
050,01,111,"Alabama","Randolph County",1,57,330,160,170
050,01,111,"Alabama","Randolph County",1,58,333,165,168
050,01,111,"Alabama","Randolph County",1,59,347,177,170
050,01,111,"Alabama","Randolph County",1,60,343,174,169
050,01,111,"Alabama","Randolph County",1,61,318,154,164
050,01,111,"Alabama","Randolph County",1,62,339,167,172
050,01,111,"Alabama","Randolph County",1,63,331,166,165
050,01,111,"Alabama","Randolph County",1,64,326,153,173
050,01,111,"Alabama","Randolph County",1,65,298,150,148
050,01,111,"Alabama","Randolph County",1,66,293,143,150
050,01,111,"Alabama","Randolph County",1,67,278,133,145
050,01,111,"Alabama","Randolph County",1,68,288,145,143
050,01,111,"Alabama","Randolph County",1,69,271,143,128
050,01,111,"Alabama","Randolph County",1,70,266,139,127
050,01,111,"Alabama","Randolph County",1,71,254,119,135
050,01,111,"Alabama","Randolph County",1,72,275,125,150
050,01,111,"Alabama","Randolph County",1,73,290,135,155
050,01,111,"Alabama","Randolph County",1,74,168,83,85
050,01,111,"Alabama","Randolph County",1,75,175,80,95
050,01,111,"Alabama","Randolph County",1,76,180,84,96
050,01,111,"Alabama","Randolph County",1,77,195,88,107
050,01,111,"Alabama","Randolph County",1,78,169,71,98
050,01,111,"Alabama","Randolph County",1,79,151,70,81
050,01,111,"Alabama","Randolph County",1,80,127,55,72
050,01,111,"Alabama","Randolph County",1,81,112,52,60
050,01,111,"Alabama","Randolph County",1,82,114,48,66
050,01,111,"Alabama","Randolph County",1,83,101,41,60
050,01,111,"Alabama","Randolph County",1,84,87,27,60
050,01,111,"Alabama","Randolph County",1,85,463,148,315
050,01,111,"Alabama","Randolph County",2,0,234,119,115
050,01,111,"Alabama","Randolph County",2,1,230,116,114
050,01,111,"Alabama","Randolph County",2,2,232,118,114
050,01,111,"Alabama","Randolph County",2,3,241,119,122
050,01,111,"Alabama","Randolph County",2,4,255,125,130
050,01,111,"Alabama","Randolph County",2,5,271,131,140
050,01,111,"Alabama","Randolph County",2,6,279,142,137
050,01,111,"Alabama","Randolph County",2,7,268,143,125
050,01,111,"Alabama","Randolph County",2,8,246,115,131
050,01,111,"Alabama","Randolph County",2,9,233,107,126
050,01,111,"Alabama","Randolph County",2,10,252,134,118
050,01,111,"Alabama","Randolph County",2,11,274,146,128
050,01,111,"Alabama","Randolph County",2,12,270,142,128
050,01,111,"Alabama","Randolph County",2,13,273,134,139
050,01,111,"Alabama","Randolph County",2,14,278,139,139
050,01,111,"Alabama","Randolph County",2,15,279,140,139
050,01,111,"Alabama","Randolph County",2,16,265,140,125
050,01,111,"Alabama","Randolph County",2,17,263,141,122
050,01,111,"Alabama","Randolph County",2,18,292,154,138
050,01,111,"Alabama","Randolph County",2,19,344,179,165
050,01,111,"Alabama","Randolph County",2,20,295,150,145
050,01,111,"Alabama","Randolph County",2,21,246,130,116
050,01,111,"Alabama","Randolph County",2,22,240,121,119
050,01,111,"Alabama","Randolph County",2,23,239,113,126
050,01,111,"Alabama","Randolph County",2,24,247,121,126
050,01,111,"Alabama","Randolph County",2,25,253,132,121
050,01,111,"Alabama","Randolph County",2,26,255,135,120
050,01,111,"Alabama","Randolph County",2,27,265,133,132
050,01,111,"Alabama","Randolph County",2,28,248,116,132
050,01,111,"Alabama","Randolph County",2,29,245,119,126
050,01,111,"Alabama","Randolph County",2,30,247,114,133
050,01,111,"Alabama","Randolph County",2,31,237,103,134
050,01,111,"Alabama","Randolph County",2,32,230,110,120
050,01,111,"Alabama","Randolph County",2,33,224,107,117
050,01,111,"Alabama","Randolph County",2,34,201,100,101
050,01,111,"Alabama","Randolph County",2,35,207,99,108
050,01,111,"Alabama","Randolph County",2,36,208,93,115
050,01,111,"Alabama","Randolph County",2,37,226,103,123
050,01,111,"Alabama","Randolph County",2,38,237,117,120
050,01,111,"Alabama","Randolph County",2,39,258,130,128
050,01,111,"Alabama","Randolph County",2,40,242,123,119
050,01,111,"Alabama","Randolph County",2,41,232,115,117
050,01,111,"Alabama","Randolph County",2,42,232,113,119
050,01,111,"Alabama","Randolph County",2,43,249,125,124
050,01,111,"Alabama","Randolph County",2,44,238,121,117
050,01,111,"Alabama","Randolph County",2,45,240,115,125
050,01,111,"Alabama","Randolph County",2,46,252,123,129
050,01,111,"Alabama","Randolph County",2,47,261,135,126
050,01,111,"Alabama","Randolph County",2,48,293,146,147
050,01,111,"Alabama","Randolph County",2,49,320,150,170
050,01,111,"Alabama","Randolph County",2,50,300,141,159
050,01,111,"Alabama","Randolph County",2,51,299,140,159
050,01,111,"Alabama","Randolph County",2,52,309,160,149
050,01,111,"Alabama","Randolph County",2,53,312,164,148
050,01,111,"Alabama","Randolph County",2,54,309,154,155
050,01,111,"Alabama","Randolph County",2,55,309,153,156
050,01,111,"Alabama","Randolph County",2,56,340,162,178
050,01,111,"Alabama","Randolph County",2,57,339,163,176
050,01,111,"Alabama","Randolph County",2,58,331,165,166
050,01,111,"Alabama","Randolph County",2,59,349,177,172
050,01,111,"Alabama","Randolph County",2,60,348,177,171
050,01,111,"Alabama","Randolph County",2,61,327,161,166
050,01,111,"Alabama","Randolph County",2,62,332,164,168
050,01,111,"Alabama","Randolph County",2,63,336,168,168
050,01,111,"Alabama","Randolph County",2,64,324,155,169
050,01,111,"Alabama","Randolph County",2,65,302,150,152
050,01,111,"Alabama","Randolph County",2,66,296,145,151
050,01,111,"Alabama","Randolph County",2,67,282,135,147
050,01,111,"Alabama","Randolph County",2,68,280,142,138
050,01,111,"Alabama","Randolph County",2,69,272,140,132
050,01,111,"Alabama","Randolph County",2,70,263,138,125
050,01,111,"Alabama","Randolph County",2,71,258,124,134
050,01,111,"Alabama","Randolph County",2,72,265,122,143
050,01,111,"Alabama","Randolph County",2,73,299,140,159
050,01,111,"Alabama","Randolph County",2,74,187,91,96
050,01,111,"Alabama","Randolph County",2,75,171,79,92
050,01,111,"Alabama","Randolph County",2,76,173,79,94
050,01,111,"Alabama","Randolph County",2,77,195,87,108
050,01,111,"Alabama","Randolph County",2,78,167,70,97
050,01,111,"Alabama","Randolph County",2,79,155,69,86
050,01,111,"Alabama","Randolph County",2,80,132,59,73
050,01,111,"Alabama","Randolph County",2,81,115,53,62
050,01,111,"Alabama","Randolph County",2,82,113,49,64
050,01,111,"Alabama","Randolph County",2,83,105,43,62
050,01,111,"Alabama","Randolph County",2,84,87,29,58
050,01,111,"Alabama","Randolph County",2,85,459,143,316
050,01,111,"Alabama","Randolph County",3,0,262,140,122
050,01,111,"Alabama","Randolph County",3,1,244,114,130
050,01,111,"Alabama","Randolph County",3,2,226,116,110
050,01,111,"Alabama","Randolph County",3,3,228,116,112
050,01,111,"Alabama","Randolph County",3,4,241,121,120
050,01,111,"Alabama","Randolph County",3,5,253,128,125
050,01,111,"Alabama","Randolph County",3,6,251,116,135
050,01,111,"Alabama","Randolph County",3,7,279,145,134
050,01,111,"Alabama","Randolph County",3,8,268,139,129
050,01,111,"Alabama","Randolph County",3,9,245,122,123
050,01,111,"Alabama","Randolph County",3,10,238,108,130
050,01,111,"Alabama","Randolph County",3,11,257,134,123
050,01,111,"Alabama","Randolph County",3,12,279,149,130
050,01,111,"Alabama","Randolph County",3,13,276,144,132
050,01,111,"Alabama","Randolph County",3,14,286,140,146
050,01,111,"Alabama","Randolph County",3,15,278,141,137
050,01,111,"Alabama","Randolph County",3,16,279,138,141
050,01,111,"Alabama","Randolph County",3,17,258,132,126
050,01,111,"Alabama","Randolph County",3,18,315,159,156
050,01,111,"Alabama","Randolph County",3,19,375,193,182
050,01,111,"Alabama","Randolph County",3,20,319,166,153
050,01,111,"Alabama","Randolph County",3,21,260,143,117
050,01,111,"Alabama","Randolph County",3,22,237,123,114
050,01,111,"Alabama","Randolph County",3,23,243,122,121
050,01,111,"Alabama","Randolph County",3,24,236,115,121
050,01,111,"Alabama","Randolph County",3,25,250,119,131
050,01,111,"Alabama","Randolph County",3,26,243,130,113
050,01,111,"Alabama","Randolph County",3,27,250,131,119
050,01,111,"Alabama","Randolph County",3,28,263,126,137
050,01,111,"Alabama","Randolph County",3,29,266,126,140
050,01,111,"Alabama","Randolph County",3,30,248,119,129
050,01,111,"Alabama","Randolph County",3,31,244,113,131
050,01,111,"Alabama","Randolph County",3,32,245,105,140
050,01,111,"Alabama","Randolph County",3,33,223,107,116
050,01,111,"Alabama","Randolph County",3,34,225,109,116
050,01,111,"Alabama","Randolph County",3,35,203,104,99
050,01,111,"Alabama","Randolph County",3,36,209,98,111
050,01,111,"Alabama","Randolph County",3,37,214,96,118
050,01,111,"Alabama","Randolph County",3,38,229,101,128
050,01,111,"Alabama","Randolph County",3,39,240,116,124
050,01,111,"Alabama","Randolph County",3,40,255,133,122
050,01,111,"Alabama","Randolph County",3,41,234,122,112
050,01,111,"Alabama","Randolph County",3,42,230,116,114
050,01,111,"Alabama","Randolph County",3,43,235,109,126
050,01,111,"Alabama","Randolph County",3,44,232,118,114
050,01,111,"Alabama","Randolph County",3,45,242,122,120
050,01,111,"Alabama","Randolph County",3,46,242,111,131
050,01,111,"Alabama","Randolph County",3,47,248,120,128
050,01,111,"Alabama","Randolph County",3,48,261,133,128
050,01,111,"Alabama","Randolph County",3,49,287,145,142
050,01,111,"Alabama","Randolph County",3,50,316,151,165
050,01,111,"Alabama","Randolph County",3,51,299,138,161
050,01,111,"Alabama","Randolph County",3,52,302,139,163
050,01,111,"Alabama","Randolph County",3,53,314,158,156
050,01,111,"Alabama","Randolph County",3,54,311,170,141
050,01,111,"Alabama","Randolph County",3,55,318,159,159
050,01,111,"Alabama","Randolph County",3,56,324,156,168
050,01,111,"Alabama","Randolph County",3,57,358,176,182
050,01,111,"Alabama","Randolph County",3,58,323,155,168
050,01,111,"Alabama","Randolph County",3,59,338,167,171
050,01,111,"Alabama","Randolph County",3,60,353,174,179
050,01,111,"Alabama","Randolph County",3,61,350,177,173
050,01,111,"Alabama","Randolph County",3,62,329,157,172
050,01,111,"Alabama","Randolph County",3,63,324,160,164
050,01,111,"Alabama","Randolph County",3,64,339,169,170
050,01,111,"Alabama","Randolph County",3,65,324,153,171
050,01,111,"Alabama","Randolph County",3,66,307,151,156
050,01,111,"Alabama","Randolph County",3,67,294,147,147
050,01,111,"Alabama","Randolph County",3,68,274,132,142
050,01,111,"Alabama","Randolph County",3,69,281,141,140
050,01,111,"Alabama","Randolph County",3,70,268,139,129
050,01,111,"Alabama","Randolph County",3,71,258,138,120
050,01,111,"Alabama","Randolph County",3,72,239,106,133
050,01,111,"Alabama","Randolph County",3,73,252,113,139
050,01,111,"Alabama","Randolph County",3,74,289,136,153
050,01,111,"Alabama","Randolph County",3,75,181,90,91
050,01,111,"Alabama","Randolph County",3,76,156,71,85
050,01,111,"Alabama","Randolph County",3,77,166,74,92
050,01,111,"Alabama","Randolph County",3,78,177,77,100
050,01,111,"Alabama","Randolph County",3,79,164,71,93
050,01,111,"Alabama","Randolph County",3,80,139,66,73
050,01,111,"Alabama","Randolph County",3,81,120,50,70
050,01,111,"Alabama","Randolph County",3,82,95,47,48
050,01,111,"Alabama","Randolph County",3,83,103,47,56
050,01,111,"Alabama","Randolph County",3,84,93,38,55
050,01,111,"Alabama","Randolph County",3,85,455,141,314
050,01,111,"Alabama","Randolph County",4,0,252,131,121
050,01,111,"Alabama","Randolph County",4,1,236,126,110
050,01,111,"Alabama","Randolph County",4,2,255,132,123
050,01,111,"Alabama","Randolph County",4,3,234,121,113
050,01,111,"Alabama","Randolph County",4,4,245,127,118
050,01,111,"Alabama","Randolph County",4,5,243,124,119
050,01,111,"Alabama","Randolph County",4,6,265,133,132
050,01,111,"Alabama","Randolph County",4,7,254,119,135
050,01,111,"Alabama","Randolph County",4,8,276,143,133
050,01,111,"Alabama","Randolph County",4,9,278,141,137
050,01,111,"Alabama","Randolph County",4,10,261,133,128
050,01,111,"Alabama","Randolph County",4,11,236,108,128
050,01,111,"Alabama","Randolph County",4,12,258,134,124
050,01,111,"Alabama","Randolph County",4,13,293,166,127
050,01,111,"Alabama","Randolph County",4,14,295,152,143
050,01,111,"Alabama","Randolph County",4,15,292,145,147
050,01,111,"Alabama","Randolph County",4,16,278,144,134
050,01,111,"Alabama","Randolph County",4,17,280,134,146
050,01,111,"Alabama","Randolph County",4,18,307,153,154
050,01,111,"Alabama","Randolph County",4,19,363,192,171
050,01,111,"Alabama","Randolph County",4,20,298,152,146
050,01,111,"Alabama","Randolph County",4,21,252,140,112
050,01,111,"Alabama","Randolph County",4,22,267,146,121
050,01,111,"Alabama","Randolph County",4,23,249,125,124
050,01,111,"Alabama","Randolph County",4,24,242,115,127
050,01,111,"Alabama","Randolph County",4,25,252,121,131
050,01,111,"Alabama","Randolph County",4,26,254,123,131
050,01,111,"Alabama","Randolph County",4,27,248,130,118
050,01,111,"Alabama","Randolph County",4,28,256,133,123
050,01,111,"Alabama","Randolph County",4,29,260,124,136
050,01,111,"Alabama","Randolph County",4,30,255,114,141
050,01,111,"Alabama","Randolph County",4,31,248,116,132
050,01,111,"Alabama","Randolph County",4,32,252,116,136
050,01,111,"Alabama","Randolph County",4,33,233,97,136
050,01,111,"Alabama","Randolph County",4,34,234,113,121
050,01,111,"Alabama","Randolph County",4,35,230,117,113
050,01,111,"Alabama","Randolph County",4,36,210,104,106
050,01,111,"Alabama","Randolph County",4,37,212,100,112
050,01,111,"Alabama","Randolph County",4,38,221,96,125
050,01,111,"Alabama","Randolph County",4,39,231,104,127
050,01,111,"Alabama","Randolph County",4,40,231,108,123
050,01,111,"Alabama","Randolph County",4,41,254,127,127
050,01,111,"Alabama","Randolph County",4,42,243,129,114
050,01,111,"Alabama","Randolph County",4,43,238,120,118
050,01,111,"Alabama","Randolph County",4,44,235,108,127
050,01,111,"Alabama","Randolph County",4,45,235,120,115
050,01,111,"Alabama","Randolph County",4,46,240,120,120
050,01,111,"Alabama","Randolph County",4,47,251,118,133
050,01,111,"Alabama","Randolph County",4,48,261,123,138
050,01,111,"Alabama","Randolph County",4,49,270,141,129
050,01,111,"Alabama","Randolph County",4,50,297,151,146
050,01,111,"Alabama","Randolph County",4,51,320,150,170
050,01,111,"Alabama","Randolph County",4,52,310,147,163
050,01,111,"Alabama","Randolph County",4,53,307,140,167
050,01,111,"Alabama","Randolph County",4,54,327,161,166
050,01,111,"Alabama","Randolph County",4,55,323,170,153
050,01,111,"Alabama","Randolph County",4,56,316,156,160
050,01,111,"Alabama","Randolph County",4,57,344,170,174
050,01,111,"Alabama","Randolph County",4,58,360,177,183
050,01,111,"Alabama","Randolph County",4,59,324,153,171
050,01,111,"Alabama","Randolph County",4,60,336,165,171
050,01,111,"Alabama","Randolph County",4,61,362,180,182
050,01,111,"Alabama","Randolph County",4,62,344,177,167
050,01,111,"Alabama","Randolph County",4,63,328,153,175
050,01,111,"Alabama","Randolph County",4,64,315,151,164
050,01,111,"Alabama","Randolph County",4,65,339,164,175
050,01,111,"Alabama","Randolph County",4,66,333,154,179
050,01,111,"Alabama","Randolph County",4,67,303,148,155
050,01,111,"Alabama","Randolph County",4,68,289,145,144
050,01,111,"Alabama","Randolph County",4,69,274,133,141
050,01,111,"Alabama","Randolph County",4,70,278,144,134
050,01,111,"Alabama","Randolph County",4,71,264,138,126
050,01,111,"Alabama","Randolph County",4,72,250,134,116
050,01,111,"Alabama","Randolph County",4,73,237,104,133
050,01,111,"Alabama","Randolph County",4,74,245,112,133
050,01,111,"Alabama","Randolph County",4,75,278,129,149
050,01,111,"Alabama","Randolph County",4,76,162,81,81
050,01,111,"Alabama","Randolph County",4,77,153,70,83
050,01,111,"Alabama","Randolph County",4,78,162,70,92
050,01,111,"Alabama","Randolph County",4,79,173,77,96
050,01,111,"Alabama","Randolph County",4,80,153,70,83
050,01,111,"Alabama","Randolph County",4,81,128,60,68
050,01,111,"Alabama","Randolph County",4,82,108,46,62
050,01,111,"Alabama","Randolph County",4,83,84,41,43
050,01,111,"Alabama","Randolph County",4,84,93,42,51
050,01,111,"Alabama","Randolph County",4,85,478,151,327
050,01,111,"Alabama","Randolph County",5,0,247,126,121
050,01,111,"Alabama","Randolph County",5,1,258,137,121
050,01,111,"Alabama","Randolph County",5,2,246,130,116
050,01,111,"Alabama","Randolph County",5,3,253,133,120
050,01,111,"Alabama","Randolph County",5,4,240,128,112
050,01,111,"Alabama","Randolph County",5,5,240,121,119
050,01,111,"Alabama","Randolph County",5,6,253,124,129
050,01,111,"Alabama","Randolph County",5,7,276,143,133
050,01,111,"Alabama","Randolph County",5,8,268,131,137
050,01,111,"Alabama","Randolph County",5,9,282,142,140
050,01,111,"Alabama","Randolph County",5,10,275,141,134
050,01,111,"Alabama","Randolph County",5,11,257,126,131
050,01,111,"Alabama","Randolph County",5,12,247,116,131
050,01,111,"Alabama","Randolph County",5,13,263,131,132
050,01,111,"Alabama","Randolph County",5,14,300,175,125
050,01,111,"Alabama","Randolph County",5,15,295,157,138
050,01,111,"Alabama","Randolph County",5,16,309,152,157
050,01,111,"Alabama","Randolph County",5,17,289,148,141
050,01,111,"Alabama","Randolph County",5,18,328,160,168
050,01,111,"Alabama","Randolph County",5,19,367,186,181
050,01,111,"Alabama","Randolph County",5,20,290,149,141
050,01,111,"Alabama","Randolph County",5,21,241,132,109
050,01,111,"Alabama","Randolph County",5,22,238,126,112
050,01,111,"Alabama","Randolph County",5,23,276,146,130
050,01,111,"Alabama","Randolph County",5,24,264,134,130
050,01,111,"Alabama","Randolph County",5,25,241,117,124
050,01,111,"Alabama","Randolph County",5,26,250,132,118
050,01,111,"Alabama","Randolph County",5,27,243,114,129
050,01,111,"Alabama","Randolph County",5,28,255,133,122
050,01,111,"Alabama","Randolph County",5,29,251,132,119
050,01,111,"Alabama","Randolph County",5,30,269,130,139
050,01,111,"Alabama","Randolph County",5,31,256,121,135
050,01,111,"Alabama","Randolph County",5,32,263,119,144
050,01,111,"Alabama","Randolph County",5,33,258,115,143
050,01,111,"Alabama","Randolph County",5,34,242,97,145
050,01,111,"Alabama","Randolph County",5,35,249,123,126
050,01,111,"Alabama","Randolph County",5,36,234,118,116
050,01,111,"Alabama","Randolph County",5,37,212,107,105
050,01,111,"Alabama","Randolph County",5,38,224,102,122
050,01,111,"Alabama","Randolph County",5,39,224,96,128
050,01,111,"Alabama","Randolph County",5,40,240,110,130
050,01,111,"Alabama","Randolph County",5,41,249,123,126
050,01,111,"Alabama","Randolph County",5,42,255,128,127
050,01,111,"Alabama","Randolph County",5,43,252,132,120
050,01,111,"Alabama","Randolph County",5,44,227,117,110
050,01,111,"Alabama","Randolph County",5,45,238,113,125
050,01,111,"Alabama","Randolph County",5,46,249,123,126
050,01,111,"Alabama","Randolph County",5,47,232,117,115
050,01,111,"Alabama","Randolph County",5,48,258,118,140
050,01,111,"Alabama","Randolph County",5,49,267,129,138
050,01,111,"Alabama","Randolph County",5,50,278,148,130
050,01,111,"Alabama","Randolph County",5,51,307,153,154
050,01,111,"Alabama","Randolph County",5,52,317,147,170
050,01,111,"Alabama","Randolph County",5,53,324,154,170
050,01,111,"Alabama","Randolph County",5,54,303,139,164
050,01,111,"Alabama","Randolph County",5,55,330,161,169
050,01,111,"Alabama","Randolph County",5,56,321,169,152
050,01,111,"Alabama","Randolph County",5,57,336,167,169
050,01,111,"Alabama","Randolph County",5,58,342,169,173
050,01,111,"Alabama","Randolph County",5,59,378,185,193
050,01,111,"Alabama","Randolph County",5,60,323,150,173
050,01,111,"Alabama","Randolph County",5,61,338,168,170
050,01,111,"Alabama","Randolph County",5,62,368,186,182
050,01,111,"Alabama","Randolph County",5,63,344,185,159
050,01,111,"Alabama","Randolph County",5,64,319,151,168
050,01,111,"Alabama","Randolph County",5,65,311,150,161
050,01,111,"Alabama","Randolph County",5,66,335,161,174
050,01,111,"Alabama","Randolph County",5,67,339,159,180
050,01,111,"Alabama","Randolph County",5,68,300,148,152
050,01,111,"Alabama","Randolph County",5,69,289,143,146
050,01,111,"Alabama","Randolph County",5,70,273,132,141
050,01,111,"Alabama","Randolph County",5,71,278,145,133
050,01,111,"Alabama","Randolph County",5,72,252,129,123
050,01,111,"Alabama","Randolph County",5,73,248,132,116
050,01,111,"Alabama","Randolph County",5,74,234,101,133
050,01,111,"Alabama","Randolph County",5,75,238,105,133
050,01,111,"Alabama","Randolph County",5,76,265,122,143
050,01,111,"Alabama","Randolph County",5,77,159,81,78
050,01,111,"Alabama","Randolph County",5,78,143,64,79
050,01,111,"Alabama","Randolph County",5,79,154,66,88
050,01,111,"Alabama","Randolph County",5,80,158,73,85
050,01,111,"Alabama","Randolph County",5,81,144,63,81
050,01,111,"Alabama","Randolph County",5,82,114,54,60
050,01,111,"Alabama","Randolph County",5,83,94,39,55
050,01,111,"Alabama","Randolph County",5,84,77,35,42
050,01,111,"Alabama","Randolph County",5,85,513,168,345
050,01,113,"Alabama","Russell County",1,0,741,381,360
050,01,113,"Alabama","Russell County",1,1,806,391,415
050,01,113,"Alabama","Russell County",1,2,838,402,436
050,01,113,"Alabama","Russell County",1,3,816,404,412
050,01,113,"Alabama","Russell County",1,4,792,413,379
050,01,113,"Alabama","Russell County",1,5,849,441,408
050,01,113,"Alabama","Russell County",1,6,783,399,384
050,01,113,"Alabama","Russell County",1,7,811,398,413
050,01,113,"Alabama","Russell County",1,8,820,403,417
050,01,113,"Alabama","Russell County",1,9,784,413,371
050,01,113,"Alabama","Russell County",1,10,817,436,381
050,01,113,"Alabama","Russell County",1,11,840,433,407
050,01,113,"Alabama","Russell County",1,12,820,421,399
050,01,113,"Alabama","Russell County",1,13,785,387,398
050,01,113,"Alabama","Russell County",1,14,771,397,374
050,01,113,"Alabama","Russell County",1,15,772,406,366
050,01,113,"Alabama","Russell County",1,16,737,377,360
050,01,113,"Alabama","Russell County",1,17,745,385,360
050,01,113,"Alabama","Russell County",1,18,653,332,321
050,01,113,"Alabama","Russell County",1,19,581,305,276
050,01,113,"Alabama","Russell County",1,20,625,325,300
050,01,113,"Alabama","Russell County",1,21,651,320,331
050,01,113,"Alabama","Russell County",1,22,658,297,361
050,01,113,"Alabama","Russell County",1,23,711,327,384
050,01,113,"Alabama","Russell County",1,24,758,366,392
050,01,113,"Alabama","Russell County",1,25,850,401,449
050,01,113,"Alabama","Russell County",1,26,898,438,460
050,01,113,"Alabama","Russell County",1,27,922,431,491
050,01,113,"Alabama","Russell County",1,28,966,457,509
050,01,113,"Alabama","Russell County",1,29,985,455,530
050,01,113,"Alabama","Russell County",1,30,911,450,461
050,01,113,"Alabama","Russell County",1,31,852,410,442
050,01,113,"Alabama","Russell County",1,32,829,396,433
050,01,113,"Alabama","Russell County",1,33,817,368,449
050,01,113,"Alabama","Russell County",1,34,819,388,431
050,01,113,"Alabama","Russell County",1,35,804,381,423
050,01,113,"Alabama","Russell County",1,36,779,361,418
050,01,113,"Alabama","Russell County",1,37,796,376,420
050,01,113,"Alabama","Russell County",1,38,757,369,388
050,01,113,"Alabama","Russell County",1,39,797,404,393
050,01,113,"Alabama","Russell County",1,40,726,327,399
050,01,113,"Alabama","Russell County",1,41,686,312,374
050,01,113,"Alabama","Russell County",1,42,727,342,385
050,01,113,"Alabama","Russell County",1,43,693,338,355
050,01,113,"Alabama","Russell County",1,44,694,345,349
050,01,113,"Alabama","Russell County",1,45,693,345,348
050,01,113,"Alabama","Russell County",1,46,681,324,357
050,01,113,"Alabama","Russell County",1,47,723,343,380
050,01,113,"Alabama","Russell County",1,48,739,355,384
050,01,113,"Alabama","Russell County",1,49,760,366,394
050,01,113,"Alabama","Russell County",1,50,739,361,378
050,01,113,"Alabama","Russell County",1,51,715,342,373
050,01,113,"Alabama","Russell County",1,52,705,335,370
050,01,113,"Alabama","Russell County",1,53,753,376,377
050,01,113,"Alabama","Russell County",1,54,805,403,402
050,01,113,"Alabama","Russell County",1,55,822,408,414
050,01,113,"Alabama","Russell County",1,56,809,385,424
050,01,113,"Alabama","Russell County",1,57,813,393,420
050,01,113,"Alabama","Russell County",1,58,830,414,416
050,01,113,"Alabama","Russell County",1,59,801,390,411
050,01,113,"Alabama","Russell County",1,60,784,378,406
050,01,113,"Alabama","Russell County",1,61,793,398,395
050,01,113,"Alabama","Russell County",1,62,759,361,398
050,01,113,"Alabama","Russell County",1,63,744,347,397
050,01,113,"Alabama","Russell County",1,64,689,325,364
050,01,113,"Alabama","Russell County",1,65,688,320,368
050,01,113,"Alabama","Russell County",1,66,681,312,369
050,01,113,"Alabama","Russell County",1,67,624,294,330
050,01,113,"Alabama","Russell County",1,68,572,251,321
050,01,113,"Alabama","Russell County",1,69,523,223,300
050,01,113,"Alabama","Russell County",1,70,479,209,270
050,01,113,"Alabama","Russell County",1,71,516,214,302
050,01,113,"Alabama","Russell County",1,72,501,214,287
050,01,113,"Alabama","Russell County",1,73,461,192,269
050,01,113,"Alabama","Russell County",1,74,355,162,193
050,01,113,"Alabama","Russell County",1,75,362,173,189
050,01,113,"Alabama","Russell County",1,76,335,140,195
050,01,113,"Alabama","Russell County",1,77,326,133,193
050,01,113,"Alabama","Russell County",1,78,253,107,146
050,01,113,"Alabama","Russell County",1,79,243,99,144
050,01,113,"Alabama","Russell County",1,80,229,90,139
050,01,113,"Alabama","Russell County",1,81,212,88,124
050,01,113,"Alabama","Russell County",1,82,196,84,112
050,01,113,"Alabama","Russell County",1,83,155,54,101
050,01,113,"Alabama","Russell County",1,84,173,67,106
050,01,113,"Alabama","Russell County",1,85,869,246,623
050,01,113,"Alabama","Russell County",2,0,749,387,362
050,01,113,"Alabama","Russell County",2,1,798,394,404
050,01,113,"Alabama","Russell County",2,2,837,404,433
050,01,113,"Alabama","Russell County",2,3,815,403,412
050,01,113,"Alabama","Russell County",2,4,806,413,393
050,01,113,"Alabama","Russell County",2,5,836,430,406
050,01,113,"Alabama","Russell County",2,6,804,408,396
050,01,113,"Alabama","Russell County",2,7,810,400,410
050,01,113,"Alabama","Russell County",2,8,816,402,414
050,01,113,"Alabama","Russell County",2,9,784,406,378
050,01,113,"Alabama","Russell County",2,10,805,427,378
050,01,113,"Alabama","Russell County",2,11,822,427,395
050,01,113,"Alabama","Russell County",2,12,819,418,401
050,01,113,"Alabama","Russell County",2,13,786,392,394
050,01,113,"Alabama","Russell County",2,14,771,394,377
050,01,113,"Alabama","Russell County",2,15,773,407,366
050,01,113,"Alabama","Russell County",2,16,744,386,358
050,01,113,"Alabama","Russell County",2,17,741,381,360
050,01,113,"Alabama","Russell County",2,18,650,335,315
050,01,113,"Alabama","Russell County",2,19,576,299,277
050,01,113,"Alabama","Russell County",2,20,637,332,305
050,01,113,"Alabama","Russell County",2,21,659,327,332
050,01,113,"Alabama","Russell County",2,22,675,314,361
050,01,113,"Alabama","Russell County",2,23,713,330,383
050,01,113,"Alabama","Russell County",2,24,761,362,399
050,01,113,"Alabama","Russell County",2,25,840,396,444
050,01,113,"Alabama","Russell County",2,26,892,430,462
050,01,113,"Alabama","Russell County",2,27,921,437,484
050,01,113,"Alabama","Russell County",2,28,964,452,512
050,01,113,"Alabama","Russell County",2,29,981,458,523
050,01,113,"Alabama","Russell County",2,30,930,452,478
050,01,113,"Alabama","Russell County",2,31,864,416,448
050,01,113,"Alabama","Russell County",2,32,833,395,438
050,01,113,"Alabama","Russell County",2,33,824,377,447
050,01,113,"Alabama","Russell County",2,34,818,385,433
050,01,113,"Alabama","Russell County",2,35,806,379,427
050,01,113,"Alabama","Russell County",2,36,783,366,417
050,01,113,"Alabama","Russell County",2,37,793,375,418
050,01,113,"Alabama","Russell County",2,38,765,368,397
050,01,113,"Alabama","Russell County",2,39,777,387,390
050,01,113,"Alabama","Russell County",2,40,743,344,399
050,01,113,"Alabama","Russell County",2,41,693,314,379
050,01,113,"Alabama","Russell County",2,42,708,329,379
050,01,113,"Alabama","Russell County",2,43,700,337,363
050,01,113,"Alabama","Russell County",2,44,680,339,341
050,01,113,"Alabama","Russell County",2,45,692,342,350
050,01,113,"Alabama","Russell County",2,46,680,327,353
050,01,113,"Alabama","Russell County",2,47,712,339,373
050,01,113,"Alabama","Russell County",2,48,737,352,385
050,01,113,"Alabama","Russell County",2,49,757,364,393
050,01,113,"Alabama","Russell County",2,50,741,361,380
050,01,113,"Alabama","Russell County",2,51,713,342,371
050,01,113,"Alabama","Russell County",2,52,713,339,374
050,01,113,"Alabama","Russell County",2,53,739,365,374
050,01,113,"Alabama","Russell County",2,54,785,392,393
050,01,113,"Alabama","Russell County",2,55,815,404,411
050,01,113,"Alabama","Russell County",2,56,815,393,422
050,01,113,"Alabama","Russell County",2,57,815,393,422
050,01,113,"Alabama","Russell County",2,58,825,409,416
050,01,113,"Alabama","Russell County",2,59,810,396,414
050,01,113,"Alabama","Russell County",2,60,791,383,408
050,01,113,"Alabama","Russell County",2,61,789,393,396
050,01,113,"Alabama","Russell County",2,62,765,367,398
050,01,113,"Alabama","Russell County",2,63,753,350,403
050,01,113,"Alabama","Russell County",2,64,703,329,374
050,01,113,"Alabama","Russell County",2,65,689,321,368
050,01,113,"Alabama","Russell County",2,66,683,313,370
050,01,113,"Alabama","Russell County",2,67,633,297,336
050,01,113,"Alabama","Russell County",2,68,580,259,321
050,01,113,"Alabama","Russell County",2,69,539,232,307
050,01,113,"Alabama","Russell County",2,70,484,211,273
050,01,113,"Alabama","Russell County",2,71,500,209,291
050,01,113,"Alabama","Russell County",2,72,497,209,288
050,01,113,"Alabama","Russell County",2,73,493,206,287
050,01,113,"Alabama","Russell County",2,74,354,156,198
050,01,113,"Alabama","Russell County",2,75,350,167,183
050,01,113,"Alabama","Russell County",2,76,335,145,190
050,01,113,"Alabama","Russell County",2,77,333,136,197
050,01,113,"Alabama","Russell County",2,78,258,107,151
050,01,113,"Alabama","Russell County",2,79,240,97,143
050,01,113,"Alabama","Russell County",2,80,229,90,139
050,01,113,"Alabama","Russell County",2,81,211,88,123
050,01,113,"Alabama","Russell County",2,82,194,82,112
050,01,113,"Alabama","Russell County",2,83,164,60,104
050,01,113,"Alabama","Russell County",2,84,166,62,104
050,01,113,"Alabama","Russell County",2,85,874,250,624
050,01,113,"Alabama","Russell County",3,0,775,396,379
050,01,113,"Alabama","Russell County",3,1,741,385,356
050,01,113,"Alabama","Russell County",3,2,770,368,402
050,01,113,"Alabama","Russell County",3,3,821,372,449
050,01,113,"Alabama","Russell County",3,4,783,390,393
050,01,113,"Alabama","Russell County",3,5,786,383,403
050,01,113,"Alabama","Russell County",3,6,810,419,391
050,01,113,"Alabama","Russell County",3,7,811,423,388
050,01,113,"Alabama","Russell County",3,8,796,400,396
050,01,113,"Alabama","Russell County",3,9,828,397,431
050,01,113,"Alabama","Russell County",3,10,762,386,376
050,01,113,"Alabama","Russell County",3,11,830,447,383
050,01,113,"Alabama","Russell County",3,12,817,424,393
050,01,113,"Alabama","Russell County",3,13,825,424,401
050,01,113,"Alabama","Russell County",3,14,804,401,403
050,01,113,"Alabama","Russell County",3,15,760,391,369
050,01,113,"Alabama","Russell County",3,16,763,398,365
050,01,113,"Alabama","Russell County",3,17,723,366,357
050,01,113,"Alabama","Russell County",3,18,631,338,293
050,01,113,"Alabama","Russell County",3,19,548,271,277
050,01,113,"Alabama","Russell County",3,20,604,299,305
050,01,113,"Alabama","Russell County",3,21,699,341,358
050,01,113,"Alabama","Russell County",3,22,710,324,386
050,01,113,"Alabama","Russell County",3,23,713,323,390
050,01,113,"Alabama","Russell County",3,24,723,349,374
050,01,113,"Alabama","Russell County",3,25,727,329,398
050,01,113,"Alabama","Russell County",3,26,838,405,433
050,01,113,"Alabama","Russell County",3,27,889,424,465
050,01,113,"Alabama","Russell County",3,28,939,463,476
050,01,113,"Alabama","Russell County",3,29,952,420,532
050,01,113,"Alabama","Russell County",3,30,957,443,514
050,01,113,"Alabama","Russell County",3,31,912,447,465
050,01,113,"Alabama","Russell County",3,32,827,401,426
050,01,113,"Alabama","Russell County",3,33,807,383,424
050,01,113,"Alabama","Russell County",3,34,788,372,416
050,01,113,"Alabama","Russell County",3,35,797,373,424
050,01,113,"Alabama","Russell County",3,36,766,344,422
050,01,113,"Alabama","Russell County",3,37,777,365,412
050,01,113,"Alabama","Russell County",3,38,758,356,402
050,01,113,"Alabama","Russell County",3,39,762,362,400
050,01,113,"Alabama","Russell County",3,40,754,373,381
050,01,113,"Alabama","Russell County",3,41,717,331,386
050,01,113,"Alabama","Russell County",3,42,670,293,377
050,01,113,"Alabama","Russell County",3,43,694,316,378
050,01,113,"Alabama","Russell County",3,44,678,328,350
050,01,113,"Alabama","Russell County",3,45,668,324,344
050,01,113,"Alabama","Russell County",3,46,663,325,338
050,01,113,"Alabama","Russell County",3,47,676,327,349
050,01,113,"Alabama","Russell County",3,48,717,340,377
050,01,113,"Alabama","Russell County",3,49,720,334,386
050,01,113,"Alabama","Russell County",3,50,733,352,381
050,01,113,"Alabama","Russell County",3,51,736,358,378
050,01,113,"Alabama","Russell County",3,52,710,347,363
050,01,113,"Alabama","Russell County",3,53,697,341,356
050,01,113,"Alabama","Russell County",3,54,737,358,379
050,01,113,"Alabama","Russell County",3,55,754,374,380
050,01,113,"Alabama","Russell County",3,56,806,396,410
050,01,113,"Alabama","Russell County",3,57,807,385,422
050,01,113,"Alabama","Russell County",3,58,831,400,431
050,01,113,"Alabama","Russell County",3,59,803,399,404
050,01,113,"Alabama","Russell County",3,60,792,391,401
050,01,113,"Alabama","Russell County",3,61,789,387,402
050,01,113,"Alabama","Russell County",3,62,770,380,390
050,01,113,"Alabama","Russell County",3,63,759,350,409
050,01,113,"Alabama","Russell County",3,64,748,356,392
050,01,113,"Alabama","Russell County",3,65,690,319,371
050,01,113,"Alabama","Russell County",3,66,681,319,362
050,01,113,"Alabama","Russell County",3,67,659,298,361
050,01,113,"Alabama","Russell County",3,68,604,279,325
050,01,113,"Alabama","Russell County",3,69,573,252,321
050,01,113,"Alabama","Russell County",3,70,517,217,300
050,01,113,"Alabama","Russell County",3,71,461,198,263
050,01,113,"Alabama","Russell County",3,72,482,195,287
050,01,113,"Alabama","Russell County",3,73,476,197,279
050,01,113,"Alabama","Russell County",3,74,465,191,274
050,01,113,"Alabama","Russell County",3,75,334,150,184
050,01,113,"Alabama","Russell County",3,76,332,156,176
050,01,113,"Alabama","Russell County",3,77,316,137,179
050,01,113,"Alabama","Russell County",3,78,314,132,182
050,01,113,"Alabama","Russell County",3,79,234,90,144
050,01,113,"Alabama","Russell County",3,80,216,82,134
050,01,113,"Alabama","Russell County",3,81,211,82,129
050,01,113,"Alabama","Russell County",3,82,185,83,102
050,01,113,"Alabama","Russell County",3,83,177,70,107
050,01,113,"Alabama","Russell County",3,84,143,49,94
050,01,113,"Alabama","Russell County",3,85,853,250,603
050,01,113,"Alabama","Russell County",4,0,818,440,378
050,01,113,"Alabama","Russell County",4,1,782,393,389
050,01,113,"Alabama","Russell County",4,2,763,393,370
050,01,113,"Alabama","Russell County",4,3,771,366,405
050,01,113,"Alabama","Russell County",4,4,837,387,450
050,01,113,"Alabama","Russell County",4,5,787,393,394
050,01,113,"Alabama","Russell County",4,6,799,387,412
050,01,113,"Alabama","Russell County",4,7,813,402,411
050,01,113,"Alabama","Russell County",4,8,811,436,375
050,01,113,"Alabama","Russell County",4,9,785,393,392
050,01,113,"Alabama","Russell County",4,10,823,407,416
050,01,113,"Alabama","Russell County",4,11,759,391,368
050,01,113,"Alabama","Russell County",4,12,818,441,377
050,01,113,"Alabama","Russell County",4,13,806,414,392
050,01,113,"Alabama","Russell County",4,14,820,427,393
050,01,113,"Alabama","Russell County",4,15,826,417,409
050,01,113,"Alabama","Russell County",4,16,761,403,358
050,01,113,"Alabama","Russell County",4,17,772,394,378
050,01,113,"Alabama","Russell County",4,18,634,329,305
050,01,113,"Alabama","Russell County",4,19,499,257,242
050,01,113,"Alabama","Russell County",4,20,556,279,277
050,01,113,"Alabama","Russell County",4,21,642,317,325
050,01,113,"Alabama","Russell County",4,22,723,338,385
050,01,113,"Alabama","Russell County",4,23,762,367,395
050,01,113,"Alabama","Russell County",4,24,751,344,407
050,01,113,"Alabama","Russell County",4,25,748,362,386
050,01,113,"Alabama","Russell County",4,26,774,343,431
050,01,113,"Alabama","Russell County",4,27,847,420,427
050,01,113,"Alabama","Russell County",4,28,877,432,445
050,01,113,"Alabama","Russell County",4,29,906,448,458
050,01,113,"Alabama","Russell County",4,30,956,439,517
050,01,113,"Alabama","Russell County",4,31,956,443,513
050,01,113,"Alabama","Russell County",4,32,907,448,459
050,01,113,"Alabama","Russell County",4,33,811,375,436
050,01,113,"Alabama","Russell County",4,34,763,358,405
050,01,113,"Alabama","Russell County",4,35,752,356,396
050,01,113,"Alabama","Russell County",4,36,786,347,439
050,01,113,"Alabama","Russell County",4,37,743,322,421
050,01,113,"Alabama","Russell County",4,38,771,370,401
050,01,113,"Alabama","Russell County",4,39,743,339,404
050,01,113,"Alabama","Russell County",4,40,747,352,395
050,01,113,"Alabama","Russell County",4,41,735,365,370
050,01,113,"Alabama","Russell County",4,42,715,331,384
050,01,113,"Alabama","Russell County",4,43,687,284,403
050,01,113,"Alabama","Russell County",4,44,687,311,376
050,01,113,"Alabama","Russell County",4,45,625,282,343
050,01,113,"Alabama","Russell County",4,46,623,299,324
050,01,113,"Alabama","Russell County",4,47,656,324,332
050,01,113,"Alabama","Russell County",4,48,667,328,339
050,01,113,"Alabama","Russell County",4,49,702,329,373
050,01,113,"Alabama","Russell County",4,50,695,324,371
050,01,113,"Alabama","Russell County",4,51,749,351,398
050,01,113,"Alabama","Russell County",4,52,735,355,380
050,01,113,"Alabama","Russell County",4,53,726,353,373
050,01,113,"Alabama","Russell County",4,54,710,349,361
050,01,113,"Alabama","Russell County",4,55,721,354,367
050,01,113,"Alabama","Russell County",4,56,762,377,385
050,01,113,"Alabama","Russell County",4,57,797,389,408
050,01,113,"Alabama","Russell County",4,58,811,386,425
050,01,113,"Alabama","Russell County",4,59,811,392,419
050,01,113,"Alabama","Russell County",4,60,794,398,396
050,01,113,"Alabama","Russell County",4,61,790,383,407
050,01,113,"Alabama","Russell County",4,62,769,363,406
050,01,113,"Alabama","Russell County",4,63,738,362,376
050,01,113,"Alabama","Russell County",4,64,730,340,390
050,01,113,"Alabama","Russell County",4,65,725,342,383
050,01,113,"Alabama","Russell County",4,66,675,305,370
050,01,113,"Alabama","Russell County",4,67,670,315,355
050,01,113,"Alabama","Russell County",4,68,646,285,361
050,01,113,"Alabama","Russell County",4,69,586,263,323
050,01,113,"Alabama","Russell County",4,70,537,232,305
050,01,113,"Alabama","Russell County",4,71,509,212,297
050,01,113,"Alabama","Russell County",4,72,456,194,262
050,01,113,"Alabama","Russell County",4,73,466,187,279
050,01,113,"Alabama","Russell County",4,74,460,187,273
050,01,113,"Alabama","Russell County",4,75,447,185,262
050,01,113,"Alabama","Russell County",4,76,321,141,180
050,01,113,"Alabama","Russell County",4,77,322,148,174
050,01,113,"Alabama","Russell County",4,78,288,130,158
050,01,113,"Alabama","Russell County",4,79,280,110,170
050,01,113,"Alabama","Russell County",4,80,206,73,133
050,01,113,"Alabama","Russell County",4,81,197,72,125
050,01,113,"Alabama","Russell County",4,82,189,78,111
050,01,113,"Alabama","Russell County",4,83,171,68,103
050,01,113,"Alabama","Russell County",4,84,169,63,106
050,01,113,"Alabama","Russell County",4,85,834,240,594
050,01,113,"Alabama","Russell County",5,0,681,364,317
050,01,113,"Alabama","Russell County",5,1,777,396,381
050,01,113,"Alabama","Russell County",5,2,816,387,429
050,01,113,"Alabama","Russell County",5,3,789,408,381
050,01,113,"Alabama","Russell County",5,4,774,370,404
050,01,113,"Alabama","Russell County",5,5,832,396,436
050,01,113,"Alabama","Russell County",5,6,842,425,417
050,01,113,"Alabama","Russell County",5,7,838,422,416
050,01,113,"Alabama","Russell County",5,8,830,405,425
050,01,113,"Alabama","Russell County",5,9,792,424,368
050,01,113,"Alabama","Russell County",5,10,799,400,399
050,01,113,"Alabama","Russell County",5,11,825,410,415
050,01,113,"Alabama","Russell County",5,12,765,401,364
050,01,113,"Alabama","Russell County",5,13,816,454,362
050,01,113,"Alabama","Russell County",5,14,798,414,384
050,01,113,"Alabama","Russell County",5,15,834,440,394
050,01,113,"Alabama","Russell County",5,16,841,426,415
050,01,113,"Alabama","Russell County",5,17,752,398,354
050,01,113,"Alabama","Russell County",5,18,667,360,307
050,01,113,"Alabama","Russell County",5,19,537,283,254
050,01,113,"Alabama","Russell County",5,20,557,276,281
050,01,113,"Alabama","Russell County",5,21,578,297,281
050,01,113,"Alabama","Russell County",5,22,660,323,337
050,01,113,"Alabama","Russell County",5,23,747,354,393
050,01,113,"Alabama","Russell County",5,24,750,357,393
050,01,113,"Alabama","Russell County",5,25,756,362,394
050,01,113,"Alabama","Russell County",5,26,761,369,392
050,01,113,"Alabama","Russell County",5,27,765,359,406
050,01,113,"Alabama","Russell County",5,28,886,448,438
050,01,113,"Alabama","Russell County",5,29,889,424,465
050,01,113,"Alabama","Russell County",5,30,922,448,474
050,01,113,"Alabama","Russell County",5,31,948,433,515
050,01,113,"Alabama","Russell County",5,32,951,447,504
050,01,113,"Alabama","Russell County",5,33,913,433,480
050,01,113,"Alabama","Russell County",5,34,772,351,421
050,01,113,"Alabama","Russell County",5,35,775,350,425
050,01,113,"Alabama","Russell County",5,36,758,354,404
050,01,113,"Alabama","Russell County",5,37,772,340,432
050,01,113,"Alabama","Russell County",5,38,747,337,410
050,01,113,"Alabama","Russell County",5,39,767,357,410
050,01,113,"Alabama","Russell County",5,40,718,314,404
050,01,113,"Alabama","Russell County",5,41,707,335,372
050,01,113,"Alabama","Russell County",5,42,715,360,355
050,01,113,"Alabama","Russell County",5,43,715,319,396
050,01,113,"Alabama","Russell County",5,44,689,285,404
050,01,113,"Alabama","Russell County",5,45,683,306,377
050,01,113,"Alabama","Russell County",5,46,637,298,339
050,01,113,"Alabama","Russell County",5,47,643,311,332
050,01,113,"Alabama","Russell County",5,48,646,322,324
050,01,113,"Alabama","Russell County",5,49,667,332,335
050,01,113,"Alabama","Russell County",5,50,711,333,378
050,01,113,"Alabama","Russell County",5,51,694,319,375
050,01,113,"Alabama","Russell County",5,52,757,351,406
050,01,113,"Alabama","Russell County",5,53,729,359,370
050,01,113,"Alabama","Russell County",5,54,724,357,367
050,01,113,"Alabama","Russell County",5,55,708,353,355
050,01,113,"Alabama","Russell County",5,56,725,353,372
050,01,113,"Alabama","Russell County",5,57,753,371,382
050,01,113,"Alabama","Russell County",5,58,785,381,404
050,01,113,"Alabama","Russell County",5,59,796,373,423
050,01,113,"Alabama","Russell County",5,60,815,391,424
050,01,113,"Alabama","Russell County",5,61,785,390,395
050,01,113,"Alabama","Russell County",5,62,786,389,397
050,01,113,"Alabama","Russell County",5,63,740,352,388
050,01,113,"Alabama","Russell County",5,64,729,357,372
050,01,113,"Alabama","Russell County",5,65,706,325,381
050,01,113,"Alabama","Russell County",5,66,720,335,385
050,01,113,"Alabama","Russell County",5,67,652,290,362
050,01,113,"Alabama","Russell County",5,68,646,297,349
050,01,113,"Alabama","Russell County",5,69,635,274,361
050,01,113,"Alabama","Russell County",5,70,558,246,312
050,01,113,"Alabama","Russell County",5,71,519,218,301
050,01,113,"Alabama","Russell County",5,72,502,205,297
050,01,113,"Alabama","Russell County",5,73,447,191,256
050,01,113,"Alabama","Russell County",5,74,449,180,269
050,01,113,"Alabama","Russell County",5,75,445,185,260
050,01,113,"Alabama","Russell County",5,76,433,170,263
050,01,113,"Alabama","Russell County",5,77,304,130,174
050,01,113,"Alabama","Russell County",5,78,294,141,153
050,01,113,"Alabama","Russell County",5,79,263,115,148
050,01,113,"Alabama","Russell County",5,80,266,95,171
050,01,113,"Alabama","Russell County",5,81,190,65,125
050,01,113,"Alabama","Russell County",5,82,172,65,107
050,01,113,"Alabama","Russell County",5,83,177,65,112
050,01,113,"Alabama","Russell County",5,84,165,60,105
050,01,113,"Alabama","Russell County",5,85,865,258,607
050,01,115,"Alabama","St. Clair County",1,0,937,476,461
050,01,115,"Alabama","St. Clair County",1,1,980,499,481
050,01,115,"Alabama","St. Clair County",1,2,1040,509,531
050,01,115,"Alabama","St. Clair County",1,3,1070,564,506
050,01,115,"Alabama","St. Clair County",1,4,1114,538,576
050,01,115,"Alabama","St. Clair County",1,5,1113,569,544
050,01,115,"Alabama","St. Clair County",1,6,1149,587,562
050,01,115,"Alabama","St. Clair County",1,7,1120,587,533
050,01,115,"Alabama","St. Clair County",1,8,1117,595,522
050,01,115,"Alabama","St. Clair County",1,9,1152,609,543
050,01,115,"Alabama","St. Clair County",1,10,1206,635,571
050,01,115,"Alabama","St. Clair County",1,11,1239,663,576
050,01,115,"Alabama","St. Clair County",1,12,1307,673,634
050,01,115,"Alabama","St. Clair County",1,13,1259,649,610
050,01,115,"Alabama","St. Clair County",1,14,1243,658,585
050,01,115,"Alabama","St. Clair County",1,15,1227,660,567
050,01,115,"Alabama","St. Clair County",1,16,1206,624,582
050,01,115,"Alabama","St. Clair County",1,17,1183,607,576
050,01,115,"Alabama","St. Clair County",1,18,996,529,467
050,01,115,"Alabama","St. Clair County",1,19,803,434,369
050,01,115,"Alabama","St. Clair County",1,20,849,446,403
050,01,115,"Alabama","St. Clair County",1,21,894,471,423
050,01,115,"Alabama","St. Clair County",1,22,904,483,421
050,01,115,"Alabama","St. Clair County",1,23,942,481,461
050,01,115,"Alabama","St. Clair County",1,24,970,484,486
050,01,115,"Alabama","St. Clair County",1,25,1074,546,528
050,01,115,"Alabama","St. Clair County",1,26,1064,552,512
050,01,115,"Alabama","St. Clair County",1,27,1084,561,523
050,01,115,"Alabama","St. Clair County",1,28,1165,592,573
050,01,115,"Alabama","St. Clair County",1,29,1288,658,630
050,01,115,"Alabama","St. Clair County",1,30,1280,652,628
050,01,115,"Alabama","St. Clair County",1,31,1280,651,629
050,01,115,"Alabama","St. Clair County",1,32,1189,607,582
050,01,115,"Alabama","St. Clair County",1,33,1180,604,576
050,01,115,"Alabama","St. Clair County",1,34,1206,640,566
050,01,115,"Alabama","St. Clair County",1,35,1243,610,633
050,01,115,"Alabama","St. Clair County",1,36,1258,616,642
050,01,115,"Alabama","St. Clair County",1,37,1214,597,617
050,01,115,"Alabama","St. Clair County",1,38,1218,626,592
050,01,115,"Alabama","St. Clair County",1,39,1224,632,592
050,01,115,"Alabama","St. Clair County",1,40,1165,584,581
050,01,115,"Alabama","St. Clair County",1,41,1118,564,554
050,01,115,"Alabama","St. Clair County",1,42,1169,587,582
050,01,115,"Alabama","St. Clair County",1,43,1168,583,585
050,01,115,"Alabama","St. Clair County",1,44,1159,561,598
050,01,115,"Alabama","St. Clair County",1,45,1127,543,584
050,01,115,"Alabama","St. Clair County",1,46,1153,582,571
050,01,115,"Alabama","St. Clair County",1,47,1271,641,630
050,01,115,"Alabama","St. Clair County",1,48,1306,653,653
050,01,115,"Alabama","St. Clair County",1,49,1370,681,689
050,01,115,"Alabama","St. Clair County",1,50,1290,665,625
050,01,115,"Alabama","St. Clair County",1,51,1278,667,611
050,01,115,"Alabama","St. Clair County",1,52,1159,599,560
050,01,115,"Alabama","St. Clair County",1,53,1206,604,602
050,01,115,"Alabama","St. Clair County",1,54,1222,623,599
050,01,115,"Alabama","St. Clair County",1,55,1302,654,648
050,01,115,"Alabama","St. Clair County",1,56,1249,608,641
050,01,115,"Alabama","St. Clair County",1,57,1309,652,657
050,01,115,"Alabama","St. Clair County",1,58,1355,674,681
050,01,115,"Alabama","St. Clair County",1,59,1336,650,686
050,01,115,"Alabama","St. Clair County",1,60,1264,626,638
050,01,115,"Alabama","St. Clair County",1,61,1225,605,620
050,01,115,"Alabama","St. Clair County",1,62,1219,598,621
050,01,115,"Alabama","St. Clair County",1,63,1187,590,597
050,01,115,"Alabama","St. Clair County",1,64,1159,554,605
050,01,115,"Alabama","St. Clair County",1,65,1095,496,599
050,01,115,"Alabama","St. Clair County",1,66,1056,498,558
050,01,115,"Alabama","St. Clair County",1,67,1044,487,557
050,01,115,"Alabama","St. Clair County",1,68,1003,440,563
050,01,115,"Alabama","St. Clair County",1,69,930,417,513
050,01,115,"Alabama","St. Clair County",1,70,955,453,502
050,01,115,"Alabama","St. Clair County",1,71,920,427,493
050,01,115,"Alabama","St. Clair County",1,72,891,405,486
050,01,115,"Alabama","St. Clair County",1,73,910,434,476
050,01,115,"Alabama","St. Clair County",1,74,681,308,373
050,01,115,"Alabama","St. Clair County",1,75,662,282,380
050,01,115,"Alabama","St. Clair County",1,76,656,293,363
050,01,115,"Alabama","St. Clair County",1,77,648,298,350
050,01,115,"Alabama","St. Clair County",1,78,548,258,290
050,01,115,"Alabama","St. Clair County",1,79,505,214,291
050,01,115,"Alabama","St. Clair County",1,80,418,194,224
050,01,115,"Alabama","St. Clair County",1,81,405,189,216
050,01,115,"Alabama","St. Clair County",1,82,381,161,220
050,01,115,"Alabama","St. Clair County",1,83,295,105,190
050,01,115,"Alabama","St. Clair County",1,84,265,100,165
050,01,115,"Alabama","St. Clair County",1,85,1447,490,957
050,01,115,"Alabama","St. Clair County",2,0,942,480,462
050,01,115,"Alabama","St. Clair County",2,1,970,494,476
050,01,115,"Alabama","St. Clair County",2,2,1031,513,518
050,01,115,"Alabama","St. Clair County",2,3,1066,551,515
050,01,115,"Alabama","St. Clair County",2,4,1109,547,562
050,01,115,"Alabama","St. Clair County",2,5,1121,563,558
050,01,115,"Alabama","St. Clair County",2,6,1146,584,562
050,01,115,"Alabama","St. Clair County",2,7,1131,588,543
050,01,115,"Alabama","St. Clair County",2,8,1121,593,528
050,01,115,"Alabama","St. Clair County",2,9,1140,607,533
050,01,115,"Alabama","St. Clair County",2,10,1193,629,564
050,01,115,"Alabama","St. Clair County",2,11,1229,652,577
050,01,115,"Alabama","St. Clair County",2,12,1300,674,626
050,01,115,"Alabama","St. Clair County",2,13,1274,658,616
050,01,115,"Alabama","St. Clair County",2,14,1246,656,590
050,01,115,"Alabama","St. Clair County",2,15,1237,663,574
050,01,115,"Alabama","St. Clair County",2,16,1218,636,582
050,01,115,"Alabama","St. Clair County",2,17,1194,613,581
050,01,115,"Alabama","St. Clair County",2,18,994,525,469
050,01,115,"Alabama","St. Clair County",2,19,809,435,374
050,01,115,"Alabama","St. Clair County",2,20,862,453,409
050,01,115,"Alabama","St. Clair County",2,21,894,471,423
050,01,115,"Alabama","St. Clair County",2,22,919,486,433
050,01,115,"Alabama","St. Clair County",2,23,950,487,463
050,01,115,"Alabama","St. Clair County",2,24,980,490,490
050,01,115,"Alabama","St. Clair County",2,25,1054,534,520
050,01,115,"Alabama","St. Clair County",2,26,1071,550,521
050,01,115,"Alabama","St. Clair County",2,27,1079,555,524
050,01,115,"Alabama","St. Clair County",2,28,1157,590,567
050,01,115,"Alabama","St. Clair County",2,29,1261,644,617
050,01,115,"Alabama","St. Clair County",2,30,1294,655,639
050,01,115,"Alabama","St. Clair County",2,31,1278,652,626
050,01,115,"Alabama","St. Clair County",2,32,1203,610,593
050,01,115,"Alabama","St. Clair County",2,33,1181,605,576
050,01,115,"Alabama","St. Clair County",2,34,1201,630,571
050,01,115,"Alabama","St. Clair County",2,35,1247,626,621
050,01,115,"Alabama","St. Clair County",2,36,1244,607,637
050,01,115,"Alabama","St. Clair County",2,37,1230,604,626
050,01,115,"Alabama","St. Clair County",2,38,1230,625,605
050,01,115,"Alabama","St. Clair County",2,39,1218,625,593
050,01,115,"Alabama","St. Clair County",2,40,1180,594,586
050,01,115,"Alabama","St. Clair County",2,41,1128,567,561
050,01,115,"Alabama","St. Clair County",2,42,1153,581,572
050,01,115,"Alabama","St. Clair County",2,43,1180,587,593
050,01,115,"Alabama","St. Clair County",2,44,1149,560,589
050,01,115,"Alabama","St. Clair County",2,45,1139,547,592
050,01,115,"Alabama","St. Clair County",2,46,1144,570,574
050,01,115,"Alabama","St. Clair County",2,47,1244,625,619
050,01,115,"Alabama","St. Clair County",2,48,1301,648,653
050,01,115,"Alabama","St. Clair County",2,49,1361,678,683
050,01,115,"Alabama","St. Clair County",2,50,1311,667,644
050,01,115,"Alabama","St. Clair County",2,51,1273,663,610
050,01,115,"Alabama","St. Clair County",2,52,1188,614,574
050,01,115,"Alabama","St. Clair County",2,53,1195,601,594
050,01,115,"Alabama","St. Clair County",2,54,1210,615,595
050,01,115,"Alabama","St. Clair County",2,55,1276,640,636
050,01,115,"Alabama","St. Clair County",2,56,1267,622,645
050,01,115,"Alabama","St. Clair County",2,57,1294,642,652
050,01,115,"Alabama","St. Clair County",2,58,1341,668,673
050,01,115,"Alabama","St. Clair County",2,59,1344,656,688
050,01,115,"Alabama","St. Clair County",2,60,1277,626,651
050,01,115,"Alabama","St. Clair County",2,61,1231,608,623
050,01,115,"Alabama","St. Clair County",2,62,1225,603,622
050,01,115,"Alabama","St. Clair County",2,63,1201,598,603
050,01,115,"Alabama","St. Clair County",2,64,1163,560,603
050,01,115,"Alabama","St. Clair County",2,65,1114,508,606
050,01,115,"Alabama","St. Clair County",2,66,1071,498,573
050,01,115,"Alabama","St. Clair County",2,67,1050,491,559
050,01,115,"Alabama","St. Clair County",2,68,1005,446,559
050,01,115,"Alabama","St. Clair County",2,69,944,419,525
050,01,115,"Alabama","St. Clair County",2,70,945,441,504
050,01,115,"Alabama","St. Clair County",2,71,919,429,490
050,01,115,"Alabama","St. Clair County",2,72,882,401,481
050,01,115,"Alabama","St. Clair County",2,73,949,447,502
050,01,115,"Alabama","St. Clair County",2,74,694,315,379
050,01,115,"Alabama","St. Clair County",2,75,666,287,379
050,01,115,"Alabama","St. Clair County",2,76,644,289,355
050,01,115,"Alabama","St. Clair County",2,77,665,302,363
050,01,115,"Alabama","St. Clair County",2,78,552,258,294
050,01,115,"Alabama","St. Clair County",2,79,510,219,291
050,01,115,"Alabama","St. Clair County",2,80,433,198,235
050,01,115,"Alabama","St. Clair County",2,81,398,185,213
050,01,115,"Alabama","St. Clair County",2,82,388,164,224
050,01,115,"Alabama","St. Clair County",2,83,307,115,192
050,01,115,"Alabama","St. Clair County",2,84,266,99,167
050,01,115,"Alabama","St. Clair County",2,85,1456,493,963
050,01,115,"Alabama","St. Clair County",3,0,951,485,466
050,01,115,"Alabama","St. Clair County",3,1,982,529,453
050,01,115,"Alabama","St. Clair County",3,2,1016,511,505
050,01,115,"Alabama","St. Clair County",3,3,1068,546,522
050,01,115,"Alabama","St. Clair County",3,4,1077,558,519
050,01,115,"Alabama","St. Clair County",3,5,1129,556,573
050,01,115,"Alabama","St. Clair County",3,6,1137,578,559
050,01,115,"Alabama","St. Clair County",3,7,1171,586,585
050,01,115,"Alabama","St. Clair County",3,8,1163,594,569
050,01,115,"Alabama","St. Clair County",3,9,1145,601,544
050,01,115,"Alabama","St. Clair County",3,10,1163,627,536
050,01,115,"Alabama","St. Clair County",3,11,1214,639,575
050,01,115,"Alabama","St. Clair County",3,12,1241,647,594
050,01,115,"Alabama","St. Clair County",3,13,1318,672,646
050,01,115,"Alabama","St. Clair County",3,14,1304,675,629
050,01,115,"Alabama","St. Clair County",3,15,1275,682,593
050,01,115,"Alabama","St. Clair County",3,16,1266,666,600
050,01,115,"Alabama","St. Clair County",3,17,1209,632,577
050,01,115,"Alabama","St. Clair County",3,18,1015,543,472
050,01,115,"Alabama","St. Clair County",3,19,819,428,391
050,01,115,"Alabama","St. Clair County",3,20,878,461,417
050,01,115,"Alabama","St. Clair County",3,21,935,492,443
050,01,115,"Alabama","St. Clair County",3,22,939,497,442
050,01,115,"Alabama","St. Clair County",3,23,943,488,455
050,01,115,"Alabama","St. Clair County",3,24,1029,541,488
050,01,115,"Alabama","St. Clair County",3,25,1029,506,523
050,01,115,"Alabama","St. Clair County",3,26,1105,544,561
050,01,115,"Alabama","St. Clair County",3,27,1092,578,514
050,01,115,"Alabama","St. Clair County",3,28,1139,585,554
050,01,115,"Alabama","St. Clair County",3,29,1201,633,568
050,01,115,"Alabama","St. Clair County",3,30,1298,652,646
050,01,115,"Alabama","St. Clair County",3,31,1352,685,667
050,01,115,"Alabama","St. Clair County",3,32,1317,665,652
050,01,115,"Alabama","St. Clair County",3,33,1261,657,604
050,01,115,"Alabama","St. Clair County",3,34,1221,638,583
050,01,115,"Alabama","St. Clair County",3,35,1215,629,586
050,01,115,"Alabama","St. Clair County",3,36,1265,617,648
050,01,115,"Alabama","St. Clair County",3,37,1261,616,645
050,01,115,"Alabama","St. Clair County",3,38,1259,608,651
050,01,115,"Alabama","St. Clair County",3,39,1229,614,615
050,01,115,"Alabama","St. Clair County",3,40,1222,626,596
050,01,115,"Alabama","St. Clair County",3,41,1227,615,612
050,01,115,"Alabama","St. Clair County",3,42,1160,575,585
050,01,115,"Alabama","St. Clair County",3,43,1168,591,577
050,01,115,"Alabama","St. Clair County",3,44,1179,580,599
050,01,115,"Alabama","St. Clair County",3,45,1149,577,572
050,01,115,"Alabama","St. Clair County",3,46,1165,559,606
050,01,115,"Alabama","St. Clair County",3,47,1163,584,579
050,01,115,"Alabama","St. Clair County",3,48,1230,622,608
050,01,115,"Alabama","St. Clair County",3,49,1286,639,647
050,01,115,"Alabama","St. Clair County",3,50,1394,688,706
050,01,115,"Alabama","St. Clair County",3,51,1320,665,655
050,01,115,"Alabama","St. Clair County",3,52,1283,669,614
050,01,115,"Alabama","St. Clair County",3,53,1206,625,581
050,01,115,"Alabama","St. Clair County",3,54,1178,583,595
050,01,115,"Alabama","St. Clair County",3,55,1209,606,603
050,01,115,"Alabama","St. Clair County",3,56,1263,633,630
050,01,115,"Alabama","St. Clair County",3,57,1266,609,657
050,01,115,"Alabama","St. Clair County",3,58,1297,648,649
050,01,115,"Alabama","St. Clair County",3,59,1341,668,673
050,01,115,"Alabama","St. Clair County",3,60,1343,645,698
050,01,115,"Alabama","St. Clair County",3,61,1254,610,644
050,01,115,"Alabama","St. Clair County",3,62,1228,601,627
050,01,115,"Alabama","St. Clair County",3,63,1197,586,611
050,01,115,"Alabama","St. Clair County",3,64,1186,587,599
050,01,115,"Alabama","St. Clair County",3,65,1157,544,613
050,01,115,"Alabama","St. Clair County",3,66,1110,505,605
050,01,115,"Alabama","St. Clair County",3,67,1077,507,570
050,01,115,"Alabama","St. Clair County",3,68,1036,482,554
050,01,115,"Alabama","St. Clair County",3,69,969,420,549
050,01,115,"Alabama","St. Clair County",3,70,940,415,525
050,01,115,"Alabama","St. Clair County",3,71,914,430,484
050,01,115,"Alabama","St. Clair County",3,72,887,404,483
050,01,115,"Alabama","St. Clair County",3,73,856,393,463
050,01,115,"Alabama","St. Clair County",3,74,946,438,508
050,01,115,"Alabama","St. Clair County",3,75,655,293,362
050,01,115,"Alabama","St. Clair County",3,76,631,273,358
050,01,115,"Alabama","St. Clair County",3,77,643,286,357
050,01,115,"Alabama","St. Clair County",3,78,601,269,332
050,01,115,"Alabama","St. Clair County",3,79,529,232,297
050,01,115,"Alabama","St. Clair County",3,80,482,207,275
050,01,115,"Alabama","St. Clair County",3,81,400,188,212
050,01,115,"Alabama","St. Clair County",3,82,385,172,213
050,01,115,"Alabama","St. Clair County",3,83,358,153,205
050,01,115,"Alabama","St. Clair County",3,84,277,102,175
050,01,115,"Alabama","St. Clair County",3,85,1476,479,997
050,01,115,"Alabama","St. Clair County",4,0,1015,532,483
050,01,115,"Alabama","St. Clair County",4,1,951,505,446
050,01,115,"Alabama","St. Clair County",4,2,1000,524,476
050,01,115,"Alabama","St. Clair County",4,3,1037,511,526
050,01,115,"Alabama","St. Clair County",4,4,1068,547,521
050,01,115,"Alabama","St. Clair County",4,5,1134,586,548
050,01,115,"Alabama","St. Clair County",4,6,1155,570,585
050,01,115,"Alabama","St. Clair County",4,7,1146,597,549
050,01,115,"Alabama","St. Clair County",4,8,1204,624,580
050,01,115,"Alabama","St. Clair County",4,9,1166,593,573
050,01,115,"Alabama","St. Clair County",4,10,1171,614,557
050,01,115,"Alabama","St. Clair County",4,11,1188,646,542
050,01,115,"Alabama","St. Clair County",4,12,1233,652,581
050,01,115,"Alabama","St. Clair County",4,13,1258,645,613
050,01,115,"Alabama","St. Clair County",4,14,1329,671,658
050,01,115,"Alabama","St. Clair County",4,15,1327,680,647
050,01,115,"Alabama","St. Clair County",4,16,1277,679,598
050,01,115,"Alabama","St. Clair County",4,17,1260,665,595
050,01,115,"Alabama","St. Clair County",4,18,1036,554,482
050,01,115,"Alabama","St. Clair County",4,19,778,420,358
050,01,115,"Alabama","St. Clair County",4,20,873,453,420
050,01,115,"Alabama","St. Clair County",4,21,909,479,430
050,01,115,"Alabama","St. Clair County",4,22,982,506,476
050,01,115,"Alabama","St. Clair County",4,23,979,494,485
050,01,115,"Alabama","St. Clair County",4,24,1021,533,488
050,01,115,"Alabama","St. Clair County",4,25,1094,574,520
050,01,115,"Alabama","St. Clair County",4,26,1044,521,523
050,01,115,"Alabama","St. Clair County",4,27,1136,578,558
050,01,115,"Alabama","St. Clair County",4,28,1089,565,524
050,01,115,"Alabama","St. Clair County",4,29,1163,600,563
050,01,115,"Alabama","St. Clair County",4,30,1247,669,578
050,01,115,"Alabama","St. Clair County",4,31,1353,693,660
050,01,115,"Alabama","St. Clair County",4,32,1379,684,695
050,01,115,"Alabama","St. Clair County",4,33,1337,670,667
050,01,115,"Alabama","St. Clair County",4,34,1286,669,617
050,01,115,"Alabama","St. Clair County",4,35,1216,614,602
050,01,115,"Alabama","St. Clair County",4,36,1230,620,610
050,01,115,"Alabama","St. Clair County",4,37,1277,631,646
050,01,115,"Alabama","St. Clair County",4,38,1263,617,646
050,01,115,"Alabama","St. Clair County",4,39,1251,611,640
050,01,115,"Alabama","St. Clair County",4,40,1265,628,637
050,01,115,"Alabama","St. Clair County",4,41,1243,637,606
050,01,115,"Alabama","St. Clair County",4,42,1226,629,597
050,01,115,"Alabama","St. Clair County",4,43,1135,560,575
050,01,115,"Alabama","St. Clair County",4,44,1189,603,586
050,01,115,"Alabama","St. Clair County",4,45,1186,589,597
050,01,115,"Alabama","St. Clair County",4,46,1170,585,585
050,01,115,"Alabama","St. Clair County",4,47,1196,574,622
050,01,115,"Alabama","St. Clair County",4,48,1175,579,596
050,01,115,"Alabama","St. Clair County",4,49,1237,622,615
050,01,115,"Alabama","St. Clair County",4,50,1294,641,653
050,01,115,"Alabama","St. Clair County",4,51,1423,689,734
050,01,115,"Alabama","St. Clair County",4,52,1333,670,663
050,01,115,"Alabama","St. Clair County",4,53,1301,679,622
050,01,115,"Alabama","St. Clair County",4,54,1215,620,595
050,01,115,"Alabama","St. Clair County",4,55,1181,586,595
050,01,115,"Alabama","St. Clair County",4,56,1195,601,594
050,01,115,"Alabama","St. Clair County",4,57,1262,621,641
050,01,115,"Alabama","St. Clair County",4,58,1288,633,655
050,01,115,"Alabama","St. Clair County",4,59,1308,645,663
050,01,115,"Alabama","St. Clair County",4,60,1332,651,681
050,01,115,"Alabama","St. Clair County",4,61,1335,636,699
050,01,115,"Alabama","St. Clair County",4,62,1270,619,651
050,01,115,"Alabama","St. Clair County",4,63,1220,591,629
050,01,115,"Alabama","St. Clair County",4,64,1196,584,612
050,01,115,"Alabama","St. Clair County",4,65,1174,578,596
050,01,115,"Alabama","St. Clair County",4,66,1153,542,611
050,01,115,"Alabama","St. Clair County",4,67,1128,524,604
050,01,115,"Alabama","St. Clair County",4,68,1058,499,559
050,01,115,"Alabama","St. Clair County",4,69,1027,470,557
050,01,115,"Alabama","St. Clair County",4,70,977,424,553
050,01,115,"Alabama","St. Clair County",4,71,902,395,507
050,01,115,"Alabama","St. Clair County",4,72,864,399,465
050,01,115,"Alabama","St. Clair County",4,73,857,390,467
050,01,115,"Alabama","St. Clair County",4,74,834,377,457
050,01,115,"Alabama","St. Clair County",4,75,915,421,494
050,01,115,"Alabama","St. Clair County",4,76,626,281,345
050,01,115,"Alabama","St. Clair County",4,77,637,269,368
050,01,115,"Alabama","St. Clair County",4,78,594,264,330
050,01,115,"Alabama","St. Clair County",4,79,581,250,331
050,01,115,"Alabama","St. Clair County",4,80,491,224,267
050,01,115,"Alabama","St. Clair County",4,81,459,193,266
050,01,115,"Alabama","St. Clair County",4,82,367,161,206
050,01,115,"Alabama","St. Clair County",4,83,347,155,192
050,01,115,"Alabama","St. Clair County",4,84,322,138,184
050,01,115,"Alabama","St. Clair County",4,85,1531,484,1047
050,01,115,"Alabama","St. Clair County",5,0,1023,536,487
050,01,115,"Alabama","St. Clair County",5,1,1032,542,490
050,01,115,"Alabama","St. Clair County",5,2,1012,537,475
050,01,115,"Alabama","St. Clair County",5,3,1030,542,488
050,01,115,"Alabama","St. Clair County",5,4,1087,522,565
050,01,115,"Alabama","St. Clair County",5,5,1059,544,515
050,01,115,"Alabama","St. Clair County",5,6,1162,596,566
050,01,115,"Alabama","St. Clair County",5,7,1179,584,595
050,01,115,"Alabama","St. Clair County",5,8,1174,614,560
050,01,115,"Alabama","St. Clair County",5,9,1230,647,583
050,01,115,"Alabama","St. Clair County",5,10,1216,635,581
050,01,115,"Alabama","St. Clair County",5,11,1169,617,552
050,01,115,"Alabama","St. Clair County",5,12,1207,657,550
050,01,115,"Alabama","St. Clair County",5,13,1262,662,600
050,01,115,"Alabama","St. Clair County",5,14,1287,679,608
050,01,115,"Alabama","St. Clair County",5,15,1343,675,668
050,01,115,"Alabama","St. Clair County",5,16,1353,686,667
050,01,115,"Alabama","St. Clair County",5,17,1285,690,595
050,01,115,"Alabama","St. Clair County",5,18,1060,583,477
050,01,115,"Alabama","St. Clair County",5,19,811,429,382
050,01,115,"Alabama","St. Clair County",5,20,848,459,389
050,01,115,"Alabama","St. Clair County",5,21,945,474,471
050,01,115,"Alabama","St. Clair County",5,22,1021,537,484
050,01,115,"Alabama","St. Clair County",5,23,1075,560,515
050,01,115,"Alabama","St. Clair County",5,24,1041,529,512
050,01,115,"Alabama","St. Clair County",5,25,1098,573,525
050,01,115,"Alabama","St. Clair County",5,26,1146,598,548
050,01,115,"Alabama","St. Clair County",5,27,1077,557,520
050,01,115,"Alabama","St. Clair County",5,28,1126,555,571
050,01,115,"Alabama","St. Clair County",5,29,1177,611,566
050,01,115,"Alabama","St. Clair County",5,30,1179,611,568
050,01,115,"Alabama","St. Clair County",5,31,1292,699,593
050,01,115,"Alabama","St. Clair County",5,32,1370,682,688
050,01,115,"Alabama","St. Clair County",5,33,1414,684,730
050,01,115,"Alabama","St. Clair County",5,34,1355,689,666
050,01,115,"Alabama","St. Clair County",5,35,1298,670,628
050,01,115,"Alabama","St. Clair County",5,36,1248,625,623
050,01,115,"Alabama","St. Clair County",5,37,1266,645,621
050,01,115,"Alabama","St. Clair County",5,38,1285,627,658
050,01,115,"Alabama","St. Clair County",5,39,1292,625,667
050,01,115,"Alabama","St. Clair County",5,40,1283,636,647
050,01,115,"Alabama","St. Clair County",5,41,1291,644,647
050,01,115,"Alabama","St. Clair County",5,42,1262,656,606
050,01,115,"Alabama","St. Clair County",5,43,1246,632,614
050,01,115,"Alabama","St. Clair County",5,44,1167,576,591
050,01,115,"Alabama","St. Clair County",5,45,1200,609,591
050,01,115,"Alabama","St. Clair County",5,46,1183,594,589
050,01,115,"Alabama","St. Clair County",5,47,1197,614,583
050,01,115,"Alabama","St. Clair County",5,48,1191,553,638
050,01,115,"Alabama","St. Clair County",5,49,1193,592,601
050,01,115,"Alabama","St. Clair County",5,50,1290,638,652
050,01,115,"Alabama","St. Clair County",5,51,1317,646,671
050,01,115,"Alabama","St. Clair County",5,52,1424,697,727
050,01,115,"Alabama","St. Clair County",5,53,1345,686,659
050,01,115,"Alabama","St. Clair County",5,54,1317,680,637
050,01,115,"Alabama","St. Clair County",5,55,1219,612,607
050,01,115,"Alabama","St. Clair County",5,56,1181,573,608
050,01,115,"Alabama","St. Clair County",5,57,1204,606,598
050,01,115,"Alabama","St. Clair County",5,58,1276,628,648
050,01,115,"Alabama","St. Clair County",5,59,1312,647,665
050,01,115,"Alabama","St. Clair County",5,60,1278,628,650
050,01,115,"Alabama","St. Clair County",5,61,1337,655,682
050,01,115,"Alabama","St. Clair County",5,62,1351,639,712
050,01,115,"Alabama","St. Clair County",5,63,1255,602,653
050,01,115,"Alabama","St. Clair County",5,64,1256,605,651
050,01,115,"Alabama","St. Clair County",5,65,1172,557,615
050,01,115,"Alabama","St. Clair County",5,66,1173,567,606
050,01,115,"Alabama","St. Clair County",5,67,1167,555,612
050,01,115,"Alabama","St. Clair County",5,68,1122,516,606
050,01,115,"Alabama","St. Clair County",5,69,1038,486,552
050,01,115,"Alabama","St. Clair County",5,70,1028,463,565
050,01,115,"Alabama","St. Clair County",5,71,953,416,537
050,01,115,"Alabama","St. Clair County",5,72,879,382,497
050,01,115,"Alabama","St. Clair County",5,73,837,389,448
050,01,115,"Alabama","St. Clair County",5,74,858,383,475
050,01,115,"Alabama","St. Clair County",5,75,798,353,445
050,01,115,"Alabama","St. Clair County",5,76,868,405,463
050,01,115,"Alabama","St. Clair County",5,77,629,275,354
050,01,115,"Alabama","St. Clair County",5,78,600,251,349
050,01,115,"Alabama","St. Clair County",5,79,569,244,325
050,01,115,"Alabama","St. Clair County",5,80,548,238,310
050,01,115,"Alabama","St. Clair County",5,81,465,210,255
050,01,115,"Alabama","St. Clair County",5,82,440,178,262
050,01,115,"Alabama","St. Clair County",5,83,338,150,188
050,01,115,"Alabama","St. Clair County",5,84,309,143,166
050,01,115,"Alabama","St. Clair County",5,85,1652,545,1107
050,01,117,"Alabama","Shelby County",1,0,2250,1147,1103
050,01,117,"Alabama","Shelby County",1,1,2393,1217,1176
050,01,117,"Alabama","Shelby County",1,2,2397,1200,1197
050,01,117,"Alabama","Shelby County",1,3,2463,1271,1192
050,01,117,"Alabama","Shelby County",1,4,2707,1356,1351
050,01,117,"Alabama","Shelby County",1,5,2725,1312,1413
050,01,117,"Alabama","Shelby County",1,6,2732,1315,1417
050,01,117,"Alabama","Shelby County",1,7,2744,1386,1358
050,01,117,"Alabama","Shelby County",1,8,2901,1509,1392
050,01,117,"Alabama","Shelby County",1,9,2992,1538,1454
050,01,117,"Alabama","Shelby County",1,10,3040,1537,1503
050,01,117,"Alabama","Shelby County",1,11,3182,1632,1550
050,01,117,"Alabama","Shelby County",1,12,3393,1729,1664
050,01,117,"Alabama","Shelby County",1,13,3321,1733,1588
050,01,117,"Alabama","Shelby County",1,14,3250,1699,1551
050,01,117,"Alabama","Shelby County",1,15,3251,1642,1609
050,01,117,"Alabama","Shelby County",1,16,3351,1665,1686
050,01,117,"Alabama","Shelby County",1,17,3237,1646,1591
050,01,117,"Alabama","Shelby County",1,18,2869,1462,1407
050,01,117,"Alabama","Shelby County",1,19,2562,1274,1288
050,01,117,"Alabama","Shelby County",1,20,2604,1268,1336
050,01,117,"Alabama","Shelby County",1,21,2598,1315,1283
050,01,117,"Alabama","Shelby County",1,22,2671,1299,1372
050,01,117,"Alabama","Shelby County",1,23,2670,1320,1350
050,01,117,"Alabama","Shelby County",1,24,2517,1227,1290
050,01,117,"Alabama","Shelby County",1,25,2523,1254,1269
050,01,117,"Alabama","Shelby County",1,26,2543,1255,1288
050,01,117,"Alabama","Shelby County",1,27,2627,1328,1299
050,01,117,"Alabama","Shelby County",1,28,2606,1248,1358
050,01,117,"Alabama","Shelby County",1,29,2719,1310,1409
050,01,117,"Alabama","Shelby County",1,30,2730,1297,1433
050,01,117,"Alabama","Shelby County",1,31,2708,1324,1384
050,01,117,"Alabama","Shelby County",1,32,2693,1340,1353
050,01,117,"Alabama","Shelby County",1,33,2762,1282,1480
050,01,117,"Alabama","Shelby County",1,34,2783,1288,1495
050,01,117,"Alabama","Shelby County",1,35,2936,1407,1529
050,01,117,"Alabama","Shelby County",1,36,2930,1444,1486
050,01,117,"Alabama","Shelby County",1,37,3042,1514,1528
050,01,117,"Alabama","Shelby County",1,38,3107,1520,1587
050,01,117,"Alabama","Shelby County",1,39,3187,1587,1600
050,01,117,"Alabama","Shelby County",1,40,3184,1583,1601
050,01,117,"Alabama","Shelby County",1,41,3084,1494,1590
050,01,117,"Alabama","Shelby County",1,42,3109,1498,1611
050,01,117,"Alabama","Shelby County",1,43,3054,1513,1541
050,01,117,"Alabama","Shelby County",1,44,3047,1531,1516
050,01,117,"Alabama","Shelby County",1,45,3008,1487,1521
050,01,117,"Alabama","Shelby County",1,46,2991,1497,1494
050,01,117,"Alabama","Shelby County",1,47,3125,1614,1511
050,01,117,"Alabama","Shelby County",1,48,3320,1643,1677
050,01,117,"Alabama","Shelby County",1,49,3468,1699,1769
050,01,117,"Alabama","Shelby County",1,50,3319,1607,1712
050,01,117,"Alabama","Shelby County",1,51,3075,1504,1571
050,01,117,"Alabama","Shelby County",1,52,2891,1442,1449
050,01,117,"Alabama","Shelby County",1,53,2907,1439,1468
050,01,117,"Alabama","Shelby County",1,54,2883,1433,1450
050,01,117,"Alabama","Shelby County",1,55,3039,1493,1546
050,01,117,"Alabama","Shelby County",1,56,3078,1529,1549
050,01,117,"Alabama","Shelby County",1,57,2986,1465,1521
050,01,117,"Alabama","Shelby County",1,58,3020,1466,1554
050,01,117,"Alabama","Shelby County",1,59,2931,1395,1536
050,01,117,"Alabama","Shelby County",1,60,2819,1352,1467
050,01,117,"Alabama","Shelby County",1,61,2809,1365,1444
050,01,117,"Alabama","Shelby County",1,62,2820,1368,1452
050,01,117,"Alabama","Shelby County",1,63,2709,1333,1376
050,01,117,"Alabama","Shelby County",1,64,2646,1287,1359
050,01,117,"Alabama","Shelby County",1,65,2507,1163,1344
050,01,117,"Alabama","Shelby County",1,66,2458,1131,1327
050,01,117,"Alabama","Shelby County",1,67,2405,1118,1287
050,01,117,"Alabama","Shelby County",1,68,2421,1123,1298
050,01,117,"Alabama","Shelby County",1,69,2179,998,1181
050,01,117,"Alabama","Shelby County",1,70,2156,956,1200
050,01,117,"Alabama","Shelby County",1,71,2067,913,1154
050,01,117,"Alabama","Shelby County",1,72,2093,1010,1083
050,01,117,"Alabama","Shelby County",1,73,2083,1002,1081
050,01,117,"Alabama","Shelby County",1,74,1397,627,770
050,01,117,"Alabama","Shelby County",1,75,1379,649,730
050,01,117,"Alabama","Shelby County",1,76,1356,621,735
050,01,117,"Alabama","Shelby County",1,77,1346,599,747
050,01,117,"Alabama","Shelby County",1,78,1112,483,629
050,01,117,"Alabama","Shelby County",1,79,984,414,570
050,01,117,"Alabama","Shelby County",1,80,884,385,499
050,01,117,"Alabama","Shelby County",1,81,831,370,461
050,01,117,"Alabama","Shelby County",1,82,754,345,409
050,01,117,"Alabama","Shelby County",1,83,633,263,370
050,01,117,"Alabama","Shelby County",1,84,570,219,351
050,01,117,"Alabama","Shelby County",1,85,3385,1228,2157
050,01,117,"Alabama","Shelby County",2,0,2250,1159,1091
050,01,117,"Alabama","Shelby County",2,1,2366,1202,1164
050,01,117,"Alabama","Shelby County",2,2,2406,1210,1196
050,01,117,"Alabama","Shelby County",2,3,2457,1257,1200
050,01,117,"Alabama","Shelby County",2,4,2666,1347,1319
050,01,117,"Alabama","Shelby County",2,5,2742,1334,1408
050,01,117,"Alabama","Shelby County",2,6,2749,1326,1423
050,01,117,"Alabama","Shelby County",2,7,2756,1378,1378
050,01,117,"Alabama","Shelby County",2,8,2873,1480,1393
050,01,117,"Alabama","Shelby County",2,9,2990,1541,1449
050,01,117,"Alabama","Shelby County",2,10,3044,1545,1499
050,01,117,"Alabama","Shelby County",2,11,3162,1618,1544
050,01,117,"Alabama","Shelby County",2,12,3368,1722,1646
050,01,117,"Alabama","Shelby County",2,13,3354,1744,1610
050,01,117,"Alabama","Shelby County",2,14,3288,1717,1571
050,01,117,"Alabama","Shelby County",2,15,3273,1666,1607
050,01,117,"Alabama","Shelby County",2,16,3338,1664,1674
050,01,117,"Alabama","Shelby County",2,17,3275,1660,1615
050,01,117,"Alabama","Shelby County",2,18,2860,1458,1402
050,01,117,"Alabama","Shelby County",2,19,2548,1270,1278
050,01,117,"Alabama","Shelby County",2,20,2628,1293,1335
050,01,117,"Alabama","Shelby County",2,21,2622,1322,1300
050,01,117,"Alabama","Shelby County",2,22,2673,1309,1364
050,01,117,"Alabama","Shelby County",2,23,2678,1319,1359
050,01,117,"Alabama","Shelby County",2,24,2563,1250,1313
050,01,117,"Alabama","Shelby County",2,25,2533,1248,1285
050,01,117,"Alabama","Shelby County",2,26,2560,1264,1296
050,01,117,"Alabama","Shelby County",2,27,2620,1316,1304
050,01,117,"Alabama","Shelby County",2,28,2647,1289,1358
050,01,117,"Alabama","Shelby County",2,29,2715,1308,1407
050,01,117,"Alabama","Shelby County",2,30,2772,1326,1446
050,01,117,"Alabama","Shelby County",2,31,2730,1331,1399
050,01,117,"Alabama","Shelby County",2,32,2721,1344,1377
050,01,117,"Alabama","Shelby County",2,33,2767,1306,1461
050,01,117,"Alabama","Shelby County",2,34,2809,1305,1504
050,01,117,"Alabama","Shelby County",2,35,2923,1389,1534
050,01,117,"Alabama","Shelby County",2,36,2927,1430,1497
050,01,117,"Alabama","Shelby County",2,37,3039,1512,1527
050,01,117,"Alabama","Shelby County",2,38,3115,1530,1585
050,01,117,"Alabama","Shelby County",2,39,3177,1580,1597
050,01,117,"Alabama","Shelby County",2,40,3208,1593,1615
050,01,117,"Alabama","Shelby County",2,41,3131,1530,1601
050,01,117,"Alabama","Shelby County",2,42,3087,1490,1597
050,01,117,"Alabama","Shelby County",2,43,3105,1528,1577
050,01,117,"Alabama","Shelby County",2,44,3035,1520,1515
050,01,117,"Alabama","Shelby County",2,45,3043,1511,1532
050,01,117,"Alabama","Shelby County",2,46,3002,1502,1500
050,01,117,"Alabama","Shelby County",2,47,3102,1594,1508
050,01,117,"Alabama","Shelby County",2,48,3273,1637,1636
050,01,117,"Alabama","Shelby County",2,49,3459,1700,1759
050,01,117,"Alabama","Shelby County",2,50,3366,1632,1734
050,01,117,"Alabama","Shelby County",2,51,3120,1526,1594
050,01,117,"Alabama","Shelby County",2,52,2932,1456,1476
050,01,117,"Alabama","Shelby County",2,53,2897,1436,1461
050,01,117,"Alabama","Shelby County",2,54,2886,1434,1452
050,01,117,"Alabama","Shelby County",2,55,3004,1479,1525
050,01,117,"Alabama","Shelby County",2,56,3075,1529,1546
050,01,117,"Alabama","Shelby County",2,57,3006,1480,1526
050,01,117,"Alabama","Shelby County",2,58,2999,1459,1540
050,01,117,"Alabama","Shelby County",2,59,2966,1422,1544
050,01,117,"Alabama","Shelby County",2,60,2831,1353,1478
050,01,117,"Alabama","Shelby County",2,61,2804,1360,1444
050,01,117,"Alabama","Shelby County",2,62,2811,1362,1449
050,01,117,"Alabama","Shelby County",2,63,2760,1356,1404
050,01,117,"Alabama","Shelby County",2,64,2643,1288,1355
050,01,117,"Alabama","Shelby County",2,65,2541,1189,1352
050,01,117,"Alabama","Shelby County",2,66,2473,1135,1338
050,01,117,"Alabama","Shelby County",2,67,2413,1119,1294
050,01,117,"Alabama","Shelby County",2,68,2390,1110,1280
050,01,117,"Alabama","Shelby County",2,69,2251,1032,1219
050,01,117,"Alabama","Shelby County",2,70,2156,957,1199
050,01,117,"Alabama","Shelby County",2,71,2086,918,1168
050,01,117,"Alabama","Shelby County",2,72,2056,971,1085
050,01,117,"Alabama","Shelby County",2,73,2177,1044,1133
050,01,117,"Alabama","Shelby County",2,74,1468,673,795
050,01,117,"Alabama","Shelby County",2,75,1384,641,743
050,01,117,"Alabama","Shelby County",2,76,1342,624,718
050,01,117,"Alabama","Shelby County",2,77,1378,618,760
050,01,117,"Alabama","Shelby County",2,78,1132,495,637
050,01,117,"Alabama","Shelby County",2,79,1001,426,575
050,01,117,"Alabama","Shelby County",2,80,909,387,522
050,01,117,"Alabama","Shelby County",2,81,834,373,461
050,01,117,"Alabama","Shelby County",2,82,760,345,415
050,01,117,"Alabama","Shelby County",2,83,646,276,370
050,01,117,"Alabama","Shelby County",2,84,567,227,340
050,01,117,"Alabama","Shelby County",2,85,3419,1237,2182
050,01,117,"Alabama","Shelby County",3,0,2236,1105,1131
050,01,117,"Alabama","Shelby County",3,1,2309,1185,1124
050,01,117,"Alabama","Shelby County",3,2,2463,1248,1215
050,01,117,"Alabama","Shelby County",3,3,2494,1251,1243
050,01,117,"Alabama","Shelby County",3,4,2534,1301,1233
050,01,117,"Alabama","Shelby County",3,5,2769,1412,1357
050,01,117,"Alabama","Shelby County",3,6,2818,1365,1453
050,01,117,"Alabama","Shelby County",3,7,2838,1365,1473
050,01,117,"Alabama","Shelby County",3,8,2815,1407,1408
050,01,117,"Alabama","Shelby County",3,9,2934,1499,1435
050,01,117,"Alabama","Shelby County",3,10,3030,1567,1463
050,01,117,"Alabama","Shelby County",3,11,3069,1554,1515
050,01,117,"Alabama","Shelby County",3,12,3242,1664,1578
050,01,117,"Alabama","Shelby County",3,13,3383,1732,1651
050,01,117,"Alabama","Shelby County",3,14,3412,1760,1652
050,01,117,"Alabama","Shelby County",3,15,3358,1759,1599
050,01,117,"Alabama","Shelby County",3,16,3299,1682,1617
050,01,117,"Alabama","Shelby County",3,17,3385,1690,1695
050,01,117,"Alabama","Shelby County",3,18,2937,1490,1447
050,01,117,"Alabama","Shelby County",3,19,2478,1231,1247
050,01,117,"Alabama","Shelby County",3,20,2697,1346,1351
050,01,117,"Alabama","Shelby County",3,21,2745,1401,1344
050,01,117,"Alabama","Shelby County",3,22,2692,1339,1353
050,01,117,"Alabama","Shelby County",3,23,2719,1323,1396
050,01,117,"Alabama","Shelby County",3,24,2682,1297,1385
050,01,117,"Alabama","Shelby County",3,25,2706,1339,1367
050,01,117,"Alabama","Shelby County",3,26,2580,1267,1313
050,01,117,"Alabama","Shelby County",3,27,2695,1337,1358
050,01,117,"Alabama","Shelby County",3,28,2726,1343,1383
050,01,117,"Alabama","Shelby County",3,29,2769,1340,1429
050,01,117,"Alabama","Shelby County",3,30,2873,1411,1462
050,01,117,"Alabama","Shelby County",3,31,2883,1358,1525
050,01,117,"Alabama","Shelby County",3,32,2811,1370,1441
050,01,117,"Alabama","Shelby County",3,33,2837,1394,1443
050,01,117,"Alabama","Shelby County",3,34,2839,1362,1477
050,01,117,"Alabama","Shelby County",3,35,2844,1309,1535
050,01,117,"Alabama","Shelby County",3,36,2956,1416,1540
050,01,117,"Alabama","Shelby County",3,37,3035,1468,1567
050,01,117,"Alabama","Shelby County",3,38,3101,1535,1566
050,01,117,"Alabama","Shelby County",3,39,3208,1586,1622
050,01,117,"Alabama","Shelby County",3,40,3226,1612,1614
050,01,117,"Alabama","Shelby County",3,41,3220,1610,1610
050,01,117,"Alabama","Shelby County",3,42,3144,1520,1624
050,01,117,"Alabama","Shelby County",3,43,3074,1473,1601
050,01,117,"Alabama","Shelby County",3,44,3136,1550,1586
050,01,117,"Alabama","Shelby County",3,45,3088,1544,1544
050,01,117,"Alabama","Shelby County",3,46,3086,1537,1549
050,01,117,"Alabama","Shelby County",3,47,3055,1519,1536
050,01,117,"Alabama","Shelby County",3,48,3100,1584,1516
050,01,117,"Alabama","Shelby County",3,49,3234,1619,1615
050,01,117,"Alabama","Shelby County",3,50,3518,1730,1788
050,01,117,"Alabama","Shelby County",3,51,3412,1656,1756
050,01,117,"Alabama","Shelby County",3,52,3137,1527,1610
050,01,117,"Alabama","Shelby County",3,53,2962,1483,1479
050,01,117,"Alabama","Shelby County",3,54,2859,1414,1445
050,01,117,"Alabama","Shelby County",3,55,2906,1452,1454
050,01,117,"Alabama","Shelby County",3,56,2954,1445,1509
050,01,117,"Alabama","Shelby County",3,57,3047,1494,1553
050,01,117,"Alabama","Shelby County",3,58,2976,1451,1525
050,01,117,"Alabama","Shelby County",3,59,3006,1452,1554
050,01,117,"Alabama","Shelby County",3,60,2941,1411,1530
050,01,117,"Alabama","Shelby County",3,61,2792,1333,1459
050,01,117,"Alabama","Shelby County",3,62,2813,1364,1449
050,01,117,"Alabama","Shelby County",3,63,2800,1355,1445
050,01,117,"Alabama","Shelby County",3,64,2756,1356,1400
050,01,117,"Alabama","Shelby County",3,65,2657,1276,1381
050,01,117,"Alabama","Shelby County",3,66,2515,1186,1329
050,01,117,"Alabama","Shelby County",3,67,2484,1132,1352
050,01,117,"Alabama","Shelby County",3,68,2382,1093,1289
050,01,117,"Alabama","Shelby County",3,69,2371,1116,1255
050,01,117,"Alabama","Shelby County",3,70,2236,1018,1218
050,01,117,"Alabama","Shelby County",3,71,2105,931,1174
050,01,117,"Alabama","Shelby County",3,72,2068,907,1161
050,01,117,"Alabama","Shelby County",3,73,2006,935,1071
050,01,117,"Alabama","Shelby County",3,74,2158,1028,1130
050,01,117,"Alabama","Shelby County",3,75,1428,636,792
050,01,117,"Alabama","Shelby County",3,76,1350,628,722
050,01,117,"Alabama","Shelby County",3,77,1317,605,712
050,01,117,"Alabama","Shelby County",3,78,1334,583,751
050,01,117,"Alabama","Shelby County",3,79,1086,484,602
050,01,117,"Alabama","Shelby County",3,80,991,400,591
050,01,117,"Alabama","Shelby County",3,81,882,380,502
050,01,117,"Alabama","Shelby County",3,82,767,340,427
050,01,117,"Alabama","Shelby County",3,83,707,317,390
050,01,117,"Alabama","Shelby County",3,84,611,251,360
050,01,117,"Alabama","Shelby County",3,85,3555,1274,2281
050,01,117,"Alabama","Shelby County",4,0,2361,1181,1180
050,01,117,"Alabama","Shelby County",4,1,2293,1151,1142
050,01,117,"Alabama","Shelby County",4,2,2348,1205,1143
050,01,117,"Alabama","Shelby County",4,3,2494,1266,1228
050,01,117,"Alabama","Shelby County",4,4,2531,1286,1245
050,01,117,"Alabama","Shelby County",4,5,2576,1316,1260
050,01,117,"Alabama","Shelby County",4,6,2824,1428,1396
050,01,117,"Alabama","Shelby County",4,7,2881,1406,1475
050,01,117,"Alabama","Shelby County",4,8,2878,1379,1499
050,01,117,"Alabama","Shelby County",4,9,2883,1456,1427
050,01,117,"Alabama","Shelby County",4,10,3030,1547,1483
050,01,117,"Alabama","Shelby County",4,11,3102,1618,1484
050,01,117,"Alabama","Shelby County",4,12,3133,1601,1532
050,01,117,"Alabama","Shelby County",4,13,3279,1669,1610
050,01,117,"Alabama","Shelby County",4,14,3441,1739,1702
050,01,117,"Alabama","Shelby County",4,15,3471,1817,1654
050,01,117,"Alabama","Shelby County",4,16,3378,1751,1627
050,01,117,"Alabama","Shelby County",4,17,3311,1681,1630
050,01,117,"Alabama","Shelby County",4,18,3016,1509,1507
050,01,117,"Alabama","Shelby County",4,19,2544,1266,1278
050,01,117,"Alabama","Shelby County",4,20,2622,1292,1330
050,01,117,"Alabama","Shelby County",4,21,2806,1435,1371
050,01,117,"Alabama","Shelby County",4,22,2813,1398,1415
050,01,117,"Alabama","Shelby County",4,23,2725,1363,1362
050,01,117,"Alabama","Shelby County",4,24,2746,1322,1424
050,01,117,"Alabama","Shelby County",4,25,2670,1325,1345
050,01,117,"Alabama","Shelby County",4,26,2694,1338,1356
050,01,117,"Alabama","Shelby County",4,27,2635,1306,1329
050,01,117,"Alabama","Shelby County",4,28,2749,1341,1408
050,01,117,"Alabama","Shelby County",4,29,2799,1381,1418
050,01,117,"Alabama","Shelby County",4,30,2870,1407,1463
050,01,117,"Alabama","Shelby County",4,31,2914,1452,1462
050,01,117,"Alabama","Shelby County",4,32,2921,1361,1560
050,01,117,"Alabama","Shelby County",4,33,2885,1416,1469
050,01,117,"Alabama","Shelby County",4,34,2937,1456,1481
050,01,117,"Alabama","Shelby County",4,35,2852,1368,1484
050,01,117,"Alabama","Shelby County",4,36,2899,1313,1586
050,01,117,"Alabama","Shelby County",4,37,3023,1438,1585
050,01,117,"Alabama","Shelby County",4,38,3098,1508,1590
050,01,117,"Alabama","Shelby County",4,39,3118,1515,1603
050,01,117,"Alabama","Shelby County",4,40,3199,1576,1623
050,01,117,"Alabama","Shelby County",4,41,3279,1645,1634
050,01,117,"Alabama","Shelby County",4,42,3257,1625,1632
050,01,117,"Alabama","Shelby County",4,43,3146,1518,1628
050,01,117,"Alabama","Shelby County",4,44,3136,1524,1612
050,01,117,"Alabama","Shelby County",4,45,3159,1556,1603
050,01,117,"Alabama","Shelby County",4,46,3113,1552,1561
050,01,117,"Alabama","Shelby County",4,47,3083,1525,1558
050,01,117,"Alabama","Shelby County",4,48,3059,1505,1554
050,01,117,"Alabama","Shelby County",4,49,3099,1586,1513
050,01,117,"Alabama","Shelby County",4,50,3274,1647,1627
050,01,117,"Alabama","Shelby County",4,51,3468,1706,1762
050,01,117,"Alabama","Shelby County",4,52,3386,1653,1733
050,01,117,"Alabama","Shelby County",4,53,3124,1532,1592
050,01,117,"Alabama","Shelby County",4,54,2955,1468,1487
050,01,117,"Alabama","Shelby County",4,55,2822,1382,1440
050,01,117,"Alabama","Shelby County",4,56,2904,1443,1461
050,01,117,"Alabama","Shelby County",4,57,2915,1411,1504
050,01,117,"Alabama","Shelby County",4,58,3008,1476,1532
050,01,117,"Alabama","Shelby County",4,59,2983,1462,1521
050,01,117,"Alabama","Shelby County",4,60,3004,1443,1561
050,01,117,"Alabama","Shelby County",4,61,2920,1398,1522
050,01,117,"Alabama","Shelby County",4,62,2801,1323,1478
050,01,117,"Alabama","Shelby County",4,63,2801,1355,1446
050,01,117,"Alabama","Shelby County",4,64,2809,1360,1449
050,01,117,"Alabama","Shelby County",4,65,2764,1329,1435
050,01,117,"Alabama","Shelby County",4,66,2624,1248,1376
050,01,117,"Alabama","Shelby County",4,67,2514,1194,1320
050,01,117,"Alabama","Shelby County",4,68,2435,1104,1331
050,01,117,"Alabama","Shelby County",4,69,2343,1078,1265
050,01,117,"Alabama","Shelby County",4,70,2349,1091,1258
050,01,117,"Alabama","Shelby County",4,71,2234,1003,1231
050,01,117,"Alabama","Shelby County",4,72,2085,926,1159
050,01,117,"Alabama","Shelby County",4,73,2024,881,1143
050,01,117,"Alabama","Shelby County",4,74,1998,920,1078
050,01,117,"Alabama","Shelby County",4,75,2113,980,1133
050,01,117,"Alabama","Shelby County",4,76,1396,616,780
050,01,117,"Alabama","Shelby County",4,77,1338,610,728
050,01,117,"Alabama","Shelby County",4,78,1273,580,693
050,01,117,"Alabama","Shelby County",4,79,1292,570,722
050,01,117,"Alabama","Shelby County",4,80,1065,449,616
050,01,117,"Alabama","Shelby County",4,81,944,373,571
050,01,117,"Alabama","Shelby County",4,82,809,352,457
050,01,117,"Alabama","Shelby County",4,83,706,309,397
050,01,117,"Alabama","Shelby County",4,84,679,303,376
050,01,117,"Alabama","Shelby County",4,85,3794,1384,2410
050,01,117,"Alabama","Shelby County",5,0,2380,1191,1189
050,01,117,"Alabama","Shelby County",5,1,2449,1239,1210
050,01,117,"Alabama","Shelby County",5,2,2347,1169,1178
050,01,117,"Alabama","Shelby County",5,3,2466,1264,1202
050,01,117,"Alabama","Shelby County",5,4,2588,1313,1275
050,01,117,"Alabama","Shelby County",5,5,2616,1334,1282
050,01,117,"Alabama","Shelby County",5,6,2631,1365,1266
050,01,117,"Alabama","Shelby County",5,7,2874,1445,1429
050,01,117,"Alabama","Shelby County",5,8,2942,1417,1525
050,01,117,"Alabama","Shelby County",5,9,2965,1458,1507
050,01,117,"Alabama","Shelby County",5,10,2929,1491,1438
050,01,117,"Alabama","Shelby County",5,11,3076,1556,1520
050,01,117,"Alabama","Shelby County",5,12,3167,1676,1491
050,01,117,"Alabama","Shelby County",5,13,3165,1640,1525
050,01,117,"Alabama","Shelby County",5,14,3351,1701,1650
050,01,117,"Alabama","Shelby County",5,15,3500,1786,1714
050,01,117,"Alabama","Shelby County",5,16,3496,1831,1665
050,01,117,"Alabama","Shelby County",5,17,3376,1758,1618
050,01,117,"Alabama","Shelby County",5,18,2947,1498,1449
050,01,117,"Alabama","Shelby County",5,19,2651,1302,1349
050,01,117,"Alabama","Shelby County",5,20,2693,1338,1355
050,01,117,"Alabama","Shelby County",5,21,2759,1372,1387
050,01,117,"Alabama","Shelby County",5,22,2874,1424,1450
050,01,117,"Alabama","Shelby County",5,23,2822,1423,1399
050,01,117,"Alabama","Shelby County",5,24,2753,1378,1375
050,01,117,"Alabama","Shelby County",5,25,2706,1286,1420
050,01,117,"Alabama","Shelby County",5,26,2699,1322,1377
050,01,117,"Alabama","Shelby County",5,27,2729,1345,1384
050,01,117,"Alabama","Shelby County",5,28,2672,1304,1368
050,01,117,"Alabama","Shelby County",5,29,2827,1376,1451
050,01,117,"Alabama","Shelby County",5,30,2858,1411,1447
050,01,117,"Alabama","Shelby County",5,31,2890,1429,1461
050,01,117,"Alabama","Shelby County",5,32,2964,1468,1496
050,01,117,"Alabama","Shelby County",5,33,2983,1397,1586
050,01,117,"Alabama","Shelby County",5,34,2969,1460,1509
050,01,117,"Alabama","Shelby County",5,35,3022,1506,1516
050,01,117,"Alabama","Shelby County",5,36,2898,1365,1533
050,01,117,"Alabama","Shelby County",5,37,3000,1378,1622
050,01,117,"Alabama","Shelby County",5,38,3044,1441,1603
050,01,117,"Alabama","Shelby County",5,39,3138,1540,1598
050,01,117,"Alabama","Shelby County",5,40,3112,1501,1611
050,01,117,"Alabama","Shelby County",5,41,3290,1630,1660
050,01,117,"Alabama","Shelby County",5,42,3293,1643,1650
050,01,117,"Alabama","Shelby County",5,43,3238,1619,1619
050,01,117,"Alabama","Shelby County",5,44,3164,1506,1658
050,01,117,"Alabama","Shelby County",5,45,3178,1553,1625
050,01,117,"Alabama","Shelby County",5,46,3155,1558,1597
050,01,117,"Alabama","Shelby County",5,47,3153,1569,1584
050,01,117,"Alabama","Shelby County",5,48,3094,1528,1566
050,01,117,"Alabama","Shelby County",5,49,3016,1482,1534
050,01,117,"Alabama","Shelby County",5,50,3095,1602,1493
050,01,117,"Alabama","Shelby County",5,51,3274,1641,1633
050,01,117,"Alabama","Shelby County",5,52,3462,1710,1752
050,01,117,"Alabama","Shelby County",5,53,3354,1632,1722
050,01,117,"Alabama","Shelby County",5,54,3106,1527,1579
050,01,117,"Alabama","Shelby County",5,55,2976,1479,1497
050,01,117,"Alabama","Shelby County",5,56,2796,1364,1432
050,01,117,"Alabama","Shelby County",5,57,2901,1414,1487
050,01,117,"Alabama","Shelby County",5,58,2937,1418,1519
050,01,117,"Alabama","Shelby County",5,59,3008,1470,1538
050,01,117,"Alabama","Shelby County",5,60,2957,1438,1519
050,01,117,"Alabama","Shelby County",5,61,2978,1429,1549
050,01,117,"Alabama","Shelby County",5,62,2917,1381,1536
050,01,117,"Alabama","Shelby County",5,63,2834,1327,1507
050,01,117,"Alabama","Shelby County",5,64,2805,1357,1448
050,01,117,"Alabama","Shelby County",5,65,2818,1357,1461
050,01,117,"Alabama","Shelby County",5,66,2751,1323,1428
050,01,117,"Alabama","Shelby County",5,67,2608,1244,1364
050,01,117,"Alabama","Shelby County",5,68,2491,1171,1320
050,01,117,"Alabama","Shelby County",5,69,2377,1078,1299
050,01,117,"Alabama","Shelby County",5,70,2358,1076,1282
050,01,117,"Alabama","Shelby County",5,71,2323,1084,1239
050,01,117,"Alabama","Shelby County",5,72,2229,999,1230
050,01,117,"Alabama","Shelby County",5,73,2067,918,1149
050,01,117,"Alabama","Shelby County",5,74,1988,857,1131
050,01,117,"Alabama","Shelby County",5,75,1946,895,1051
050,01,117,"Alabama","Shelby County",5,76,2092,959,1133
050,01,117,"Alabama","Shelby County",5,77,1384,602,782
050,01,117,"Alabama","Shelby County",5,78,1299,583,716
050,01,117,"Alabama","Shelby County",5,79,1234,575,659
050,01,117,"Alabama","Shelby County",5,80,1280,545,735
050,01,117,"Alabama","Shelby County",5,81,1017,425,592
050,01,117,"Alabama","Shelby County",5,82,884,349,535
050,01,117,"Alabama","Shelby County",5,83,766,330,436
050,01,117,"Alabama","Shelby County",5,84,691,304,387
050,01,117,"Alabama","Shelby County",5,85,4088,1548,2540
050,01,119,"Alabama","Sumter County",1,0,129,65,64
050,01,119,"Alabama","Sumter County",1,1,132,63,69
050,01,119,"Alabama","Sumter County",1,2,144,65,79
050,01,119,"Alabama","Sumter County",1,3,137,61,76
050,01,119,"Alabama","Sumter County",1,4,146,82,64
050,01,119,"Alabama","Sumter County",1,5,150,77,73
050,01,119,"Alabama","Sumter County",1,6,134,72,62
050,01,119,"Alabama","Sumter County",1,7,116,56,60
050,01,119,"Alabama","Sumter County",1,8,121,62,59
050,01,119,"Alabama","Sumter County",1,9,114,68,46
050,01,119,"Alabama","Sumter County",1,10,111,56,55
050,01,119,"Alabama","Sumter County",1,11,124,63,61
050,01,119,"Alabama","Sumter County",1,12,130,70,60
050,01,119,"Alabama","Sumter County",1,13,140,56,84
050,01,119,"Alabama","Sumter County",1,14,123,56,67
050,01,119,"Alabama","Sumter County",1,15,116,55,61
050,01,119,"Alabama","Sumter County",1,16,131,69,62
050,01,119,"Alabama","Sumter County",1,17,141,68,73
050,01,119,"Alabama","Sumter County",1,18,227,110,117
050,01,119,"Alabama","Sumter County",1,19,441,208,233
050,01,119,"Alabama","Sumter County",1,20,571,257,314
050,01,119,"Alabama","Sumter County",1,21,417,165,252
050,01,119,"Alabama","Sumter County",1,22,329,138,191
050,01,119,"Alabama","Sumter County",1,23,257,129,128
050,01,119,"Alabama","Sumter County",1,24,218,104,114
050,01,119,"Alabama","Sumter County",1,25,194,102,92
050,01,119,"Alabama","Sumter County",1,26,183,95,88
050,01,119,"Alabama","Sumter County",1,27,173,77,96
050,01,119,"Alabama","Sumter County",1,28,163,82,81
050,01,119,"Alabama","Sumter County",1,29,139,65,74
050,01,119,"Alabama","Sumter County",1,30,136,65,71
050,01,119,"Alabama","Sumter County",1,31,109,59,50
050,01,119,"Alabama","Sumter County",1,32,98,46,52
050,01,119,"Alabama","Sumter County",1,33,102,48,54
050,01,119,"Alabama","Sumter County",1,34,103,56,47
050,01,119,"Alabama","Sumter County",1,35,109,54,55
050,01,119,"Alabama","Sumter County",1,36,95,42,53
050,01,119,"Alabama","Sumter County",1,37,98,47,51
050,01,119,"Alabama","Sumter County",1,38,108,50,58
050,01,119,"Alabama","Sumter County",1,39,106,53,53
050,01,119,"Alabama","Sumter County",1,40,93,38,55
050,01,119,"Alabama","Sumter County",1,41,98,43,55
050,01,119,"Alabama","Sumter County",1,42,102,39,63
050,01,119,"Alabama","Sumter County",1,43,110,47,63
050,01,119,"Alabama","Sumter County",1,44,107,44,63
050,01,119,"Alabama","Sumter County",1,45,100,47,53
050,01,119,"Alabama","Sumter County",1,46,114,50,64
050,01,119,"Alabama","Sumter County",1,47,127,53,74
050,01,119,"Alabama","Sumter County",1,48,129,56,73
050,01,119,"Alabama","Sumter County",1,49,147,73,74
050,01,119,"Alabama","Sumter County",1,50,136,65,71
050,01,119,"Alabama","Sumter County",1,51,117,56,61
050,01,119,"Alabama","Sumter County",1,52,130,62,68
050,01,119,"Alabama","Sumter County",1,53,121,54,67
050,01,119,"Alabama","Sumter County",1,54,116,47,69
050,01,119,"Alabama","Sumter County",1,55,126,56,70
050,01,119,"Alabama","Sumter County",1,56,153,72,81
050,01,119,"Alabama","Sumter County",1,57,156,70,86
050,01,119,"Alabama","Sumter County",1,58,168,70,98
050,01,119,"Alabama","Sumter County",1,59,183,85,98
050,01,119,"Alabama","Sumter County",1,60,169,77,92
050,01,119,"Alabama","Sumter County",1,61,156,75,81
050,01,119,"Alabama","Sumter County",1,62,155,64,91
050,01,119,"Alabama","Sumter County",1,63,179,80,99
050,01,119,"Alabama","Sumter County",1,64,173,80,93
050,01,119,"Alabama","Sumter County",1,65,167,88,79
050,01,119,"Alabama","Sumter County",1,66,180,93,87
050,01,119,"Alabama","Sumter County",1,67,173,87,86
050,01,119,"Alabama","Sumter County",1,68,142,65,77
050,01,119,"Alabama","Sumter County",1,69,128,61,67
050,01,119,"Alabama","Sumter County",1,70,132,64,68
050,01,119,"Alabama","Sumter County",1,71,142,65,77
050,01,119,"Alabama","Sumter County",1,72,105,46,59
050,01,119,"Alabama","Sumter County",1,73,87,37,50
050,01,119,"Alabama","Sumter County",1,74,72,37,35
050,01,119,"Alabama","Sumter County",1,75,85,36,49
050,01,119,"Alabama","Sumter County",1,76,84,33,51
050,01,119,"Alabama","Sumter County",1,77,79,26,53
050,01,119,"Alabama","Sumter County",1,78,66,23,43
050,01,119,"Alabama","Sumter County",1,79,54,19,35
050,01,119,"Alabama","Sumter County",1,80,70,29,41
050,01,119,"Alabama","Sumter County",1,81,70,27,43
050,01,119,"Alabama","Sumter County",1,82,52,19,33
050,01,119,"Alabama","Sumter County",1,83,45,21,24
050,01,119,"Alabama","Sumter County",1,84,36,16,20
050,01,119,"Alabama","Sumter County",1,85,295,73,222
050,01,119,"Alabama","Sumter County",2,0,125,65,60
050,01,119,"Alabama","Sumter County",2,1,130,62,68
050,01,119,"Alabama","Sumter County",2,2,143,64,79
050,01,119,"Alabama","Sumter County",2,3,138,62,76
050,01,119,"Alabama","Sumter County",2,4,144,76,68
050,01,119,"Alabama","Sumter County",2,5,151,79,72
050,01,119,"Alabama","Sumter County",2,6,138,73,65
050,01,119,"Alabama","Sumter County",2,7,120,59,61
050,01,119,"Alabama","Sumter County",2,8,119,61,58
050,01,119,"Alabama","Sumter County",2,9,115,66,49
050,01,119,"Alabama","Sumter County",2,10,110,59,51
050,01,119,"Alabama","Sumter County",2,11,120,62,58
050,01,119,"Alabama","Sumter County",2,12,127,66,61
050,01,119,"Alabama","Sumter County",2,13,136,58,78
050,01,119,"Alabama","Sumter County",2,14,126,55,71
050,01,119,"Alabama","Sumter County",2,15,116,54,62
050,01,119,"Alabama","Sumter County",2,16,127,65,62
050,01,119,"Alabama","Sumter County",2,17,138,68,70
050,01,119,"Alabama","Sumter County",2,18,221,107,114
050,01,119,"Alabama","Sumter County",2,19,409,192,217
050,01,119,"Alabama","Sumter County",2,20,541,247,294
050,01,119,"Alabama","Sumter County",2,21,407,159,248
050,01,119,"Alabama","Sumter County",2,22,323,135,188
050,01,119,"Alabama","Sumter County",2,23,245,122,123
050,01,119,"Alabama","Sumter County",2,24,215,100,115
050,01,119,"Alabama","Sumter County",2,25,185,96,89
050,01,119,"Alabama","Sumter County",2,26,185,97,88
050,01,119,"Alabama","Sumter County",2,27,168,77,91
050,01,119,"Alabama","Sumter County",2,28,164,81,83
050,01,119,"Alabama","Sumter County",2,29,146,70,76
050,01,119,"Alabama","Sumter County",2,30,137,67,70
050,01,119,"Alabama","Sumter County",2,31,113,58,55
050,01,119,"Alabama","Sumter County",2,32,99,48,51
050,01,119,"Alabama","Sumter County",2,33,102,47,55
050,01,119,"Alabama","Sumter County",2,34,101,54,47
050,01,119,"Alabama","Sumter County",2,35,108,54,54
050,01,119,"Alabama","Sumter County",2,36,97,45,52
050,01,119,"Alabama","Sumter County",2,37,96,45,51
050,01,119,"Alabama","Sumter County",2,38,104,49,55
050,01,119,"Alabama","Sumter County",2,39,106,52,54
050,01,119,"Alabama","Sumter County",2,40,97,43,54
050,01,119,"Alabama","Sumter County",2,41,96,42,54
050,01,119,"Alabama","Sumter County",2,42,100,40,60
050,01,119,"Alabama","Sumter County",2,43,110,46,64
050,01,119,"Alabama","Sumter County",2,44,106,44,62
050,01,119,"Alabama","Sumter County",2,45,103,47,56
050,01,119,"Alabama","Sumter County",2,46,111,48,63
050,01,119,"Alabama","Sumter County",2,47,123,52,71
050,01,119,"Alabama","Sumter County",2,48,130,56,74
050,01,119,"Alabama","Sumter County",2,49,140,67,73
050,01,119,"Alabama","Sumter County",2,50,139,67,72
050,01,119,"Alabama","Sumter County",2,51,119,57,62
050,01,119,"Alabama","Sumter County",2,52,126,61,65
050,01,119,"Alabama","Sumter County",2,53,122,55,67
050,01,119,"Alabama","Sumter County",2,54,117,49,68
050,01,119,"Alabama","Sumter County",2,55,122,53,69
050,01,119,"Alabama","Sumter County",2,56,147,69,78
050,01,119,"Alabama","Sumter County",2,57,153,69,84
050,01,119,"Alabama","Sumter County",2,58,165,70,95
050,01,119,"Alabama","Sumter County",2,59,177,80,97
050,01,119,"Alabama","Sumter County",2,60,172,78,94
050,01,119,"Alabama","Sumter County",2,61,158,74,84
050,01,119,"Alabama","Sumter County",2,62,152,64,88
050,01,119,"Alabama","Sumter County",2,63,176,78,98
050,01,119,"Alabama","Sumter County",2,64,172,79,93
050,01,119,"Alabama","Sumter County",2,65,164,84,80
050,01,119,"Alabama","Sumter County",2,66,178,93,85
050,01,119,"Alabama","Sumter County",2,67,172,86,86
050,01,119,"Alabama","Sumter County",2,68,146,69,77
050,01,119,"Alabama","Sumter County",2,69,131,61,70
050,01,119,"Alabama","Sumter County",2,70,131,63,68
050,01,119,"Alabama","Sumter County",2,71,139,65,74
050,01,119,"Alabama","Sumter County",2,72,111,49,62
050,01,119,"Alabama","Sumter County",2,73,92,39,53
050,01,119,"Alabama","Sumter County",2,74,70,33,37
050,01,119,"Alabama","Sumter County",2,75,82,37,45
050,01,119,"Alabama","Sumter County",2,76,84,33,51
050,01,119,"Alabama","Sumter County",2,77,81,27,54
050,01,119,"Alabama","Sumter County",2,78,66,24,42
050,01,119,"Alabama","Sumter County",2,79,55,18,37
050,01,119,"Alabama","Sumter County",2,80,65,27,38
050,01,119,"Alabama","Sumter County",2,81,67,27,40
050,01,119,"Alabama","Sumter County",2,82,54,20,34
050,01,119,"Alabama","Sumter County",2,83,46,20,26
050,01,119,"Alabama","Sumter County",2,84,40,18,22
050,01,119,"Alabama","Sumter County",2,85,289,72,217
050,01,119,"Alabama","Sumter County",3,0,124,75,49
050,01,119,"Alabama","Sumter County",3,1,125,65,60
050,01,119,"Alabama","Sumter County",3,2,123,60,63
050,01,119,"Alabama","Sumter County",3,3,146,68,78
050,01,119,"Alabama","Sumter County",3,4,134,59,75
050,01,119,"Alabama","Sumter County",3,5,144,80,64
050,01,119,"Alabama","Sumter County",3,6,153,83,70
050,01,119,"Alabama","Sumter County",3,7,144,75,69
050,01,119,"Alabama","Sumter County",3,8,120,59,61
050,01,119,"Alabama","Sumter County",3,9,117,58,59
050,01,119,"Alabama","Sumter County",3,10,118,68,50
050,01,119,"Alabama","Sumter County",3,11,115,60,55
050,01,119,"Alabama","Sumter County",3,12,122,68,54
050,01,119,"Alabama","Sumter County",3,13,125,64,61
050,01,119,"Alabama","Sumter County",3,14,134,62,72
050,01,119,"Alabama","Sumter County",3,15,123,53,70
050,01,119,"Alabama","Sumter County",3,16,115,54,61
050,01,119,"Alabama","Sumter County",3,17,122,61,61
050,01,119,"Alabama","Sumter County",3,18,213,101,112
050,01,119,"Alabama","Sumter County",3,19,377,173,204
050,01,119,"Alabama","Sumter County",3,20,489,224,265
050,01,119,"Alabama","Sumter County",3,21,391,153,238
050,01,119,"Alabama","Sumter County",3,22,319,130,189
050,01,119,"Alabama","Sumter County",3,23,222,109,113
050,01,119,"Alabama","Sumter County",3,24,208,98,110
050,01,119,"Alabama","Sumter County",3,25,155,81,74
050,01,119,"Alabama","Sumter County",3,26,161,87,74
050,01,119,"Alabama","Sumter County",3,27,166,84,82
050,01,119,"Alabama","Sumter County",3,28,160,73,87
050,01,119,"Alabama","Sumter County",3,29,159,82,77
050,01,119,"Alabama","Sumter County",3,30,153,73,80
050,01,119,"Alabama","Sumter County",3,31,131,61,70
050,01,119,"Alabama","Sumter County",3,32,118,59,59
050,01,119,"Alabama","Sumter County",3,33,100,46,54
050,01,119,"Alabama","Sumter County",3,34,105,51,54
050,01,119,"Alabama","Sumter County",3,35,97,49,48
050,01,119,"Alabama","Sumter County",3,36,113,57,56
050,01,119,"Alabama","Sumter County",3,37,104,51,53
050,01,119,"Alabama","Sumter County",3,38,94,43,51
050,01,119,"Alabama","Sumter County",3,39,98,48,50
050,01,119,"Alabama","Sumter County",3,40,102,47,55
050,01,119,"Alabama","Sumter County",3,41,97,43,54
050,01,119,"Alabama","Sumter County",3,42,93,42,51
050,01,119,"Alabama","Sumter County",3,43,97,41,56
050,01,119,"Alabama","Sumter County",3,44,105,44,61
050,01,119,"Alabama","Sumter County",3,45,105,45,60
050,01,119,"Alabama","Sumter County",3,46,103,49,54
050,01,119,"Alabama","Sumter County",3,47,112,52,60
050,01,119,"Alabama","Sumter County",3,48,119,47,72
050,01,119,"Alabama","Sumter County",3,49,131,58,73
050,01,119,"Alabama","Sumter County",3,50,137,66,71
050,01,119,"Alabama","Sumter County",3,51,131,61,70
050,01,119,"Alabama","Sumter County",3,52,120,57,63
050,01,119,"Alabama","Sumter County",3,53,128,60,68
050,01,119,"Alabama","Sumter County",3,54,123,55,68
050,01,119,"Alabama","Sumter County",3,55,114,47,67
050,01,119,"Alabama","Sumter County",3,56,121,51,70
050,01,119,"Alabama","Sumter County",3,57,144,64,80
050,01,119,"Alabama","Sumter County",3,58,154,67,87
050,01,119,"Alabama","Sumter County",3,59,164,69,95
050,01,119,"Alabama","Sumter County",3,60,177,80,97
050,01,119,"Alabama","Sumter County",3,61,176,80,96
050,01,119,"Alabama","Sumter County",3,62,154,74,80
050,01,119,"Alabama","Sumter County",3,63,145,59,86
050,01,119,"Alabama","Sumter County",3,64,178,82,96
050,01,119,"Alabama","Sumter County",3,65,166,76,90
050,01,119,"Alabama","Sumter County",3,66,163,83,80
050,01,119,"Alabama","Sumter County",3,67,174,92,82
050,01,119,"Alabama","Sumter County",3,68,168,84,84
050,01,119,"Alabama","Sumter County",3,69,138,69,69
050,01,119,"Alabama","Sumter County",3,70,125,56,69
050,01,119,"Alabama","Sumter County",3,71,130,63,67
050,01,119,"Alabama","Sumter County",3,72,130,60,70
050,01,119,"Alabama","Sumter County",3,73,107,47,60
050,01,119,"Alabama","Sumter County",3,74,90,39,51
050,01,119,"Alabama","Sumter County",3,75,67,29,38
050,01,119,"Alabama","Sumter County",3,76,76,35,41
050,01,119,"Alabama","Sumter County",3,77,83,28,55
050,01,119,"Alabama","Sumter County",3,78,74,28,46
050,01,119,"Alabama","Sumter County",3,79,55,19,36
050,01,119,"Alabama","Sumter County",3,80,55,16,39
050,01,119,"Alabama","Sumter County",3,81,57,24,33
050,01,119,"Alabama","Sumter County",3,82,62,26,36
050,01,119,"Alabama","Sumter County",3,83,47,15,32
050,01,119,"Alabama","Sumter County",3,84,47,21,26
050,01,119,"Alabama","Sumter County",3,85,286,74,212
050,01,119,"Alabama","Sumter County",4,0,132,67,65
050,01,119,"Alabama","Sumter County",4,1,121,74,47
050,01,119,"Alabama","Sumter County",4,2,128,68,60
050,01,119,"Alabama","Sumter County",4,3,118,57,61
050,01,119,"Alabama","Sumter County",4,4,139,64,75
050,01,119,"Alabama","Sumter County",4,5,132,55,77
050,01,119,"Alabama","Sumter County",4,6,128,73,55
050,01,119,"Alabama","Sumter County",4,7,148,77,71
050,01,119,"Alabama","Sumter County",4,8,141,72,69
050,01,119,"Alabama","Sumter County",4,9,127,66,61
050,01,119,"Alabama","Sumter County",4,10,112,56,56
050,01,119,"Alabama","Sumter County",4,11,126,73,53
050,01,119,"Alabama","Sumter County",4,12,111,60,51
050,01,119,"Alabama","Sumter County",4,13,126,70,56
050,01,119,"Alabama","Sumter County",4,14,124,59,65
050,01,119,"Alabama","Sumter County",4,15,142,67,75
050,01,119,"Alabama","Sumter County",4,16,123,55,68
050,01,119,"Alabama","Sumter County",4,17,111,49,62
050,01,119,"Alabama","Sumter County",4,18,215,105,110
050,01,119,"Alabama","Sumter County",4,19,389,179,210
050,01,119,"Alabama","Sumter County",4,20,511,234,277
050,01,119,"Alabama","Sumter County",4,21,377,141,236
050,01,119,"Alabama","Sumter County",4,22,312,129,183
050,01,119,"Alabama","Sumter County",4,23,232,120,112
050,01,119,"Alabama","Sumter County",4,24,192,80,112
050,01,119,"Alabama","Sumter County",4,25,145,74,71
050,01,119,"Alabama","Sumter County",4,26,149,77,72
050,01,119,"Alabama","Sumter County",4,27,144,76,68
050,01,119,"Alabama","Sumter County",4,28,149,76,73
050,01,119,"Alabama","Sumter County",4,29,164,72,92
050,01,119,"Alabama","Sumter County",4,30,164,88,76
050,01,119,"Alabama","Sumter County",4,31,145,71,74
050,01,119,"Alabama","Sumter County",4,32,132,63,69
050,01,119,"Alabama","Sumter County",4,33,123,60,63
050,01,119,"Alabama","Sumter County",4,34,96,43,53
050,01,119,"Alabama","Sumter County",4,35,103,51,52
050,01,119,"Alabama","Sumter County",4,36,97,51,46
050,01,119,"Alabama","Sumter County",4,37,110,52,58
050,01,119,"Alabama","Sumter County",4,38,103,50,53
050,01,119,"Alabama","Sumter County",4,39,95,43,52
050,01,119,"Alabama","Sumter County",4,40,107,53,54
050,01,119,"Alabama","Sumter County",4,41,104,51,53
050,01,119,"Alabama","Sumter County",4,42,100,45,55
050,01,119,"Alabama","Sumter County",4,43,88,39,49
050,01,119,"Alabama","Sumter County",4,44,92,35,57
050,01,119,"Alabama","Sumter County",4,45,98,40,58
050,01,119,"Alabama","Sumter County",4,46,100,44,56
050,01,119,"Alabama","Sumter County",4,47,98,46,52
050,01,119,"Alabama","Sumter County",4,48,111,49,62
050,01,119,"Alabama","Sumter County",4,49,110,49,61
050,01,119,"Alabama","Sumter County",4,50,138,66,72
050,01,119,"Alabama","Sumter County",4,51,139,68,71
050,01,119,"Alabama","Sumter County",4,52,132,64,68
050,01,119,"Alabama","Sumter County",4,53,121,55,66
050,01,119,"Alabama","Sumter County",4,54,123,58,65
050,01,119,"Alabama","Sumter County",4,55,119,56,63
050,01,119,"Alabama","Sumter County",4,56,103,45,58
050,01,119,"Alabama","Sumter County",4,57,119,52,67
050,01,119,"Alabama","Sumter County",4,58,140,61,79
050,01,119,"Alabama","Sumter County",4,59,151,67,84
050,01,119,"Alabama","Sumter County",4,60,159,66,93
050,01,119,"Alabama","Sumter County",4,61,174,76,98
050,01,119,"Alabama","Sumter County",4,62,165,71,94
050,01,119,"Alabama","Sumter County",4,63,150,71,79
050,01,119,"Alabama","Sumter County",4,64,144,57,87
050,01,119,"Alabama","Sumter County",4,65,172,76,96
050,01,119,"Alabama","Sumter County",4,66,165,74,91
050,01,119,"Alabama","Sumter County",4,67,155,80,75
050,01,119,"Alabama","Sumter County",4,68,173,92,81
050,01,119,"Alabama","Sumter County",4,69,164,84,80
050,01,119,"Alabama","Sumter County",4,70,133,68,65
050,01,119,"Alabama","Sumter County",4,71,124,55,69
050,01,119,"Alabama","Sumter County",4,72,124,60,64
050,01,119,"Alabama","Sumter County",4,73,123,58,65
050,01,119,"Alabama","Sumter County",4,74,105,47,58
050,01,119,"Alabama","Sumter County",4,75,88,37,51
050,01,119,"Alabama","Sumter County",4,76,64,28,36
050,01,119,"Alabama","Sumter County",4,77,72,30,42
050,01,119,"Alabama","Sumter County",4,78,78,29,49
050,01,119,"Alabama","Sumter County",4,79,70,26,44
050,01,119,"Alabama","Sumter County",4,80,54,16,38
050,01,119,"Alabama","Sumter County",4,81,46,13,33
050,01,119,"Alabama","Sumter County",4,82,56,24,32
050,01,119,"Alabama","Sumter County",4,83,56,22,34
050,01,119,"Alabama","Sumter County",4,84,47,15,32
050,01,119,"Alabama","Sumter County",4,85,299,87,212
050,01,119,"Alabama","Sumter County",5,0,112,54,58
050,01,119,"Alabama","Sumter County",5,1,139,69,70
050,01,119,"Alabama","Sumter County",5,2,122,72,50
050,01,119,"Alabama","Sumter County",5,3,121,67,54
050,01,119,"Alabama","Sumter County",5,4,122,55,67
050,01,119,"Alabama","Sumter County",5,5,142,64,78
050,01,119,"Alabama","Sumter County",5,6,137,55,82
050,01,119,"Alabama","Sumter County",5,7,132,76,56
050,01,119,"Alabama","Sumter County",5,8,146,76,70
050,01,119,"Alabama","Sumter County",5,9,138,68,70
050,01,119,"Alabama","Sumter County",5,10,127,68,59
050,01,119,"Alabama","Sumter County",5,11,110,55,55
050,01,119,"Alabama","Sumter County",5,12,127,77,50
050,01,119,"Alabama","Sumter County",5,13,116,59,57
050,01,119,"Alabama","Sumter County",5,14,118,61,57
050,01,119,"Alabama","Sumter County",5,15,125,60,65
050,01,119,"Alabama","Sumter County",5,16,137,66,71
050,01,119,"Alabama","Sumter County",5,17,122,57,65
050,01,119,"Alabama","Sumter County",5,18,200,94,106
050,01,119,"Alabama","Sumter County",5,19,380,177,203
050,01,119,"Alabama","Sumter County",5,20,496,224,272
050,01,119,"Alabama","Sumter County",5,21,373,144,229
050,01,119,"Alabama","Sumter County",5,22,296,116,180
050,01,119,"Alabama","Sumter County",5,23,210,104,106
050,01,119,"Alabama","Sumter County",5,24,203,97,106
050,01,119,"Alabama","Sumter County",5,25,129,62,67
050,01,119,"Alabama","Sumter County",5,26,136,71,65
050,01,119,"Alabama","Sumter County",5,27,139,65,74
050,01,119,"Alabama","Sumter County",5,28,150,80,70
050,01,119,"Alabama","Sumter County",5,29,149,75,74
050,01,119,"Alabama","Sumter County",5,30,159,65,94
050,01,119,"Alabama","Sumter County",5,31,153,72,81
050,01,119,"Alabama","Sumter County",5,32,123,60,63
050,01,119,"Alabama","Sumter County",5,33,135,60,75
050,01,119,"Alabama","Sumter County",5,34,115,58,57
050,01,119,"Alabama","Sumter County",5,35,104,51,53
050,01,119,"Alabama","Sumter County",5,36,109,55,54
050,01,119,"Alabama","Sumter County",5,37,98,50,48
050,01,119,"Alabama","Sumter County",5,38,108,48,60
050,01,119,"Alabama","Sumter County",5,39,99,49,50
050,01,119,"Alabama","Sumter County",5,40,91,42,49
050,01,119,"Alabama","Sumter County",5,41,107,54,53
050,01,119,"Alabama","Sumter County",5,42,107,51,56
050,01,119,"Alabama","Sumter County",5,43,99,45,54
050,01,119,"Alabama","Sumter County",5,44,82,32,50
050,01,119,"Alabama","Sumter County",5,45,83,29,54
050,01,119,"Alabama","Sumter County",5,46,98,41,57
050,01,119,"Alabama","Sumter County",5,47,98,46,52
050,01,119,"Alabama","Sumter County",5,48,91,38,53
050,01,119,"Alabama","Sumter County",5,49,108,46,62
050,01,119,"Alabama","Sumter County",5,50,116,55,61
050,01,119,"Alabama","Sumter County",5,51,127,65,62
050,01,119,"Alabama","Sumter County",5,52,140,68,72
050,01,119,"Alabama","Sumter County",5,53,129,61,68
050,01,119,"Alabama","Sumter County",5,54,122,55,67
050,01,119,"Alabama","Sumter County",5,55,124,58,66
050,01,119,"Alabama","Sumter County",5,56,118,54,64
050,01,119,"Alabama","Sumter County",5,57,99,47,52
050,01,119,"Alabama","Sumter County",5,58,117,53,64
050,01,119,"Alabama","Sumter County",5,59,133,59,74
050,01,119,"Alabama","Sumter County",5,60,148,66,82
050,01,119,"Alabama","Sumter County",5,61,152,60,92
050,01,119,"Alabama","Sumter County",5,62,160,67,93
050,01,119,"Alabama","Sumter County",5,63,162,71,91
050,01,119,"Alabama","Sumter County",5,64,151,71,80
050,01,119,"Alabama","Sumter County",5,65,149,59,90
050,01,119,"Alabama","Sumter County",5,66,174,75,99
050,01,119,"Alabama","Sumter County",5,67,156,72,84
050,01,119,"Alabama","Sumter County",5,68,153,79,74
050,01,119,"Alabama","Sumter County",5,69,169,92,77
050,01,119,"Alabama","Sumter County",5,70,160,82,78
050,01,119,"Alabama","Sumter County",5,71,129,64,65
050,01,119,"Alabama","Sumter County",5,72,117,53,64
050,01,119,"Alabama","Sumter County",5,73,116,57,59
050,01,119,"Alabama","Sumter County",5,74,119,56,63
050,01,119,"Alabama","Sumter County",5,75,101,44,57
050,01,119,"Alabama","Sumter County",5,76,86,37,49
050,01,119,"Alabama","Sumter County",5,77,63,24,39
050,01,119,"Alabama","Sumter County",5,78,67,31,36
050,01,119,"Alabama","Sumter County",5,79,74,26,48
050,01,119,"Alabama","Sumter County",5,80,71,24,47
050,01,119,"Alabama","Sumter County",5,81,49,14,35
050,01,119,"Alabama","Sumter County",5,82,42,10,32
050,01,119,"Alabama","Sumter County",5,83,52,20,32
050,01,119,"Alabama","Sumter County",5,84,56,23,33
050,01,119,"Alabama","Sumter County",5,85,305,90,215
050,01,121,"Alabama","Talladega County",1,0,853,437,416
050,01,121,"Alabama","Talladega County",1,1,887,474,413
050,01,121,"Alabama","Talladega County",1,2,857,451,406
050,01,121,"Alabama","Talladega County",1,3,884,455,429
050,01,121,"Alabama","Talladega County",1,4,915,472,443
050,01,121,"Alabama","Talladega County",1,5,889,454,435
050,01,121,"Alabama","Talladega County",1,6,866,427,439
050,01,121,"Alabama","Talladega County",1,7,866,451,415
050,01,121,"Alabama","Talladega County",1,8,911,470,441
050,01,121,"Alabama","Talladega County",1,9,936,467,469
050,01,121,"Alabama","Talladega County",1,10,953,484,469
050,01,121,"Alabama","Talladega County",1,11,1058,511,547
050,01,121,"Alabama","Talladega County",1,12,1105,518,587
050,01,121,"Alabama","Talladega County",1,13,1045,510,535
050,01,121,"Alabama","Talladega County",1,14,1049,496,553
050,01,121,"Alabama","Talladega County",1,15,1018,505,513
050,01,121,"Alabama","Talladega County",1,16,1036,524,512
050,01,121,"Alabama","Talladega County",1,17,1033,490,543
050,01,121,"Alabama","Talladega County",1,18,1033,488,545
050,01,121,"Alabama","Talladega County",1,19,982,422,560
050,01,121,"Alabama","Talladega County",1,20,1020,453,567
050,01,121,"Alabama","Talladega County",1,21,1049,455,594
050,01,121,"Alabama","Talladega County",1,22,1031,462,569
050,01,121,"Alabama","Talladega County",1,23,1014,490,524
050,01,121,"Alabama","Talladega County",1,24,999,509,490
050,01,121,"Alabama","Talladega County",1,25,962,489,473
050,01,121,"Alabama","Talladega County",1,26,1032,531,501
050,01,121,"Alabama","Talladega County",1,27,1059,553,506
050,01,121,"Alabama","Talladega County",1,28,1097,577,520
050,01,121,"Alabama","Talladega County",1,29,1145,564,581
050,01,121,"Alabama","Talladega County",1,30,1173,584,589
050,01,121,"Alabama","Talladega County",1,31,1054,546,508
050,01,121,"Alabama","Talladega County",1,32,1015,518,497
050,01,121,"Alabama","Talladega County",1,33,1008,489,519
050,01,121,"Alabama","Talladega County",1,34,948,464,484
050,01,121,"Alabama","Talladega County",1,35,981,481,500
050,01,121,"Alabama","Talladega County",1,36,976,456,520
050,01,121,"Alabama","Talladega County",1,37,1016,474,542
050,01,121,"Alabama","Talladega County",1,38,981,486,495
050,01,121,"Alabama","Talladega County",1,39,986,476,510
050,01,121,"Alabama","Talladega County",1,40,1008,500,508
050,01,121,"Alabama","Talladega County",1,41,1028,506,522
050,01,121,"Alabama","Talladega County",1,42,937,430,507
050,01,121,"Alabama","Talladega County",1,43,909,426,483
050,01,121,"Alabama","Talladega County",1,44,936,485,451
050,01,121,"Alabama","Talladega County",1,45,982,504,478
050,01,121,"Alabama","Talladega County",1,46,1004,508,496
050,01,121,"Alabama","Talladega County",1,47,1060,523,537
050,01,121,"Alabama","Talladega County",1,48,1158,551,607
050,01,121,"Alabama","Talladega County",1,49,1240,599,641
050,01,121,"Alabama","Talladega County",1,50,1153,576,577
050,01,121,"Alabama","Talladega County",1,51,1089,551,538
050,01,121,"Alabama","Talladega County",1,52,1052,522,530
050,01,121,"Alabama","Talladega County",1,53,1118,557,561
050,01,121,"Alabama","Talladega County",1,54,1105,543,562
050,01,121,"Alabama","Talladega County",1,55,1127,562,565
050,01,121,"Alabama","Talladega County",1,56,1151,549,602
050,01,121,"Alabama","Talladega County",1,57,1146,552,594
050,01,121,"Alabama","Talladega County",1,58,1157,576,581
050,01,121,"Alabama","Talladega County",1,59,1178,578,600
050,01,121,"Alabama","Talladega County",1,60,1188,552,636
050,01,121,"Alabama","Talladega County",1,61,1115,522,593
050,01,121,"Alabama","Talladega County",1,62,1178,550,628
050,01,121,"Alabama","Talladega County",1,63,1206,578,628
050,01,121,"Alabama","Talladega County",1,64,1133,547,586
050,01,121,"Alabama","Talladega County",1,65,1108,534,574
050,01,121,"Alabama","Talladega County",1,66,1073,525,548
050,01,121,"Alabama","Talladega County",1,67,1043,512,531
050,01,121,"Alabama","Talladega County",1,68,964,456,508
050,01,121,"Alabama","Talladega County",1,69,903,434,469
050,01,121,"Alabama","Talladega County",1,70,904,434,470
050,01,121,"Alabama","Talladega County",1,71,900,439,461
050,01,121,"Alabama","Talladega County",1,72,934,434,500
050,01,121,"Alabama","Talladega County",1,73,905,427,478
050,01,121,"Alabama","Talladega County",1,74,601,278,323
050,01,121,"Alabama","Talladega County",1,75,585,259,326
050,01,121,"Alabama","Talladega County",1,76,590,263,327
050,01,121,"Alabama","Talladega County",1,77,598,246,352
050,01,121,"Alabama","Talladega County",1,78,497,228,269
050,01,121,"Alabama","Talladega County",1,79,441,215,226
050,01,121,"Alabama","Talladega County",1,80,408,173,235
050,01,121,"Alabama","Talladega County",1,81,366,157,209
050,01,121,"Alabama","Talladega County",1,82,349,140,209
050,01,121,"Alabama","Talladega County",1,83,310,122,188
050,01,121,"Alabama","Talladega County",1,84,264,112,152
050,01,121,"Alabama","Talladega County",1,85,1326,457,869
050,01,121,"Alabama","Talladega County",2,0,862,431,431
050,01,121,"Alabama","Talladega County",2,1,879,466,413
050,01,121,"Alabama","Talladega County",2,2,870,460,410
050,01,121,"Alabama","Talladega County",2,3,873,452,421
050,01,121,"Alabama","Talladega County",2,4,911,469,442
050,01,121,"Alabama","Talladega County",2,5,897,458,439
050,01,121,"Alabama","Talladega County",2,6,875,437,438
050,01,121,"Alabama","Talladega County",2,7,865,444,421
050,01,121,"Alabama","Talladega County",2,8,896,462,434
050,01,121,"Alabama","Talladega County",2,9,923,464,459
050,01,121,"Alabama","Talladega County",2,10,946,477,469
050,01,121,"Alabama","Talladega County",2,11,1026,499,527
050,01,121,"Alabama","Talladega County",2,12,1097,519,578
050,01,121,"Alabama","Talladega County",2,13,1060,512,548
050,01,121,"Alabama","Talladega County",2,14,1045,496,549
050,01,121,"Alabama","Talladega County",2,15,1022,503,519
050,01,121,"Alabama","Talladega County",2,16,1032,518,514
050,01,121,"Alabama","Talladega County",2,17,1033,498,535
050,01,121,"Alabama","Talladega County",2,18,966,472,494
050,01,121,"Alabama","Talladega County",2,19,875,416,459
050,01,121,"Alabama","Talladega County",2,20,931,450,481
050,01,121,"Alabama","Talladega County",2,21,948,450,498
050,01,121,"Alabama","Talladega County",2,22,968,458,510
050,01,121,"Alabama","Talladega County",2,23,989,483,506
050,01,121,"Alabama","Talladega County",2,24,991,503,488
050,01,121,"Alabama","Talladega County",2,25,969,491,478
050,01,121,"Alabama","Talladega County",2,26,1009,517,492
050,01,121,"Alabama","Talladega County",2,27,1052,553,499
050,01,121,"Alabama","Talladega County",2,28,1079,567,512
050,01,121,"Alabama","Talladega County",2,29,1134,566,568
050,01,121,"Alabama","Talladega County",2,30,1166,579,587
050,01,121,"Alabama","Talladega County",2,31,1075,546,529
050,01,121,"Alabama","Talladega County",2,32,1019,521,498
050,01,121,"Alabama","Talladega County",2,33,1010,497,513
050,01,121,"Alabama","Talladega County",2,34,955,461,494
050,01,121,"Alabama","Talladega County",2,35,977,473,504
050,01,121,"Alabama","Talladega County",2,36,966,454,512
050,01,121,"Alabama","Talladega County",2,37,1001,463,538
050,01,121,"Alabama","Talladega County",2,38,991,481,510
050,01,121,"Alabama","Talladega County",2,39,974,469,505
050,01,121,"Alabama","Talladega County",2,40,1009,495,514
050,01,121,"Alabama","Talladega County",2,41,1018,501,517
050,01,121,"Alabama","Talladega County",2,42,948,440,508
050,01,121,"Alabama","Talladega County",2,43,925,432,493
050,01,121,"Alabama","Talladega County",2,44,913,460,453
050,01,121,"Alabama","Talladega County",2,45,974,503,471
050,01,121,"Alabama","Talladega County",2,46,990,504,486
050,01,121,"Alabama","Talladega County",2,47,1043,516,527
050,01,121,"Alabama","Talladega County",2,48,1132,543,589
050,01,121,"Alabama","Talladega County",2,49,1228,593,635
050,01,121,"Alabama","Talladega County",2,50,1175,582,593
050,01,121,"Alabama","Talladega County",2,51,1096,551,545
050,01,121,"Alabama","Talladega County",2,52,1057,525,532
050,01,121,"Alabama","Talladega County",2,53,1096,543,553
050,01,121,"Alabama","Talladega County",2,54,1105,545,560
050,01,121,"Alabama","Talladega County",2,55,1115,553,562
050,01,121,"Alabama","Talladega County",2,56,1151,555,596
050,01,121,"Alabama","Talladega County",2,57,1148,551,597
050,01,121,"Alabama","Talladega County",2,58,1153,570,583
050,01,121,"Alabama","Talladega County",2,59,1176,578,598
050,01,121,"Alabama","Talladega County",2,60,1180,553,627
050,01,121,"Alabama","Talladega County",2,61,1127,523,604
050,01,121,"Alabama","Talladega County",2,62,1155,540,615
050,01,121,"Alabama","Talladega County",2,63,1205,574,631
050,01,121,"Alabama","Talladega County",2,64,1142,548,594
050,01,121,"Alabama","Talladega County",2,65,1109,534,575
050,01,121,"Alabama","Talladega County",2,66,1081,528,553
050,01,121,"Alabama","Talladega County",2,67,1044,515,529
050,01,121,"Alabama","Talladega County",2,68,971,464,507
050,01,121,"Alabama","Talladega County",2,69,926,444,482
050,01,121,"Alabama","Talladega County",2,70,900,433,467
050,01,121,"Alabama","Talladega County",2,71,897,434,463
050,01,121,"Alabama","Talladega County",2,72,905,423,482
050,01,121,"Alabama","Talladega County",2,73,947,444,503
050,01,121,"Alabama","Talladega County",2,74,624,290,334
050,01,121,"Alabama","Talladega County",2,75,582,262,320
050,01,121,"Alabama","Talladega County",2,76,578,256,322
050,01,121,"Alabama","Talladega County",2,77,604,254,350
050,01,121,"Alabama","Talladega County",2,78,508,225,283
050,01,121,"Alabama","Talladega County",2,79,447,214,233
050,01,121,"Alabama","Talladega County",2,80,414,180,234
050,01,121,"Alabama","Talladega County",2,81,367,155,212
050,01,121,"Alabama","Talladega County",2,82,350,144,206
050,01,121,"Alabama","Talladega County",2,83,307,119,188
050,01,121,"Alabama","Talladega County",2,84,270,112,158
050,01,121,"Alabama","Talladega County",2,85,1326,454,872
050,01,121,"Alabama","Talladega County",3,0,864,426,438
050,01,121,"Alabama","Talladega County",3,1,887,428,459
050,01,121,"Alabama","Talladega County",3,2,880,482,398
050,01,121,"Alabama","Talladega County",3,3,852,453,399
050,01,121,"Alabama","Talladega County",3,4,836,425,411
050,01,121,"Alabama","Talladega County",3,5,894,454,440
050,01,121,"Alabama","Talladega County",3,6,892,453,439
050,01,121,"Alabama","Talladega County",3,7,876,438,438
050,01,121,"Alabama","Talladega County",3,8,884,465,419
050,01,121,"Alabama","Talladega County",3,9,861,445,416
050,01,121,"Alabama","Talladega County",3,10,916,469,447
050,01,121,"Alabama","Talladega County",3,11,964,476,488
050,01,121,"Alabama","Talladega County",3,12,992,490,502
050,01,121,"Alabama","Talladega County",3,13,1096,525,571
050,01,121,"Alabama","Talladega County",3,14,1082,526,556
050,01,121,"Alabama","Talladega County",3,15,1029,492,537
050,01,121,"Alabama","Talladega County",3,16,1020,500,520
050,01,121,"Alabama","Talladega County",3,17,1018,522,496
050,01,121,"Alabama","Talladega County",3,18,888,446,442
050,01,121,"Alabama","Talladega County",3,19,782,390,392
050,01,121,"Alabama","Talladega County",3,20,870,456,414
050,01,121,"Alabama","Talladega County",3,21,885,446,439
050,01,121,"Alabama","Talladega County",3,22,917,463,454
050,01,121,"Alabama","Talladega County",3,23,946,459,487
050,01,121,"Alabama","Talladega County",3,24,1000,501,499
050,01,121,"Alabama","Talladega County",3,25,982,497,485
050,01,121,"Alabama","Talladega County",3,26,949,495,454
050,01,121,"Alabama","Talladega County",3,27,1025,531,494
050,01,121,"Alabama","Talladega County",3,28,1013,528,485
050,01,121,"Alabama","Talladega County",3,29,1075,556,519
050,01,121,"Alabama","Talladega County",3,30,1138,586,552
050,01,121,"Alabama","Talladega County",3,31,1144,558,586
050,01,121,"Alabama","Talladega County",3,32,1049,526,523
050,01,121,"Alabama","Talladega County",3,33,1022,526,496
050,01,121,"Alabama","Talladega County",3,34,1004,491,513
050,01,121,"Alabama","Talladega County",3,35,967,466,501
050,01,121,"Alabama","Talladega County",3,36,967,481,486
050,01,121,"Alabama","Talladega County",3,37,952,435,517
050,01,121,"Alabama","Talladega County",3,38,994,457,537
050,01,121,"Alabama","Talladega County",3,39,993,479,514
050,01,121,"Alabama","Talladega County",3,40,973,473,500
050,01,121,"Alabama","Talladega County",3,41,1015,506,509
050,01,121,"Alabama","Talladega County",3,42,987,483,504
050,01,121,"Alabama","Talladega County",3,43,964,452,512
050,01,121,"Alabama","Talladega County",3,44,931,424,507
050,01,121,"Alabama","Talladega County",3,45,929,464,465
050,01,121,"Alabama","Talladega County",3,46,962,498,464
050,01,121,"Alabama","Talladega County",3,47,959,489,470
050,01,121,"Alabama","Talladega County",3,48,1023,493,530
050,01,121,"Alabama","Talladega County",3,49,1143,569,574
050,01,121,"Alabama","Talladega County",3,50,1227,589,638
050,01,121,"Alabama","Talladega County",3,51,1158,569,589
050,01,121,"Alabama","Talladega County",3,52,1085,550,535
050,01,121,"Alabama","Talladega County",3,53,1027,507,520
050,01,121,"Alabama","Talladega County",3,54,1113,549,564
050,01,121,"Alabama","Talladega County",3,55,1105,535,570
050,01,121,"Alabama","Talladega County",3,56,1129,556,573
050,01,121,"Alabama","Talladega County",3,57,1114,529,585
050,01,121,"Alabama","Talladega County",3,58,1122,538,584
050,01,121,"Alabama","Talladega County",3,59,1142,575,567
050,01,121,"Alabama","Talladega County",3,60,1170,573,597
050,01,121,"Alabama","Talladega County",3,61,1174,548,626
050,01,121,"Alabama","Talladega County",3,62,1118,520,598
050,01,121,"Alabama","Talladega County",3,63,1150,532,618
050,01,121,"Alabama","Talladega County",3,64,1194,566,628
050,01,121,"Alabama","Talladega County",3,65,1111,529,582
050,01,121,"Alabama","Talladega County",3,66,1087,525,562
050,01,121,"Alabama","Talladega County",3,67,1069,518,551
050,01,121,"Alabama","Talladega County",3,68,1015,494,521
050,01,121,"Alabama","Talladega County",3,69,949,459,490
050,01,121,"Alabama","Talladega County",3,70,900,422,478
050,01,121,"Alabama","Talladega County",3,71,859,417,442
050,01,121,"Alabama","Talladega County",3,72,863,412,451
050,01,121,"Alabama","Talladega County",3,73,857,397,460
050,01,121,"Alabama","Talladega County",3,74,907,420,487
050,01,121,"Alabama","Talladega County",3,75,584,273,311
050,01,121,"Alabama","Talladega County",3,76,562,249,313
050,01,121,"Alabama","Talladega County",3,77,553,245,308
050,01,121,"Alabama","Talladega County",3,78,559,237,322
050,01,121,"Alabama","Talladega County",3,79,464,203,261
050,01,121,"Alabama","Talladega County",3,80,420,199,221
050,01,121,"Alabama","Talladega County",3,81,390,164,226
050,01,121,"Alabama","Talladega County",3,82,343,144,199
050,01,121,"Alabama","Talladega County",3,83,307,118,189
050,01,121,"Alabama","Talladega County",3,84,273,102,171
050,01,121,"Alabama","Talladega County",3,85,1343,472,871
050,01,121,"Alabama","Talladega County",4,0,854,422,432
050,01,121,"Alabama","Talladega County",4,1,843,416,427
050,01,121,"Alabama","Talladega County",4,2,882,434,448
050,01,121,"Alabama","Talladega County",4,3,880,478,402
050,01,121,"Alabama","Talladega County",4,4,831,433,398
050,01,121,"Alabama","Talladega County",4,5,850,423,427
050,01,121,"Alabama","Talladega County",4,6,900,455,445
050,01,121,"Alabama","Talladega County",4,7,907,465,442
050,01,121,"Alabama","Talladega County",4,8,858,425,433
050,01,121,"Alabama","Talladega County",4,9,856,440,416
050,01,121,"Alabama","Talladega County",4,10,882,451,431
050,01,121,"Alabama","Talladega County",4,11,932,467,465
050,01,121,"Alabama","Talladega County",4,12,964,480,484
050,01,121,"Alabama","Talladega County",4,13,989,496,493
050,01,121,"Alabama","Talladega County",4,14,1131,537,594
050,01,121,"Alabama","Talladega County",4,15,1064,518,546
050,01,121,"Alabama","Talladega County",4,16,1055,513,542
050,01,121,"Alabama","Talladega County",4,17,1011,506,505
050,01,121,"Alabama","Talladega County",4,18,876,469,407
050,01,121,"Alabama","Talladega County",4,19,725,369,356
050,01,121,"Alabama","Talladega County",4,20,848,422,426
050,01,121,"Alabama","Talladega County",4,21,903,473,430
050,01,121,"Alabama","Talladega County",4,22,928,467,461
050,01,121,"Alabama","Talladega County",4,23,958,464,494
050,01,121,"Alabama","Talladega County",4,24,996,503,493
050,01,121,"Alabama","Talladega County",4,25,998,495,503
050,01,121,"Alabama","Talladega County",4,26,969,474,495
050,01,121,"Alabama","Talladega County",4,27,970,522,448
050,01,121,"Alabama","Talladega County",4,28,1047,542,505
050,01,121,"Alabama","Talladega County",4,29,1019,540,479
050,01,121,"Alabama","Talladega County",4,30,1103,594,509
050,01,121,"Alabama","Talladega County",4,31,1113,558,555
050,01,121,"Alabama","Talladega County",4,32,1147,565,582
050,01,121,"Alabama","Talladega County",4,33,1082,553,529
050,01,121,"Alabama","Talladega County",4,34,1016,523,493
050,01,121,"Alabama","Talladega County",4,35,1031,496,535
050,01,121,"Alabama","Talladega County",4,36,956,467,489
050,01,121,"Alabama","Talladega County",4,37,975,478,497
050,01,121,"Alabama","Talladega County",4,38,961,447,514
050,01,121,"Alabama","Talladega County",4,39,977,448,529
050,01,121,"Alabama","Talladega County",4,40,987,476,511
050,01,121,"Alabama","Talladega County",4,41,973,478,495
050,01,121,"Alabama","Talladega County",4,42,1013,502,511
050,01,121,"Alabama","Talladega County",4,43,1008,506,502
050,01,121,"Alabama","Talladega County",4,44,966,450,516
050,01,121,"Alabama","Talladega County",4,45,944,434,510
050,01,121,"Alabama","Talladega County",4,46,931,473,458
050,01,121,"Alabama","Talladega County",4,47,951,491,460
050,01,121,"Alabama","Talladega County",4,48,934,471,463
050,01,121,"Alabama","Talladega County",4,49,1041,509,532
050,01,121,"Alabama","Talladega County",4,50,1158,573,585
050,01,121,"Alabama","Talladega County",4,51,1233,594,639
050,01,121,"Alabama","Talladega County",4,52,1166,577,589
050,01,121,"Alabama","Talladega County",4,53,1072,532,540
050,01,121,"Alabama","Talladega County",4,54,1034,520,514
050,01,121,"Alabama","Talladega County",4,55,1111,552,559
050,01,121,"Alabama","Talladega County",4,56,1117,543,574
050,01,121,"Alabama","Talladega County",4,57,1111,542,569
050,01,121,"Alabama","Talladega County",4,58,1123,537,586
050,01,121,"Alabama","Talladega County",4,59,1118,536,582
050,01,121,"Alabama","Talladega County",4,60,1111,551,560
050,01,121,"Alabama","Talladega County",4,61,1152,565,587
050,01,121,"Alabama","Talladega County",4,62,1170,542,628
050,01,121,"Alabama","Talladega County",4,63,1123,521,602
050,01,121,"Alabama","Talladega County",4,64,1121,517,604
050,01,121,"Alabama","Talladega County",4,65,1170,545,625
050,01,121,"Alabama","Talladega County",4,66,1096,527,569
050,01,121,"Alabama","Talladega County",4,67,1065,507,558
050,01,121,"Alabama","Talladega County",4,68,1017,494,523
050,01,121,"Alabama","Talladega County",4,69,997,484,513
050,01,121,"Alabama","Talladega County",4,70,913,435,478
050,01,121,"Alabama","Talladega County",4,71,874,410,464
050,01,121,"Alabama","Talladega County",4,72,832,396,436
050,01,121,"Alabama","Talladega County",4,73,841,400,441
050,01,121,"Alabama","Talladega County",4,74,838,384,454
050,01,121,"Alabama","Talladega County",4,75,866,405,461
050,01,121,"Alabama","Talladega County",4,76,554,255,299
050,01,121,"Alabama","Talladega County",4,77,544,245,299
050,01,121,"Alabama","Talladega County",4,78,521,226,295
050,01,121,"Alabama","Talladega County",4,79,517,213,304
050,01,121,"Alabama","Talladega County",4,80,433,183,250
050,01,121,"Alabama","Talladega County",4,81,393,182,211
050,01,121,"Alabama","Talladega County",4,82,359,156,203
050,01,121,"Alabama","Talladega County",4,83,307,122,185
050,01,121,"Alabama","Talladega County",4,84,277,106,171
050,01,121,"Alabama","Talladega County",4,85,1379,491,888
050,01,121,"Alabama","Talladega County",5,0,852,419,433
050,01,121,"Alabama","Talladega County",5,1,892,422,470
050,01,121,"Alabama","Talladega County",5,2,856,415,441
050,01,121,"Alabama","Talladega County",5,3,898,432,466
050,01,121,"Alabama","Talladega County",5,4,866,478,388
050,01,121,"Alabama","Talladega County",5,5,861,455,406
050,01,121,"Alabama","Talladega County",5,6,851,416,435
050,01,121,"Alabama","Talladega County",5,7,894,449,445
050,01,121,"Alabama","Talladega County",5,8,920,469,451
050,01,121,"Alabama","Talladega County",5,9,836,409,427
050,01,121,"Alabama","Talladega County",5,10,898,462,436
050,01,121,"Alabama","Talladega County",5,11,899,456,443
050,01,121,"Alabama","Talladega County",5,12,925,462,463
050,01,121,"Alabama","Talladega County",5,13,953,472,481
050,01,121,"Alabama","Talladega County",5,14,1025,497,528
050,01,121,"Alabama","Talladega County",5,15,1129,539,590
050,01,121,"Alabama","Talladega County",5,16,1077,526,551
050,01,121,"Alabama","Talladega County",5,17,1033,501,532
050,01,121,"Alabama","Talladega County",5,18,865,445,420
050,01,121,"Alabama","Talladega County",5,19,718,390,328
050,01,121,"Alabama","Talladega County",5,20,796,402,394
050,01,121,"Alabama","Talladega County",5,21,922,455,467
050,01,121,"Alabama","Talladega County",5,22,985,509,476
050,01,121,"Alabama","Talladega County",5,23,999,487,512
050,01,121,"Alabama","Talladega County",5,24,1011,502,509
050,01,121,"Alabama","Talladega County",5,25,1006,504,502
050,01,121,"Alabama","Talladega County",5,26,1003,491,512
050,01,121,"Alabama","Talladega County",5,27,983,484,499
050,01,121,"Alabama","Talladega County",5,28,980,523,457
050,01,121,"Alabama","Talladega County",5,29,1042,540,502
050,01,121,"Alabama","Talladega County",5,30,1037,575,462
050,01,121,"Alabama","Talladega County",5,31,1083,560,523
050,01,121,"Alabama","Talladega County",5,32,1096,547,549
050,01,121,"Alabama","Talladega County",5,33,1166,569,597
050,01,121,"Alabama","Talladega County",5,34,1083,544,539
050,01,121,"Alabama","Talladega County",5,35,1002,514,488
050,01,121,"Alabama","Talladega County",5,36,1050,513,537
050,01,121,"Alabama","Talladega County",5,37,963,467,496
050,01,121,"Alabama","Talladega County",5,38,964,475,489
050,01,121,"Alabama","Talladega County",5,39,948,436,512
050,01,121,"Alabama","Talladega County",5,40,989,460,529
050,01,121,"Alabama","Talladega County",5,41,991,491,500
050,01,121,"Alabama","Talladega County",5,42,950,446,504
050,01,121,"Alabama","Talladega County",5,43,1025,518,507
050,01,121,"Alabama","Talladega County",5,44,1021,506,515
050,01,121,"Alabama","Talladega County",5,45,970,460,510
050,01,121,"Alabama","Talladega County",5,46,958,452,506
050,01,121,"Alabama","Talladega County",5,47,923,461,462
050,01,121,"Alabama","Talladega County",5,48,955,478,477
050,01,121,"Alabama","Talladega County",5,49,949,492,457
050,01,121,"Alabama","Talladega County",5,50,1060,518,542
050,01,121,"Alabama","Talladega County",5,51,1159,573,586
050,01,121,"Alabama","Talladega County",5,52,1229,580,649
050,01,121,"Alabama","Talladega County",5,53,1185,580,605
050,01,121,"Alabama","Talladega County",5,54,1082,535,547
050,01,121,"Alabama","Talladega County",5,55,1039,524,515
050,01,121,"Alabama","Talladega County",5,56,1082,529,553
050,01,121,"Alabama","Talladega County",5,57,1098,522,576
050,01,121,"Alabama","Talladega County",5,58,1105,551,554
050,01,121,"Alabama","Talladega County",5,59,1139,550,589
050,01,121,"Alabama","Talladega County",5,60,1123,532,591
050,01,121,"Alabama","Talladega County",5,61,1113,543,570
050,01,121,"Alabama","Talladega County",5,62,1153,555,598
050,01,121,"Alabama","Talladega County",5,63,1183,549,634
050,01,121,"Alabama","Talladega County",5,64,1099,510,589
050,01,121,"Alabama","Talladega County",5,65,1091,497,594
050,01,121,"Alabama","Talladega County",5,66,1148,542,606
050,01,121,"Alabama","Talladega County",5,67,1088,517,571
050,01,121,"Alabama","Talladega County",5,68,1043,493,550
050,01,121,"Alabama","Talladega County",5,69,1007,487,520
050,01,121,"Alabama","Talladega County",5,70,972,472,500
050,01,121,"Alabama","Talladega County",5,71,878,420,458
050,01,121,"Alabama","Talladega County",5,72,853,397,456
050,01,121,"Alabama","Talladega County",5,73,807,381,426
050,01,121,"Alabama","Talladega County",5,74,809,377,432
050,01,121,"Alabama","Talladega County",5,75,804,367,437
050,01,121,"Alabama","Talladega County",5,76,828,385,443
050,01,121,"Alabama","Talladega County",5,77,537,245,292
050,01,121,"Alabama","Talladega County",5,78,521,229,292
050,01,121,"Alabama","Talladega County",5,79,485,206,279
050,01,121,"Alabama","Talladega County",5,80,491,195,296
050,01,121,"Alabama","Talladega County",5,81,414,167,247
050,01,121,"Alabama","Talladega County",5,82,360,172,188
050,01,121,"Alabama","Talladega County",5,83,325,142,183
050,01,121,"Alabama","Talladega County",5,84,286,117,169
050,01,121,"Alabama","Talladega County",5,85,1438,522,916
050,01,123,"Alabama","Tallapoosa County",1,0,371,190,181
050,01,123,"Alabama","Tallapoosa County",1,1,386,201,185
050,01,123,"Alabama","Tallapoosa County",1,2,434,213,221
050,01,123,"Alabama","Tallapoosa County",1,3,456,219,237
050,01,123,"Alabama","Tallapoosa County",1,4,479,249,230
050,01,123,"Alabama","Tallapoosa County",1,5,488,259,229
050,01,123,"Alabama","Tallapoosa County",1,6,485,248,237
050,01,123,"Alabama","Tallapoosa County",1,7,476,241,235
050,01,123,"Alabama","Tallapoosa County",1,8,496,251,245
050,01,123,"Alabama","Tallapoosa County",1,9,480,252,228
050,01,123,"Alabama","Tallapoosa County",1,10,496,258,238
050,01,123,"Alabama","Tallapoosa County",1,11,514,275,239
050,01,123,"Alabama","Tallapoosa County",1,12,527,283,244
050,01,123,"Alabama","Tallapoosa County",1,13,510,258,252
050,01,123,"Alabama","Tallapoosa County",1,14,483,247,236
050,01,123,"Alabama","Tallapoosa County",1,15,468,241,227
050,01,123,"Alabama","Tallapoosa County",1,16,494,247,247
050,01,123,"Alabama","Tallapoosa County",1,17,476,237,239
050,01,123,"Alabama","Tallapoosa County",1,18,404,224,180
050,01,123,"Alabama","Tallapoosa County",1,19,385,188,197
050,01,123,"Alabama","Tallapoosa County",1,20,407,194,213
050,01,123,"Alabama","Tallapoosa County",1,21,435,231,204
050,01,123,"Alabama","Tallapoosa County",1,22,418,212,206
050,01,123,"Alabama","Tallapoosa County",1,23,441,215,226
050,01,123,"Alabama","Tallapoosa County",1,24,442,229,213
050,01,123,"Alabama","Tallapoosa County",1,25,480,252,228
050,01,123,"Alabama","Tallapoosa County",1,26,489,236,253
050,01,123,"Alabama","Tallapoosa County",1,27,472,227,245
050,01,123,"Alabama","Tallapoosa County",1,28,486,233,253
050,01,123,"Alabama","Tallapoosa County",1,29,540,279,261
050,01,123,"Alabama","Tallapoosa County",1,30,526,249,277
050,01,123,"Alabama","Tallapoosa County",1,31,467,214,253
050,01,123,"Alabama","Tallapoosa County",1,32,454,223,231
050,01,123,"Alabama","Tallapoosa County",1,33,400,195,205
050,01,123,"Alabama","Tallapoosa County",1,34,394,190,204
050,01,123,"Alabama","Tallapoosa County",1,35,420,201,219
050,01,123,"Alabama","Tallapoosa County",1,36,423,188,235
050,01,123,"Alabama","Tallapoosa County",1,37,414,200,214
050,01,123,"Alabama","Tallapoosa County",1,38,434,203,231
050,01,123,"Alabama","Tallapoosa County",1,39,421,194,227
050,01,123,"Alabama","Tallapoosa County",1,40,449,212,237
050,01,123,"Alabama","Tallapoosa County",1,41,441,224,217
050,01,123,"Alabama","Tallapoosa County",1,42,414,208,206
050,01,123,"Alabama","Tallapoosa County",1,43,398,190,208
050,01,123,"Alabama","Tallapoosa County",1,44,400,183,217
050,01,123,"Alabama","Tallapoosa County",1,45,459,206,253
050,01,123,"Alabama","Tallapoosa County",1,46,466,222,244
050,01,123,"Alabama","Tallapoosa County",1,47,464,224,240
050,01,123,"Alabama","Tallapoosa County",1,48,493,234,259
050,01,123,"Alabama","Tallapoosa County",1,49,557,267,290
050,01,123,"Alabama","Tallapoosa County",1,50,599,280,319
050,01,123,"Alabama","Tallapoosa County",1,51,566,262,304
050,01,123,"Alabama","Tallapoosa County",1,52,530,259,271
050,01,123,"Alabama","Tallapoosa County",1,53,595,289,306
050,01,123,"Alabama","Tallapoosa County",1,54,608,291,317
050,01,123,"Alabama","Tallapoosa County",1,55,637,307,330
050,01,123,"Alabama","Tallapoosa County",1,56,634,321,313
050,01,123,"Alabama","Tallapoosa County",1,57,578,298,280
050,01,123,"Alabama","Tallapoosa County",1,58,613,315,298
050,01,123,"Alabama","Tallapoosa County",1,59,648,330,318
050,01,123,"Alabama","Tallapoosa County",1,60,652,331,321
050,01,123,"Alabama","Tallapoosa County",1,61,638,305,333
050,01,123,"Alabama","Tallapoosa County",1,62,643,293,350
050,01,123,"Alabama","Tallapoosa County",1,63,691,332,359
050,01,123,"Alabama","Tallapoosa County",1,64,658,335,323
050,01,123,"Alabama","Tallapoosa County",1,65,639,312,327
050,01,123,"Alabama","Tallapoosa County",1,66,622,313,309
050,01,123,"Alabama","Tallapoosa County",1,67,585,294,291
050,01,123,"Alabama","Tallapoosa County",1,68,606,288,318
050,01,123,"Alabama","Tallapoosa County",1,69,572,274,298
050,01,123,"Alabama","Tallapoosa County",1,70,556,259,297
050,01,123,"Alabama","Tallapoosa County",1,71,516,246,270
050,01,123,"Alabama","Tallapoosa County",1,72,562,266,296
050,01,123,"Alabama","Tallapoosa County",1,73,567,277,290
050,01,123,"Alabama","Tallapoosa County",1,74,362,172,190
050,01,123,"Alabama","Tallapoosa County",1,75,347,147,200
050,01,123,"Alabama","Tallapoosa County",1,76,378,186,192
050,01,123,"Alabama","Tallapoosa County",1,77,388,178,210
050,01,123,"Alabama","Tallapoosa County",1,78,313,148,165
050,01,123,"Alabama","Tallapoosa County",1,79,283,127,156
050,01,123,"Alabama","Tallapoosa County",1,80,268,123,145
050,01,123,"Alabama","Tallapoosa County",1,81,239,110,129
050,01,123,"Alabama","Tallapoosa County",1,82,236,106,130
050,01,123,"Alabama","Tallapoosa County",1,83,201,88,113
050,01,123,"Alabama","Tallapoosa County",1,84,164,72,92
050,01,123,"Alabama","Tallapoosa County",1,85,803,345,458
050,01,123,"Alabama","Tallapoosa County",2,0,384,206,178
050,01,123,"Alabama","Tallapoosa County",2,1,382,197,185
050,01,123,"Alabama","Tallapoosa County",2,2,425,210,215
050,01,123,"Alabama","Tallapoosa County",2,3,449,217,232
050,01,123,"Alabama","Tallapoosa County",2,4,473,243,230
050,01,123,"Alabama","Tallapoosa County",2,5,486,257,229
050,01,123,"Alabama","Tallapoosa County",2,6,485,249,236
050,01,123,"Alabama","Tallapoosa County",2,7,480,244,236
050,01,123,"Alabama","Tallapoosa County",2,8,488,248,240
050,01,123,"Alabama","Tallapoosa County",2,9,483,250,233
050,01,123,"Alabama","Tallapoosa County",2,10,491,257,234
050,01,123,"Alabama","Tallapoosa County",2,11,508,271,237
050,01,123,"Alabama","Tallapoosa County",2,12,528,283,245
050,01,123,"Alabama","Tallapoosa County",2,13,512,263,249
050,01,123,"Alabama","Tallapoosa County",2,14,487,247,240
050,01,123,"Alabama","Tallapoosa County",2,15,469,242,227
050,01,123,"Alabama","Tallapoosa County",2,16,489,246,243
050,01,123,"Alabama","Tallapoosa County",2,17,482,242,240
050,01,123,"Alabama","Tallapoosa County",2,18,407,220,187
050,01,123,"Alabama","Tallapoosa County",2,19,375,188,187
050,01,123,"Alabama","Tallapoosa County",2,20,414,198,216
050,01,123,"Alabama","Tallapoosa County",2,21,432,225,207
050,01,123,"Alabama","Tallapoosa County",2,22,422,216,206
050,01,123,"Alabama","Tallapoosa County",2,23,441,217,224
050,01,123,"Alabama","Tallapoosa County",2,24,444,228,216
050,01,123,"Alabama","Tallapoosa County",2,25,476,247,229
050,01,123,"Alabama","Tallapoosa County",2,26,490,244,246
050,01,123,"Alabama","Tallapoosa County",2,27,475,225,250
050,01,123,"Alabama","Tallapoosa County",2,28,484,234,250
050,01,123,"Alabama","Tallapoosa County",2,29,527,268,259
050,01,123,"Alabama","Tallapoosa County",2,30,528,253,275
050,01,123,"Alabama","Tallapoosa County",2,31,480,221,259
050,01,123,"Alabama","Tallapoosa County",2,32,453,219,234
050,01,123,"Alabama","Tallapoosa County",2,33,411,200,211
050,01,123,"Alabama","Tallapoosa County",2,34,397,191,206
050,01,123,"Alabama","Tallapoosa County",2,35,413,198,215
050,01,123,"Alabama","Tallapoosa County",2,36,419,191,228
050,01,123,"Alabama","Tallapoosa County",2,37,418,196,222
050,01,123,"Alabama","Tallapoosa County",2,38,432,203,229
050,01,123,"Alabama","Tallapoosa County",2,39,420,195,225
050,01,123,"Alabama","Tallapoosa County",2,40,447,210,237
050,01,123,"Alabama","Tallapoosa County",2,41,443,223,220
050,01,123,"Alabama","Tallapoosa County",2,42,414,207,207
050,01,123,"Alabama","Tallapoosa County",2,43,403,196,207
050,01,123,"Alabama","Tallapoosa County",2,44,392,181,211
050,01,123,"Alabama","Tallapoosa County",2,45,445,201,244
050,01,123,"Alabama","Tallapoosa County",2,46,462,217,245
050,01,123,"Alabama","Tallapoosa County",2,47,463,221,242
050,01,123,"Alabama","Tallapoosa County",2,48,488,233,255
050,01,123,"Alabama","Tallapoosa County",2,49,548,263,285
050,01,123,"Alabama","Tallapoosa County",2,50,593,279,314
050,01,123,"Alabama","Tallapoosa County",2,51,570,265,305
050,01,123,"Alabama","Tallapoosa County",2,52,532,255,277
050,01,123,"Alabama","Tallapoosa County",2,53,580,284,296
050,01,123,"Alabama","Tallapoosa County",2,54,603,290,313
050,01,123,"Alabama","Tallapoosa County",2,55,629,302,327
050,01,123,"Alabama","Tallapoosa County",2,56,642,322,320
050,01,123,"Alabama","Tallapoosa County",2,57,590,303,287
050,01,123,"Alabama","Tallapoosa County",2,58,609,313,296
050,01,123,"Alabama","Tallapoosa County",2,59,641,325,316
050,01,123,"Alabama","Tallapoosa County",2,60,651,332,319
050,01,123,"Alabama","Tallapoosa County",2,61,644,314,330
050,01,123,"Alabama","Tallapoosa County",2,62,637,294,343
050,01,123,"Alabama","Tallapoosa County",2,63,681,322,359
050,01,123,"Alabama","Tallapoosa County",2,64,665,333,332
050,01,123,"Alabama","Tallapoosa County",2,65,641,316,325
050,01,123,"Alabama","Tallapoosa County",2,66,630,317,313
050,01,123,"Alabama","Tallapoosa County",2,67,591,297,294
050,01,123,"Alabama","Tallapoosa County",2,68,594,286,308
050,01,123,"Alabama","Tallapoosa County",2,69,579,275,304
050,01,123,"Alabama","Tallapoosa County",2,70,556,260,296
050,01,123,"Alabama","Tallapoosa County",2,71,525,250,275
050,01,123,"Alabama","Tallapoosa County",2,72,539,254,285
050,01,123,"Alabama","Tallapoosa County",2,73,584,284,300
050,01,123,"Alabama","Tallapoosa County",2,74,379,182,197
050,01,123,"Alabama","Tallapoosa County",2,75,343,147,196
050,01,123,"Alabama","Tallapoosa County",2,76,366,176,190
050,01,123,"Alabama","Tallapoosa County",2,77,392,184,208
050,01,123,"Alabama","Tallapoosa County",2,78,319,149,170
050,01,123,"Alabama","Tallapoosa County",2,79,286,131,155
050,01,123,"Alabama","Tallapoosa County",2,80,268,122,146
050,01,123,"Alabama","Tallapoosa County",2,81,240,111,129
050,01,123,"Alabama","Tallapoosa County",2,82,233,107,126
050,01,123,"Alabama","Tallapoosa County",2,83,203,91,112
050,01,123,"Alabama","Tallapoosa County",2,84,171,73,98
050,01,123,"Alabama","Tallapoosa County",2,85,814,345,469
050,01,123,"Alabama","Tallapoosa County",3,0,393,188,205
050,01,123,"Alabama","Tallapoosa County",3,1,392,206,186
050,01,123,"Alabama","Tallapoosa County",3,2,359,179,180
050,01,123,"Alabama","Tallapoosa County",3,3,441,217,224
050,01,123,"Alabama","Tallapoosa County",3,4,448,216,232
050,01,123,"Alabama","Tallapoosa County",3,5,472,246,226
050,01,123,"Alabama","Tallapoosa County",3,6,473,245,228
050,01,123,"Alabama","Tallapoosa County",3,7,483,245,238
050,01,123,"Alabama","Tallapoosa County",3,8,475,238,237
050,01,123,"Alabama","Tallapoosa County",3,9,474,235,239
050,01,123,"Alabama","Tallapoosa County",3,10,487,249,238
050,01,123,"Alabama","Tallapoosa County",3,11,491,257,234
050,01,123,"Alabama","Tallapoosa County",3,12,493,261,232
050,01,123,"Alabama","Tallapoosa County",3,13,527,282,245
050,01,123,"Alabama","Tallapoosa County",3,14,502,267,235
050,01,123,"Alabama","Tallapoosa County",3,15,478,244,234
050,01,123,"Alabama","Tallapoosa County",3,16,467,238,229
050,01,123,"Alabama","Tallapoosa County",3,17,500,248,252
050,01,123,"Alabama","Tallapoosa County",3,18,416,213,203
050,01,123,"Alabama","Tallapoosa County",3,19,349,191,158
050,01,123,"Alabama","Tallapoosa County",3,20,413,202,211
050,01,123,"Alabama","Tallapoosa County",3,21,435,208,227
050,01,123,"Alabama","Tallapoosa County",3,22,442,216,226
050,01,123,"Alabama","Tallapoosa County",3,23,426,221,205
050,01,123,"Alabama","Tallapoosa County",3,24,458,242,216
050,01,123,"Alabama","Tallapoosa County",3,25,446,230,216
050,01,123,"Alabama","Tallapoosa County",3,26,473,256,217
050,01,123,"Alabama","Tallapoosa County",3,27,464,227,237
050,01,123,"Alabama","Tallapoosa County",3,28,454,218,236
050,01,123,"Alabama","Tallapoosa County",3,29,494,246,248
050,01,123,"Alabama","Tallapoosa County",3,30,520,279,241
050,01,123,"Alabama","Tallapoosa County",3,31,527,247,280
050,01,123,"Alabama","Tallapoosa County",3,32,479,222,257
050,01,123,"Alabama","Tallapoosa County",3,33,454,215,239
050,01,123,"Alabama","Tallapoosa County",3,34,411,199,212
050,01,123,"Alabama","Tallapoosa County",3,35,397,189,208
050,01,123,"Alabama","Tallapoosa County",3,36,416,200,216
050,01,123,"Alabama","Tallapoosa County",3,37,410,187,223
050,01,123,"Alabama","Tallapoosa County",3,38,411,190,221
050,01,123,"Alabama","Tallapoosa County",3,39,412,194,218
050,01,123,"Alabama","Tallapoosa County",3,40,426,201,225
050,01,123,"Alabama","Tallapoosa County",3,41,455,222,233
050,01,123,"Alabama","Tallapoosa County",3,42,445,218,227
050,01,123,"Alabama","Tallapoosa County",3,43,420,210,210
050,01,123,"Alabama","Tallapoosa County",3,44,402,199,203
050,01,123,"Alabama","Tallapoosa County",3,45,413,188,225
050,01,123,"Alabama","Tallapoosa County",3,46,448,202,246
050,01,123,"Alabama","Tallapoosa County",3,47,459,214,245
050,01,123,"Alabama","Tallapoosa County",3,48,469,225,244
050,01,123,"Alabama","Tallapoosa County",3,49,508,246,262
050,01,123,"Alabama","Tallapoosa County",3,50,542,253,289
050,01,123,"Alabama","Tallapoosa County",3,51,609,293,316
050,01,123,"Alabama","Tallapoosa County",3,52,559,258,301
050,01,123,"Alabama","Tallapoosa County",3,53,540,273,267
050,01,123,"Alabama","Tallapoosa County",3,54,573,273,300
050,01,123,"Alabama","Tallapoosa County",3,55,611,291,320
050,01,123,"Alabama","Tallapoosa County",3,56,640,318,322
050,01,123,"Alabama","Tallapoosa County",3,57,646,315,331
050,01,123,"Alabama","Tallapoosa County",3,58,598,305,293
050,01,123,"Alabama","Tallapoosa County",3,59,601,301,300
050,01,123,"Alabama","Tallapoosa County",3,60,664,329,335
050,01,123,"Alabama","Tallapoosa County",3,61,651,329,322
050,01,123,"Alabama","Tallapoosa County",3,62,648,324,324
050,01,123,"Alabama","Tallapoosa County",3,63,633,291,342
050,01,123,"Alabama","Tallapoosa County",3,64,682,319,363
050,01,123,"Alabama","Tallapoosa County",3,65,634,311,323
050,01,123,"Alabama","Tallapoosa County",3,66,628,309,319
050,01,123,"Alabama","Tallapoosa County",3,67,604,301,303
050,01,123,"Alabama","Tallapoosa County",3,68,588,293,295
050,01,123,"Alabama","Tallapoosa County",3,69,590,280,310
050,01,123,"Alabama","Tallapoosa County",3,70,564,267,297
050,01,123,"Alabama","Tallapoosa County",3,71,551,257,294
050,01,123,"Alabama","Tallapoosa County",3,72,502,232,270
050,01,123,"Alabama","Tallapoosa County",3,73,523,245,278
050,01,123,"Alabama","Tallapoosa County",3,74,561,268,293
050,01,123,"Alabama","Tallapoosa County",3,75,360,166,194
050,01,123,"Alabama","Tallapoosa County",3,76,344,148,196
050,01,123,"Alabama","Tallapoosa County",3,77,344,167,177
050,01,123,"Alabama","Tallapoosa County",3,78,361,168,193
050,01,123,"Alabama","Tallapoosa County",3,79,298,141,157
050,01,123,"Alabama","Tallapoosa County",3,80,264,120,144
050,01,123,"Alabama","Tallapoosa County",3,81,243,110,133
050,01,123,"Alabama","Tallapoosa County",3,82,223,101,122
050,01,123,"Alabama","Tallapoosa County",3,83,212,100,112
050,01,123,"Alabama","Tallapoosa County",3,84,184,76,108
050,01,123,"Alabama","Tallapoosa County",3,85,817,353,464
050,01,123,"Alabama","Tallapoosa County",4,0,386,192,194
050,01,123,"Alabama","Tallapoosa County",4,1,391,172,219
050,01,123,"Alabama","Tallapoosa County",4,2,412,213,199
050,01,123,"Alabama","Tallapoosa County",4,3,359,180,179
050,01,123,"Alabama","Tallapoosa County",4,4,419,210,209
050,01,123,"Alabama","Tallapoosa County",4,5,425,207,218
050,01,123,"Alabama","Tallapoosa County",4,6,456,236,220
050,01,123,"Alabama","Tallapoosa County",4,7,456,234,222
050,01,123,"Alabama","Tallapoosa County",4,8,485,248,237
050,01,123,"Alabama","Tallapoosa County",4,9,466,232,234
050,01,123,"Alabama","Tallapoosa County",4,10,471,236,235
050,01,123,"Alabama","Tallapoosa County",4,11,478,242,236
050,01,123,"Alabama","Tallapoosa County",4,12,482,254,228
050,01,123,"Alabama","Tallapoosa County",4,13,485,253,232
050,01,123,"Alabama","Tallapoosa County",4,14,522,269,253
050,01,123,"Alabama","Tallapoosa County",4,15,508,272,236
050,01,123,"Alabama","Tallapoosa County",4,16,462,237,225
050,01,123,"Alabama","Tallapoosa County",4,17,453,229,224
050,01,123,"Alabama","Tallapoosa County",4,18,422,217,205
050,01,123,"Alabama","Tallapoosa County",4,19,338,173,165
050,01,123,"Alabama","Tallapoosa County",4,20,372,198,174
050,01,123,"Alabama","Tallapoosa County",4,21,447,223,224
050,01,123,"Alabama","Tallapoosa County",4,22,465,215,250
050,01,123,"Alabama","Tallapoosa County",4,23,455,233,222
050,01,123,"Alabama","Tallapoosa County",4,24,433,228,205
050,01,123,"Alabama","Tallapoosa County",4,25,442,230,212
050,01,123,"Alabama","Tallapoosa County",4,26,441,229,212
050,01,123,"Alabama","Tallapoosa County",4,27,465,246,219
050,01,123,"Alabama","Tallapoosa County",4,28,460,233,227
050,01,123,"Alabama","Tallapoosa County",4,29,475,224,251
050,01,123,"Alabama","Tallapoosa County",4,30,479,240,239
050,01,123,"Alabama","Tallapoosa County",4,31,505,268,237
050,01,123,"Alabama","Tallapoosa County",4,32,518,238,280
050,01,123,"Alabama","Tallapoosa County",4,33,466,217,249
050,01,123,"Alabama","Tallapoosa County",4,34,437,207,230
050,01,123,"Alabama","Tallapoosa County",4,35,409,199,210
050,01,123,"Alabama","Tallapoosa County",4,36,395,196,199
050,01,123,"Alabama","Tallapoosa County",4,37,421,198,223
050,01,123,"Alabama","Tallapoosa County",4,38,405,182,223
050,01,123,"Alabama","Tallapoosa County",4,39,407,182,225
050,01,123,"Alabama","Tallapoosa County",4,40,416,195,221
050,01,123,"Alabama","Tallapoosa County",4,41,427,206,221
050,01,123,"Alabama","Tallapoosa County",4,42,448,217,231
050,01,123,"Alabama","Tallapoosa County",4,43,455,222,233
050,01,123,"Alabama","Tallapoosa County",4,44,415,207,208
050,01,123,"Alabama","Tallapoosa County",4,45,416,207,209
050,01,123,"Alabama","Tallapoosa County",4,46,414,191,223
050,01,123,"Alabama","Tallapoosa County",4,47,453,205,248
050,01,123,"Alabama","Tallapoosa County",4,48,465,214,251
050,01,123,"Alabama","Tallapoosa County",4,49,480,228,252
050,01,123,"Alabama","Tallapoosa County",4,50,514,245,269
050,01,123,"Alabama","Tallapoosa County",4,51,574,267,307
050,01,123,"Alabama","Tallapoosa County",4,52,596,291,305
050,01,123,"Alabama","Tallapoosa County",4,53,566,264,302
050,01,123,"Alabama","Tallapoosa County",4,54,530,268,262
050,01,123,"Alabama","Tallapoosa County",4,55,574,279,295
050,01,123,"Alabama","Tallapoosa County",4,56,639,314,325
050,01,123,"Alabama","Tallapoosa County",4,57,640,316,324
050,01,123,"Alabama","Tallapoosa County",4,58,636,305,331
050,01,123,"Alabama","Tallapoosa County",4,59,586,292,294
050,01,123,"Alabama","Tallapoosa County",4,60,615,304,311
050,01,123,"Alabama","Tallapoosa County",4,61,665,328,337
050,01,123,"Alabama","Tallapoosa County",4,62,660,341,319
050,01,123,"Alabama","Tallapoosa County",4,63,662,322,340
050,01,123,"Alabama","Tallapoosa County",4,64,654,304,350
050,01,123,"Alabama","Tallapoosa County",4,65,676,321,355
050,01,123,"Alabama","Tallapoosa County",4,66,636,316,320
050,01,123,"Alabama","Tallapoosa County",4,67,602,301,301
050,01,123,"Alabama","Tallapoosa County",4,68,596,302,294
050,01,123,"Alabama","Tallapoosa County",4,69,593,291,302
050,01,123,"Alabama","Tallapoosa County",4,70,581,275,306
050,01,123,"Alabama","Tallapoosa County",4,71,561,266,295
050,01,123,"Alabama","Tallapoosa County",4,72,525,239,286
050,01,123,"Alabama","Tallapoosa County",4,73,499,237,262
050,01,123,"Alabama","Tallapoosa County",4,74,502,232,270
050,01,123,"Alabama","Tallapoosa County",4,75,532,248,284
050,01,123,"Alabama","Tallapoosa County",4,76,348,165,183
050,01,123,"Alabama","Tallapoosa County",4,77,335,137,198
050,01,123,"Alabama","Tallapoosa County",4,78,316,154,162
050,01,123,"Alabama","Tallapoosa County",4,79,347,159,188
050,01,123,"Alabama","Tallapoosa County",4,80,284,136,148
050,01,123,"Alabama","Tallapoosa County",4,81,238,115,123
050,01,123,"Alabama","Tallapoosa County",4,82,231,103,128
050,01,123,"Alabama","Tallapoosa County",4,83,202,91,111
050,01,123,"Alabama","Tallapoosa County",4,84,191,89,102
050,01,123,"Alabama","Tallapoosa County",4,85,845,374,471
050,01,123,"Alabama","Tallapoosa County",5,0,389,191,198
050,01,123,"Alabama","Tallapoosa County",5,1,381,199,182
050,01,123,"Alabama","Tallapoosa County",5,2,385,172,213
050,01,123,"Alabama","Tallapoosa County",5,3,395,210,185
050,01,123,"Alabama","Tallapoosa County",5,4,380,190,190
050,01,123,"Alabama","Tallapoosa County",5,5,412,210,202
050,01,123,"Alabama","Tallapoosa County",5,6,436,214,222
050,01,123,"Alabama","Tallapoosa County",5,7,457,232,225
050,01,123,"Alabama","Tallapoosa County",5,8,472,241,231
050,01,123,"Alabama","Tallapoosa County",5,9,484,250,234
050,01,123,"Alabama","Tallapoosa County",5,10,474,243,231
050,01,123,"Alabama","Tallapoosa County",5,11,477,236,241
050,01,123,"Alabama","Tallapoosa County",5,12,471,252,219
050,01,123,"Alabama","Tallapoosa County",5,13,494,256,238
050,01,123,"Alabama","Tallapoosa County",5,14,486,256,230
050,01,123,"Alabama","Tallapoosa County",5,15,512,272,240
050,01,123,"Alabama","Tallapoosa County",5,16,496,269,227
050,01,123,"Alabama","Tallapoosa County",5,17,469,240,229
050,01,123,"Alabama","Tallapoosa County",5,18,386,200,186
050,01,123,"Alabama","Tallapoosa County",5,19,350,183,167
050,01,123,"Alabama","Tallapoosa County",5,20,359,181,178
050,01,123,"Alabama","Tallapoosa County",5,21,409,210,199
050,01,123,"Alabama","Tallapoosa County",5,22,459,219,240
050,01,123,"Alabama","Tallapoosa County",5,23,486,227,259
050,01,123,"Alabama","Tallapoosa County",5,24,453,236,217
050,01,123,"Alabama","Tallapoosa County",5,25,426,216,210
050,01,123,"Alabama","Tallapoosa County",5,26,431,237,194
050,01,123,"Alabama","Tallapoosa County",5,27,412,215,197
050,01,123,"Alabama","Tallapoosa County",5,28,436,231,205
050,01,123,"Alabama","Tallapoosa County",5,29,440,227,213
050,01,123,"Alabama","Tallapoosa County",5,30,475,227,248
050,01,123,"Alabama","Tallapoosa County",5,31,495,249,246
050,01,123,"Alabama","Tallapoosa County",5,32,501,251,250
050,01,123,"Alabama","Tallapoosa County",5,33,516,237,279
050,01,123,"Alabama","Tallapoosa County",5,34,457,211,246
050,01,123,"Alabama","Tallapoosa County",5,35,446,214,232
050,01,123,"Alabama","Tallapoosa County",5,36,405,198,207
050,01,123,"Alabama","Tallapoosa County",5,37,384,186,198
050,01,123,"Alabama","Tallapoosa County",5,38,427,208,219
050,01,123,"Alabama","Tallapoosa County",5,39,376,164,212
050,01,123,"Alabama","Tallapoosa County",5,40,405,174,231
050,01,123,"Alabama","Tallapoosa County",5,41,415,197,218
050,01,123,"Alabama","Tallapoosa County",5,42,420,193,227
050,01,123,"Alabama","Tallapoosa County",5,43,452,220,232
050,01,123,"Alabama","Tallapoosa County",5,44,456,222,234
050,01,123,"Alabama","Tallapoosa County",5,45,413,202,211
050,01,123,"Alabama","Tallapoosa County",5,46,431,214,217
050,01,123,"Alabama","Tallapoosa County",5,47,418,188,230
050,01,123,"Alabama","Tallapoosa County",5,48,467,209,258
050,01,123,"Alabama","Tallapoosa County",5,49,459,215,244
050,01,123,"Alabama","Tallapoosa County",5,50,494,235,259
050,01,123,"Alabama","Tallapoosa County",5,51,515,253,262
050,01,123,"Alabama","Tallapoosa County",5,52,563,261,302
050,01,123,"Alabama","Tallapoosa County",5,53,591,285,306
050,01,123,"Alabama","Tallapoosa County",5,54,547,255,292
050,01,123,"Alabama","Tallapoosa County",5,55,528,265,263
050,01,123,"Alabama","Tallapoosa County",5,56,579,284,295
050,01,123,"Alabama","Tallapoosa County",5,57,630,301,329
050,01,123,"Alabama","Tallapoosa County",5,58,630,305,325
050,01,123,"Alabama","Tallapoosa County",5,59,627,302,325
050,01,123,"Alabama","Tallapoosa County",5,60,591,293,298
050,01,123,"Alabama","Tallapoosa County",5,61,622,309,313
050,01,123,"Alabama","Tallapoosa County",5,62,669,331,338
050,01,123,"Alabama","Tallapoosa County",5,63,657,343,314
050,01,123,"Alabama","Tallapoosa County",5,64,663,324,339
050,01,123,"Alabama","Tallapoosa County",5,65,652,302,350
050,01,123,"Alabama","Tallapoosa County",5,66,687,322,365
050,01,123,"Alabama","Tallapoosa County",5,67,621,310,311
050,01,123,"Alabama","Tallapoosa County",5,68,590,294,296
050,01,123,"Alabama","Tallapoosa County",5,69,584,291,293
050,01,123,"Alabama","Tallapoosa County",5,70,567,280,287
050,01,123,"Alabama","Tallapoosa County",5,71,583,272,311
050,01,123,"Alabama","Tallapoosa County",5,72,547,254,293
050,01,123,"Alabama","Tallapoosa County",5,73,494,231,263
050,01,123,"Alabama","Tallapoosa County",5,74,466,219,247
050,01,123,"Alabama","Tallapoosa County",5,75,472,214,258
050,01,123,"Alabama","Tallapoosa County",5,76,521,246,275
050,01,123,"Alabama","Tallapoosa County",5,77,337,158,179
050,01,123,"Alabama","Tallapoosa County",5,78,301,126,175
050,01,123,"Alabama","Tallapoosa County",5,79,303,149,154
050,01,123,"Alabama","Tallapoosa County",5,80,322,147,175
050,01,123,"Alabama","Tallapoosa County",5,81,259,130,129
050,01,123,"Alabama","Tallapoosa County",5,82,222,104,118
050,01,123,"Alabama","Tallapoosa County",5,83,216,97,119
050,01,123,"Alabama","Tallapoosa County",5,84,188,79,109
050,01,123,"Alabama","Tallapoosa County",5,85,904,414,490
050,01,125,"Alabama","Tuscaloosa County",1,0,2551,1293,1258
050,01,125,"Alabama","Tuscaloosa County",1,1,2583,1315,1268
050,01,125,"Alabama","Tuscaloosa County",1,2,2725,1415,1310
050,01,125,"Alabama","Tuscaloosa County",1,3,2782,1437,1345
050,01,125,"Alabama","Tuscaloosa County",1,4,2812,1392,1420
050,01,125,"Alabama","Tuscaloosa County",1,5,2770,1401,1369
050,01,125,"Alabama","Tuscaloosa County",1,6,2738,1429,1309
050,01,125,"Alabama","Tuscaloosa County",1,7,2713,1334,1379
050,01,125,"Alabama","Tuscaloosa County",1,8,2686,1344,1342
050,01,125,"Alabama","Tuscaloosa County",1,9,2677,1340,1337
050,01,125,"Alabama","Tuscaloosa County",1,10,2801,1418,1383
050,01,125,"Alabama","Tuscaloosa County",1,11,2814,1412,1402
050,01,125,"Alabama","Tuscaloosa County",1,12,2778,1439,1339
050,01,125,"Alabama","Tuscaloosa County",1,13,2755,1390,1365
050,01,125,"Alabama","Tuscaloosa County",1,14,2651,1355,1296
050,01,125,"Alabama","Tuscaloosa County",1,15,2564,1307,1257
050,01,125,"Alabama","Tuscaloosa County",1,16,2660,1333,1327
050,01,125,"Alabama","Tuscaloosa County",1,17,2636,1341,1295
050,01,125,"Alabama","Tuscaloosa County",1,18,4257,1969,2288
050,01,125,"Alabama","Tuscaloosa County",1,19,6575,3125,3450
050,01,125,"Alabama","Tuscaloosa County",1,20,5724,2665,3059
050,01,125,"Alabama","Tuscaloosa County",1,21,5595,2608,2987
050,01,125,"Alabama","Tuscaloosa County",1,22,5206,2612,2594
050,01,125,"Alabama","Tuscaloosa County",1,23,4495,2276,2219
050,01,125,"Alabama","Tuscaloosa County",1,24,3992,2098,1894
050,01,125,"Alabama","Tuscaloosa County",1,25,3497,1754,1743
050,01,125,"Alabama","Tuscaloosa County",1,26,3372,1682,1690
050,01,125,"Alabama","Tuscaloosa County",1,27,3263,1621,1642
050,01,125,"Alabama","Tuscaloosa County",1,28,3327,1602,1725
050,01,125,"Alabama","Tuscaloosa County",1,29,3587,1749,1838
050,01,125,"Alabama","Tuscaloosa County",1,30,3597,1787,1810
050,01,125,"Alabama","Tuscaloosa County",1,31,3443,1703,1740
050,01,125,"Alabama","Tuscaloosa County",1,32,3149,1597,1552
050,01,125,"Alabama","Tuscaloosa County",1,33,2874,1424,1450
050,01,125,"Alabama","Tuscaloosa County",1,34,2780,1364,1416
050,01,125,"Alabama","Tuscaloosa County",1,35,2668,1289,1379
050,01,125,"Alabama","Tuscaloosa County",1,36,2785,1349,1436
050,01,125,"Alabama","Tuscaloosa County",1,37,2887,1400,1487
050,01,125,"Alabama","Tuscaloosa County",1,38,2956,1495,1461
050,01,125,"Alabama","Tuscaloosa County",1,39,2992,1491,1501
050,01,125,"Alabama","Tuscaloosa County",1,40,2868,1417,1451
050,01,125,"Alabama","Tuscaloosa County",1,41,2711,1295,1416
050,01,125,"Alabama","Tuscaloosa County",1,42,2672,1296,1376
050,01,125,"Alabama","Tuscaloosa County",1,43,2540,1207,1333
050,01,125,"Alabama","Tuscaloosa County",1,44,2496,1214,1282
050,01,125,"Alabama","Tuscaloosa County",1,45,2591,1256,1335
050,01,125,"Alabama","Tuscaloosa County",1,46,2569,1222,1347
050,01,125,"Alabama","Tuscaloosa County",1,47,2599,1219,1380
050,01,125,"Alabama","Tuscaloosa County",1,48,2764,1351,1413
050,01,125,"Alabama","Tuscaloosa County",1,49,2805,1374,1431
050,01,125,"Alabama","Tuscaloosa County",1,50,2580,1283,1297
050,01,125,"Alabama","Tuscaloosa County",1,51,2449,1200,1249
050,01,125,"Alabama","Tuscaloosa County",1,52,2355,1135,1220
050,01,125,"Alabama","Tuscaloosa County",1,53,2414,1158,1256
050,01,125,"Alabama","Tuscaloosa County",1,54,2444,1193,1251
050,01,125,"Alabama","Tuscaloosa County",1,55,2603,1264,1339
050,01,125,"Alabama","Tuscaloosa County",1,56,2509,1245,1264
050,01,125,"Alabama","Tuscaloosa County",1,57,2544,1236,1308
050,01,125,"Alabama","Tuscaloosa County",1,58,2678,1296,1382
050,01,125,"Alabama","Tuscaloosa County",1,59,2598,1284,1314
050,01,125,"Alabama","Tuscaloosa County",1,60,2535,1238,1297
050,01,125,"Alabama","Tuscaloosa County",1,61,2539,1202,1337
050,01,125,"Alabama","Tuscaloosa County",1,62,2519,1193,1326
050,01,125,"Alabama","Tuscaloosa County",1,63,2556,1201,1355
050,01,125,"Alabama","Tuscaloosa County",1,64,2515,1191,1324
050,01,125,"Alabama","Tuscaloosa County",1,65,2418,1145,1273
050,01,125,"Alabama","Tuscaloosa County",1,66,2370,1109,1261
050,01,125,"Alabama","Tuscaloosa County",1,67,2252,1057,1195
050,01,125,"Alabama","Tuscaloosa County",1,68,2159,1013,1146
050,01,125,"Alabama","Tuscaloosa County",1,69,1999,906,1093
050,01,125,"Alabama","Tuscaloosa County",1,70,1842,840,1002
050,01,125,"Alabama","Tuscaloosa County",1,71,1792,817,975
050,01,125,"Alabama","Tuscaloosa County",1,72,1772,828,944
050,01,125,"Alabama","Tuscaloosa County",1,73,1663,749,914
050,01,125,"Alabama","Tuscaloosa County",1,74,1158,532,626
050,01,125,"Alabama","Tuscaloosa County",1,75,1113,504,609
050,01,125,"Alabama","Tuscaloosa County",1,76,1143,495,648
050,01,125,"Alabama","Tuscaloosa County",1,77,1133,463,670
050,01,125,"Alabama","Tuscaloosa County",1,78,935,392,543
050,01,125,"Alabama","Tuscaloosa County",1,79,811,376,435
050,01,125,"Alabama","Tuscaloosa County",1,80,782,346,436
050,01,125,"Alabama","Tuscaloosa County",1,81,715,284,431
050,01,125,"Alabama","Tuscaloosa County",1,82,638,257,381
050,01,125,"Alabama","Tuscaloosa County",1,83,556,204,352
050,01,125,"Alabama","Tuscaloosa County",1,84,516,192,324
050,01,125,"Alabama","Tuscaloosa County",1,85,3100,973,2127
050,01,125,"Alabama","Tuscaloosa County",2,0,2520,1284,1236
050,01,125,"Alabama","Tuscaloosa County",2,1,2580,1311,1269
050,01,125,"Alabama","Tuscaloosa County",2,2,2692,1386,1306
050,01,125,"Alabama","Tuscaloosa County",2,3,2763,1425,1338
050,01,125,"Alabama","Tuscaloosa County",2,4,2809,1405,1404
050,01,125,"Alabama","Tuscaloosa County",2,5,2782,1402,1380
050,01,125,"Alabama","Tuscaloosa County",2,6,2749,1422,1327
050,01,125,"Alabama","Tuscaloosa County",2,7,2716,1353,1363
050,01,125,"Alabama","Tuscaloosa County",2,8,2686,1337,1349
050,01,125,"Alabama","Tuscaloosa County",2,9,2676,1343,1333
050,01,125,"Alabama","Tuscaloosa County",2,10,2773,1400,1373
050,01,125,"Alabama","Tuscaloosa County",2,11,2800,1404,1396
050,01,125,"Alabama","Tuscaloosa County",2,12,2806,1440,1366
050,01,125,"Alabama","Tuscaloosa County",2,13,2762,1404,1358
050,01,125,"Alabama","Tuscaloosa County",2,14,2672,1361,1311
050,01,125,"Alabama","Tuscaloosa County",2,15,2584,1317,1267
050,01,125,"Alabama","Tuscaloosa County",2,16,2643,1329,1314
050,01,125,"Alabama","Tuscaloosa County",2,17,2657,1343,1314
050,01,125,"Alabama","Tuscaloosa County",2,18,5140,2310,2830
050,01,125,"Alabama","Tuscaloosa County",2,19,8359,3926,4433
050,01,125,"Alabama","Tuscaloosa County",2,20,6489,3048,3441
050,01,125,"Alabama","Tuscaloosa County",2,21,6056,2810,3246
050,01,125,"Alabama","Tuscaloosa County",2,22,5409,2711,2698
050,01,125,"Alabama","Tuscaloosa County",2,23,4565,2311,2254
050,01,125,"Alabama","Tuscaloosa County",2,24,4007,2108,1899
050,01,125,"Alabama","Tuscaloosa County",2,25,3490,1750,1740
050,01,125,"Alabama","Tuscaloosa County",2,26,3336,1670,1666
050,01,125,"Alabama","Tuscaloosa County",2,27,3253,1612,1641
050,01,125,"Alabama","Tuscaloosa County",2,28,3297,1597,1700
050,01,125,"Alabama","Tuscaloosa County",2,29,3519,1703,1816
050,01,125,"Alabama","Tuscaloosa County",2,30,3610,1781,1829
050,01,125,"Alabama","Tuscaloosa County",2,31,3453,1712,1741
050,01,125,"Alabama","Tuscaloosa County",2,32,3212,1619,1593
050,01,125,"Alabama","Tuscaloosa County",2,33,2945,1470,1475
050,01,125,"Alabama","Tuscaloosa County",2,34,2810,1378,1432
050,01,125,"Alabama","Tuscaloosa County",2,35,2712,1321,1391
050,01,125,"Alabama","Tuscaloosa County",2,36,2731,1320,1411
050,01,125,"Alabama","Tuscaloosa County",2,37,2866,1392,1474
050,01,125,"Alabama","Tuscaloosa County",2,38,2952,1471,1481
050,01,125,"Alabama","Tuscaloosa County",2,39,2975,1491,1484
050,01,125,"Alabama","Tuscaloosa County",2,40,2918,1441,1477
050,01,125,"Alabama","Tuscaloosa County",2,41,2743,1320,1423
050,01,125,"Alabama","Tuscaloosa County",2,42,2664,1286,1378
050,01,125,"Alabama","Tuscaloosa County",2,43,2596,1240,1356
050,01,125,"Alabama","Tuscaloosa County",2,44,2495,1207,1288
050,01,125,"Alabama","Tuscaloosa County",2,45,2595,1257,1338
050,01,125,"Alabama","Tuscaloosa County",2,46,2569,1230,1339
050,01,125,"Alabama","Tuscaloosa County",2,47,2597,1223,1374
050,01,125,"Alabama","Tuscaloosa County",2,48,2728,1320,1408
050,01,125,"Alabama","Tuscaloosa County",2,49,2801,1370,1431
050,01,125,"Alabama","Tuscaloosa County",2,50,2641,1314,1327
050,01,125,"Alabama","Tuscaloosa County",2,51,2468,1217,1251
050,01,125,"Alabama","Tuscaloosa County",2,52,2380,1152,1228
050,01,125,"Alabama","Tuscaloosa County",2,53,2399,1153,1246
050,01,125,"Alabama","Tuscaloosa County",2,54,2432,1182,1250
050,01,125,"Alabama","Tuscaloosa County",2,55,2574,1251,1323
050,01,125,"Alabama","Tuscaloosa County",2,56,2540,1253,1287
050,01,125,"Alabama","Tuscaloosa County",2,57,2542,1240,1302
050,01,125,"Alabama","Tuscaloosa County",2,58,2641,1281,1360
050,01,125,"Alabama","Tuscaloosa County",2,59,2623,1292,1331
050,01,125,"Alabama","Tuscaloosa County",2,60,2528,1233,1295
050,01,125,"Alabama","Tuscaloosa County",2,61,2519,1199,1320
050,01,125,"Alabama","Tuscaloosa County",2,62,2515,1191,1324
050,01,125,"Alabama","Tuscaloosa County",2,63,2560,1201,1359
050,01,125,"Alabama","Tuscaloosa County",2,64,2499,1182,1317
050,01,125,"Alabama","Tuscaloosa County",2,65,2429,1150,1279
050,01,125,"Alabama","Tuscaloosa County",2,66,2376,1112,1264
050,01,125,"Alabama","Tuscaloosa County",2,67,2268,1064,1204
050,01,125,"Alabama","Tuscaloosa County",2,68,2150,1005,1145
050,01,125,"Alabama","Tuscaloosa County",2,69,2040,932,1108
050,01,125,"Alabama","Tuscaloosa County",2,70,1860,845,1015
050,01,125,"Alabama","Tuscaloosa County",2,71,1797,819,978
050,01,125,"Alabama","Tuscaloosa County",2,72,1735,804,931
050,01,125,"Alabama","Tuscaloosa County",2,73,1762,801,961
050,01,125,"Alabama","Tuscaloosa County",2,74,1198,546,652
050,01,125,"Alabama","Tuscaloosa County",2,75,1124,505,619
050,01,125,"Alabama","Tuscaloosa County",2,76,1124,492,632
050,01,125,"Alabama","Tuscaloosa County",2,77,1152,473,679
050,01,125,"Alabama","Tuscaloosa County",2,78,954,396,558
050,01,125,"Alabama","Tuscaloosa County",2,79,827,373,454
050,01,125,"Alabama","Tuscaloosa County",2,80,783,349,434
050,01,125,"Alabama","Tuscaloosa County",2,81,712,286,426
050,01,125,"Alabama","Tuscaloosa County",2,82,650,261,389
050,01,125,"Alabama","Tuscaloosa County",2,83,574,216,358
050,01,125,"Alabama","Tuscaloosa County",2,84,510,186,324
050,01,125,"Alabama","Tuscaloosa County",2,85,3099,971,2128
050,01,125,"Alabama","Tuscaloosa County",3,0,2470,1272,1198
050,01,125,"Alabama","Tuscaloosa County",3,1,2491,1273,1218
050,01,125,"Alabama","Tuscaloosa County",3,2,2594,1340,1254
050,01,125,"Alabama","Tuscaloosa County",3,3,2643,1370,1273
050,01,125,"Alabama","Tuscaloosa County",3,4,2759,1412,1347
050,01,125,"Alabama","Tuscaloosa County",3,5,2832,1439,1393
050,01,125,"Alabama","Tuscaloosa County",3,6,2767,1410,1357
050,01,125,"Alabama","Tuscaloosa County",3,7,2753,1419,1334
050,01,125,"Alabama","Tuscaloosa County",3,8,2739,1375,1364
050,01,125,"Alabama","Tuscaloosa County",3,9,2715,1362,1353
050,01,125,"Alabama","Tuscaloosa County",3,10,2703,1360,1343
050,01,125,"Alabama","Tuscaloosa County",3,11,2760,1376,1384
050,01,125,"Alabama","Tuscaloosa County",3,12,2814,1412,1402
050,01,125,"Alabama","Tuscaloosa County",3,13,2817,1450,1367
050,01,125,"Alabama","Tuscaloosa County",3,14,2768,1416,1352
050,01,125,"Alabama","Tuscaloosa County",3,15,2672,1355,1317
050,01,125,"Alabama","Tuscaloosa County",3,16,2555,1304,1251
050,01,125,"Alabama","Tuscaloosa County",3,17,2672,1341,1331
050,01,125,"Alabama","Tuscaloosa County",3,18,6059,2678,3381
050,01,125,"Alabama","Tuscaloosa County",3,19,10049,4721,5328
050,01,125,"Alabama","Tuscaloosa County",3,20,7127,3391,3736
050,01,125,"Alabama","Tuscaloosa County",3,21,6559,3044,3515
050,01,125,"Alabama","Tuscaloosa County",3,22,5618,2823,2795
050,01,125,"Alabama","Tuscaloosa County",3,23,4672,2359,2313
050,01,125,"Alabama","Tuscaloosa County",3,24,3978,2099,1879
050,01,125,"Alabama","Tuscaloosa County",3,25,3383,1689,1694
050,01,125,"Alabama","Tuscaloosa County",3,26,3073,1520,1553
050,01,125,"Alabama","Tuscaloosa County",3,27,3170,1540,1630
050,01,125,"Alabama","Tuscaloosa County",3,28,3169,1542,1627
050,01,125,"Alabama","Tuscaloosa County",3,29,3274,1570,1704
050,01,125,"Alabama","Tuscaloosa County",3,30,3473,1685,1788
050,01,125,"Alabama","Tuscaloosa County",3,31,3501,1705,1796
050,01,125,"Alabama","Tuscaloosa County",3,32,3427,1677,1750
050,01,125,"Alabama","Tuscaloosa County",3,33,3128,1569,1559
050,01,125,"Alabama","Tuscaloosa County",3,34,2923,1456,1467
050,01,125,"Alabama","Tuscaloosa County",3,35,2798,1371,1427
050,01,125,"Alabama","Tuscaloosa County",3,36,2694,1303,1391
050,01,125,"Alabama","Tuscaloosa County",3,37,2685,1312,1373
050,01,125,"Alabama","Tuscaloosa County",3,38,2821,1353,1468
050,01,125,"Alabama","Tuscaloosa County",3,39,2939,1477,1462
050,01,125,"Alabama","Tuscaloosa County",3,40,2955,1468,1487
050,01,125,"Alabama","Tuscaloosa County",3,41,2881,1419,1462
050,01,125,"Alabama","Tuscaloosa County",3,42,2706,1300,1406
050,01,125,"Alabama","Tuscaloosa County",3,43,2685,1308,1377
050,01,125,"Alabama","Tuscaloosa County",3,44,2609,1239,1370
050,01,125,"Alabama","Tuscaloosa County",3,45,2503,1216,1287
050,01,125,"Alabama","Tuscaloosa County",3,46,2551,1257,1294
050,01,125,"Alabama","Tuscaloosa County",3,47,2555,1216,1339
050,01,125,"Alabama","Tuscaloosa County",3,48,2568,1192,1376
050,01,125,"Alabama","Tuscaloosa County",3,49,2657,1249,1408
050,01,125,"Alabama","Tuscaloosa County",3,50,2834,1402,1432
050,01,125,"Alabama","Tuscaloosa County",3,51,2629,1311,1318
050,01,125,"Alabama","Tuscaloosa County",3,52,2445,1209,1236
050,01,125,"Alabama","Tuscaloosa County",3,53,2385,1150,1235
050,01,125,"Alabama","Tuscaloosa County",3,54,2371,1156,1215
050,01,125,"Alabama","Tuscaloosa County",3,55,2419,1162,1257
050,01,125,"Alabama","Tuscaloosa County",3,56,2538,1230,1308
050,01,125,"Alabama","Tuscaloosa County",3,57,2547,1246,1301
050,01,125,"Alabama","Tuscaloosa County",3,58,2519,1223,1296
050,01,125,"Alabama","Tuscaloosa County",3,59,2653,1288,1365
050,01,125,"Alabama","Tuscaloosa County",3,60,2586,1254,1332
050,01,125,"Alabama","Tuscaloosa County",3,61,2485,1198,1287
050,01,125,"Alabama","Tuscaloosa County",3,62,2523,1207,1316
050,01,125,"Alabama","Tuscaloosa County",3,63,2511,1171,1340
050,01,125,"Alabama","Tuscaloosa County",3,64,2513,1184,1329
050,01,125,"Alabama","Tuscaloosa County",3,65,2445,1155,1290
050,01,125,"Alabama","Tuscaloosa County",3,66,2381,1113,1268
050,01,125,"Alabama","Tuscaloosa County",3,67,2334,1100,1234
050,01,125,"Alabama","Tuscaloosa County",3,68,2215,1027,1188
050,01,125,"Alabama","Tuscaloosa County",3,69,2075,964,1111
050,01,125,"Alabama","Tuscaloosa County",3,70,1988,894,1094
050,01,125,"Alabama","Tuscaloosa County",3,71,1821,812,1009
050,01,125,"Alabama","Tuscaloosa County",3,72,1740,784,956
050,01,125,"Alabama","Tuscaloosa County",3,73,1698,782,916
050,01,125,"Alabama","Tuscaloosa County",3,74,1706,772,934
050,01,125,"Alabama","Tuscaloosa County",3,75,1137,508,629
050,01,125,"Alabama","Tuscaloosa County",3,76,1092,493,599
050,01,125,"Alabama","Tuscaloosa County",3,77,1074,464,610
050,01,125,"Alabama","Tuscaloosa County",3,78,1092,445,647
050,01,125,"Alabama","Tuscaloosa County",3,79,890,377,513
050,01,125,"Alabama","Tuscaloosa County",3,80,788,349,439
050,01,125,"Alabama","Tuscaloosa County",3,81,727,315,412
050,01,125,"Alabama","Tuscaloosa County",3,82,667,266,401
050,01,125,"Alabama","Tuscaloosa County",3,83,609,240,369
050,01,125,"Alabama","Tuscaloosa County",3,84,510,186,324
050,01,125,"Alabama","Tuscaloosa County",3,85,3009,923,2086
050,01,125,"Alabama","Tuscaloosa County",4,0,2459,1265,1194
050,01,125,"Alabama","Tuscaloosa County",4,1,2490,1283,1207
050,01,125,"Alabama","Tuscaloosa County",4,2,2481,1246,1235
050,01,125,"Alabama","Tuscaloosa County",4,3,2588,1335,1253
050,01,125,"Alabama","Tuscaloosa County",4,4,2627,1362,1265
050,01,125,"Alabama","Tuscaloosa County",4,5,2792,1427,1365
050,01,125,"Alabama","Tuscaloosa County",4,6,2779,1408,1371
050,01,125,"Alabama","Tuscaloosa County",4,7,2787,1409,1378
050,01,125,"Alabama","Tuscaloosa County",4,8,2771,1434,1337
050,01,125,"Alabama","Tuscaloosa County",4,9,2735,1386,1349
050,01,125,"Alabama","Tuscaloosa County",4,10,2680,1357,1323
050,01,125,"Alabama","Tuscaloosa County",4,11,2730,1379,1351
050,01,125,"Alabama","Tuscaloosa County",4,12,2804,1402,1402
050,01,125,"Alabama","Tuscaloosa County",4,13,2843,1422,1421
050,01,125,"Alabama","Tuscaloosa County",4,14,2835,1467,1368
050,01,125,"Alabama","Tuscaloosa County",4,15,2799,1423,1376
050,01,125,"Alabama","Tuscaloosa County",4,16,2703,1364,1339
050,01,125,"Alabama","Tuscaloosa County",4,17,2593,1324,1269
050,01,125,"Alabama","Tuscaloosa County",4,18,6148,2717,3431
050,01,125,"Alabama","Tuscaloosa County",4,19,10273,4827,5446
050,01,125,"Alabama","Tuscaloosa County",4,20,7081,3384,3697
050,01,125,"Alabama","Tuscaloosa County",4,21,6587,3081,3506
050,01,125,"Alabama","Tuscaloosa County",4,22,5686,2817,2869
050,01,125,"Alabama","Tuscaloosa County",4,23,4592,2313,2279
050,01,125,"Alabama","Tuscaloosa County",4,24,4080,2145,1935
050,01,125,"Alabama","Tuscaloosa County",4,25,3273,1634,1639
050,01,125,"Alabama","Tuscaloosa County",4,26,3076,1499,1577
050,01,125,"Alabama","Tuscaloosa County",4,27,2954,1448,1506
050,01,125,"Alabama","Tuscaloosa County",4,28,3096,1473,1623
050,01,125,"Alabama","Tuscaloosa County",4,29,3079,1469,1610
050,01,125,"Alabama","Tuscaloosa County",4,30,3202,1568,1634
050,01,125,"Alabama","Tuscaloosa County",4,31,3392,1597,1795
050,01,125,"Alabama","Tuscaloosa County",4,32,3448,1670,1778
050,01,125,"Alabama","Tuscaloosa County",4,33,3369,1656,1713
050,01,125,"Alabama","Tuscaloosa County",4,34,3085,1510,1575
050,01,125,"Alabama","Tuscaloosa County",4,35,2862,1416,1446
050,01,125,"Alabama","Tuscaloosa County",4,36,2770,1350,1420
050,01,125,"Alabama","Tuscaloosa County",4,37,2650,1309,1341
050,01,125,"Alabama","Tuscaloosa County",4,38,2664,1302,1362
050,01,125,"Alabama","Tuscaloosa County",4,39,2842,1374,1468
050,01,125,"Alabama","Tuscaloosa County",4,40,2875,1396,1479
050,01,125,"Alabama","Tuscaloosa County",4,41,2910,1416,1494
050,01,125,"Alabama","Tuscaloosa County",4,42,2899,1421,1478
050,01,125,"Alabama","Tuscaloosa County",4,43,2707,1292,1415
050,01,125,"Alabama","Tuscaloosa County",4,44,2707,1308,1399
050,01,125,"Alabama","Tuscaloosa County",4,45,2615,1232,1383
050,01,125,"Alabama","Tuscaloosa County",4,46,2468,1200,1268
050,01,125,"Alabama","Tuscaloosa County",4,47,2591,1277,1314
050,01,125,"Alabama","Tuscaloosa County",4,48,2552,1210,1342
050,01,125,"Alabama","Tuscaloosa County",4,49,2532,1157,1375
050,01,125,"Alabama","Tuscaloosa County",4,50,2671,1266,1405
050,01,125,"Alabama","Tuscaloosa County",4,51,2860,1407,1453
050,01,125,"Alabama","Tuscaloosa County",4,52,2623,1304,1319
050,01,125,"Alabama","Tuscaloosa County",4,53,2448,1200,1248
050,01,125,"Alabama","Tuscaloosa County",4,54,2382,1142,1240
050,01,125,"Alabama","Tuscaloosa County",4,55,2397,1163,1234
050,01,125,"Alabama","Tuscaloosa County",4,56,2424,1162,1262
050,01,125,"Alabama","Tuscaloosa County",4,57,2542,1230,1312
050,01,125,"Alabama","Tuscaloosa County",4,58,2521,1228,1293
050,01,125,"Alabama","Tuscaloosa County",4,59,2527,1249,1278
050,01,125,"Alabama","Tuscaloosa County",4,60,2625,1274,1351
050,01,125,"Alabama","Tuscaloosa County",4,61,2575,1233,1342
050,01,125,"Alabama","Tuscaloosa County",4,62,2457,1192,1265
050,01,125,"Alabama","Tuscaloosa County",4,63,2498,1171,1327
050,01,125,"Alabama","Tuscaloosa County",4,64,2461,1160,1301
050,01,125,"Alabama","Tuscaloosa County",4,65,2474,1157,1317
050,01,125,"Alabama","Tuscaloosa County",4,66,2429,1134,1295
050,01,125,"Alabama","Tuscaloosa County",4,67,2339,1098,1241
050,01,125,"Alabama","Tuscaloosa County",4,68,2288,1069,1219
050,01,125,"Alabama","Tuscaloosa County",4,69,2141,981,1160
050,01,125,"Alabama","Tuscaloosa County",4,70,2049,938,1111
050,01,125,"Alabama","Tuscaloosa County",4,71,1941,858,1083
050,01,125,"Alabama","Tuscaloosa County",4,72,1763,791,972
050,01,125,"Alabama","Tuscaloosa County",4,73,1686,747,939
050,01,125,"Alabama","Tuscaloosa County",4,74,1652,763,889
050,01,125,"Alabama","Tuscaloosa County",4,75,1651,733,918
050,01,125,"Alabama","Tuscaloosa County",4,76,1113,492,621
050,01,125,"Alabama","Tuscaloosa County",4,77,1083,483,600
050,01,125,"Alabama","Tuscaloosa County",4,78,1004,428,576
050,01,125,"Alabama","Tuscaloosa County",4,79,1011,418,593
050,01,125,"Alabama","Tuscaloosa County",4,80,862,357,505
050,01,125,"Alabama","Tuscaloosa County",4,81,754,326,428
050,01,125,"Alabama","Tuscaloosa County",4,82,688,296,392
050,01,125,"Alabama","Tuscaloosa County",4,83,625,246,379
050,01,125,"Alabama","Tuscaloosa County",4,84,550,214,336
050,01,125,"Alabama","Tuscaloosa County",4,85,3015,920,2095
050,01,125,"Alabama","Tuscaloosa County",5,0,2485,1286,1199
050,01,125,"Alabama","Tuscaloosa County",5,1,2465,1307,1158
050,01,125,"Alabama","Tuscaloosa County",5,2,2467,1274,1193
050,01,125,"Alabama","Tuscaloosa County",5,3,2488,1245,1243
050,01,125,"Alabama","Tuscaloosa County",5,4,2573,1325,1248
050,01,125,"Alabama","Tuscaloosa County",5,5,2597,1351,1246
050,01,125,"Alabama","Tuscaloosa County",5,6,2771,1405,1366
050,01,125,"Alabama","Tuscaloosa County",5,7,2782,1420,1362
050,01,125,"Alabama","Tuscaloosa County",5,8,2787,1406,1381
050,01,125,"Alabama","Tuscaloosa County",5,9,2741,1403,1338
050,01,125,"Alabama","Tuscaloosa County",5,10,2742,1404,1338
050,01,125,"Alabama","Tuscaloosa County",5,11,2670,1349,1321
050,01,125,"Alabama","Tuscaloosa County",5,12,2731,1389,1342
050,01,125,"Alabama","Tuscaloosa County",5,13,2794,1406,1388
050,01,125,"Alabama","Tuscaloosa County",5,14,2876,1449,1427
050,01,125,"Alabama","Tuscaloosa County",5,15,2806,1460,1346
050,01,125,"Alabama","Tuscaloosa County",5,16,2785,1410,1375
050,01,125,"Alabama","Tuscaloosa County",5,17,2726,1395,1331
050,01,125,"Alabama","Tuscaloosa County",5,18,6199,2734,3465
050,01,125,"Alabama","Tuscaloosa County",5,19,10552,4931,5621
050,01,125,"Alabama","Tuscaloosa County",5,20,7152,3440,3712
050,01,125,"Alabama","Tuscaloosa County",5,21,6424,3021,3403
050,01,125,"Alabama","Tuscaloosa County",5,22,5677,2866,2811
050,01,125,"Alabama","Tuscaloosa County",5,23,4700,2328,2372
050,01,125,"Alabama","Tuscaloosa County",5,24,4001,2087,1914
050,01,125,"Alabama","Tuscaloosa County",5,25,3364,1684,1680
050,01,125,"Alabama","Tuscaloosa County",5,26,2949,1483,1466
050,01,125,"Alabama","Tuscaloosa County",5,27,2875,1387,1488
050,01,125,"Alabama","Tuscaloosa County",5,28,2885,1406,1479
050,01,125,"Alabama","Tuscaloosa County",5,29,3011,1448,1563
050,01,125,"Alabama","Tuscaloosa County",5,30,3033,1461,1572
050,01,125,"Alabama","Tuscaloosa County",5,31,3102,1487,1615
050,01,125,"Alabama","Tuscaloosa County",5,32,3335,1572,1763
050,01,125,"Alabama","Tuscaloosa County",5,33,3381,1644,1737
050,01,125,"Alabama","Tuscaloosa County",5,34,3322,1628,1694
050,01,125,"Alabama","Tuscaloosa County",5,35,3031,1485,1546
050,01,125,"Alabama","Tuscaloosa County",5,36,2832,1376,1456
050,01,125,"Alabama","Tuscaloosa County",5,37,2767,1356,1411
050,01,125,"Alabama","Tuscaloosa County",5,38,2644,1299,1345
050,01,125,"Alabama","Tuscaloosa County",5,39,2656,1307,1349
050,01,125,"Alabama","Tuscaloosa County",5,40,2826,1333,1493
050,01,125,"Alabama","Tuscaloosa County",5,41,2896,1396,1500
050,01,125,"Alabama","Tuscaloosa County",5,42,2863,1392,1471
050,01,125,"Alabama","Tuscaloosa County",5,43,2902,1413,1489
050,01,125,"Alabama","Tuscaloosa County",5,44,2703,1276,1427
050,01,125,"Alabama","Tuscaloosa County",5,45,2694,1292,1402
050,01,125,"Alabama","Tuscaloosa County",5,46,2604,1229,1375
050,01,125,"Alabama","Tuscaloosa County",5,47,2438,1194,1244
050,01,125,"Alabama","Tuscaloosa County",5,48,2580,1270,1310
050,01,125,"Alabama","Tuscaloosa County",5,49,2523,1177,1346
050,01,125,"Alabama","Tuscaloosa County",5,50,2532,1170,1362
050,01,125,"Alabama","Tuscaloosa County",5,51,2713,1286,1427
050,01,125,"Alabama","Tuscaloosa County",5,52,2806,1379,1427
050,01,125,"Alabama","Tuscaloosa County",5,53,2610,1298,1312
050,01,125,"Alabama","Tuscaloosa County",5,54,2448,1198,1250
050,01,125,"Alabama","Tuscaloosa County",5,55,2375,1128,1247
050,01,125,"Alabama","Tuscaloosa County",5,56,2374,1136,1238
050,01,125,"Alabama","Tuscaloosa County",5,57,2428,1168,1260
050,01,125,"Alabama","Tuscaloosa County",5,58,2522,1209,1313
050,01,125,"Alabama","Tuscaloosa County",5,59,2545,1254,1291
050,01,125,"Alabama","Tuscaloosa County",5,60,2490,1220,1270
050,01,125,"Alabama","Tuscaloosa County",5,61,2606,1257,1349
050,01,125,"Alabama","Tuscaloosa County",5,62,2534,1227,1307
050,01,125,"Alabama","Tuscaloosa County",5,63,2444,1190,1254
050,01,125,"Alabama","Tuscaloosa County",5,64,2447,1153,1294
050,01,125,"Alabama","Tuscaloosa County",5,65,2386,1109,1277
050,01,125,"Alabama","Tuscaloosa County",5,66,2451,1136,1315
050,01,125,"Alabama","Tuscaloosa County",5,67,2383,1122,1261
050,01,125,"Alabama","Tuscaloosa County",5,68,2292,1063,1229
050,01,125,"Alabama","Tuscaloosa County",5,69,2242,1036,1206
050,01,125,"Alabama","Tuscaloosa County",5,70,2096,948,1148
050,01,125,"Alabama","Tuscaloosa County",5,71,2009,905,1104
050,01,125,"Alabama","Tuscaloosa County",5,72,1909,842,1067
050,01,125,"Alabama","Tuscaloosa County",5,73,1717,761,956
050,01,125,"Alabama","Tuscaloosa County",5,74,1641,731,910
050,01,125,"Alabama","Tuscaloosa County",5,75,1614,729,885
050,01,125,"Alabama","Tuscaloosa County",5,76,1616,710,906
050,01,125,"Alabama","Tuscaloosa County",5,77,1108,486,622
050,01,125,"Alabama","Tuscaloosa County",5,78,1025,451,574
050,01,125,"Alabama","Tuscaloosa County",5,79,945,413,532
050,01,125,"Alabama","Tuscaloosa County",5,80,989,394,595
050,01,125,"Alabama","Tuscaloosa County",5,81,825,336,489
050,01,125,"Alabama","Tuscaloosa County",5,82,715,312,403
050,01,125,"Alabama","Tuscaloosa County",5,83,669,282,387
050,01,125,"Alabama","Tuscaloosa County",5,84,568,226,342
050,01,125,"Alabama","Tuscaloosa County",5,85,3092,972,2120
050,01,127,"Alabama","Walker County",1,0,786,404,382
050,01,127,"Alabama","Walker County",1,1,808,403,405
050,01,127,"Alabama","Walker County",1,2,795,413,382
050,01,127,"Alabama","Walker County",1,3,799,404,395
050,01,127,"Alabama","Walker County",1,4,788,405,383
050,01,127,"Alabama","Walker County",1,5,820,425,395
050,01,127,"Alabama","Walker County",1,6,817,413,404
050,01,127,"Alabama","Walker County",1,7,800,402,398
050,01,127,"Alabama","Walker County",1,8,833,427,406
050,01,127,"Alabama","Walker County",1,9,828,431,397
050,01,127,"Alabama","Walker County",1,10,813,400,413
050,01,127,"Alabama","Walker County",1,11,814,386,428
050,01,127,"Alabama","Walker County",1,12,850,425,425
050,01,127,"Alabama","Walker County",1,13,852,445,407
050,01,127,"Alabama","Walker County",1,14,792,424,368
050,01,127,"Alabama","Walker County",1,15,819,443,376
050,01,127,"Alabama","Walker County",1,16,864,455,409
050,01,127,"Alabama","Walker County",1,17,870,446,424
050,01,127,"Alabama","Walker County",1,18,740,392,348
050,01,127,"Alabama","Walker County",1,19,604,330,274
050,01,127,"Alabama","Walker County",1,20,650,348,302
050,01,127,"Alabama","Walker County",1,21,651,336,315
050,01,127,"Alabama","Walker County",1,22,728,339,389
050,01,127,"Alabama","Walker County",1,23,791,395,396
050,01,127,"Alabama","Walker County",1,24,779,390,389
050,01,127,"Alabama","Walker County",1,25,785,405,380
050,01,127,"Alabama","Walker County",1,26,800,424,376
050,01,127,"Alabama","Walker County",1,27,788,408,380
050,01,127,"Alabama","Walker County",1,28,844,425,419
050,01,127,"Alabama","Walker County",1,29,885,423,462
050,01,127,"Alabama","Walker County",1,30,848,409,439
050,01,127,"Alabama","Walker County",1,31,740,360,380
050,01,127,"Alabama","Walker County",1,32,742,371,371
050,01,127,"Alabama","Walker County",1,33,732,383,349
050,01,127,"Alabama","Walker County",1,34,700,350,350
050,01,127,"Alabama","Walker County",1,35,659,324,335
050,01,127,"Alabama","Walker County",1,36,666,312,354
050,01,127,"Alabama","Walker County",1,37,727,370,357
050,01,127,"Alabama","Walker County",1,38,699,356,343
050,01,127,"Alabama","Walker County",1,39,734,370,364
050,01,127,"Alabama","Walker County",1,40,789,383,406
050,01,127,"Alabama","Walker County",1,41,778,358,420
050,01,127,"Alabama","Walker County",1,42,750,357,393
050,01,127,"Alabama","Walker County",1,43,793,383,410
050,01,127,"Alabama","Walker County",1,44,753,346,407
050,01,127,"Alabama","Walker County",1,45,743,366,377
050,01,127,"Alabama","Walker County",1,46,747,394,353
050,01,127,"Alabama","Walker County",1,47,806,424,382
050,01,127,"Alabama","Walker County",1,48,872,455,417
050,01,127,"Alabama","Walker County",1,49,942,489,453
050,01,127,"Alabama","Walker County",1,50,874,442,432
050,01,127,"Alabama","Walker County",1,51,867,450,417
050,01,127,"Alabama","Walker County",1,52,840,424,416
050,01,127,"Alabama","Walker County",1,53,827,432,395
050,01,127,"Alabama","Walker County",1,54,854,445,409
050,01,127,"Alabama","Walker County",1,55,893,436,457
050,01,127,"Alabama","Walker County",1,56,956,475,481
050,01,127,"Alabama","Walker County",1,57,928,476,452
050,01,127,"Alabama","Walker County",1,58,976,474,502
050,01,127,"Alabama","Walker County",1,59,917,441,476
050,01,127,"Alabama","Walker County",1,60,902,439,463
050,01,127,"Alabama","Walker County",1,61,950,438,512
050,01,127,"Alabama","Walker County",1,62,927,424,503
050,01,127,"Alabama","Walker County",1,63,907,429,478
050,01,127,"Alabama","Walker County",1,64,897,421,476
050,01,127,"Alabama","Walker County",1,65,888,427,461
050,01,127,"Alabama","Walker County",1,66,835,392,443
050,01,127,"Alabama","Walker County",1,67,830,393,437
050,01,127,"Alabama","Walker County",1,68,813,407,406
050,01,127,"Alabama","Walker County",1,69,789,390,399
050,01,127,"Alabama","Walker County",1,70,727,336,391
050,01,127,"Alabama","Walker County",1,71,742,321,421
050,01,127,"Alabama","Walker County",1,72,775,344,431
050,01,127,"Alabama","Walker County",1,73,764,343,421
050,01,127,"Alabama","Walker County",1,74,536,228,308
050,01,127,"Alabama","Walker County",1,75,532,236,296
050,01,127,"Alabama","Walker County",1,76,529,236,293
050,01,127,"Alabama","Walker County",1,77,515,229,286
050,01,127,"Alabama","Walker County",1,78,450,194,256
050,01,127,"Alabama","Walker County",1,79,415,173,242
050,01,127,"Alabama","Walker County",1,80,359,146,213
050,01,127,"Alabama","Walker County",1,81,370,147,223
050,01,127,"Alabama","Walker County",1,82,318,129,189
050,01,127,"Alabama","Walker County",1,83,279,110,169
050,01,127,"Alabama","Walker County",1,84,278,108,170
050,01,127,"Alabama","Walker County",1,85,1072,373,699
050,01,127,"Alabama","Walker County",2,0,761,380,381
050,01,127,"Alabama","Walker County",2,1,802,402,400
050,01,127,"Alabama","Walker County",2,2,794,408,386
050,01,127,"Alabama","Walker County",2,3,793,403,390
050,01,127,"Alabama","Walker County",2,4,791,405,386
050,01,127,"Alabama","Walker County",2,5,813,421,392
050,01,127,"Alabama","Walker County",2,6,820,416,404
050,01,127,"Alabama","Walker County",2,7,802,403,399
050,01,127,"Alabama","Walker County",2,8,823,420,403
050,01,127,"Alabama","Walker County",2,9,825,427,398
050,01,127,"Alabama","Walker County",2,10,813,405,408
050,01,127,"Alabama","Walker County",2,11,806,388,418
050,01,127,"Alabama","Walker County",2,12,841,415,426
050,01,127,"Alabama","Walker County",2,13,847,440,407
050,01,127,"Alabama","Walker County",2,14,806,427,379
050,01,127,"Alabama","Walker County",2,15,812,436,376
050,01,127,"Alabama","Walker County",2,16,852,450,402
050,01,127,"Alabama","Walker County",2,17,867,446,421
050,01,127,"Alabama","Walker County",2,18,735,388,347
050,01,127,"Alabama","Walker County",2,19,607,327,280
050,01,127,"Alabama","Walker County",2,20,660,353,307
050,01,127,"Alabama","Walker County",2,21,659,341,318
050,01,127,"Alabama","Walker County",2,22,721,342,379
050,01,127,"Alabama","Walker County",2,23,785,385,400
050,01,127,"Alabama","Walker County",2,24,784,392,392
050,01,127,"Alabama","Walker County",2,25,786,405,381
050,01,127,"Alabama","Walker County",2,26,801,424,377
050,01,127,"Alabama","Walker County",2,27,788,406,382
050,01,127,"Alabama","Walker County",2,28,835,422,413
050,01,127,"Alabama","Walker County",2,29,869,420,449
050,01,127,"Alabama","Walker County",2,30,862,412,450
050,01,127,"Alabama","Walker County",2,31,758,368,390
050,01,127,"Alabama","Walker County",2,32,740,369,371
050,01,127,"Alabama","Walker County",2,33,732,379,353
050,01,127,"Alabama","Walker County",2,34,709,359,350
050,01,127,"Alabama","Walker County",2,35,677,332,345
050,01,127,"Alabama","Walker County",2,36,657,311,346
050,01,127,"Alabama","Walker County",2,37,703,352,351
050,01,127,"Alabama","Walker County",2,38,707,363,344
050,01,127,"Alabama","Walker County",2,39,718,361,357
050,01,127,"Alabama","Walker County",2,40,781,382,399
050,01,127,"Alabama","Walker County",2,41,773,360,413
050,01,127,"Alabama","Walker County",2,42,753,357,396
050,01,127,"Alabama","Walker County",2,43,789,380,409
050,01,127,"Alabama","Walker County",2,44,748,348,400
050,01,127,"Alabama","Walker County",2,45,747,362,385
050,01,127,"Alabama","Walker County",2,46,738,383,355
050,01,127,"Alabama","Walker County",2,47,782,410,372
050,01,127,"Alabama","Walker County",2,48,858,452,406
050,01,127,"Alabama","Walker County",2,49,919,476,443
050,01,127,"Alabama","Walker County",2,50,886,448,438
050,01,127,"Alabama","Walker County",2,51,863,447,416
050,01,127,"Alabama","Walker County",2,52,843,428,415
050,01,127,"Alabama","Walker County",2,53,831,432,399
050,01,127,"Alabama","Walker County",2,54,839,438,401
050,01,127,"Alabama","Walker County",2,55,877,432,445
050,01,127,"Alabama","Walker County",2,56,946,472,474
050,01,127,"Alabama","Walker County",2,57,934,474,460
050,01,127,"Alabama","Walker County",2,58,961,471,490
050,01,127,"Alabama","Walker County",2,59,932,451,481
050,01,127,"Alabama","Walker County",2,60,890,428,462
050,01,127,"Alabama","Walker County",2,61,929,432,497
050,01,127,"Alabama","Walker County",2,62,926,425,501
050,01,127,"Alabama","Walker County",2,63,917,428,489
050,01,127,"Alabama","Walker County",2,64,891,421,470
050,01,127,"Alabama","Walker County",2,65,883,422,461
050,01,127,"Alabama","Walker County",2,66,842,396,446
050,01,127,"Alabama","Walker County",2,67,829,390,439
050,01,127,"Alabama","Walker County",2,68,803,398,405
050,01,127,"Alabama","Walker County",2,69,790,390,400
050,01,127,"Alabama","Walker County",2,70,736,347,389
050,01,127,"Alabama","Walker County",2,71,731,322,409
050,01,127,"Alabama","Walker County",2,72,752,328,424
050,01,127,"Alabama","Walker County",2,73,802,357,445
050,01,127,"Alabama","Walker County",2,74,550,237,313
050,01,127,"Alabama","Walker County",2,75,521,231,290
050,01,127,"Alabama","Walker County",2,76,520,231,289
050,01,127,"Alabama","Walker County",2,77,523,228,295
050,01,127,"Alabama","Walker County",2,78,444,192,252
050,01,127,"Alabama","Walker County",2,79,413,172,241
050,01,127,"Alabama","Walker County",2,80,360,146,214
050,01,127,"Alabama","Walker County",2,81,359,144,215
050,01,127,"Alabama","Walker County",2,82,324,128,196
050,01,127,"Alabama","Walker County",2,83,277,107,170
050,01,127,"Alabama","Walker County",2,84,274,105,169
050,01,127,"Alabama","Walker County",2,85,1091,384,707
050,01,127,"Alabama","Walker County",3,0,762,388,374
050,01,127,"Alabama","Walker County",3,1,746,362,384
050,01,127,"Alabama","Walker County",3,2,799,412,387
050,01,127,"Alabama","Walker County",3,3,798,424,374
050,01,127,"Alabama","Walker County",3,4,795,409,386
050,01,127,"Alabama","Walker County",3,5,794,403,391
050,01,127,"Alabama","Walker County",3,6,806,415,391
050,01,127,"Alabama","Walker County",3,7,816,414,402
050,01,127,"Alabama","Walker County",3,8,811,414,397
050,01,127,"Alabama","Walker County",3,9,842,437,405
050,01,127,"Alabama","Walker County",3,10,827,428,399
050,01,127,"Alabama","Walker County",3,11,828,413,415
050,01,127,"Alabama","Walker County",3,12,811,397,414
050,01,127,"Alabama","Walker County",3,13,863,434,429
050,01,127,"Alabama","Walker County",3,14,851,439,412
050,01,127,"Alabama","Walker County",3,15,802,418,384
050,01,127,"Alabama","Walker County",3,16,816,440,376
050,01,127,"Alabama","Walker County",3,17,852,443,409
050,01,127,"Alabama","Walker County",3,18,721,392,329
050,01,127,"Alabama","Walker County",3,19,584,308,276
050,01,127,"Alabama","Walker County",3,20,673,351,322
050,01,127,"Alabama","Walker County",3,21,706,372,334
050,01,127,"Alabama","Walker County",3,22,726,358,368
050,01,127,"Alabama","Walker County",3,23,752,357,395
050,01,127,"Alabama","Walker County",3,24,806,396,410
050,01,127,"Alabama","Walker County",3,25,784,393,391
050,01,127,"Alabama","Walker County",3,26,781,403,378
050,01,127,"Alabama","Walker County",3,27,796,420,376
050,01,127,"Alabama","Walker County",3,28,791,420,371
050,01,127,"Alabama","Walker County",3,29,827,405,422
050,01,127,"Alabama","Walker County",3,30,870,413,457
050,01,127,"Alabama","Walker County",3,31,841,408,433
050,01,127,"Alabama","Walker County",3,32,782,387,395
050,01,127,"Alabama","Walker County",3,33,709,358,351
050,01,127,"Alabama","Walker County",3,34,732,385,347
050,01,127,"Alabama","Walker County",3,35,724,353,371
050,01,127,"Alabama","Walker County",3,36,661,320,341
050,01,127,"Alabama","Walker County",3,37,661,319,342
050,01,127,"Alabama","Walker County",3,38,705,363,342
050,01,127,"Alabama","Walker County",3,39,681,341,340
050,01,127,"Alabama","Walker County",3,40,749,376,373
050,01,127,"Alabama","Walker County",3,41,764,372,392
050,01,127,"Alabama","Walker County",3,42,751,361,390
050,01,127,"Alabama","Walker County",3,43,764,365,399
050,01,127,"Alabama","Walker County",3,44,781,372,409
050,01,127,"Alabama","Walker County",3,45,748,347,401
050,01,127,"Alabama","Walker County",3,46,743,364,379
050,01,127,"Alabama","Walker County",3,47,721,372,349
050,01,127,"Alabama","Walker County",3,48,773,410,363
050,01,127,"Alabama","Walker County",3,49,853,442,411
050,01,127,"Alabama","Walker County",3,50,917,473,444
050,01,127,"Alabama","Walker County",3,51,869,442,427
050,01,127,"Alabama","Walker County",3,52,855,433,422
050,01,127,"Alabama","Walker County",3,53,842,429,413
050,01,127,"Alabama","Walker County",3,54,833,423,410
050,01,127,"Alabama","Walker County",3,55,834,427,407
050,01,127,"Alabama","Walker County",3,56,882,436,446
050,01,127,"Alabama","Walker County",3,57,921,468,453
050,01,127,"Alabama","Walker County",3,58,905,445,460
050,01,127,"Alabama","Walker County",3,59,958,467,491
050,01,127,"Alabama","Walker County",3,60,911,434,477
050,01,127,"Alabama","Walker County",3,61,874,412,462
050,01,127,"Alabama","Walker County",3,62,909,419,490
050,01,127,"Alabama","Walker County",3,63,908,421,487
050,01,127,"Alabama","Walker County",3,64,892,416,476
050,01,127,"Alabama","Walker County",3,65,855,409,446
050,01,127,"Alabama","Walker County",3,66,864,406,458
050,01,127,"Alabama","Walker County",3,67,817,378,439
050,01,127,"Alabama","Walker County",3,68,795,369,426
050,01,127,"Alabama","Walker County",3,69,768,371,397
050,01,127,"Alabama","Walker County",3,70,746,362,384
050,01,127,"Alabama","Walker County",3,71,710,342,368
050,01,127,"Alabama","Walker County",3,72,694,298,396
050,01,127,"Alabama","Walker County",3,73,728,314,414
050,01,127,"Alabama","Walker County",3,74,759,328,431
050,01,127,"Alabama","Walker County",3,75,493,209,284
050,01,127,"Alabama","Walker County",3,76,499,217,282
050,01,127,"Alabama","Walker County",3,77,480,214,266
050,01,127,"Alabama","Walker County",3,78,484,215,269
050,01,127,"Alabama","Walker County",3,79,410,173,237
050,01,127,"Alabama","Walker County",3,80,366,150,216
050,01,127,"Alabama","Walker County",3,81,344,135,209
050,01,127,"Alabama","Walker County",3,82,301,119,182
050,01,127,"Alabama","Walker County",3,83,285,109,176
050,01,127,"Alabama","Walker County",3,84,260,87,173
050,01,127,"Alabama","Walker County",3,85,1089,382,707
050,01,127,"Alabama","Walker County",4,0,781,391,390
050,01,127,"Alabama","Walker County",4,1,787,404,383
050,01,127,"Alabama","Walker County",4,2,743,352,391
050,01,127,"Alabama","Walker County",4,3,810,412,398
050,01,127,"Alabama","Walker County",4,4,825,437,388
050,01,127,"Alabama","Walker County",4,5,791,412,379
050,01,127,"Alabama","Walker County",4,6,779,388,391
050,01,127,"Alabama","Walker County",4,7,805,420,385
050,01,127,"Alabama","Walker County",4,8,821,413,408
050,01,127,"Alabama","Walker County",4,9,822,418,404
050,01,127,"Alabama","Walker County",4,10,849,429,420
050,01,127,"Alabama","Walker County",4,11,822,425,397
050,01,127,"Alabama","Walker County",4,12,843,427,416
050,01,127,"Alabama","Walker County",4,13,828,410,418
050,01,127,"Alabama","Walker County",4,14,888,444,444
050,01,127,"Alabama","Walker County",4,15,852,440,412
050,01,127,"Alabama","Walker County",4,16,811,427,384
050,01,127,"Alabama","Walker County",4,17,832,447,385
050,01,127,"Alabama","Walker County",4,18,718,393,325
050,01,127,"Alabama","Walker County",4,19,569,306,263
050,01,127,"Alabama","Walker County",4,20,610,318,292
050,01,127,"Alabama","Walker County",4,21,694,357,337
050,01,127,"Alabama","Walker County",4,22,753,388,365
050,01,127,"Alabama","Walker County",4,23,768,371,397
050,01,127,"Alabama","Walker County",4,24,760,369,391
050,01,127,"Alabama","Walker County",4,25,801,406,395
050,01,127,"Alabama","Walker County",4,26,807,402,405
050,01,127,"Alabama","Walker County",4,27,788,390,398
050,01,127,"Alabama","Walker County",4,28,797,427,370
050,01,127,"Alabama","Walker County",4,29,784,405,379
050,01,127,"Alabama","Walker County",4,30,821,401,420
050,01,127,"Alabama","Walker County",4,31,845,404,441
050,01,127,"Alabama","Walker County",4,32,860,418,442
050,01,127,"Alabama","Walker County",4,33,781,390,391
050,01,127,"Alabama","Walker County",4,34,713,351,362
050,01,127,"Alabama","Walker County",4,35,757,395,362
050,01,127,"Alabama","Walker County",4,36,703,330,373
050,01,127,"Alabama","Walker County",4,37,670,323,347
050,01,127,"Alabama","Walker County",4,38,675,336,339
050,01,127,"Alabama","Walker County",4,39,711,362,349
050,01,127,"Alabama","Walker County",4,40,691,344,347
050,01,127,"Alabama","Walker County",4,41,723,352,371
050,01,127,"Alabama","Walker County",4,42,757,369,388
050,01,127,"Alabama","Walker County",4,43,755,365,390
050,01,127,"Alabama","Walker County",4,44,743,350,393
050,01,127,"Alabama","Walker County",4,45,765,354,411
050,01,127,"Alabama","Walker County",4,46,750,355,395
050,01,127,"Alabama","Walker County",4,47,727,350,377
050,01,127,"Alabama","Walker County",4,48,735,386,349
050,01,127,"Alabama","Walker County",4,49,778,402,376
050,01,127,"Alabama","Walker County",4,50,850,443,407
050,01,127,"Alabama","Walker County",4,51,902,452,450
050,01,127,"Alabama","Walker County",4,52,864,441,423
050,01,127,"Alabama","Walker County",4,53,862,442,420
050,01,127,"Alabama","Walker County",4,54,819,410,409
050,01,127,"Alabama","Walker County",4,55,833,413,420
050,01,127,"Alabama","Walker County",4,56,854,443,411
050,01,127,"Alabama","Walker County",4,57,859,438,421
050,01,127,"Alabama","Walker County",4,58,915,452,463
050,01,127,"Alabama","Walker County",4,59,890,447,443
050,01,127,"Alabama","Walker County",4,60,947,453,494
050,01,127,"Alabama","Walker County",4,61,910,431,479
050,01,127,"Alabama","Walker County",4,62,850,409,441
050,01,127,"Alabama","Walker County",4,63,896,407,489
050,01,127,"Alabama","Walker County",4,64,887,396,491
050,01,127,"Alabama","Walker County",4,65,867,404,463
050,01,127,"Alabama","Walker County",4,66,825,387,438
050,01,127,"Alabama","Walker County",4,67,846,394,452
050,01,127,"Alabama","Walker County",4,68,783,365,418
050,01,127,"Alabama","Walker County",4,69,769,351,418
050,01,127,"Alabama","Walker County",4,70,743,352,391
050,01,127,"Alabama","Walker County",4,71,728,357,371
050,01,127,"Alabama","Walker County",4,72,676,323,353
050,01,127,"Alabama","Walker County",4,73,669,289,380
050,01,127,"Alabama","Walker County",4,74,677,279,398
050,01,127,"Alabama","Walker County",4,75,695,295,400
050,01,127,"Alabama","Walker County",4,76,482,205,277
050,01,127,"Alabama","Walker County",4,77,470,205,265
050,01,127,"Alabama","Walker County",4,78,442,202,240
050,01,127,"Alabama","Walker County",4,79,463,197,266
050,01,127,"Alabama","Walker County",4,80,370,151,219
050,01,127,"Alabama","Walker County",4,81,353,148,205
050,01,127,"Alabama","Walker County",4,82,293,114,179
050,01,127,"Alabama","Walker County",4,83,271,106,165
050,01,127,"Alabama","Walker County",4,84,275,95,180
050,01,127,"Alabama","Walker County",4,85,1105,368,737
050,01,127,"Alabama","Walker County",5,0,804,402,402
050,01,127,"Alabama","Walker County",5,1,805,404,401
050,01,127,"Alabama","Walker County",5,2,786,397,389
050,01,127,"Alabama","Walker County",5,3,754,362,392
050,01,127,"Alabama","Walker County",5,4,822,430,392
050,01,127,"Alabama","Walker County",5,5,831,445,386
050,01,127,"Alabama","Walker County",5,6,810,419,391
050,01,127,"Alabama","Walker County",5,7,790,392,398
050,01,127,"Alabama","Walker County",5,8,795,414,381
050,01,127,"Alabama","Walker County",5,9,819,414,405
050,01,127,"Alabama","Walker County",5,10,843,433,410
050,01,127,"Alabama","Walker County",5,11,863,440,423
050,01,127,"Alabama","Walker County",5,12,819,412,407
050,01,127,"Alabama","Walker County",5,13,860,436,424
050,01,127,"Alabama","Walker County",5,14,832,401,431
050,01,127,"Alabama","Walker County",5,15,893,451,442
050,01,127,"Alabama","Walker County",5,16,870,452,418
050,01,127,"Alabama","Walker County",5,17,818,431,387
050,01,127,"Alabama","Walker County",5,18,691,383,308
050,01,127,"Alabama","Walker County",5,19,570,314,256
050,01,127,"Alabama","Walker County",5,20,628,336,292
050,01,127,"Alabama","Walker County",5,21,672,343,329
050,01,127,"Alabama","Walker County",5,22,765,387,378
050,01,127,"Alabama","Walker County",5,23,775,407,368
050,01,127,"Alabama","Walker County",5,24,803,394,409
050,01,127,"Alabama","Walker County",5,25,787,378,409
050,01,127,"Alabama","Walker County",5,26,841,438,403
050,01,127,"Alabama","Walker County",5,27,810,391,419
050,01,127,"Alabama","Walker County",5,28,800,409,391
050,01,127,"Alabama","Walker County",5,29,781,411,370
050,01,127,"Alabama","Walker County",5,30,793,401,392
050,01,127,"Alabama","Walker County",5,31,794,388,406
050,01,127,"Alabama","Walker County",5,32,850,407,443
050,01,127,"Alabama","Walker County",5,33,850,420,430
050,01,127,"Alabama","Walker County",5,34,788,393,395
050,01,127,"Alabama","Walker County",5,35,730,355,375
050,01,127,"Alabama","Walker County",5,36,751,390,361
050,01,127,"Alabama","Walker County",5,37,704,332,372
050,01,127,"Alabama","Walker County",5,38,671,327,344
050,01,127,"Alabama","Walker County",5,39,669,328,341
050,01,127,"Alabama","Walker County",5,40,744,382,362
050,01,127,"Alabama","Walker County",5,41,705,352,353
050,01,127,"Alabama","Walker County",5,42,724,345,379
050,01,127,"Alabama","Walker County",5,43,773,387,386
050,01,127,"Alabama","Walker County",5,44,744,351,393
050,01,127,"Alabama","Walker County",5,45,739,335,404
050,01,127,"Alabama","Walker County",5,46,777,365,412
050,01,127,"Alabama","Walker County",5,47,740,345,395
050,01,127,"Alabama","Walker County",5,48,733,368,365
050,01,127,"Alabama","Walker County",5,49,730,377,353
050,01,127,"Alabama","Walker County",5,50,778,408,370
050,01,127,"Alabama","Walker County",5,51,844,443,401
050,01,127,"Alabama","Walker County",5,52,921,455,466
050,01,127,"Alabama","Walker County",5,53,879,450,429
050,01,127,"Alabama","Walker County",5,54,836,427,409
050,01,127,"Alabama","Walker County",5,55,820,407,413
050,01,127,"Alabama","Walker County",5,56,846,424,422
050,01,127,"Alabama","Walker County",5,57,851,450,401
050,01,127,"Alabama","Walker County",5,58,851,420,431
050,01,127,"Alabama","Walker County",5,59,924,456,468
050,01,127,"Alabama","Walker County",5,60,884,437,447
050,01,127,"Alabama","Walker County",5,61,937,448,489
050,01,127,"Alabama","Walker County",5,62,888,422,466
050,01,127,"Alabama","Walker County",5,63,858,413,445
050,01,127,"Alabama","Walker County",5,64,881,389,492
050,01,127,"Alabama","Walker County",5,65,850,386,464
050,01,127,"Alabama","Walker County",5,66,860,393,467
050,01,127,"Alabama","Walker County",5,67,821,377,444
050,01,127,"Alabama","Walker County",5,68,818,372,446
050,01,127,"Alabama","Walker County",5,69,784,354,430
050,01,127,"Alabama","Walker County",5,70,743,339,404
050,01,127,"Alabama","Walker County",5,71,724,350,374
050,01,127,"Alabama","Walker County",5,72,703,347,356
050,01,127,"Alabama","Walker County",5,73,655,307,348
050,01,127,"Alabama","Walker County",5,74,625,264,361
050,01,127,"Alabama","Walker County",5,75,623,250,373
050,01,127,"Alabama","Walker County",5,76,672,290,382
050,01,127,"Alabama","Walker County",5,77,463,194,269
050,01,127,"Alabama","Walker County",5,78,441,195,246
050,01,127,"Alabama","Walker County",5,79,419,186,233
050,01,127,"Alabama","Walker County",5,80,430,179,251
050,01,127,"Alabama","Walker County",5,81,362,149,213
050,01,127,"Alabama","Walker County",5,82,308,128,180
050,01,127,"Alabama","Walker County",5,83,266,104,162
050,01,127,"Alabama","Walker County",5,84,267,94,173
050,01,127,"Alabama","Walker County",5,85,1150,372,778
050,01,129,"Alabama","Washington County",1,0,168,85,83
050,01,129,"Alabama","Washington County",1,1,164,80,84
050,01,129,"Alabama","Washington County",1,2,175,84,91
050,01,129,"Alabama","Washington County",1,3,171,84,87
050,01,129,"Alabama","Washington County",1,4,193,84,109
050,01,129,"Alabama","Washington County",1,5,171,76,95
050,01,129,"Alabama","Washington County",1,6,161,78,83
050,01,129,"Alabama","Washington County",1,7,173,96,77
050,01,129,"Alabama","Washington County",1,8,179,103,76
050,01,129,"Alabama","Washington County",1,9,164,82,82
050,01,129,"Alabama","Washington County",1,10,158,79,79
050,01,129,"Alabama","Washington County",1,11,196,92,104
050,01,129,"Alabama","Washington County",1,12,212,102,110
050,01,129,"Alabama","Washington County",1,13,198,100,98
050,01,129,"Alabama","Washington County",1,14,205,109,96
050,01,129,"Alabama","Washington County",1,15,205,104,101
050,01,129,"Alabama","Washington County",1,16,212,116,96
050,01,129,"Alabama","Washington County",1,17,224,123,101
050,01,129,"Alabama","Washington County",1,18,194,108,86
050,01,129,"Alabama","Washington County",1,19,149,78,71
050,01,129,"Alabama","Washington County",1,20,160,81,79
050,01,129,"Alabama","Washington County",1,21,181,100,81
050,01,129,"Alabama","Washington County",1,22,178,102,76
050,01,129,"Alabama","Washington County",1,23,177,90,87
050,01,129,"Alabama","Washington County",1,24,177,86,91
050,01,129,"Alabama","Washington County",1,25,178,86,92
050,01,129,"Alabama","Washington County",1,26,185,95,90
050,01,129,"Alabama","Washington County",1,27,181,96,85
050,01,129,"Alabama","Washington County",1,28,173,93,80
050,01,129,"Alabama","Washington County",1,29,208,102,106
050,01,129,"Alabama","Washington County",1,30,175,94,81
050,01,129,"Alabama","Washington County",1,31,146,80,66
050,01,129,"Alabama","Washington County",1,32,140,71,69
050,01,129,"Alabama","Washington County",1,33,167,82,85
050,01,129,"Alabama","Washington County",1,34,153,74,79
050,01,129,"Alabama","Washington County",1,35,156,78,78
050,01,129,"Alabama","Washington County",1,36,169,79,90
050,01,129,"Alabama","Washington County",1,37,178,82,96
050,01,129,"Alabama","Washington County",1,38,184,77,107
050,01,129,"Alabama","Washington County",1,39,172,88,84
050,01,129,"Alabama","Washington County",1,40,177,80,97
050,01,129,"Alabama","Washington County",1,41,161,81,80
050,01,129,"Alabama","Washington County",1,42,166,85,81
050,01,129,"Alabama","Washington County",1,43,163,78,85
050,01,129,"Alabama","Washington County",1,44,170,78,92
050,01,129,"Alabama","Washington County",1,45,181,81,100
050,01,129,"Alabama","Washington County",1,46,168,78,90
050,01,129,"Alabama","Washington County",1,47,193,92,101
050,01,129,"Alabama","Washington County",1,48,202,98,104
050,01,129,"Alabama","Washington County",1,49,230,126,104
050,01,129,"Alabama","Washington County",1,50,244,126,118
050,01,129,"Alabama","Washington County",1,51,209,101,108
050,01,129,"Alabama","Washington County",1,52,209,103,106
050,01,129,"Alabama","Washington County",1,53,200,101,99
050,01,129,"Alabama","Washington County",1,54,215,99,116
050,01,129,"Alabama","Washington County",1,55,227,112,115
050,01,129,"Alabama","Washington County",1,56,244,131,113
050,01,129,"Alabama","Washington County",1,57,233,122,111
050,01,129,"Alabama","Washington County",1,58,238,119,119
050,01,129,"Alabama","Washington County",1,59,234,113,121
050,01,129,"Alabama","Washington County",1,60,252,120,132
050,01,129,"Alabama","Washington County",1,61,220,107,113
050,01,129,"Alabama","Washington County",1,62,244,121,123
050,01,129,"Alabama","Washington County",1,63,228,111,117
050,01,129,"Alabama","Washington County",1,64,201,97,104
050,01,129,"Alabama","Washington County",1,65,206,97,109
050,01,129,"Alabama","Washington County",1,66,205,87,118
050,01,129,"Alabama","Washington County",1,67,193,89,104
050,01,129,"Alabama","Washington County",1,68,185,84,101
050,01,129,"Alabama","Washington County",1,69,188,91,97
050,01,129,"Alabama","Washington County",1,70,195,91,104
050,01,129,"Alabama","Washington County",1,71,175,85,90
050,01,129,"Alabama","Washington County",1,72,177,91,86
050,01,129,"Alabama","Washington County",1,73,185,88,97
050,01,129,"Alabama","Washington County",1,74,129,63,66
050,01,129,"Alabama","Washington County",1,75,122,57,65
050,01,129,"Alabama","Washington County",1,76,134,62,72
050,01,129,"Alabama","Washington County",1,77,128,57,71
050,01,129,"Alabama","Washington County",1,78,102,47,55
050,01,129,"Alabama","Washington County",1,79,98,44,54
050,01,129,"Alabama","Washington County",1,80,88,32,56
050,01,129,"Alabama","Washington County",1,81,80,34,46
050,01,129,"Alabama","Washington County",1,82,75,36,39
050,01,129,"Alabama","Washington County",1,83,73,34,39
050,01,129,"Alabama","Washington County",1,84,52,24,28
050,01,129,"Alabama","Washington County",1,85,280,107,173
050,01,129,"Alabama","Washington County",2,0,171,89,82
050,01,129,"Alabama","Washington County",2,1,166,82,84
050,01,129,"Alabama","Washington County",2,2,173,84,89
050,01,129,"Alabama","Washington County",2,3,171,85,86
050,01,129,"Alabama","Washington County",2,4,187,84,103
050,01,129,"Alabama","Washington County",2,5,174,78,96
050,01,129,"Alabama","Washington County",2,6,163,77,86
050,01,129,"Alabama","Washington County",2,7,170,92,78
050,01,129,"Alabama","Washington County",2,8,177,101,76
050,01,129,"Alabama","Washington County",2,9,165,87,78
050,01,129,"Alabama","Washington County",2,10,162,80,82
050,01,129,"Alabama","Washington County",2,11,186,88,98
050,01,129,"Alabama","Washington County",2,12,207,98,109
050,01,129,"Alabama","Washington County",2,13,198,98,100
050,01,129,"Alabama","Washington County",2,14,201,106,95
050,01,129,"Alabama","Washington County",2,15,206,105,101
050,01,129,"Alabama","Washington County",2,16,208,112,96
050,01,129,"Alabama","Washington County",2,17,215,118,97
050,01,129,"Alabama","Washington County",2,18,191,107,84
050,01,129,"Alabama","Washington County",2,19,151,81,70
050,01,129,"Alabama","Washington County",2,20,159,81,78
050,01,129,"Alabama","Washington County",2,21,175,96,79
050,01,129,"Alabama","Washington County",2,22,180,102,78
050,01,129,"Alabama","Washington County",2,23,179,93,86
050,01,129,"Alabama","Washington County",2,24,178,87,91
050,01,129,"Alabama","Washington County",2,25,177,85,92
050,01,129,"Alabama","Washington County",2,26,183,92,91
050,01,129,"Alabama","Washington County",2,27,181,96,85
050,01,129,"Alabama","Washington County",2,28,173,93,80
050,01,129,"Alabama","Washington County",2,29,197,99,98
050,01,129,"Alabama","Washington County",2,30,184,96,88
050,01,129,"Alabama","Washington County",2,31,151,82,69
050,01,129,"Alabama","Washington County",2,32,142,74,68
050,01,129,"Alabama","Washington County",2,33,161,79,82
050,01,129,"Alabama","Washington County",2,34,157,77,80
050,01,129,"Alabama","Washington County",2,35,156,77,79
050,01,129,"Alabama","Washington County",2,36,165,78,87
050,01,129,"Alabama","Washington County",2,37,177,82,95
050,01,129,"Alabama","Washington County",2,38,181,78,103
050,01,129,"Alabama","Washington County",2,39,176,85,91
050,01,129,"Alabama","Washington County",2,40,177,83,94
050,01,129,"Alabama","Washington County",2,41,164,80,84
050,01,129,"Alabama","Washington County",2,42,164,83,81
050,01,129,"Alabama","Washington County",2,43,166,81,85
050,01,129,"Alabama","Washington County",2,44,166,78,88
050,01,129,"Alabama","Washington County",2,45,178,80,98
050,01,129,"Alabama","Washington County",2,46,170,79,91
050,01,129,"Alabama","Washington County",2,47,185,88,97
050,01,129,"Alabama","Washington County",2,48,200,97,103
050,01,129,"Alabama","Washington County",2,49,223,120,103
050,01,129,"Alabama","Washington County",2,50,236,124,112
050,01,129,"Alabama","Washington County",2,51,216,106,110
050,01,129,"Alabama","Washington County",2,52,207,101,106
050,01,129,"Alabama","Washington County",2,53,199,98,101
050,01,129,"Alabama","Washington County",2,54,209,98,111
050,01,129,"Alabama","Washington County",2,55,223,108,115
050,01,129,"Alabama","Washington County",2,56,239,126,113
050,01,129,"Alabama","Washington County",2,57,235,124,111
050,01,129,"Alabama","Washington County",2,58,237,119,118
050,01,129,"Alabama","Washington County",2,59,236,114,122
050,01,129,"Alabama","Washington County",2,60,246,119,127
050,01,129,"Alabama","Washington County",2,61,227,110,117
050,01,129,"Alabama","Washington County",2,62,237,118,119
050,01,129,"Alabama","Washington County",2,63,232,114,118
050,01,129,"Alabama","Washington County",2,64,207,100,107
050,01,129,"Alabama","Washington County",2,65,205,97,108
050,01,129,"Alabama","Washington County",2,66,205,89,116
050,01,129,"Alabama","Washington County",2,67,195,88,107
050,01,129,"Alabama","Washington County",2,68,185,84,101
050,01,129,"Alabama","Washington County",2,69,188,89,99
050,01,129,"Alabama","Washington County",2,70,193,91,102
050,01,129,"Alabama","Washington County",2,71,179,86,93
050,01,129,"Alabama","Washington County",2,72,171,86,85
050,01,129,"Alabama","Washington County",2,73,188,92,96
050,01,129,"Alabama","Washington County",2,74,134,64,70
050,01,129,"Alabama","Washington County",2,75,124,59,65
050,01,129,"Alabama","Washington County",2,76,128,59,69
050,01,129,"Alabama","Washington County",2,77,130,57,73
050,01,129,"Alabama","Washington County",2,78,103,47,56
050,01,129,"Alabama","Washington County",2,79,96,43,53
050,01,129,"Alabama","Washington County",2,80,89,35,54
050,01,129,"Alabama","Washington County",2,81,82,34,48
050,01,129,"Alabama","Washington County",2,82,75,35,40
050,01,129,"Alabama","Washington County",2,83,71,33,38
050,01,129,"Alabama","Washington County",2,84,58,27,31
050,01,129,"Alabama","Washington County",2,85,277,104,173
050,01,129,"Alabama","Washington County",3,0,182,99,83
050,01,129,"Alabama","Washington County",3,1,179,90,89
050,01,129,"Alabama","Washington County",3,2,181,89,92
050,01,129,"Alabama","Washington County",3,3,160,80,80
050,01,129,"Alabama","Washington County",3,4,176,83,93
050,01,129,"Alabama","Washington County",3,5,180,84,96
050,01,129,"Alabama","Washington County",3,6,186,86,100
050,01,129,"Alabama","Washington County",3,7,172,76,96
050,01,129,"Alabama","Washington County",3,8,168,93,75
050,01,129,"Alabama","Washington County",3,9,170,95,75
050,01,129,"Alabama","Washington County",3,10,166,89,77
050,01,129,"Alabama","Washington County",3,11,161,80,81
050,01,129,"Alabama","Washington County",3,12,183,94,89
050,01,129,"Alabama","Washington County",3,13,211,105,106
050,01,129,"Alabama","Washington County",3,14,199,104,95
050,01,129,"Alabama","Washington County",3,15,201,106,95
050,01,129,"Alabama","Washington County",3,16,200,101,99
050,01,129,"Alabama","Washington County",3,17,200,110,90
050,01,129,"Alabama","Washington County",3,18,182,103,79
050,01,129,"Alabama","Washington County",3,19,163,92,71
050,01,129,"Alabama","Washington County",3,20,167,90,77
050,01,129,"Alabama","Washington County",3,21,171,83,88
050,01,129,"Alabama","Washington County",3,22,184,98,86
050,01,129,"Alabama","Washington County",3,23,191,101,90
050,01,129,"Alabama","Washington County",3,24,167,91,76
050,01,129,"Alabama","Washington County",3,25,178,93,85
050,01,129,"Alabama","Washington County",3,26,169,79,90
050,01,129,"Alabama","Washington County",3,27,174,91,83
050,01,129,"Alabama","Washington County",3,28,167,92,75
050,01,129,"Alabama","Washington County",3,29,180,96,84
050,01,129,"Alabama","Washington County",3,30,196,100,96
050,01,129,"Alabama","Washington County",3,31,186,94,92
050,01,129,"Alabama","Washington County",3,32,145,71,74
050,01,129,"Alabama","Washington County",3,33,138,69,69
050,01,129,"Alabama","Washington County",3,34,161,81,80
050,01,129,"Alabama","Washington County",3,35,159,78,81
050,01,129,"Alabama","Washington County",3,36,162,82,80
050,01,129,"Alabama","Washington County",3,37,162,78,84
050,01,129,"Alabama","Washington County",3,38,178,81,97
050,01,129,"Alabama","Washington County",3,39,183,78,105
050,01,129,"Alabama","Washington County",3,40,169,84,85
050,01,129,"Alabama","Washington County",3,41,179,83,96
050,01,129,"Alabama","Washington County",3,42,165,77,88
050,01,129,"Alabama","Washington County",3,43,163,77,86
050,01,129,"Alabama","Washington County",3,44,167,81,86
050,01,129,"Alabama","Washington County",3,45,157,74,83
050,01,129,"Alabama","Washington County",3,46,179,79,100
050,01,129,"Alabama","Washington County",3,47,167,76,91
050,01,129,"Alabama","Washington County",3,48,172,83,89
050,01,129,"Alabama","Washington County",3,49,210,108,102
050,01,129,"Alabama","Washington County",3,50,215,113,102
050,01,129,"Alabama","Washington County",3,51,232,119,113
050,01,129,"Alabama","Washington County",3,52,211,102,109
050,01,129,"Alabama","Washington County",3,53,202,97,105
050,01,129,"Alabama","Washington County",3,54,200,99,101
050,01,129,"Alabama","Washington County",3,55,211,103,108
050,01,129,"Alabama","Washington County",3,56,228,108,120
050,01,129,"Alabama","Washington County",3,57,233,120,113
050,01,129,"Alabama","Washington County",3,58,230,117,113
050,01,129,"Alabama","Washington County",3,59,227,113,114
050,01,129,"Alabama","Washington County",3,60,233,111,122
050,01,129,"Alabama","Washington County",3,61,238,114,124
050,01,129,"Alabama","Washington County",3,62,220,105,115
050,01,129,"Alabama","Washington County",3,63,236,116,120
050,01,129,"Alabama","Washington County",3,64,236,114,122
050,01,129,"Alabama","Washington County",3,65,209,102,107
050,01,129,"Alabama","Washington County",3,66,195,92,103
050,01,129,"Alabama","Washington County",3,67,199,83,116
050,01,129,"Alabama","Washington County",3,68,189,87,102
050,01,129,"Alabama","Washington County",3,69,180,79,101
050,01,129,"Alabama","Washington County",3,70,179,84,95
050,01,129,"Alabama","Washington County",3,71,185,88,97
050,01,129,"Alabama","Washington County",3,72,169,81,88
050,01,129,"Alabama","Washington County",3,73,168,82,86
050,01,129,"Alabama","Washington County",3,74,181,89,92
050,01,129,"Alabama","Washington County",3,75,129,63,66
050,01,129,"Alabama","Washington County",3,76,121,57,64
050,01,129,"Alabama","Washington County",3,77,120,55,65
050,01,129,"Alabama","Washington County",3,78,124,55,69
050,01,129,"Alabama","Washington County",3,79,93,43,50
050,01,129,"Alabama","Washington County",3,80,89,38,51
050,01,129,"Alabama","Washington County",3,81,84,34,50
050,01,129,"Alabama","Washington County",3,82,76,30,46
050,01,129,"Alabama","Washington County",3,83,70,32,38
050,01,129,"Alabama","Washington County",3,84,67,30,37
050,01,129,"Alabama","Washington County",3,85,278,110,168
050,01,129,"Alabama","Washington County",4,0,187,107,80
050,01,129,"Alabama","Washington County",4,1,174,88,86
050,01,129,"Alabama","Washington County",4,2,180,90,90
050,01,129,"Alabama","Washington County",4,3,185,91,94
050,01,129,"Alabama","Washington County",4,4,163,80,83
050,01,129,"Alabama","Washington County",4,5,176,92,84
050,01,129,"Alabama","Washington County",4,6,182,81,101
050,01,129,"Alabama","Washington County",4,7,183,85,98
050,01,129,"Alabama","Washington County",4,8,166,79,87
050,01,129,"Alabama","Washington County",4,9,173,93,80
050,01,129,"Alabama","Washington County",4,10,159,88,71
050,01,129,"Alabama","Washington County",4,11,163,87,76
050,01,129,"Alabama","Washington County",4,12,171,88,83
050,01,129,"Alabama","Washington County",4,13,179,90,89
050,01,129,"Alabama","Washington County",4,14,210,104,106
050,01,129,"Alabama","Washington County",4,15,201,108,93
050,01,129,"Alabama","Washington County",4,16,205,110,95
050,01,129,"Alabama","Washington County",4,17,211,101,110
050,01,129,"Alabama","Washington County",4,18,178,101,77
050,01,129,"Alabama","Washington County",4,19,138,80,58
050,01,129,"Alabama","Washington County",4,20,170,90,80
050,01,129,"Alabama","Washington County",4,21,164,83,81
050,01,129,"Alabama","Washington County",4,22,163,76,87
050,01,129,"Alabama","Washington County",4,23,183,97,86
050,01,129,"Alabama","Washington County",4,24,191,102,89
050,01,129,"Alabama","Washington County",4,25,172,95,77
050,01,129,"Alabama","Washington County",4,26,173,88,85
050,01,129,"Alabama","Washington County",4,27,173,85,88
050,01,129,"Alabama","Washington County",4,28,163,81,82
050,01,129,"Alabama","Washington County",4,29,159,95,64
050,01,129,"Alabama","Washington County",4,30,172,90,82
050,01,129,"Alabama","Washington County",4,31,201,103,98
050,01,129,"Alabama","Washington County",4,32,189,97,92
050,01,129,"Alabama","Washington County",4,33,140,74,66
050,01,129,"Alabama","Washington County",4,34,141,71,70
050,01,129,"Alabama","Washington County",4,35,157,80,77
050,01,129,"Alabama","Washington County",4,36,160,77,83
050,01,129,"Alabama","Washington County",4,37,158,85,73
050,01,129,"Alabama","Washington County",4,38,156,72,84
050,01,129,"Alabama","Washington County",4,39,183,85,98
050,01,129,"Alabama","Washington County",4,40,171,73,98
050,01,129,"Alabama","Washington County",4,41,169,84,85
050,01,129,"Alabama","Washington County",4,42,176,84,92
050,01,129,"Alabama","Washington County",4,43,165,80,85
050,01,129,"Alabama","Washington County",4,44,161,77,84
050,01,129,"Alabama","Washington County",4,45,154,75,79
050,01,129,"Alabama","Washington County",4,46,158,75,83
050,01,129,"Alabama","Washington County",4,47,173,71,102
050,01,129,"Alabama","Washington County",4,48,167,78,89
050,01,129,"Alabama","Washington County",4,49,175,82,93
050,01,129,"Alabama","Washington County",4,50,205,98,107
050,01,129,"Alabama","Washington County",4,51,221,116,105
050,01,129,"Alabama","Washington County",4,52,234,121,113
050,01,129,"Alabama","Washington County",4,53,209,101,108
050,01,129,"Alabama","Washington County",4,54,201,95,106
050,01,129,"Alabama","Washington County",4,55,208,102,106
050,01,129,"Alabama","Washington County",4,56,211,105,106
050,01,129,"Alabama","Washington County",4,57,223,105,118
050,01,129,"Alabama","Washington County",4,58,230,119,111
050,01,129,"Alabama","Washington County",4,59,222,116,106
050,01,129,"Alabama","Washington County",4,60,226,113,113
050,01,129,"Alabama","Washington County",4,61,236,110,126
050,01,129,"Alabama","Washington County",4,62,231,110,121
050,01,129,"Alabama","Washington County",4,63,223,108,115
050,01,129,"Alabama","Washington County",4,64,241,124,117
050,01,129,"Alabama","Washington County",4,65,227,105,122
050,01,129,"Alabama","Washington County",4,66,198,97,101
050,01,129,"Alabama","Washington County",4,67,193,91,102
050,01,129,"Alabama","Washington County",4,68,197,85,112
050,01,129,"Alabama","Washington County",4,69,185,86,99
050,01,129,"Alabama","Washington County",4,70,168,74,94
050,01,129,"Alabama","Washington County",4,71,174,83,91
050,01,129,"Alabama","Washington County",4,72,181,88,93
050,01,129,"Alabama","Washington County",4,73,160,76,84
050,01,129,"Alabama","Washington County",4,74,161,78,83
050,01,129,"Alabama","Washington County",4,75,168,81,87
050,01,129,"Alabama","Washington County",4,76,125,62,63
050,01,129,"Alabama","Washington County",4,77,113,52,61
050,01,129,"Alabama","Washington County",4,78,119,56,63
050,01,129,"Alabama","Washington County",4,79,116,51,65
050,01,129,"Alabama","Washington County",4,80,82,38,44
050,01,129,"Alabama","Washington County",4,81,79,32,47
050,01,129,"Alabama","Washington County",4,82,79,31,48
050,01,129,"Alabama","Washington County",4,83,69,29,40
050,01,129,"Alabama","Washington County",4,84,68,30,38
050,01,129,"Alabama","Washington County",4,85,290,118,172
050,01,129,"Alabama","Washington County",5,0,181,103,78
050,01,129,"Alabama","Washington County",5,1,197,117,80
050,01,129,"Alabama","Washington County",5,2,183,95,88
050,01,129,"Alabama","Washington County",5,3,190,100,90
050,01,129,"Alabama","Washington County",5,4,170,86,84
050,01,129,"Alabama","Washington County",5,5,166,89,77
050,01,129,"Alabama","Washington County",5,6,179,88,91
050,01,129,"Alabama","Washington County",5,7,178,78,100
050,01,129,"Alabama","Washington County",5,8,187,90,97
050,01,129,"Alabama","Washington County",5,9,161,81,80
050,01,129,"Alabama","Washington County",5,10,174,94,80
050,01,129,"Alabama","Washington County",5,11,149,84,65
050,01,129,"Alabama","Washington County",5,12,161,85,76
050,01,129,"Alabama","Washington County",5,13,169,84,85
050,01,129,"Alabama","Washington County",5,14,174,87,87
050,01,129,"Alabama","Washington County",5,15,204,100,104
050,01,129,"Alabama","Washington County",5,16,191,102,89
050,01,129,"Alabama","Washington County",5,17,202,104,98
050,01,129,"Alabama","Washington County",5,18,171,85,86
050,01,129,"Alabama","Washington County",5,19,132,74,58
050,01,129,"Alabama","Washington County",5,20,146,81,65
050,01,129,"Alabama","Washington County",5,21,176,97,79
050,01,129,"Alabama","Washington County",5,22,174,86,88
050,01,129,"Alabama","Washington County",5,23,171,78,93
050,01,129,"Alabama","Washington County",5,24,193,103,90
050,01,129,"Alabama","Washington County",5,25,196,99,97
050,01,129,"Alabama","Washington County",5,26,176,93,83
050,01,129,"Alabama","Washington County",5,27,164,84,80
050,01,129,"Alabama","Washington County",5,28,179,87,92
050,01,129,"Alabama","Washington County",5,29,174,86,88
050,01,129,"Alabama","Washington County",5,30,163,96,67
050,01,129,"Alabama","Washington County",5,31,170,86,84
050,01,129,"Alabama","Washington County",5,32,194,96,98
050,01,129,"Alabama","Washington County",5,33,185,98,87
050,01,129,"Alabama","Washington County",5,34,147,75,72
050,01,129,"Alabama","Washington County",5,35,146,74,72
050,01,129,"Alabama","Washington County",5,36,159,79,80
050,01,129,"Alabama","Washington County",5,37,160,73,87
050,01,129,"Alabama","Washington County",5,38,149,81,68
050,01,129,"Alabama","Washington County",5,39,157,72,85
050,01,129,"Alabama","Washington County",5,40,181,85,96
050,01,129,"Alabama","Washington County",5,41,172,73,99
050,01,129,"Alabama","Washington County",5,42,174,86,88
050,01,129,"Alabama","Washington County",5,43,178,90,88
050,01,129,"Alabama","Washington County",5,44,159,75,84
050,01,129,"Alabama","Washington County",5,45,160,77,83
050,01,129,"Alabama","Washington County",5,46,153,76,77
050,01,129,"Alabama","Washington County",5,47,155,73,82
050,01,129,"Alabama","Washington County",5,48,178,76,102
050,01,129,"Alabama","Washington County",5,49,161,78,83
050,01,129,"Alabama","Washington County",5,50,174,76,98
050,01,129,"Alabama","Washington County",5,51,203,98,105
050,01,129,"Alabama","Washington County",5,52,213,113,100
050,01,129,"Alabama","Washington County",5,53,226,116,110
050,01,129,"Alabama","Washington County",5,54,203,95,108
050,01,129,"Alabama","Washington County",5,55,199,92,107
050,01,129,"Alabama","Washington County",5,56,210,106,104
050,01,129,"Alabama","Washington County",5,57,213,107,106
050,01,129,"Alabama","Washington County",5,58,218,100,118
050,01,129,"Alabama","Washington County",5,59,224,120,104
050,01,129,"Alabama","Washington County",5,60,225,114,111
050,01,129,"Alabama","Washington County",5,61,224,112,112
050,01,129,"Alabama","Washington County",5,62,229,104,125
050,01,129,"Alabama","Washington County",5,63,231,109,122
050,01,129,"Alabama","Washington County",5,64,221,105,116
050,01,129,"Alabama","Washington County",5,65,229,114,115
050,01,129,"Alabama","Washington County",5,66,221,100,121
050,01,129,"Alabama","Washington County",5,67,189,92,97
050,01,129,"Alabama","Washington County",5,68,195,95,100
050,01,129,"Alabama","Washington County",5,69,197,86,111
050,01,129,"Alabama","Washington County",5,70,178,84,94
050,01,129,"Alabama","Washington County",5,71,164,69,95
050,01,129,"Alabama","Washington County",5,72,168,81,87
050,01,129,"Alabama","Washington County",5,73,177,85,92
050,01,129,"Alabama","Washington County",5,74,160,72,88
050,01,129,"Alabama","Washington County",5,75,155,74,81
050,01,129,"Alabama","Washington County",5,76,166,81,85
050,01,129,"Alabama","Washington County",5,77,118,57,61
050,01,129,"Alabama","Washington County",5,78,114,53,61
050,01,129,"Alabama","Washington County",5,79,111,52,59
050,01,129,"Alabama","Washington County",5,80,107,47,60
050,01,129,"Alabama","Washington County",5,81,73,35,38
050,01,129,"Alabama","Washington County",5,82,72,29,43
050,01,129,"Alabama","Washington County",5,83,73,30,43
050,01,129,"Alabama","Washington County",5,84,66,27,39
050,01,129,"Alabama","Washington County",5,85,307,127,180
050,01,131,"Alabama","Wilcox County",1,0,122,60,62
050,01,131,"Alabama","Wilcox County",1,1,133,59,74
050,01,131,"Alabama","Wilcox County",1,2,142,73,69
050,01,131,"Alabama","Wilcox County",1,3,130,64,66
050,01,131,"Alabama","Wilcox County",1,4,131,61,70
050,01,131,"Alabama","Wilcox County",1,5,125,61,64
050,01,131,"Alabama","Wilcox County",1,6,136,65,71
050,01,131,"Alabama","Wilcox County",1,7,139,68,71
050,01,131,"Alabama","Wilcox County",1,8,125,66,59
050,01,131,"Alabama","Wilcox County",1,9,127,67,60
050,01,131,"Alabama","Wilcox County",1,10,116,59,57
050,01,131,"Alabama","Wilcox County",1,11,127,61,66
050,01,131,"Alabama","Wilcox County",1,12,141,69,72
050,01,131,"Alabama","Wilcox County",1,13,133,68,65
050,01,131,"Alabama","Wilcox County",1,14,136,65,71
050,01,131,"Alabama","Wilcox County",1,15,153,72,81
050,01,131,"Alabama","Wilcox County",1,16,154,77,77
050,01,131,"Alabama","Wilcox County",1,17,155,83,72
050,01,131,"Alabama","Wilcox County",1,18,150,73,77
050,01,131,"Alabama","Wilcox County",1,19,140,75,65
050,01,131,"Alabama","Wilcox County",1,20,140,78,62
050,01,131,"Alabama","Wilcox County",1,21,140,81,59
050,01,131,"Alabama","Wilcox County",1,22,134,72,62
050,01,131,"Alabama","Wilcox County",1,23,138,76,62
050,01,131,"Alabama","Wilcox County",1,24,139,73,66
050,01,131,"Alabama","Wilcox County",1,25,139,70,69
050,01,131,"Alabama","Wilcox County",1,26,123,59,64
050,01,131,"Alabama","Wilcox County",1,27,117,57,60
050,01,131,"Alabama","Wilcox County",1,28,125,66,59
050,01,131,"Alabama","Wilcox County",1,29,141,83,58
050,01,131,"Alabama","Wilcox County",1,30,128,66,62
050,01,131,"Alabama","Wilcox County",1,31,138,72,66
050,01,131,"Alabama","Wilcox County",1,32,113,54,59
050,01,131,"Alabama","Wilcox County",1,33,103,50,53
050,01,131,"Alabama","Wilcox County",1,34,93,41,52
050,01,131,"Alabama","Wilcox County",1,35,99,54,45
050,01,131,"Alabama","Wilcox County",1,36,97,49,48
050,01,131,"Alabama","Wilcox County",1,37,99,45,54
050,01,131,"Alabama","Wilcox County",1,38,139,61,78
050,01,131,"Alabama","Wilcox County",1,39,133,61,72
050,01,131,"Alabama","Wilcox County",1,40,124,51,73
050,01,131,"Alabama","Wilcox County",1,41,126,56,70
050,01,131,"Alabama","Wilcox County",1,42,116,45,71
050,01,131,"Alabama","Wilcox County",1,43,122,54,68
050,01,131,"Alabama","Wilcox County",1,44,113,55,58
050,01,131,"Alabama","Wilcox County",1,45,112,49,63
050,01,131,"Alabama","Wilcox County",1,46,121,60,61
050,01,131,"Alabama","Wilcox County",1,47,122,53,69
050,01,131,"Alabama","Wilcox County",1,48,115,55,60
050,01,131,"Alabama","Wilcox County",1,49,142,75,67
050,01,131,"Alabama","Wilcox County",1,50,141,60,81
050,01,131,"Alabama","Wilcox County",1,51,122,50,72
050,01,131,"Alabama","Wilcox County",1,52,113,55,58
050,01,131,"Alabama","Wilcox County",1,53,122,51,71
050,01,131,"Alabama","Wilcox County",1,54,139,66,73
050,01,131,"Alabama","Wilcox County",1,55,147,71,76
050,01,131,"Alabama","Wilcox County",1,56,147,67,80
050,01,131,"Alabama","Wilcox County",1,57,152,77,75
050,01,131,"Alabama","Wilcox County",1,58,148,60,88
050,01,131,"Alabama","Wilcox County",1,59,122,53,69
050,01,131,"Alabama","Wilcox County",1,60,141,68,73
050,01,131,"Alabama","Wilcox County",1,61,130,63,67
050,01,131,"Alabama","Wilcox County",1,62,151,74,77
050,01,131,"Alabama","Wilcox County",1,63,138,72,66
050,01,131,"Alabama","Wilcox County",1,64,148,67,81
050,01,131,"Alabama","Wilcox County",1,65,161,78,83
050,01,131,"Alabama","Wilcox County",1,66,156,74,82
050,01,131,"Alabama","Wilcox County",1,67,131,66,65
050,01,131,"Alabama","Wilcox County",1,68,131,62,69
050,01,131,"Alabama","Wilcox County",1,69,118,59,59
050,01,131,"Alabama","Wilcox County",1,70,114,59,55
050,01,131,"Alabama","Wilcox County",1,71,128,59,69
050,01,131,"Alabama","Wilcox County",1,72,124,55,69
050,01,131,"Alabama","Wilcox County",1,73,115,61,54
050,01,131,"Alabama","Wilcox County",1,74,100,48,52
050,01,131,"Alabama","Wilcox County",1,75,101,49,52
050,01,131,"Alabama","Wilcox County",1,76,89,36,53
050,01,131,"Alabama","Wilcox County",1,77,68,29,39
050,01,131,"Alabama","Wilcox County",1,78,61,28,33
050,01,131,"Alabama","Wilcox County",1,79,59,32,27
050,01,131,"Alabama","Wilcox County",1,80,53,25,28
050,01,131,"Alabama","Wilcox County",1,81,50,20,30
050,01,131,"Alabama","Wilcox County",1,82,51,17,34
050,01,131,"Alabama","Wilcox County",1,83,49,20,29
050,01,131,"Alabama","Wilcox County",1,84,47,17,30
050,01,131,"Alabama","Wilcox County",1,85,225,53,172
050,01,131,"Alabama","Wilcox County",2,0,122,55,67
050,01,131,"Alabama","Wilcox County",2,1,131,59,72
050,01,131,"Alabama","Wilcox County",2,2,138,69,69
050,01,131,"Alabama","Wilcox County",2,3,133,66,67
050,01,131,"Alabama","Wilcox County",2,4,129,61,68
050,01,131,"Alabama","Wilcox County",2,5,125,59,66
050,01,131,"Alabama","Wilcox County",2,6,133,64,69
050,01,131,"Alabama","Wilcox County",2,7,138,66,72
050,01,131,"Alabama","Wilcox County",2,8,127,65,62
050,01,131,"Alabama","Wilcox County",2,9,124,66,58
050,01,131,"Alabama","Wilcox County",2,10,118,61,57
050,01,131,"Alabama","Wilcox County",2,11,124,61,63
050,01,131,"Alabama","Wilcox County",2,12,136,66,70
050,01,131,"Alabama","Wilcox County",2,13,134,68,66
050,01,131,"Alabama","Wilcox County",2,14,134,65,69
050,01,131,"Alabama","Wilcox County",2,15,147,70,77
050,01,131,"Alabama","Wilcox County",2,16,152,75,77
050,01,131,"Alabama","Wilcox County",2,17,152,80,72
050,01,131,"Alabama","Wilcox County",2,18,142,73,69
050,01,131,"Alabama","Wilcox County",2,19,135,71,64
050,01,131,"Alabama","Wilcox County",2,20,142,78,64
050,01,131,"Alabama","Wilcox County",2,21,141,82,59
050,01,131,"Alabama","Wilcox County",2,22,134,72,62
050,01,131,"Alabama","Wilcox County",2,23,137,76,61
050,01,131,"Alabama","Wilcox County",2,24,139,74,65
050,01,131,"Alabama","Wilcox County",2,25,136,68,68
050,01,131,"Alabama","Wilcox County",2,26,127,62,65
050,01,131,"Alabama","Wilcox County",2,27,117,57,60
050,01,131,"Alabama","Wilcox County",2,28,125,65,60
050,01,131,"Alabama","Wilcox County",2,29,138,80,58
050,01,131,"Alabama","Wilcox County",2,30,132,70,62
050,01,131,"Alabama","Wilcox County",2,31,134,69,65
050,01,131,"Alabama","Wilcox County",2,32,115,56,59
050,01,131,"Alabama","Wilcox County",2,33,104,51,53
050,01,131,"Alabama","Wilcox County",2,34,95,43,52
050,01,131,"Alabama","Wilcox County",2,35,96,49,47
050,01,131,"Alabama","Wilcox County",2,36,96,49,47
050,01,131,"Alabama","Wilcox County",2,37,97,44,53
050,01,131,"Alabama","Wilcox County",2,38,132,59,73
050,01,131,"Alabama","Wilcox County",2,39,132,60,72
050,01,131,"Alabama","Wilcox County",2,40,129,55,74
050,01,131,"Alabama","Wilcox County",2,41,123,53,70
050,01,131,"Alabama","Wilcox County",2,42,121,50,71
050,01,131,"Alabama","Wilcox County",2,43,123,53,70
050,01,131,"Alabama","Wilcox County",2,44,113,54,59
050,01,131,"Alabama","Wilcox County",2,45,110,49,61
050,01,131,"Alabama","Wilcox County",2,46,118,57,61
050,01,131,"Alabama","Wilcox County",2,47,121,53,68
050,01,131,"Alabama","Wilcox County",2,48,116,55,61
050,01,131,"Alabama","Wilcox County",2,49,139,73,66
050,01,131,"Alabama","Wilcox County",2,50,140,63,77
050,01,131,"Alabama","Wilcox County",2,51,123,50,73
050,01,131,"Alabama","Wilcox County",2,52,114,53,61
050,01,131,"Alabama","Wilcox County",2,53,120,52,68
050,01,131,"Alabama","Wilcox County",2,54,135,62,73
050,01,131,"Alabama","Wilcox County",2,55,145,70,75
050,01,131,"Alabama","Wilcox County",2,56,148,68,80
050,01,131,"Alabama","Wilcox County",2,57,149,72,77
050,01,131,"Alabama","Wilcox County",2,58,150,65,85
050,01,131,"Alabama","Wilcox County",2,59,127,53,74
050,01,131,"Alabama","Wilcox County",2,60,135,63,72
050,01,131,"Alabama","Wilcox County",2,61,131,63,68
050,01,131,"Alabama","Wilcox County",2,62,145,71,74
050,01,131,"Alabama","Wilcox County",2,63,141,71,70
050,01,131,"Alabama","Wilcox County",2,64,144,66,78
050,01,131,"Alabama","Wilcox County",2,65,159,75,84
050,01,131,"Alabama","Wilcox County",2,66,154,73,81
050,01,131,"Alabama","Wilcox County",2,67,136,68,68
050,01,131,"Alabama","Wilcox County",2,68,129,62,67
050,01,131,"Alabama","Wilcox County",2,69,119,58,61
050,01,131,"Alabama","Wilcox County",2,70,114,59,55
050,01,131,"Alabama","Wilcox County",2,71,122,57,65
050,01,131,"Alabama","Wilcox County",2,72,123,56,67
050,01,131,"Alabama","Wilcox County",2,73,123,62,61
050,01,131,"Alabama","Wilcox County",2,74,96,47,49
050,01,131,"Alabama","Wilcox County",2,75,99,48,51
050,01,131,"Alabama","Wilcox County",2,76,89,38,51
050,01,131,"Alabama","Wilcox County",2,77,75,32,43
050,01,131,"Alabama","Wilcox County",2,78,60,26,34
050,01,131,"Alabama","Wilcox County",2,79,59,31,28
050,01,131,"Alabama","Wilcox County",2,80,53,26,27
050,01,131,"Alabama","Wilcox County",2,81,49,21,28
050,01,131,"Alabama","Wilcox County",2,82,50,18,32
050,01,131,"Alabama","Wilcox County",2,83,48,19,29
050,01,131,"Alabama","Wilcox County",2,84,46,17,29
050,01,131,"Alabama","Wilcox County",2,85,228,55,173
050,01,131,"Alabama","Wilcox County",3,0,111,59,52
050,01,131,"Alabama","Wilcox County",3,1,129,61,68
050,01,131,"Alabama","Wilcox County",3,2,133,59,74
050,01,131,"Alabama","Wilcox County",3,3,132,61,71
050,01,131,"Alabama","Wilcox County",3,4,129,62,67
050,01,131,"Alabama","Wilcox County",3,5,121,58,63
050,01,131,"Alabama","Wilcox County",3,6,126,57,69
050,01,131,"Alabama","Wilcox County",3,7,127,61,66
050,01,131,"Alabama","Wilcox County",3,8,132,68,64
050,01,131,"Alabama","Wilcox County",3,9,124,65,59
050,01,131,"Alabama","Wilcox County",3,10,122,62,60
050,01,131,"Alabama","Wilcox County",3,11,118,63,55
050,01,131,"Alabama","Wilcox County",3,12,131,64,67
050,01,131,"Alabama","Wilcox County",3,13,138,69,69
050,01,131,"Alabama","Wilcox County",3,14,130,69,61
050,01,131,"Alabama","Wilcox County",3,15,131,63,68
050,01,131,"Alabama","Wilcox County",3,16,143,68,75
050,01,131,"Alabama","Wilcox County",3,17,148,72,76
050,01,131,"Alabama","Wilcox County",3,18,128,67,61
050,01,131,"Alabama","Wilcox County",3,19,122,60,62
050,01,131,"Alabama","Wilcox County",3,20,134,67,67
050,01,131,"Alabama","Wilcox County",3,21,150,83,67
050,01,131,"Alabama","Wilcox County",3,22,136,71,65
050,01,131,"Alabama","Wilcox County",3,23,142,76,66
050,01,131,"Alabama","Wilcox County",3,24,124,66,58
050,01,131,"Alabama","Wilcox County",3,25,131,71,60
050,01,131,"Alabama","Wilcox County",3,26,129,57,72
050,01,131,"Alabama","Wilcox County",3,27,132,69,63
050,01,131,"Alabama","Wilcox County",3,28,127,66,61
050,01,131,"Alabama","Wilcox County",3,29,126,72,54
050,01,131,"Alabama","Wilcox County",3,30,130,74,56
050,01,131,"Alabama","Wilcox County",3,31,132,70,62
050,01,131,"Alabama","Wilcox County",3,32,122,61,61
050,01,131,"Alabama","Wilcox County",3,33,112,57,55
050,01,131,"Alabama","Wilcox County",3,34,100,47,53
050,01,131,"Alabama","Wilcox County",3,35,85,39,46
050,01,131,"Alabama","Wilcox County",3,36,96,47,49
050,01,131,"Alabama","Wilcox County",3,37,95,47,48
050,01,131,"Alabama","Wilcox County",3,38,105,46,59
050,01,131,"Alabama","Wilcox County",3,39,118,56,62
050,01,131,"Alabama","Wilcox County",3,40,130,62,68
050,01,131,"Alabama","Wilcox County",3,41,115,44,71
050,01,131,"Alabama","Wilcox County",3,42,124,55,69
050,01,131,"Alabama","Wilcox County",3,43,118,47,71
050,01,131,"Alabama","Wilcox County",3,44,123,56,67
050,01,131,"Alabama","Wilcox County",3,45,104,49,55
050,01,131,"Alabama","Wilcox County",3,46,109,49,60
050,01,131,"Alabama","Wilcox County",3,47,116,56,60
050,01,131,"Alabama","Wilcox County",3,48,125,51,74
050,01,131,"Alabama","Wilcox County",3,49,125,62,63
050,01,131,"Alabama","Wilcox County",3,50,131,66,65
050,01,131,"Alabama","Wilcox County",3,51,139,60,79
050,01,131,"Alabama","Wilcox County",3,52,121,50,71
050,01,131,"Alabama","Wilcox County",3,53,107,51,56
050,01,131,"Alabama","Wilcox County",3,54,119,49,70
050,01,131,"Alabama","Wilcox County",3,55,141,67,74
050,01,131,"Alabama","Wilcox County",3,56,142,66,76
050,01,131,"Alabama","Wilcox County",3,57,144,64,80
050,01,131,"Alabama","Wilcox County",3,58,152,76,76
050,01,131,"Alabama","Wilcox County",3,59,146,65,81
050,01,131,"Alabama","Wilcox County",3,60,123,49,74
050,01,131,"Alabama","Wilcox County",3,61,134,61,73
050,01,131,"Alabama","Wilcox County",3,62,129,65,64
050,01,131,"Alabama","Wilcox County",3,63,140,71,69
050,01,131,"Alabama","Wilcox County",3,64,142,69,73
050,01,131,"Alabama","Wilcox County",3,65,146,69,77
050,01,131,"Alabama","Wilcox County",3,66,161,77,84
050,01,131,"Alabama","Wilcox County",3,67,157,73,84
050,01,131,"Alabama","Wilcox County",3,68,133,63,70
050,01,131,"Alabama","Wilcox County",3,69,134,65,69
050,01,131,"Alabama","Wilcox County",3,70,118,58,60
050,01,131,"Alabama","Wilcox County",3,71,110,55,55
050,01,131,"Alabama","Wilcox County",3,72,122,57,65
050,01,131,"Alabama","Wilcox County",3,73,129,58,71
050,01,131,"Alabama","Wilcox County",3,74,125,63,62
050,01,131,"Alabama","Wilcox County",3,75,95,46,49
050,01,131,"Alabama","Wilcox County",3,76,93,42,51
050,01,131,"Alabama","Wilcox County",3,77,88,35,53
050,01,131,"Alabama","Wilcox County",3,78,67,25,42
050,01,131,"Alabama","Wilcox County",3,79,59,25,34
050,01,131,"Alabama","Wilcox County",3,80,51,27,24
050,01,131,"Alabama","Wilcox County",3,81,53,23,30
050,01,131,"Alabama","Wilcox County",3,82,50,22,28
050,01,131,"Alabama","Wilcox County",3,83,47,14,33
050,01,131,"Alabama","Wilcox County",3,84,48,17,31
050,01,131,"Alabama","Wilcox County",3,85,237,63,174
050,01,131,"Alabama","Wilcox County",4,0,114,47,67
050,01,131,"Alabama","Wilcox County",4,1,116,62,54
050,01,131,"Alabama","Wilcox County",4,2,124,58,66
050,01,131,"Alabama","Wilcox County",4,3,125,57,68
050,01,131,"Alabama","Wilcox County",4,4,136,66,70
050,01,131,"Alabama","Wilcox County",4,5,131,64,67
050,01,131,"Alabama","Wilcox County",4,6,109,55,54
050,01,131,"Alabama","Wilcox County",4,7,128,64,64
050,01,131,"Alabama","Wilcox County",4,8,118,56,62
050,01,131,"Alabama","Wilcox County",4,9,130,64,66
050,01,131,"Alabama","Wilcox County",4,10,121,65,56
050,01,131,"Alabama","Wilcox County",4,11,111,56,55
050,01,131,"Alabama","Wilcox County",4,12,113,63,50
050,01,131,"Alabama","Wilcox County",4,13,127,60,67
050,01,131,"Alabama","Wilcox County",4,14,134,62,72
050,01,131,"Alabama","Wilcox County",4,15,126,68,58
050,01,131,"Alabama","Wilcox County",4,16,128,63,65
050,01,131,"Alabama","Wilcox County",4,17,138,67,71
050,01,131,"Alabama","Wilcox County",4,18,127,66,61
050,01,131,"Alabama","Wilcox County",4,19,98,53,45
050,01,131,"Alabama","Wilcox County",4,20,114,57,57
050,01,131,"Alabama","Wilcox County",4,21,144,71,73
050,01,131,"Alabama","Wilcox County",4,22,150,80,70
050,01,131,"Alabama","Wilcox County",4,23,137,77,60
050,01,131,"Alabama","Wilcox County",4,24,125,61,64
050,01,131,"Alabama","Wilcox County",4,25,112,55,57
050,01,131,"Alabama","Wilcox County",4,26,122,67,55
050,01,131,"Alabama","Wilcox County",4,27,116,51,65
050,01,131,"Alabama","Wilcox County",4,28,121,58,63
050,01,131,"Alabama","Wilcox County",4,29,122,65,57
050,01,131,"Alabama","Wilcox County",4,30,116,62,54
050,01,131,"Alabama","Wilcox County",4,31,133,76,57
050,01,131,"Alabama","Wilcox County",4,32,116,58,58
050,01,131,"Alabama","Wilcox County",4,33,125,68,57
050,01,131,"Alabama","Wilcox County",4,34,100,50,50
050,01,131,"Alabama","Wilcox County",4,35,95,45,50
050,01,131,"Alabama","Wilcox County",4,36,88,44,44
050,01,131,"Alabama","Wilcox County",4,37,93,44,49
050,01,131,"Alabama","Wilcox County",4,38,101,52,49
050,01,131,"Alabama","Wilcox County",4,39,94,42,52
050,01,131,"Alabama","Wilcox County",4,40,119,55,64
050,01,131,"Alabama","Wilcox County",4,41,122,55,67
050,01,131,"Alabama","Wilcox County",4,42,112,46,66
050,01,131,"Alabama","Wilcox County",4,43,121,49,72
050,01,131,"Alabama","Wilcox County",4,44,112,48,64
050,01,131,"Alabama","Wilcox County",4,45,115,49,66
050,01,131,"Alabama","Wilcox County",4,46,105,47,58
050,01,131,"Alabama","Wilcox County",4,47,99,48,51
050,01,131,"Alabama","Wilcox County",4,48,107,53,54
050,01,131,"Alabama","Wilcox County",4,49,138,61,77
050,01,131,"Alabama","Wilcox County",4,50,117,54,63
050,01,131,"Alabama","Wilcox County",4,51,128,63,65
050,01,131,"Alabama","Wilcox County",4,52,129,55,74
050,01,131,"Alabama","Wilcox County",4,53,117,50,67
050,01,131,"Alabama","Wilcox County",4,54,111,50,61
050,01,131,"Alabama","Wilcox County",4,55,114,47,67
050,01,131,"Alabama","Wilcox County",4,56,145,71,74
050,01,131,"Alabama","Wilcox County",4,57,135,61,74
050,01,131,"Alabama","Wilcox County",4,58,140,66,74
050,01,131,"Alabama","Wilcox County",4,59,147,72,75
050,01,131,"Alabama","Wilcox County",4,60,137,56,81
050,01,131,"Alabama","Wilcox County",4,61,122,48,74
050,01,131,"Alabama","Wilcox County",4,62,123,52,71
050,01,131,"Alabama","Wilcox County",4,63,129,63,66
050,01,131,"Alabama","Wilcox County",4,64,132,65,67
050,01,131,"Alabama","Wilcox County",4,65,141,71,70
050,01,131,"Alabama","Wilcox County",4,66,143,67,76
050,01,131,"Alabama","Wilcox County",4,67,154,73,81
050,01,131,"Alabama","Wilcox County",4,68,156,74,82
050,01,131,"Alabama","Wilcox County",4,69,138,66,72
050,01,131,"Alabama","Wilcox County",4,70,132,65,67
050,01,131,"Alabama","Wilcox County",4,71,123,60,63
050,01,131,"Alabama","Wilcox County",4,72,111,56,55
050,01,131,"Alabama","Wilcox County",4,73,124,57,67
050,01,131,"Alabama","Wilcox County",4,74,125,57,68
050,01,131,"Alabama","Wilcox County",4,75,121,61,60
050,01,131,"Alabama","Wilcox County",4,76,92,41,51
050,01,131,"Alabama","Wilcox County",4,77,84,37,47
050,01,131,"Alabama","Wilcox County",4,78,81,30,51
050,01,131,"Alabama","Wilcox County",4,79,65,25,40
050,01,131,"Alabama","Wilcox County",4,80,47,20,27
050,01,131,"Alabama","Wilcox County",4,81,47,23,24
050,01,131,"Alabama","Wilcox County",4,82,55,23,32
050,01,131,"Alabama","Wilcox County",4,83,44,19,25
050,01,131,"Alabama","Wilcox County",4,84,45,10,35
050,01,131,"Alabama","Wilcox County",4,85,257,72,185
050,01,131,"Alabama","Wilcox County",5,0,114,47,67
050,01,131,"Alabama","Wilcox County",5,1,120,48,72
050,01,131,"Alabama","Wilcox County",5,2,119,66,53
050,01,131,"Alabama","Wilcox County",5,3,122,57,65
050,01,131,"Alabama","Wilcox County",5,4,115,52,63
050,01,131,"Alabama","Wilcox County",5,5,141,66,75
050,01,131,"Alabama","Wilcox County",5,6,132,63,69
050,01,131,"Alabama","Wilcox County",5,7,103,48,55
050,01,131,"Alabama","Wilcox County",5,8,122,60,62
050,01,131,"Alabama","Wilcox County",5,9,118,54,64
050,01,131,"Alabama","Wilcox County",5,10,133,69,64
050,01,131,"Alabama","Wilcox County",5,11,118,60,58
050,01,131,"Alabama","Wilcox County",5,12,112,59,53
050,01,131,"Alabama","Wilcox County",5,13,114,60,54
050,01,131,"Alabama","Wilcox County",5,14,124,57,67
050,01,131,"Alabama","Wilcox County",5,15,130,59,71
050,01,131,"Alabama","Wilcox County",5,16,127,66,61
050,01,131,"Alabama","Wilcox County",5,17,125,60,65
050,01,131,"Alabama","Wilcox County",5,18,115,60,55
050,01,131,"Alabama","Wilcox County",5,19,107,56,51
050,01,131,"Alabama","Wilcox County",5,20,95,50,45
050,01,131,"Alabama","Wilcox County",5,21,115,55,60
050,01,131,"Alabama","Wilcox County",5,22,132,63,69
050,01,131,"Alabama","Wilcox County",5,23,141,81,60
050,01,131,"Alabama","Wilcox County",5,24,123,65,58
050,01,131,"Alabama","Wilcox County",5,25,118,51,67
050,01,131,"Alabama","Wilcox County",5,26,108,52,56
050,01,131,"Alabama","Wilcox County",5,27,123,63,60
050,01,131,"Alabama","Wilcox County",5,28,102,44,58
050,01,131,"Alabama","Wilcox County",5,29,121,60,61
050,01,131,"Alabama","Wilcox County",5,30,104,54,50
050,01,131,"Alabama","Wilcox County",5,31,116,61,55
050,01,131,"Alabama","Wilcox County",5,32,118,66,52
050,01,131,"Alabama","Wilcox County",5,33,111,56,55
050,01,131,"Alabama","Wilcox County",5,34,112,59,53
050,01,131,"Alabama","Wilcox County",5,35,99,49,50
050,01,131,"Alabama","Wilcox County",5,36,101,52,49
050,01,131,"Alabama","Wilcox County",5,37,84,40,44
050,01,131,"Alabama","Wilcox County",5,38,101,45,56
050,01,131,"Alabama","Wilcox County",5,39,93,51,42
050,01,131,"Alabama","Wilcox County",5,40,95,43,52
050,01,131,"Alabama","Wilcox County",5,41,108,46,62
050,01,131,"Alabama","Wilcox County",5,42,125,60,65
050,01,131,"Alabama","Wilcox County",5,43,115,50,65
050,01,131,"Alabama","Wilcox County",5,44,117,47,70
050,01,131,"Alabama","Wilcox County",5,45,107,42,65
050,01,131,"Alabama","Wilcox County",5,46,116,50,66
050,01,131,"Alabama","Wilcox County",5,47,100,48,52
050,01,131,"Alabama","Wilcox County",5,48,106,47,59
050,01,131,"Alabama","Wilcox County",5,49,114,56,58
050,01,131,"Alabama","Wilcox County",5,50,129,55,74
050,01,131,"Alabama","Wilcox County",5,51,106,46,60
050,01,131,"Alabama","Wilcox County",5,52,116,57,59
050,01,131,"Alabama","Wilcox County",5,53,132,55,77
050,01,131,"Alabama","Wilcox County",5,54,115,50,65
050,01,131,"Alabama","Wilcox County",5,55,112,53,59
050,01,131,"Alabama","Wilcox County",5,56,111,45,66
050,01,131,"Alabama","Wilcox County",5,57,140,65,75
050,01,131,"Alabama","Wilcox County",5,58,132,59,73
050,01,131,"Alabama","Wilcox County",5,59,138,64,74
050,01,131,"Alabama","Wilcox County",5,60,147,72,75
050,01,131,"Alabama","Wilcox County",5,61,142,60,82
050,01,131,"Alabama","Wilcox County",5,62,109,41,68
050,01,131,"Alabama","Wilcox County",5,63,115,53,62
050,01,131,"Alabama","Wilcox County",5,64,118,58,60
050,01,131,"Alabama","Wilcox County",5,65,142,67,75
050,01,131,"Alabama","Wilcox County",5,66,141,73,68
050,01,131,"Alabama","Wilcox County",5,67,143,69,74
050,01,131,"Alabama","Wilcox County",5,68,159,72,87
050,01,131,"Alabama","Wilcox County",5,69,156,71,85
050,01,131,"Alabama","Wilcox County",5,70,135,63,72
050,01,131,"Alabama","Wilcox County",5,71,129,65,64
050,01,131,"Alabama","Wilcox County",5,72,120,59,61
050,01,131,"Alabama","Wilcox County",5,73,111,56,55
050,01,131,"Alabama","Wilcox County",5,74,125,59,66
050,01,131,"Alabama","Wilcox County",5,75,117,53,64
050,01,131,"Alabama","Wilcox County",5,76,120,58,62
050,01,131,"Alabama","Wilcox County",5,77,88,38,50
050,01,131,"Alabama","Wilcox County",5,78,77,32,45
050,01,131,"Alabama","Wilcox County",5,79,78,30,48
050,01,131,"Alabama","Wilcox County",5,80,58,22,36
050,01,131,"Alabama","Wilcox County",5,81,42,16,26
050,01,131,"Alabama","Wilcox County",5,82,48,22,26
050,01,131,"Alabama","Wilcox County",5,83,50,20,30
050,01,131,"Alabama","Wilcox County",5,84,41,14,27
050,01,131,"Alabama","Wilcox County",5,85,271,71,200
050,01,133,"Alabama","Winston County",1,0,241,124,117
050,01,133,"Alabama","Winston County",1,1,238,134,104
050,01,133,"Alabama","Winston County",1,2,246,128,118
050,01,133,"Alabama","Winston County",1,3,269,123,146
050,01,133,"Alabama","Winston County",1,4,252,124,128
050,01,133,"Alabama","Winston County",1,5,255,127,128
050,01,133,"Alabama","Winston County",1,6,260,142,118
050,01,133,"Alabama","Winston County",1,7,240,124,116
050,01,133,"Alabama","Winston County",1,8,238,132,106
050,01,133,"Alabama","Winston County",1,9,251,141,110
050,01,133,"Alabama","Winston County",1,10,262,131,131
050,01,133,"Alabama","Winston County",1,11,270,136,134
050,01,133,"Alabama","Winston County",1,12,292,146,146
050,01,133,"Alabama","Winston County",1,13,310,158,152
050,01,133,"Alabama","Winston County",1,14,281,152,129
050,01,133,"Alabama","Winston County",1,15,291,144,147
050,01,133,"Alabama","Winston County",1,16,301,145,156
050,01,133,"Alabama","Winston County",1,17,289,149,140
050,01,133,"Alabama","Winston County",1,18,261,133,128
050,01,133,"Alabama","Winston County",1,19,233,126,107
050,01,133,"Alabama","Winston County",1,20,241,123,118
050,01,133,"Alabama","Winston County",1,21,249,120,129
050,01,133,"Alabama","Winston County",1,22,259,122,137
050,01,133,"Alabama","Winston County",1,23,261,133,128
050,01,133,"Alabama","Winston County",1,24,251,127,124
050,01,133,"Alabama","Winston County",1,25,250,124,126
050,01,133,"Alabama","Winston County",1,26,259,124,135
050,01,133,"Alabama","Winston County",1,27,242,121,121
050,01,133,"Alabama","Winston County",1,28,264,139,125
050,01,133,"Alabama","Winston County",1,29,253,124,129
050,01,133,"Alabama","Winston County",1,30,238,113,125
050,01,133,"Alabama","Winston County",1,31,238,130,108
050,01,133,"Alabama","Winston County",1,32,240,120,120
050,01,133,"Alabama","Winston County",1,33,248,117,131
050,01,133,"Alabama","Winston County",1,34,256,129,127
050,01,133,"Alabama","Winston County",1,35,236,113,123
050,01,133,"Alabama","Winston County",1,36,247,118,129
050,01,133,"Alabama","Winston County",1,37,248,123,125
050,01,133,"Alabama","Winston County",1,38,275,124,151
050,01,133,"Alabama","Winston County",1,39,259,131,128
050,01,133,"Alabama","Winston County",1,40,257,130,127
050,01,133,"Alabama","Winston County",1,41,256,127,129
050,01,133,"Alabama","Winston County",1,42,267,141,126
050,01,133,"Alabama","Winston County",1,43,288,156,132
050,01,133,"Alabama","Winston County",1,44,263,144,119
050,01,133,"Alabama","Winston County",1,45,272,138,134
050,01,133,"Alabama","Winston County",1,46,283,146,137
050,01,133,"Alabama","Winston County",1,47,297,152,145
050,01,133,"Alabama","Winston County",1,48,316,163,153
050,01,133,"Alabama","Winston County",1,49,349,179,170
050,01,133,"Alabama","Winston County",1,50,328,186,142
050,01,133,"Alabama","Winston County",1,51,318,165,153
050,01,133,"Alabama","Winston County",1,52,327,164,163
050,01,133,"Alabama","Winston County",1,53,324,158,166
050,01,133,"Alabama","Winston County",1,54,348,179,169
050,01,133,"Alabama","Winston County",1,55,376,202,174
050,01,133,"Alabama","Winston County",1,56,359,187,172
050,01,133,"Alabama","Winston County",1,57,396,207,189
050,01,133,"Alabama","Winston County",1,58,371,185,186
050,01,133,"Alabama","Winston County",1,59,367,175,192
050,01,133,"Alabama","Winston County",1,60,366,177,189
050,01,133,"Alabama","Winston County",1,61,346,169,177
050,01,133,"Alabama","Winston County",1,62,339,166,173
050,01,133,"Alabama","Winston County",1,63,354,176,178
050,01,133,"Alabama","Winston County",1,64,342,171,171
050,01,133,"Alabama","Winston County",1,65,327,161,166
050,01,133,"Alabama","Winston County",1,66,317,158,159
050,01,133,"Alabama","Winston County",1,67,296,159,137
050,01,133,"Alabama","Winston County",1,68,291,142,149
050,01,133,"Alabama","Winston County",1,69,308,152,156
050,01,133,"Alabama","Winston County",1,70,315,155,160
050,01,133,"Alabama","Winston County",1,71,273,123,150
050,01,133,"Alabama","Winston County",1,72,309,149,160
050,01,133,"Alabama","Winston County",1,73,309,141,168
050,01,133,"Alabama","Winston County",1,74,216,96,120
050,01,133,"Alabama","Winston County",1,75,234,108,126
050,01,133,"Alabama","Winston County",1,76,215,95,120
050,01,133,"Alabama","Winston County",1,77,215,102,113
050,01,133,"Alabama","Winston County",1,78,185,80,105
050,01,133,"Alabama","Winston County",1,79,169,67,102
050,01,133,"Alabama","Winston County",1,80,156,70,86
050,01,133,"Alabama","Winston County",1,81,142,68,74
050,01,133,"Alabama","Winston County",1,82,122,52,70
050,01,133,"Alabama","Winston County",1,83,114,48,66
050,01,133,"Alabama","Winston County",1,84,96,40,56
050,01,133,"Alabama","Winston County",1,85,535,173,362
050,01,133,"Alabama","Winston County",2,0,240,125,115
050,01,133,"Alabama","Winston County",2,1,237,132,105
050,01,133,"Alabama","Winston County",2,2,246,130,116
050,01,133,"Alabama","Winston County",2,3,262,124,138
050,01,133,"Alabama","Winston County",2,4,254,122,132
050,01,133,"Alabama","Winston County",2,5,254,126,128
050,01,133,"Alabama","Winston County",2,6,258,138,120
050,01,133,"Alabama","Winston County",2,7,244,127,117
050,01,133,"Alabama","Winston County",2,8,239,130,109
050,01,133,"Alabama","Winston County",2,9,247,137,110
050,01,133,"Alabama","Winston County",2,10,257,133,124
050,01,133,"Alabama","Winston County",2,11,265,134,131
050,01,133,"Alabama","Winston County",2,12,286,145,141
050,01,133,"Alabama","Winston County",2,13,305,156,149
050,01,133,"Alabama","Winston County",2,14,287,154,133
050,01,133,"Alabama","Winston County",2,15,291,147,144
050,01,133,"Alabama","Winston County",2,16,298,143,155
050,01,133,"Alabama","Winston County",2,17,294,148,146
050,01,133,"Alabama","Winston County",2,18,254,130,124
050,01,133,"Alabama","Winston County",2,19,226,120,106
050,01,133,"Alabama","Winston County",2,20,249,128,121
050,01,133,"Alabama","Winston County",2,21,249,121,128
050,01,133,"Alabama","Winston County",2,22,258,121,137
050,01,133,"Alabama","Winston County",2,23,262,131,131
050,01,133,"Alabama","Winston County",2,24,250,125,125
050,01,133,"Alabama","Winston County",2,25,251,126,125
050,01,133,"Alabama","Winston County",2,26,260,126,134
050,01,133,"Alabama","Winston County",2,27,247,125,122
050,01,133,"Alabama","Winston County",2,28,258,136,122
050,01,133,"Alabama","Winston County",2,29,253,127,126
050,01,133,"Alabama","Winston County",2,30,244,117,127
050,01,133,"Alabama","Winston County",2,31,238,126,112
050,01,133,"Alabama","Winston County",2,32,245,126,119
050,01,133,"Alabama","Winston County",2,33,249,120,129
050,01,133,"Alabama","Winston County",2,34,252,125,127
050,01,133,"Alabama","Winston County",2,35,244,118,126
050,01,133,"Alabama","Winston County",2,36,240,114,126
050,01,133,"Alabama","Winston County",2,37,247,121,126
050,01,133,"Alabama","Winston County",2,38,270,125,145
050,01,133,"Alabama","Winston County",2,39,259,127,132
050,01,133,"Alabama","Winston County",2,40,258,131,127
050,01,133,"Alabama","Winston County",2,41,255,127,128
050,01,133,"Alabama","Winston County",2,42,264,137,127
050,01,133,"Alabama","Winston County",2,43,287,154,133
050,01,133,"Alabama","Winston County",2,44,265,143,122
050,01,133,"Alabama","Winston County",2,45,269,138,131
050,01,133,"Alabama","Winston County",2,46,281,144,137
050,01,133,"Alabama","Winston County",2,47,290,149,141
050,01,133,"Alabama","Winston County",2,48,309,159,150
050,01,133,"Alabama","Winston County",2,49,342,176,166
050,01,133,"Alabama","Winston County",2,50,332,183,149
050,01,133,"Alabama","Winston County",2,51,321,172,149
050,01,133,"Alabama","Winston County",2,52,325,163,162
050,01,133,"Alabama","Winston County",2,53,322,158,164
050,01,133,"Alabama","Winston County",2,54,343,174,169
050,01,133,"Alabama","Winston County",2,55,367,196,171
050,01,133,"Alabama","Winston County",2,56,365,191,174
050,01,133,"Alabama","Winston County",2,57,382,199,183
050,01,133,"Alabama","Winston County",2,58,378,191,187
050,01,133,"Alabama","Winston County",2,59,367,179,188
050,01,133,"Alabama","Winston County",2,60,366,175,191
050,01,133,"Alabama","Winston County",2,61,346,167,179
050,01,133,"Alabama","Winston County",2,62,342,167,175
050,01,133,"Alabama","Winston County",2,63,353,174,179
050,01,133,"Alabama","Winston County",2,64,344,171,173
050,01,133,"Alabama","Winston County",2,65,330,162,168
050,01,133,"Alabama","Winston County",2,66,320,160,160
050,01,133,"Alabama","Winston County",2,67,299,157,142
050,01,133,"Alabama","Winston County",2,68,288,142,146
050,01,133,"Alabama","Winston County",2,69,306,150,156
050,01,133,"Alabama","Winston County",2,70,313,153,160
050,01,133,"Alabama","Winston County",2,71,281,130,151
050,01,133,"Alabama","Winston County",2,72,291,137,154
050,01,133,"Alabama","Winston County",2,73,319,149,170
050,01,133,"Alabama","Winston County",2,74,220,100,120
050,01,133,"Alabama","Winston County",2,75,230,105,125
050,01,133,"Alabama","Winston County",2,76,217,97,120
050,01,133,"Alabama","Winston County",2,77,220,103,117
050,01,133,"Alabama","Winston County",2,78,186,84,102
050,01,133,"Alabama","Winston County",2,79,168,68,100
050,01,133,"Alabama","Winston County",2,80,153,66,87
050,01,133,"Alabama","Winston County",2,81,141,66,75
050,01,133,"Alabama","Winston County",2,82,126,56,70
050,01,133,"Alabama","Winston County",2,83,111,47,64
050,01,133,"Alabama","Winston County",2,84,98,40,58
050,01,133,"Alabama","Winston County",2,85,534,174,360
050,01,133,"Alabama","Winston County",3,0,215,115,100
050,01,133,"Alabama","Winston County",3,1,242,128,114
050,01,133,"Alabama","Winston County",3,2,241,129,112
050,01,133,"Alabama","Winston County",3,3,253,125,128
050,01,133,"Alabama","Winston County",3,4,263,128,135
050,01,133,"Alabama","Winston County",3,5,270,131,139
050,01,133,"Alabama","Winston County",3,6,258,126,132
050,01,133,"Alabama","Winston County",3,7,262,134,128
050,01,133,"Alabama","Winston County",3,8,251,131,120
050,01,133,"Alabama","Winston County",3,9,250,140,110
050,01,133,"Alabama","Winston County",3,10,255,143,112
050,01,133,"Alabama","Winston County",3,11,274,143,131
050,01,133,"Alabama","Winston County",3,12,277,143,134
050,01,133,"Alabama","Winston County",3,13,287,140,147
050,01,133,"Alabama","Winston County",3,14,311,157,154
050,01,133,"Alabama","Winston County",3,15,302,166,136
050,01,133,"Alabama","Winston County",3,16,312,159,153
050,01,133,"Alabama","Winston County",3,17,306,153,153
050,01,133,"Alabama","Winston County",3,18,261,133,128
050,01,133,"Alabama","Winston County",3,19,196,100,96
050,01,133,"Alabama","Winston County",3,20,246,128,118
050,01,133,"Alabama","Winston County",3,21,254,124,130
050,01,133,"Alabama","Winston County",3,22,255,123,132
050,01,133,"Alabama","Winston County",3,23,261,125,136
050,01,133,"Alabama","Winston County",3,24,268,138,130
050,01,133,"Alabama","Winston County",3,25,263,134,129
050,01,133,"Alabama","Winston County",3,26,258,125,133
050,01,133,"Alabama","Winston County",3,27,249,123,126
050,01,133,"Alabama","Winston County",3,28,249,126,123
050,01,133,"Alabama","Winston County",3,29,269,144,125
050,01,133,"Alabama","Winston County",3,30,251,126,125
050,01,133,"Alabama","Winston County",3,31,241,110,131
050,01,133,"Alabama","Winston County",3,32,228,120,108
050,01,133,"Alabama","Winston County",3,33,260,132,128
050,01,133,"Alabama","Winston County",3,34,259,122,137
050,01,133,"Alabama","Winston County",3,35,243,126,117
050,01,133,"Alabama","Winston County",3,36,253,122,131
050,01,133,"Alabama","Winston County",3,37,238,112,126
050,01,133,"Alabama","Winston County",3,38,252,124,128
050,01,133,"Alabama","Winston County",3,39,268,122,146
050,01,133,"Alabama","Winston County",3,40,261,129,132
050,01,133,"Alabama","Winston County",3,41,259,130,129
050,01,133,"Alabama","Winston County",3,42,264,129,135
050,01,133,"Alabama","Winston County",3,43,263,135,128
050,01,133,"Alabama","Winston County",3,44,290,150,140
050,01,133,"Alabama","Winston County",3,45,272,146,126
050,01,133,"Alabama","Winston County",3,46,290,142,148
050,01,133,"Alabama","Winston County",3,47,288,153,135
050,01,133,"Alabama","Winston County",3,48,302,157,145
050,01,133,"Alabama","Winston County",3,49,309,157,152
050,01,133,"Alabama","Winston County",3,50,339,174,165
050,01,133,"Alabama","Winston County",3,51,340,187,153
050,01,133,"Alabama","Winston County",3,52,331,170,161
050,01,133,"Alabama","Winston County",3,53,328,166,162
050,01,133,"Alabama","Winston County",3,54,331,160,171
050,01,133,"Alabama","Winston County",3,55,343,168,175
050,01,133,"Alabama","Winston County",3,56,374,201,173
050,01,133,"Alabama","Winston County",3,57,381,200,181
050,01,133,"Alabama","Winston County",3,58,393,209,184
050,01,133,"Alabama","Winston County",3,59,376,190,186
050,01,133,"Alabama","Winston County",3,60,382,187,195
050,01,133,"Alabama","Winston County",3,61,362,173,189
050,01,133,"Alabama","Winston County",3,62,355,178,177
050,01,133,"Alabama","Winston County",3,63,327,159,168
050,01,133,"Alabama","Winston County",3,64,357,175,182
050,01,133,"Alabama","Winston County",3,65,335,166,169
050,01,133,"Alabama","Winston County",3,66,334,167,167
050,01,133,"Alabama","Winston County",3,67,316,159,157
050,01,133,"Alabama","Winston County",3,68,299,156,143
050,01,133,"Alabama","Winston County",3,69,271,134,137
050,01,133,"Alabama","Winston County",3,70,304,150,154
050,01,133,"Alabama","Winston County",3,71,297,147,150
050,01,133,"Alabama","Winston County",3,72,274,125,149
050,01,133,"Alabama","Winston County",3,73,271,123,148
050,01,133,"Alabama","Winston County",3,74,297,137,160
050,01,133,"Alabama","Winston County",3,75,207,93,114
050,01,133,"Alabama","Winston County",3,76,216,97,119
050,01,133,"Alabama","Winston County",3,77,212,92,120
050,01,133,"Alabama","Winston County",3,78,205,99,106
050,01,133,"Alabama","Winston County",3,79,174,71,103
050,01,133,"Alabama","Winston County",3,80,156,59,97
050,01,133,"Alabama","Winston County",3,81,134,58,76
050,01,133,"Alabama","Winston County",3,82,126,53,73
050,01,133,"Alabama","Winston County",3,83,117,53,64
050,01,133,"Alabama","Winston County",3,84,103,42,61
050,01,133,"Alabama","Winston County",3,85,539,186,353
050,01,133,"Alabama","Winston County",4,0,239,130,109
050,01,133,"Alabama","Winston County",4,1,224,118,106
050,01,133,"Alabama","Winston County",4,2,255,138,117
050,01,133,"Alabama","Winston County",4,3,246,126,120
050,01,133,"Alabama","Winston County",4,4,259,129,130
050,01,133,"Alabama","Winston County",4,5,268,132,136
050,01,133,"Alabama","Winston County",4,6,275,133,142
050,01,133,"Alabama","Winston County",4,7,273,134,139
050,01,133,"Alabama","Winston County",4,8,268,139,129
050,01,133,"Alabama","Winston County",4,9,260,135,125
050,01,133,"Alabama","Winston County",4,10,253,141,112
050,01,133,"Alabama","Winston County",4,11,273,153,120
050,01,133,"Alabama","Winston County",4,12,268,142,126
050,01,133,"Alabama","Winston County",4,13,290,150,140
050,01,133,"Alabama","Winston County",4,14,286,139,147
050,01,133,"Alabama","Winston County",4,15,310,156,154
050,01,133,"Alabama","Winston County",4,16,307,165,142
050,01,133,"Alabama","Winston County",4,17,311,156,155
050,01,133,"Alabama","Winston County",4,18,250,123,127
050,01,133,"Alabama","Winston County",4,19,205,110,95
050,01,133,"Alabama","Winston County",4,20,221,114,107
050,01,133,"Alabama","Winston County",4,21,251,132,119
050,01,133,"Alabama","Winston County",4,22,280,132,148
050,01,133,"Alabama","Winston County",4,23,284,138,146
050,01,133,"Alabama","Winston County",4,24,269,123,146
050,01,133,"Alabama","Winston County",4,25,257,139,118
050,01,133,"Alabama","Winston County",4,26,262,133,129
050,01,133,"Alabama","Winston County",4,27,254,129,125
050,01,133,"Alabama","Winston County",4,28,264,132,132
050,01,133,"Alabama","Winston County",4,29,257,136,121
050,01,133,"Alabama","Winston County",4,30,266,140,126
050,01,133,"Alabama","Winston County",4,31,275,139,136
050,01,133,"Alabama","Winston County",4,32,251,116,135
050,01,133,"Alabama","Winston County",4,33,243,126,117
050,01,133,"Alabama","Winston County",4,34,258,128,130
050,01,133,"Alabama","Winston County",4,35,262,124,138
050,01,133,"Alabama","Winston County",4,36,243,125,118
050,01,133,"Alabama","Winston County",4,37,251,124,127
050,01,133,"Alabama","Winston County",4,38,234,110,124
050,01,133,"Alabama","Winston County",4,39,245,124,121
050,01,133,"Alabama","Winston County",4,40,265,119,146
050,01,133,"Alabama","Winston County",4,41,272,135,137
050,01,133,"Alabama","Winston County",4,42,252,128,124
050,01,133,"Alabama","Winston County",4,43,275,131,144
050,01,133,"Alabama","Winston County",4,44,257,139,118
050,01,133,"Alabama","Winston County",4,45,285,146,139
050,01,133,"Alabama","Winston County",4,46,281,151,130
050,01,133,"Alabama","Winston County",4,47,283,140,143
050,01,133,"Alabama","Winston County",4,48,287,152,135
050,01,133,"Alabama","Winston County",4,49,295,152,143
050,01,133,"Alabama","Winston County",4,50,308,150,158
050,01,133,"Alabama","Winston County",4,51,351,180,171
050,01,133,"Alabama","Winston County",4,52,349,194,155
050,01,133,"Alabama","Winston County",4,53,335,176,159
050,01,133,"Alabama","Winston County",4,54,340,173,167
050,01,133,"Alabama","Winston County",4,55,319,155,164
050,01,133,"Alabama","Winston County",4,56,347,171,176
050,01,133,"Alabama","Winston County",4,57,374,199,175
050,01,133,"Alabama","Winston County",4,58,383,203,180
050,01,133,"Alabama","Winston County",4,59,397,217,180
050,01,133,"Alabama","Winston County",4,60,376,187,189
050,01,133,"Alabama","Winston County",4,61,383,188,195
050,01,133,"Alabama","Winston County",4,62,364,174,190
050,01,133,"Alabama","Winston County",4,63,344,172,172
050,01,133,"Alabama","Winston County",4,64,339,165,174
050,01,133,"Alabama","Winston County",4,65,346,170,176
050,01,133,"Alabama","Winston County",4,66,330,167,163
050,01,133,"Alabama","Winston County",4,67,334,161,173
050,01,133,"Alabama","Winston County",4,68,312,155,157
050,01,133,"Alabama","Winston County",4,69,290,153,137
050,01,133,"Alabama","Winston County",4,70,269,129,140
050,01,133,"Alabama","Winston County",4,71,290,147,143
050,01,133,"Alabama","Winston County",4,72,280,143,137
050,01,133,"Alabama","Winston County",4,73,266,120,146
050,01,133,"Alabama","Winston County",4,74,263,117,146
050,01,133,"Alabama","Winston County",4,75,286,131,155
050,01,133,"Alabama","Winston County",4,76,191,83,108
050,01,133,"Alabama","Winston County",4,77,205,92,113
050,01,133,"Alabama","Winston County",4,78,198,90,108
050,01,133,"Alabama","Winston County",4,79,187,88,99
050,01,133,"Alabama","Winston County",4,80,162,65,97
050,01,133,"Alabama","Winston County",4,81,144,55,89
050,01,133,"Alabama","Winston County",4,82,118,47,71
050,01,133,"Alabama","Winston County",4,83,115,50,65
050,01,133,"Alabama","Winston County",4,84,102,45,57
050,01,133,"Alabama","Winston County",4,85,545,189,356
050,01,133,"Alabama","Winston County",5,0,248,138,110
050,01,133,"Alabama","Winston County",5,1,220,115,105
050,01,133,"Alabama","Winston County",5,2,224,118,106
050,01,133,"Alabama","Winston County",5,3,252,132,120
050,01,133,"Alabama","Winston County",5,4,249,132,117
050,01,133,"Alabama","Winston County",5,5,255,130,125
050,01,133,"Alabama","Winston County",5,6,258,132,126
050,01,133,"Alabama","Winston County",5,7,275,128,147
050,01,133,"Alabama","Winston County",5,8,265,137,128
050,01,133,"Alabama","Winston County",5,9,270,136,134
050,01,133,"Alabama","Winston County",5,10,264,134,130
050,01,133,"Alabama","Winston County",5,11,254,137,117
050,01,133,"Alabama","Winston County",5,12,275,159,116
050,01,133,"Alabama","Winston County",5,13,270,140,130
050,01,133,"Alabama","Winston County",5,14,302,155,147
050,01,133,"Alabama","Winston County",5,15,288,141,147
050,01,133,"Alabama","Winston County",5,16,302,151,151
050,01,133,"Alabama","Winston County",5,17,303,162,141
050,01,133,"Alabama","Winston County",5,18,270,141,129
050,01,133,"Alabama","Winston County",5,19,195,99,96
050,01,133,"Alabama","Winston County",5,20,230,123,107
050,01,133,"Alabama","Winston County",5,21,224,119,105
050,01,133,"Alabama","Winston County",5,22,262,133,129
050,01,133,"Alabama","Winston County",5,23,296,145,151
050,01,133,"Alabama","Winston County",5,24,271,126,145
050,01,133,"Alabama","Winston County",5,25,274,128,146
050,01,133,"Alabama","Winston County",5,26,249,136,113
050,01,133,"Alabama","Winston County",5,27,258,132,126
050,01,133,"Alabama","Winston County",5,28,261,131,130
050,01,133,"Alabama","Winston County",5,29,262,135,127
050,01,133,"Alabama","Winston County",5,30,256,130,126
050,01,133,"Alabama","Winston County",5,31,263,136,127
050,01,133,"Alabama","Winston County",5,32,265,133,132
050,01,133,"Alabama","Winston County",5,33,244,117,127
050,01,133,"Alabama","Winston County",5,34,243,126,117
050,01,133,"Alabama","Winston County",5,35,258,126,132
050,01,133,"Alabama","Winston County",5,36,265,122,143
050,01,133,"Alabama","Winston County",5,37,243,123,120
050,01,133,"Alabama","Winston County",5,38,262,131,131
050,01,133,"Alabama","Winston County",5,39,236,108,128
050,01,133,"Alabama","Winston County",5,40,241,125,116
050,01,133,"Alabama","Winston County",5,41,272,122,150
050,01,133,"Alabama","Winston County",5,42,265,137,128
050,01,133,"Alabama","Winston County",5,43,247,127,120
050,01,133,"Alabama","Winston County",5,44,268,127,141
050,01,133,"Alabama","Winston County",5,45,254,139,115
050,01,133,"Alabama","Winston County",5,46,283,143,140
050,01,133,"Alabama","Winston County",5,47,280,153,127
050,01,133,"Alabama","Winston County",5,48,282,135,147
050,01,133,"Alabama","Winston County",5,49,281,147,134
050,01,133,"Alabama","Winston County",5,50,301,153,148
050,01,133,"Alabama","Winston County",5,51,318,155,163
050,01,133,"Alabama","Winston County",5,52,348,174,174
050,01,133,"Alabama","Winston County",5,53,348,196,152
050,01,133,"Alabama","Winston County",5,54,338,178,160
050,01,133,"Alabama","Winston County",5,55,334,171,163
050,01,133,"Alabama","Winston County",5,56,327,158,169
050,01,133,"Alabama","Winston County",5,57,341,165,176
050,01,133,"Alabama","Winston County",5,58,388,207,181
050,01,133,"Alabama","Winston County",5,59,389,205,184
050,01,133,"Alabama","Winston County",5,60,406,225,181
050,01,133,"Alabama","Winston County",5,61,371,185,186
050,01,133,"Alabama","Winston County",5,62,376,181,195
050,01,133,"Alabama","Winston County",5,63,346,163,183
050,01,133,"Alabama","Winston County",5,64,351,174,177
050,01,133,"Alabama","Winston County",5,65,331,159,172
050,01,133,"Alabama","Winston County",5,66,358,181,177
050,01,133,"Alabama","Winston County",5,67,320,164,156
050,01,133,"Alabama","Winston County",5,68,322,159,163
050,01,133,"Alabama","Winston County",5,69,298,149,149
050,01,133,"Alabama","Winston County",5,70,285,143,142
050,01,133,"Alabama","Winston County",5,71,259,126,133
050,01,133,"Alabama","Winston County",5,72,278,142,136
050,01,133,"Alabama","Winston County",5,73,269,137,132
050,01,133,"Alabama","Winston County",5,74,251,110,141
050,01,133,"Alabama","Winston County",5,75,253,111,142
050,01,133,"Alabama","Winston County",5,76,279,123,156
050,01,133,"Alabama","Winston County",5,77,183,80,103
050,01,133,"Alabama","Winston County",5,78,195,94,101
050,01,133,"Alabama","Winston County",5,79,186,79,107
050,01,133,"Alabama","Winston County",5,80,171,80,91
050,01,133,"Alabama","Winston County",5,81,149,60,89
050,01,133,"Alabama","Winston County",5,82,130,43,87
050,01,133,"Alabama","Winston County",5,83,108,41,67
050,01,133,"Alabama","Winston County",5,84,99,39,60
050,01,133,"Alabama","Winston County",5,85,571,211,360

